first_player_current_score,second_player_current_score,current_score_difference,first_player_average_score,second_player_average_score,average_score_difference,first_player_rating,second_player_rating,rating_difference,first_player_number_of_bingos,second_player_number_of_bingos,first_player_average_number_of_bingos,second_player_average_number_of_bingos,number_of_tiles_left,first_player_number_of_turns,second_player_number_of_turns,progress,first_player_rack_blanks,second_player_rack_blanks,first_player_rack_value,second_player_rack_value,final_turn,actual_outcome,predicted_outcome,first_player_probability,second_player_probability
114,236,-122,16.285714,33.714286,-122,1193,1177,16,0,1,0,0.142857,52,7,7,0.673077,0,0,13,11,false,false,false,0.026,0.974
96,67,29,16,11.166667,29,1193,1220,-27,0,0,0,0,58,6,6,0.741379,1,1,9,20,false,false,true,0.557,0.443
167,195,-28,20.875,24.375,-28,1270,1261,9,1,0,0.125,0,49,8,8,0.755102,0,0,8,16,false,false,false,0.157,0.843
207,213,-6,14.785714,16.384615,-6,526,502,24,0,0,0,0,22,14,13,2.272727,0,0,10,10,false,false,false,0.42,0.58
204,263,-59,12.75,17.533333,-59,595,540,55,0,0,0,0,3,16,15,14.333333,0,0,8,19,false,false,false,0.014,0.986
107,141,-34,35.666667,47,-34,1699,1580,119,1,0,0.333333,0,73,3,3,0.410959,0,0,8,19,false,false,false,0.082,0.918
12,0,12,12,0,12,1415,1361,54,0,0,0,0,97,1,0,0.319588,0,0,13,0,false,false,true,0.561,0.439
146,226,-80,9.733333,16.142857,-80,818,826,-8,0,0,0,0,26,15,14,2.038462,1,0,6,14,false,false,false,0.016,0.984
345,349,-4,23,23.266667,-4,1354,1210,144,0,1,0,0.066667,-8,15,15,-4.125,0,0,7,4,false,false,false,0.082,0.918
145,113,32,29,22.6,32,1770,1745,25,1,0,0.2,0,67,5,5,0.492537,0,0,7,19,false,false,true,0.63,0.37
188,324,-136,11.75,20.25,-136,977,1100,-123,0,1,0,0.0625,8,16,16,5.125,0,0,12,24,false,false,false,0,1
330,405,-75,19.411765,25.3125,-75,1176,1133,43,1,0,0.058824,0,-5,17,16,-6.8,0,0,2,3,false,false,false,0,1
287,356,-69,14.35,18.736842,-69,1101,1130,-29,1,1,0.05,0.052632,-13,20,19,-3.461538,0,1,3,3,false,false,false,0,1
261,225,36,23.727273,22.5,36,1070,814,256,1,1,0.090909,0.1,20,11,10,1.65,0,1,9,11,false,false,true,0.772,0.228
250,305,-55,17.857143,21.785714,-55,1063,1134,-71,1,0,0.071429,0,22,14,14,2,0,1,13,12,false,false,false,0,1
116,113,3,16.571429,18.833333,3,1691,1510,181,0,0,0,0,55,7,6,0.545455,1,0,21,13,false,false,true,0.592,0.408
120,150,-30,24,37.5,-30,1045,1100,-55,0,0,0,0,67,5,4,0.507463,0,1,7,9,false,false,false,0.016,0.984
171,340,-169,12.214286,26.153846,-169,940,947,-7,0,2,0,0.153846,9,14,13,3.888889,1,0,15,19,false,false,false,0,1
291,450,-159,17.117647,28.125,-159,976,995,-19,1,2,0.058824,0.125,-15,17,16,-2.533333,1,0,2,4,false,false,false,0,1
248,289,-41,13.052632,16.055556,-41,226,361,-135,0,0,0,0,-25,19,18,-1.76,0,0,11,11,false,false,false,0,1
75,90,-15,8.333333,11.25,-15,288,359,-71,0,0,0,0,58,9,8,0.465517,0,0,14,13,false,false,false,0.223,0.777
268,275,-7,20.615385,21.153846,-7,1803,1658,145,1,0,0.076923,0,1,13,13,33,0,0,7,9,false,false,false,0.097,0.903
161,178,-17,20.125,22.25,-17,1269,1477,-208,1,0,0.125,0,46,8,8,0.76087,0,1,11,13,false,false,false,0.156,0.844
333,354,-21,17.526316,18.631579,-21,944,1095,-151,0,1,0,0.052632,-14,19,19,-2.785714,0,0,1,3,false,false,false,0.029,0.971
229,275,-46,17.615385,21.153846,-46,889,895,-6,0,1,0,0.076923,13,13,13,2.846154,0,1,14,28,false,false,false,0.003,0.997
221,280,-59,17,23.333333,-59,711,746,-35,0,0,0,0,15,13,12,2.533333,0,0,9,16,false,false,false,0.006,0.994
351,356,-5,20.647059,22.25,-5,1354,1210,144,0,1,0,0.0625,-14,17,16,-2.357143,0,0,2,4,true,false,false,0.081,0.919
35,23,12,8.75,7.666667,12,1037,1016,21,0,0,0,0,85,4,3,0.682353,0,1,7,8,false,false,false,0.355,0.645
90,150,-60,22.5,37.5,-60,1045,1100,-55,0,0,0,0,70,4,4,0.485714,0,1,10,9,false,false,false,0.015,0.985
95,95,0,19,23.75,0,1432,1452,-20,0,0,0,0,67,5,4,0.537313,0,0,10,10,false,false,false,0.274,0.726
39,45,-6,19.5,22.5,-6,1312,1334,-22,0,0,0,0,83,2,2,0.46988,0,0,12,21,false,false,false,0.297,0.703
112,126,-14,18.666667,21,-14,1131,1030,101,0,0,0,0,59,6,6,0.508475,1,0,11,18,false,false,true,0.645,0.355
210,285,-75,23.333333,35.625,-75,1003,1004,-1,0,1,0,0.125,37,9,8,0.945946,0,1,7,12,false,false,false,0.025,0.975
242,316,-74,22,28.727273,-74,991,1063,-72,0,1,0,0.090909,22,11,11,1.727273,1,0,8,11,false,false,false,0.024,0.976
10,23,-13,10,23,-13,1270,1424,-154,0,0,0,0,94,1,1,0.37234,0,0,10,10,false,false,false,0.157,0.843
243,253,-10,20.25,23,-10,1110,1123,-13,0,1,0,0.090909,16,12,11,2.0625,1,1,6,17,false,false,false,0.119,0.881
119,78,41,23.8,19.5,41,711,746,-35,0,0,0,0,70,5,4,0.542857,0,0,7,12,false,false,true,0.686,0.314
135,46,89,45,23,89,1373,1334,39,1,0,0.333333,0,79,3,2,0.405063,0,0,8,7,false,false,true,0.76,0.24
329,347,-18,19.352941,20.411765,-18,1094,1041,53,1,0,0.058824,0,-19,17,17,-2,0,0,5,2,false,false,false,0.057,0.943
150,194,-44,18.75,27.714286,-44,1633,1620,13,0,0,0,0,41,8,7,0.878049,0,0,9,8,false,false,false,0.071,0.929
243,253,-10,17.357143,19.461538,-10,206,346,-140,1,0,0.071429,0,7,14,13,6.142857,0,0,27,13,false,false,false,0.112,0.888
301,328,-27,23.153846,27.333333,-27,1439,1314,125,0,0,0,0,2,13,12,14,0,1,3,8,false,false,false,0.036,0.964
255,338,-83,13.421053,17.789474,-83,653,820,-167,0,0,0,0,-28,19,19,-1.357143,0,0,1,1,true,false,false,0,1
17,26,-9,8.5,26,-9,563,523,40,0,0,0,0,88,2,1,0.420455,0,0,17,12,false,false,false,0.327,0.673
304,311,-7,20.266667,22.214286,-7,1341,1606,-265,1,0,0.066667,0,-7,15,14,-4.714286,0,0,8,5,false,false,false,0.026,0.974
264,349,-85,16.5,21.8125,-85,594,648,-54,1,1,0.0625,0.0625,3,16,16,13.333333,0,0,7,6,false,false,false,0,1
138,211,-73,15.333333,23.444444,-73,480,739,-259,0,0,0,0,43,9,9,0.906977,0,0,8,16,false,false,false,0.036,0.964
117,104,13,23.4,20.8,13,892,856,36,0,0,0,0,65,5,5,0.538462,1,0,7,7,false,false,true,0.775,0.225
36,167,-131,6,27.833333,-131,1422,1510,-88,0,1,0,0.166667,71,6,6,0.549296,0,0,18,22,false,false,false,0.01,0.99
316,374,-58,18.588235,23.375,-58,480,739,-259,1,0,0.058824,0,-4,17,16,-9.75,0,0,4,7,false,false,false,0,1
198,247,-49,16.5,22.454545,-49,771,668,103,0,0,0,0,15,12,11,2.533333,0,0,7,23,false,false,false,0.074,0.926
237,274,-37,23.7,27.4,-37,801,679,122,1,0,0.1,0,19,10,10,1.526316,1,0,14,14,false,false,false,0.107,0.893
95,72,23,19,18,23,1331,1374,-43,0,0,0,0,63,5,4,0.52381,0,0,14,15,false,false,false,0.424,0.576
22,0,22,22,0,22,1030,998,32,0,0,0,0,95,1,0,0.389474,0,0,13,0,false,false,true,0.564,0.436
46,45,1,15.333333,15,1,1552,1803,-251,0,0,0,0,83,3,3,0.39759,0,0,7,14,false,false,false,0.177,0.823
182,305,-123,12.133333,20.333333,-123,1305,1307,-2,0,1,0,0.066667,4,15,15,10.25,0,1,8,9,false,false,false,0,1
147,182,-35,24.5,36.4,-35,1537,1539,-2,0,1,0,0.2,51,6,5,0.666667,0,0,25,7,false,false,false,0.398,0.602
243,274,-31,16.2,18.266667,-31,595,538,57,0,0,0,0,0,15,15,0,0,0,10,5,false,false,false,0.19,0.81
65,54,11,13,13.5,11,814,830,-16,0,0,0,0,69,5,4,0.594203,0,0,14,11,false,false,false,0.453,0.547
207,264,-57,20.7,26.4,-57,689,804,-115,0,0,0,0,25,10,10,1.4,0,0,10,10,false,false,false,0.021,0.979
342,376,-34,18,19.789474,-34,721,757,-36,0,2,0,0.105263,-19,19,19,-2,0,0,1,1,true,false,false,0.104,0.896
322,374,-52,17.888889,20.777778,-52,1493,1413,80,0,1,0,0.055556,-21,18,18,-1.714286,0,0,2,1,true,false,false,0,1
278,300,-22,23.166667,27.272727,-22,1331,1347,-16,1,1,0.083333,0.090909,3,12,11,10.666667,0,1,10,9,false,false,false,0.041,0.959
86,71,15,17.2,17.75,15,1203,1270,-67,0,0,0,0,75,5,4,0.586667,1,0,6,18,false,false,false,0.284,0.716
145,201,-56,14.5,20.1,-56,595,540,55,0,0,0,0,34,10,10,1.264706,0,0,14,15,false,false,false,0.264,0.736
329,334,-5,15.666667,16.7,-5,430,542,-112,0,1,0,0.05,-22,21,20,-2.181818,0,0,2,5,false,false,false,0.324,0.676
169,214,-45,14.083333,19.454545,-45,830,787,43,0,0,0,0,25,12,11,1.52,0,0,8,8,false,false,false,0.088,0.912
63,62,1,21,20.666667,1,985,1062,-77,0,0,0,0,79,3,3,0.468354,0,0,8,16,false,false,false,0.269,0.731
100,88,12,20,22,12,1266,1339,-73,0,0,0,0,72,5,4,0.486111,0,0,17,18,false,false,false,0.165,0.835
110,117,-7,22,23.4,-7,450,624,-174,0,0,0,0,63,5,5,0.52381,0,0,7,12,false,false,false,0.227,0.773
20,0,20,20,0,20,1645,1636,9,0,0,0,0,95,1,0,0.347368,0,0,23,0,false,false,true,0.724,0.276
166,172,-6,20.75,24.571429,-6,1110,1123,-13,0,1,0,0.142857,43,8,7,0.767442,0,0,9,19,false,false,false,0.276,0.724
136,216,-80,15.111111,24,-80,642,952,-310,0,0,0,0,40,9,9,1.1,0,0,9,12,false,false,false,0.046,0.954
94,130,-36,15.666667,26,-36,837,844,-7,0,0,0,0,70,6,5,0.585714,0,1,10,12,false,false,false,0.039,0.961
120,552,-432,5.454545,26.285714,-432,1164,1149,15,0,3,0,0.142857,3,22,21,15.666667,0,1,12,18,false,false,false,0,1
145,100,45,24.166667,16.666667,45,1652,1473,179,1,0,0.166667,0,51,6,6,0.588235,0,0,21,10,false,false,true,0.643,0.357
264,374,-110,16.5,23.375,-110,1270,1424,-154,0,2,0,0.125,-8,16,16,-4.375,0,0,14,3,false,false,false,0,1
267,318,-51,20.538462,24.461538,-51,1101,1237,-136,1,0,0.076923,0,11,13,13,3.090909,1,0,18,12,false,false,false,0.069,0.931
31,26,5,15.5,13,5,758,791,-33,0,0,0,0,85,2,2,0.458824,0,0,16,8,false,false,true,0.56,0.44
18,0,18,18,0,18,1691,1510,181,0,0,0,0,95,1,0,0.315789,0,0,13,0,false,false,true,0.676,0.324
45,14,31,15,7,31,726,818,-92,0,0,0,0,83,3,2,0.421687,0,1,7,8,false,false,false,0.22,0.78
291,359,-68,15.315789,18.894737,-68,1305,1307,-2,0,1,0,0.052632,-21,19,19,-1.952381,0,1,3,3,false,false,false,0,1
302,371,-69,20.133333,26.5,-69,991,1063,-72,0,1,0,0.071429,0,15,14,0,0,0,15,14,false,false,false,0,1
86,102,-16,10.75,14.571429,-16,226,361,-135,0,0,0,0,47,8,7,0.93617,0,0,16,14,false,false,false,0.108,0.892
216,211,5,19.636364,19.181818,5,742,868,-126,0,0,0,0,28,11,11,1.178571,0,1,9,6,false,false,false,0.399,0.601
12,26,-14,12,26,-14,1253,1324,-71,0,0,0,0,92,1,1,0.315217,0,0,11,23,false,false,false,0.229,0.771
321,355,-34,17.833333,20.882353,-34,1063,1134,-71,1,0,0.055556,0,1,18,17,44,0,0,8,11,false,false,false,0,1
81,22,59,40.5,22,59,691,695,-4,1,0,0.5,0,84,2,1,0.380952,0,0,21,13,false,false,true,0.618,0.382
291,380,-89,24.25,34.545455,-89,1388,1455,-67,0,0,0,0,4,12,11,7,1,0,16,10,false,false,false,0,1
141,323,-182,7.833333,17.944444,-182,651,567,84,0,0,0,0,0,18,18,0,0,0,12,11,false,false,false,0,1
240,264,-24,21.818182,26.4,-24,689,804,-115,0,0,0,0,21,11,10,1.666667,0,0,7,10,false,false,false,0.04,0.96
184,333,-149,7.36,13.875,-149,651,567,84,0,0,0,0,-19,25,24,-2.894737,0,0,5,13,false,false,false,0,1
233,289,-56,16.642857,22.230769,-56,727,820,-93,0,1,0,0.076923,4,14,13,8.75,0,0,12,15,false,false,false,0.001,0.999
29,36,-7,9.666667,12,-7,1636,1702,-66,0,0,0,0,85,3,3,0.341176,0,1,25,11,false,false,false,0.306,0.694
278,281,-3,21.384615,21.615385,-3,540,498,42,1,0,0.076923,0,9,13,13,5.111111,0,0,7,8,false,false,true,0.595,0.405
196,231,-35,19.6,25.666667,-35,1038,917,121,1,1,0.1,0.111111,33,10,9,1.060606,0,0,11,7,false,false,false,0.088,0.912
154,136,18,19.25,19.428571,18,796,800,-4,1,0,0.125,0,50,8,7,0.96,0,0,13,13,false,false,false,0.408,0.592
139,210,-71,13.9,23.333333,-71,837,844,-7,0,0,0,0,46,10,9,0.891304,1,1,6,10,false,false,false,0.006,0.994
14,27,-13,14,27,-13,342,263,79,0,0,0,0,94,1,1,0.361702,0,0,7,19,false,false,true,0.554,0.446
135,147,-12,16.875,21,-12,451,448,3,0,0,0,0,51,8,7,0.72549,0,1,12,19,false,false,false,0.106,0.894
83,110,-27,13.833333,22,-27,500,509,-9,0,0,0,0,62,6,5,0.66129,0,0,14,24,false,false,false,0.163,0.837
69,25,44,23,12.5,44,711,746,-35,0,0,0,0,84,3,2,0.452381,0,1,15,7,false,false,true,0.609,0.391
82,108,-26,16.4,21.6,-26,710,758,-48,0,0,0,0,68,5,5,0.544118,0,2,14,14,false,false,false,0,1
250,232,18,20.833333,19.333333,18,1093,1173,-80,0,0,0,0,25,12,12,1.72,2,0,5,14,false,false,true,0.934,0.066
35,29,6,17.5,29,6,620,698,-78,0,0,0,0,89,2,1,0.460674,0,0,19,16,false,false,false,0.161,0.839
49,55,-6,24.5,27.5,-6,1093,1173,-80,0,0,0,0,85,2,2,0.505882,0,0,19,15,false,false,false,0.48,0.52
64,45,19,21.333333,22.5,19,518,461,57,0,0,0,0,84,3,2,0.428571,0,0,11,12,false,false,true,0.771,0.229
281,364,-83,10.807692,14,-83,651,700,-49,0,0,0,0,-49,26,26,-1.142857,0,0,14,9,false,false,false,0,1
215,275,-60,15.357143,21.153846,-60,603,721,-118,0,0,0,0,18,14,13,2.388889,0,0,8,10,false,false,false,0.005,0.995
17,26,-9,8.5,13,-9,568,570,-2,0,0,0,0,87,2,2,0.425287,0,0,10,18,false,false,false,0.482,0.518
101,146,-45,14.428571,24.333333,-45,1161,1176,-15,0,1,0,0.166667,53,7,6,0.716981,0,0,10,10,false,false,false,0.268,0.732
16,12,4,16,12,4,306,361,-55,0,0,0,0,92,1,1,0.391304,0,1,7,7,false,false,false,0.156,0.844
100,136,-36,14.285714,19.428571,-36,278,1,277,0,0,0,0,44,7,7,0.840909,0,0,20,12,false,false,false,0.499,0.501
360,511,-151,32.727273,51.1,-151,1398,1431,-33,0,0,0,0,-3,11,10,-9.333333,0,0,8,21,false,false,false,0,1
299,370,-71,14.95,18.5,-71,1305,1307,-2,0,1,0,0.05,-28,20,20,-1.464286,0,1,1,3,false,false,false,0,1
239,301,-62,18.384615,23.153846,-62,1047,1253,-206,1,1,0.076923,0.076923,14,13,13,2.642857,1,0,10,15,false,false,false,0.031,0.969
88,191,-103,14.666667,38.2,-103,935,995,-60,0,1,0,0.2,62,6,5,0.629032,2,0,14,19,false,false,false,0.066,0.934
120,411,-291,8,27.4,-291,1164,1149,15,0,2,0,0.133333,28,15,15,1.678571,0,0,12,8,false,false,false,0,1
282,397,-115,13.428571,19.85,-115,1037,1016,21,1,0,0.047619,0,-10,21,20,-5.8,1,0,12,9,false,false,false,0,1
253,453,-200,19.461538,34.846154,-200,1368,1452,-84,1,2,0.076923,0.153846,7,13,13,4.571429,0,0,21,9,false,false,false,0,1
152,184,-32,16.888889,23,-32,1123,1062,61,0,0,0,0,40,9,8,1.1,0,0,18,20,false,false,false,0.282,0.718
55,84,-29,13.75,21,-29,1030,1014,16,0,0,0,0,77,4,4,0.428571,1,0,6,16,false,false,false,0.287,0.713
190,221,-31,21.111111,24.555556,-31,621,786,-165,0,0,0,0,21,9,9,1.428571,0,0,8,19,false,false,false,0.074,0.926
248,251,-3,27.555556,27.888889,-3,1167,1245,-78,1,0,0.111111,0,23,9,9,1.217391,1,0,8,11,false,false,true,0.505,0.495
314,319,-5,17.444444,17.722222,-5,1270,1261,9,1,0,0.055556,0,-8,18,18,-4.625,0,0,3,3,false,false,true,0.617,0.383
62,102,-40,20.666667,51,-40,732,868,-136,0,1,0,0.5,79,3,2,0.405063,0,0,7,12,false,false,false,0.266,0.734
34,10,24,17,10,24,758,904,-146,0,0,0,0,89,2,1,0.382022,1,0,12,10,false,false,false,0.239,0.761
216,279,-63,13.5,17.4375,-63,830,787,43,0,0,0,0,-8,16,16,-4.75,0,0,7,7,false,false,false,0.006,0.994
287,383,-96,31.888889,47.875,-96,1885,1908,-23,1,3,0.111111,0.375,8,9,8,2.875,0,0,12,19,false,false,false,0,1
158,188,-30,17.555556,20.888889,-30,1176,1211,-35,0,0,0,0,27,9,9,1.222222,0,0,9,10,false,false,false,0.263,0.737
180,130,50,20,14.444444,50,1065,948,117,0,0,0,0,46,9,9,0.847826,0,0,17,8,false,false,true,0.946,0.054
38,27,11,19,27,11,967,856,111,0,0,0,0,89,2,1,0.370787,0,0,16,22,false,false,false,0.494,0.506
299,397,-98,16.611111,22.055556,-98,1094,1159,-65,0,0,0,0,-21,18,18,-1.809524,0,0,1,1,false,false,false,0,1
156,193,-37,22.285714,27.571429,-37,1606,1593,13,0,0,0,0,51,7,7,0.568627,0,2,8,6,false,false,false,0.036,0.964
18,0,18,18,0,18,1537,1539,-2,0,0,0,0,97,1,0,0.350515,0,0,11,0,false,false,true,0.562,0.438
254,215,39,21.166667,17.916667,39,675,570,105,0,0,0,0,14,12,12,2.5,0,0,13,12,false,false,true,0.934,0.066
24,26,-2,24,26,-2,1232,1448,-216,0,0,0,0,92,1,1,0.380435,0,0,11,12,false,false,false,0.209,0.791
200,147,53,33.333333,29.4,53,1167,1245,-78,1,0,0.166667,0,50,6,5,0.56,0,1,10,13,false,false,false,0.418,0.582
68,192,-124,9.714286,27.428571,-124,1305,1307,-2,0,1,0,0.142857,54,7,7,0.759259,0,0,11,13,false,false,false,0.028,0.972
221,299,-78,15.785714,21.357143,-78,1580,1629,-49,0,1,0,0.071429,5,14,14,7.4,0,1,16,20,false,false,false,0,1
141,175,-34,20.142857,29.166667,-34,1305,1194,111,0,0,0,0,52,7,6,0.634615,0,0,14,7,false,false,false,0.153,0.847
244,308,-64,16.266667,22,-64,1159,1131,28,0,2,0,0.142857,4,15,14,9.25,0,0,10,24,false,false,false,0.001,0.999
86,60,26,43,30,26,801,679,122,1,0,0.5,0,83,2,2,0.349398,0,1,11,8,false,false,false,0.133,0.867
205,143,62,41,35.75,62,169,306,-137,2,1,0.4,0.25,51,5,4,0.607843,0,0,12,11,false,false,false,0.011,0.989
0,0,0,0,0,0,1473,1500,-27,0,0,0,0,100,1,1,0.39,0,0,16,7,false,false,true,0.529,0.471
198,281,-83,19.8,31.222222,-83,842,926,-84,0,0,0,0,21,10,9,1.428571,0,0,9,8,false,false,false,0.004,0.996
236,246,-10,13.882353,15.375,-10,999,1071,-72,0,0,0,0,-3,17,16,-13.333333,0,0,8,18,false,false,false,0.123,0.877
221,176,45,17,14.666667,45,897,996,-99,0,0,0,0,24,13,12,1.625,0,0,15,9,false,false,true,0.668,0.332
0,20,-20,0,20,-20,343,570,-227,0,0,0,0,95,1,1,0.378947,0,0,8,16,false,false,false,0.177,0.823
280,353,-73,14.736842,18.578947,-73,1064,1397,-333,0,2,0,0.105263,-6,19,19,-7.166667,1,1,9,11,false,false,false,0,1
263,324,-61,16.4375,21.6,-61,1078,1095,-17,1,1,0.0625,0.066667,-3,16,15,-12.333333,0,0,9,11,false,false,false,0,1
33,11,22,16.5,11,22,1047,1127,-80,0,0,0,0,87,2,1,0.310345,1,1,13,12,false,false,false,0.36,0.64
164,301,-137,20.5,37.625,-137,786,848,-62,0,1,0,0.125,44,8,8,0.704545,1,0,13,10,false,false,false,0.008,0.992
237,239,-2,23.7,26.555556,-2,801,679,122,1,0,0.1,0,22,10,9,1.318182,1,0,14,20,false,false,false,0.442,0.558
246,258,-12,13.666667,14.333333,-12,999,1071,-72,0,0,0,0,-13,18,18,-3.076923,0,0,6,9,false,false,true,0.737,0.263
329,365,-36,25.307692,30.416667,-36,1344,1208,136,1,1,0.076923,0.083333,7,13,12,4.285714,1,0,7,7,false,false,false,0.03,0.97
183,261,-78,22.875,37.285714,-78,1003,1004,-1,0,1,0,0.142857,45,8,7,0.777778,0,0,9,17,false,false,false,0.027,0.973
53,69,-16,17.666667,23,-16,1266,1339,-73,0,0,0,0,82,3,3,0.426829,0,0,8,18,false,false,false,0.178,0.822
245,357,-112,15.3125,22.3125,-112,342,263,79,0,0,0,0,-21,16,16,-1.619048,1,0,1,1,false,false,false,0.009,0.991
171,267,-96,9.5,14.833333,-96,818,826,-8,0,0,0,0,-1,18,18,-53,0,0,7,28,false,false,false,0,1
284,361,-77,18.933333,25.785714,-77,653,1004,-351,0,0,0,0,-6,15,14,-4.833333,0,0,16,4,true,false,false,0,1
165,146,19,33,36.5,19,1885,1908,-23,1,2,0.2,0.5,54,5,4,0.425926,0,0,11,12,false,false,true,0.835,0.165
195,199,-4,19.5,22.111111,-4,967,856,111,0,0,0,0,35,10,9,0.942857,0,0,20,19,false,false,true,0.51,0.49
195,238,-43,13.928571,18.307692,-43,518,414,104,0,1,0,0.076923,15,14,13,2.533333,0,0,13,13,false,false,false,0.122,0.878
30,35,-5,10,17.5,-5,530,683,-153,0,0,0,0,86,3,2,0.465116,0,0,8,10,false,false,false,0.176,0.824
284,324,-40,15.777778,19.058824,-40,500,509,-9,0,0,0,0,-11,18,17,-3.727273,0,1,7,6,false,false,false,0,1
146,232,-86,16.222222,25.777778,-86,1094,1159,-65,0,0,0,0,35,9,9,1.085714,1,0,15,11,false,false,false,0.045,0.955
197,286,-89,19.7,31.777778,-89,724,398,326,1,1,0.1,0.111111,39,10,9,1,1,0,9,8,false,false,false,0.039,0.961
312,336,-24,18.352941,19.764706,-24,356,498,-142,0,1,0,0.058824,-16,17,17,-2.1875,0,0,5,5,false,false,false,0.084,0.916
53,107,-54,10.6,21.4,-54,651,996,-345,0,0,0,0,66,5,5,0.681818,0,0,10,23,false,false,false,0.072,0.928
171,129,42,34.2,32.25,42,714,820,-106,1,0,0.2,0,67,5,4,0.462687,0,0,11,10,false,false,false,0.335,0.665
155,210,-55,22.142857,30,-55,1388,1366,22,0,1,0,0.142857,45,7,7,0.711111,0,0,12,19,false,false,false,0.184,0.816
266,341,-75,12.666667,16.238095,-75,813,698,115,1,0,0.047619,0,-23,21,21,-2.086957,0,0,2,6,false,false,false,0,1
267,356,-89,12.714286,16.952381,-89,714,892,-178,0,2,0,0.095238,-25,21,21,-1.68,0,0,6,3,true,false,false,0,1
69,64,5,17.25,21.333333,5,1040,1364,-324,0,0,0,0,74,4,3,0.486486,0,0,19,16,false,false,false,0.204,0.796
309,417,-108,18.176471,24.529412,-108,726,818,-92,0,1,0,0.058824,-16,17,17,-2.1875,0,0,5,2,false,false,false,0,1
267,260,7,22.25,23.636364,7,1397,1405,-8,1,0,0.083333,0,10,12,11,2.9,0,1,10,6,false,false,false,0.256,0.744
202,220,-18,18.363636,20,-18,206,346,-140,1,0,0.090909,0,22,11,11,1.954545,0,0,11,9,false,false,false,0.043,0.957
216,188,28,18,15.666667,28,1344,1314,30,0,1,0,0.083333,21,12,12,1.619048,0,1,10,16,false,false,true,0.669,0.331
19,60,-41,4.75,20,-41,1078,983,95,0,0,0,0,83,4,3,0.578313,1,0,8,9,false,false,false,0.275,0.725
250,197,53,25,21.888889,53,1093,1100,-7,2,0,0.2,0,34,10,9,0.911765,0,0,15,20,false,false,true,0.932,0.068
47,53,-6,11.75,13.25,-6,999,1165,-166,0,0,0,0,73,4,4,0.630137,0,0,15,13,false,false,false,0.184,0.816
181,207,-26,13.923077,15.923077,-26,995,965,30,0,0,0,0,19,13,13,2.105263,0,0,21,7,false,false,false,0.494,0.506
276,265,11,18.4,17.666667,11,1193,1220,-27,1,0,0.066667,0,1,15,15,43,0,0,24,15,false,false,true,0.657,0.343
227,258,-31,14.1875,16.125,-31,1182,1075,107,0,1,0,0.0625,-10,16,16,-3.9,0,1,15,15,false,false,false,0.002,0.998
16,0,16,16,0,16,925,1000,-75,0,0,0,0,96,1,0,0.458333,0,0,9,0,false,false,true,0.51,0.49
229,390,-161,12.722222,22.941176,-161,1075,1189,-114,0,0,0,0,-10,18,17,-4,0,0,4,8,false,false,false,0,1
135,139,-4,16.875,19.857143,-4,813,698,115,1,0,0.125,0,51,8,7,0.941176,0,1,7,12,false,false,false,0.201,0.799
96,94,2,16,18.8,2,1691,1510,181,0,0,0,0,62,6,5,0.483871,0,0,19,16,false,false,false,0.346,0.654
142,201,-59,23.666667,40.2,-59,1556,1616,-60,0,0,0,0,62,6,5,0.467742,0,2,10,10,false,false,false,0,1
69,96,-27,11.5,16,-27,1075,1189,-114,0,0,0,0,61,6,6,0.655738,0,0,13,14,false,false,false,0.076,0.924
116,126,-10,16.571429,21,-10,341,416,-75,0,0,0,0,61,7,6,0.639344,0,0,12,7,false,false,false,0.118,0.882
245,238,7,27.222222,29.75,7,1556,1513,43,0,0,0,0,32,9,8,0.96875,0,0,14,7,false,false,false,0.285,0.715
100,109,-9,14.285714,15.571429,-9,1278,1101,177,0,0,0,0,55,7,7,0.672727,1,0,6,11,false,false,true,0.53,0.47
126,172,-46,31.5,43,-46,1761,1770,-9,0,1,0,0.25,65,4,4,0.4,0,0,11,8,false,false,false,0.281,0.719
180,191,-11,20,23.875,-11,1210,1162,48,0,0,0,0,41,9,8,0.780488,0,0,10,16,false,false,false,0.257,0.743
256,279,-23,16,17.4375,-23,1123,1062,61,0,0,0,0,1,16,16,44,0,0,9,17,false,false,false,0.113,0.887
150,158,-8,18.75,19.75,-8,615,542,73,0,0,0,0,50,8,8,0.84,0,0,12,11,false,false,true,0.536,0.464
265,361,-96,18.928571,25.785714,-96,527,954,-427,0,1,0,0.071429,7,14,14,5,0,0,17,10,false,false,false,0,1
114,198,-84,19,33,-84,594,648,-54,1,1,0.166667,0.166667,53,6,6,0.754717,0,0,10,11,false,false,false,0.012,0.988
186,290,-104,16.909091,29,-104,1699,1803,-104,1,1,0.090909,0.1,40,11,10,0.875,0,0,10,18,false,false,false,0,1
39,47,-8,13,23.5,-8,342,263,79,0,0,0,0,82,3,2,0.414634,0,1,10,13,false,false,false,0.459,0.541
109,210,-101,9.083333,17.5,-101,1078,983,95,0,0,0,0,34,12,12,1.411765,1,1,9,17,false,false,false,0.036,0.964
102,86,16,20.4,21.5,16,450,503,-53,0,0,0,0,68,5,4,0.573529,0,0,13,12,false,false,false,0.332,0.668
18,8,10,18,8,10,651,567,84,0,0,0,0,92,1,1,0.597826,0,0,14,17,false,false,true,0.784,0.216
134,154,-20,16.75,19.25,-20,341,416,-75,0,0,0,0,52,8,8,0.75,0,0,11,12,false,false,false,0.201,0.799
231,247,-16,17.769231,19,-16,1310,1477,-167,0,0,0,0,5,13,13,7.2,0,0,17,7,false,false,false,0.092,0.908
26,20,6,26,20,6,1232,1281,-49,0,1,0,1,88,1,1,0.352273,0,0,7,12,false,false,false,0.316,0.684
10,19,-9,10,19,-9,1021,897,124,0,0,0,0,93,1,1,0.397849,0,0,19,8,false,false,false,0.395,0.605
76,91,-15,12.666667,15.166667,-15,805,918,-113,0,0,0,0,58,6,6,0.62069,0,1,26,6,false,false,false,0.193,0.807
87,104,-17,14.5,20.8,-17,402,448,-46,0,0,0,0,64,6,5,0.578125,0,1,16,8,false,false,false,0.068,0.932
150,243,-93,13.636364,24.3,-93,503,668,-165,0,1,0,0.1,31,11,10,1.193548,0,0,15,9,false,false,false,0.004,0.996
250,277,-27,16.666667,19.785714,-27,822,845,-23,0,0,0,0,6,15,14,5.833333,0,0,15,9,false,false,false,0.103,0.897
304,308,-4,20.266667,22,-4,1473,1500,-27,0,2,0,0.142857,2,15,14,19.5,1,0,7,8,false,false,true,0.619,0.381
173,253,-80,15.727273,23,-80,1484,1556,-72,0,1,0,0.090909,16,11,11,1.9375,1,0,15,9,false,false,false,0.132,0.868
184,245,-61,18.4,27.222222,-61,1305,1254,51,0,1,0,0.111111,28,10,9,1.142857,0,0,15,11,false,false,false,0.051,0.949
193,222,-29,10.722222,13.058824,-29,542,390,152,0,0,0,0,14,18,17,3.571429,1,0,6,10,false,false,false,0.154,0.846
180,197,-17,20,24.625,-17,1093,1100,-7,1,0,0.111111,0,41,9,8,0.756098,0,0,7,20,false,false,false,0.04,0.96
257,277,-20,21.416667,25.181818,-20,1645,1636,9,0,1,0,0.090909,11,12,11,3,0,0,12,9,false,false,false,0.21,0.79
194,224,-30,16.166667,18.666667,-30,595,538,57,0,0,0,0,20,12,12,1.9,0,1,16,6,false,false,false,0.4,0.6
270,420,-150,18,30,-150,1315,1334,-19,0,2,0,0.142857,-8,15,14,-4.5,0,0,4,9,false,false,false,0,1
284,268,16,21.846154,22.333333,16,786,885,-99,1,1,0.076923,0.083333,19,13,12,1.789474,1,0,6,26,false,false,true,0.894,0.106
24,14,10,12,14,10,595,540,55,0,0,0,0,89,2,1,0.483146,0,0,13,16,false,false,true,0.728,0.272
12,0,12,12,0,12,1164,1161,3,0,0,0,0,96,1,0,0.239583,0,0,19,0,false,false,true,0.562,0.438
178,240,-62,13.692308,20,-62,1064,1397,-333,0,2,0,0.166667,32,13,12,1.34375,1,0,27,7,false,false,false,0.079,0.921
199,246,-47,18.090909,22.363636,-47,725,668,57,0,0,0,0,26,11,11,1.346154,0,0,14,9,false,false,false,0.268,0.732
263,308,-45,17.533333,20.533333,-45,1302,1351,-49,0,0,0,0,-1,15,15,-37,0,0,11,7,false,false,false,0,1
94,207,-113,15.666667,41.4,-113,1539,1891,-352,0,1,0,0.2,53,6,5,0.471698,1,0,18,12,false,false,false,0.015,0.985
293,360,-67,36.625,51.428571,-67,2147,2219,-72,1,2,0.125,0.285714,23,8,7,1.043478,1,0,9,22,false,false,false,0.048,0.952
164,196,-32,20.5,24.5,-32,1055,1019,36,0,0,0,0,33,8,8,1,1,0,14,15,false,false,false,0.487,0.513
213,219,-6,19.363636,21.9,-6,985,1062,-77,0,0,0,0,22,11,10,1.681818,1,0,18,22,false,false,false,0.152,0.848
159,175,-16,22.714286,29.166667,-16,1428,1361,67,0,0,0,0,47,7,6,0.702128,0,0,7,8,false,false,false,0.183,0.817
193,290,-97,14.846154,24.166667,-97,503,668,-165,0,1,0,0.083333,17,13,12,2.176471,2,0,5,14,false,false,false,0.006,0.994
16,6,10,8,6,10,1037,1016,21,0,0,0,0,93,2,1,0.623656,0,1,8,8,false,false,true,0.523,0.477
161,185,-24,17.888889,20.555556,-24,668,771,-103,0,0,0,0,44,9,9,0.909091,1,0,15,11,false,false,false,0.132,0.868
34,29,5,11.333333,14.5,5,566,742,-176,0,0,0,0,83,3,2,0.385542,0,1,10,15,false,false,false,0.197,0.803
191,303,-112,15.916667,25.25,-112,480,739,-259,0,0,0,0,23,12,12,1.695652,1,0,11,12,false,false,false,0,1
0,0,0,0,0,0,1354,1210,144,0,0,0,0,100,1,0,0.33,0,0,17,0,false,false,false,0.437,0.563
107,137,-30,21.4,34.25,-30,503,527,-24,0,1,0,0.25,61,5,4,0.540984,0,0,11,10,false,false,false,0.275,0.725
125,200,-75,12.5,22.222222,-75,388,542,-154,0,0,0,0,32,10,9,1.15625,0,0,13,17,false,false,false,0.015,0.985
63,71,-8,12.6,14.2,-8,163,346,-183,0,0,0,0,61,5,5,0.639344,0,1,9,8,false,false,false,0.008,0.992
18,20,-2,18,20,-2,1691,1551,140,0,0,0,0,93,1,1,0.397849,0,0,10,18,false,false,false,0.281,0.719
44,22,22,14.666667,11,22,670,576,94,0,0,0,0,79,3,2,0.518987,0,0,19,11,false,false,true,0.781,0.219
294,348,-54,18.375,23.2,-54,1397,1309,88,2,0,0.125,0,1,16,15,36,0,0,5,11,false,false,false,0,1
333,412,-79,33.3,45.777778,-79,2010,2219,-209,1,1,0.1,0.111111,13,10,9,2,0,0,13,10,false,false,false,0,1
255,298,-43,23.181818,27.090909,-43,801,679,122,1,0,0.090909,0,8,11,11,3.625,1,0,9,11,false,false,false,0.044,0.956
56,53,3,14,17.666667,3,595,412,183,0,0,0,0,79,4,3,0.658228,0,0,14,16,false,false,true,0.519,0.481
173,105,68,12.357143,8.076923,68,491,651,-160,0,0,0,0,24,14,13,1.25,0,1,24,6,false,false,true,0.742,0.258
114,77,37,22.8,19.25,37,1038,917,121,1,0,0.2,0,71,5,4,0.492958,0,1,10,17,false,false,true,0.564,0.436
28,0,28,28,0,28,985,1062,-77,0,0,0,0,97,1,0,0.381443,0,0,10,0,false,false,false,0.484,0.516
241,335,-94,26.777778,41.875,-94,1689,1777,-88,1,1,0.111111,0.125,24,9,8,1.25,0,0,23,10,false,false,false,0,1
60,14,46,30,14,46,1274,1394,-120,0,0,0,0,90,2,1,0.333333,0,0,10,11,false,false,false,0.359,0.641
22,44,-22,7.333333,22,-22,343,570,-227,0,0,0,0,80,3,2,0.45,0,0,12,15,false,false,false,0.116,0.884
127,167,-40,18.142857,27.833333,-40,694,658,36,0,1,0,0.166667,54,7,6,0.685185,0,0,34,10,false,false,false,0.315,0.685
55,59,-4,11,14.75,-4,1037,913,124,0,0,0,0,83,5,4,0.457831,1,0,8,17,false,false,true,0.517,0.483
170,178,-8,24.285714,25.428571,-8,1102,1245,-143,0,0,0,0,41,7,7,0.707317,0,0,15,19,false,false,false,0.11,0.89
228,281,-53,19,23.416667,-53,1210,1162,48,0,0,0,0,19,12,12,1.684211,1,0,15,9,false,false,false,0.185,0.815
33,31,2,16.5,15.5,2,721,757,-36,0,0,0,0,87,2,2,0.436782,0,0,9,18,false,false,false,0.307,0.693
47,24,23,15.666667,8,23,491,651,-160,0,0,0,0,82,3,3,0.365854,0,1,10,10,false,false,false,0.457,0.543
8,32,-24,8,32,-24,1021,1094,-73,0,0,0,0,93,1,1,0.397849,0,0,16,17,false,false,false,0.235,0.765
311,271,40,18.294118,15.941176,40,897,996,-99,0,0,0,0,-5,17,17,-7.8,0,0,7,15,false,false,true,0.996,0.004
106,55,51,26.5,18.333333,51,691,704,-13,0,0,0,0,75,4,3,0.506667,0,0,10,12,false,false,true,0.881,0.119
16,0,16,16,0,16,814,830,-16,0,0,0,0,96,1,0,0.427083,0,0,10,0,false,false,true,0.562,0.438
225,295,-70,18.75,26.818182,-70,1127,995,132,0,1,0,0.090909,18,12,11,1.833333,0,0,9,13,false,false,false,0.027,0.973
223,256,-33,17.153846,21.333333,-33,1422,1583,-161,0,1,0,0.083333,20,13,12,2.05,1,1,7,14,false,false,false,0.027,0.973
269,296,-27,14.157895,15.578947,-27,595,538,57,0,0,0,0,-17,19,19,-2.235294,0,0,1,1,true,false,false,0.232,0.768
80,182,-102,8.888889,22.75,-102,530,683,-153,0,1,0,0.125,56,9,8,0.714286,0,0,11,19,false,false,false,0.009,0.991
33,9,24,16.5,9,24,721,757,-36,0,0,0,0,90,2,1,0.422222,0,0,9,20,false,false,false,0.283,0.717
125,182,-57,13.888889,20.222222,-57,1182,1075,107,0,1,0,0.111111,36,9,9,1.083333,0,1,24,6,false,false,false,0.259,0.741
291,317,-26,12.652174,13.782609,-26,796,800,-4,1,0,0.043478,0,-16,23,23,-3,0,0,12,3,false,false,false,0,1
290,337,-47,20.714286,24.071429,-47,1495,1531,-36,0,1,0,0.071429,7,14,14,5.285714,0,0,7,15,false,false,false,0.017,0.983
269,345,-76,15.823529,21.5625,-76,1064,1397,-333,0,2,0,0.125,7,17,16,6.142857,1,1,9,7,false,false,false,0,1
107,145,-38,15.285714,20.714286,-38,840,1055,-215,0,0,0,0,54,7,7,0.648148,0,0,10,9,false,false,false,0.076,0.924
16,0,16,16,0,16,1331,1347,-16,0,0,0,0,95,1,0,0.336842,1,0,8,0,false,false,true,0.612,0.388
260,269,-9,17.333333,19.214286,-9,451,448,3,0,0,0,0,4,15,14,9.25,0,0,9,7,false,false,false,0.306,0.694
167,244,-77,15.181818,22.181818,-77,450,427,23,0,1,0,0.090909,23,11,11,1.608696,0,0,13,9,false,false,false,0.048,0.952
121,143,-22,20.166667,23.833333,-22,842,926,-84,0,0,0,0,52,6,6,0.576923,0,1,9,8,false,false,false,0.137,0.863
108,164,-56,10.8,16.4,-56,999,1165,-166,0,0,0,0,41,10,10,1.121951,0,0,22,10,false,false,false,0.072,0.928
8,76,-68,8,76,-68,1656,1649,7,0,0,0,0,88,1,1,0.363636,0,0,14,18,false,false,false,0.027,0.973
261,402,-141,23.727273,36.545455,-141,1586,1633,-47,1,1,0.090909,0.090909,23,11,11,1.478261,0,0,13,13,false,false,false,0,1
142,148,-6,17.75,21.142857,-6,725,668,57,0,0,0,0,51,8,7,0.686275,0,1,27,15,false,false,false,0.353,0.647
107,195,-88,15.285714,27.857143,-88,1195,1397,-202,0,1,0,0.142857,52,7,7,0.769231,0,0,9,9,false,false,false,0.055,0.945
250,140,110,19.230769,10.769231,110,1065,948,117,0,0,0,0,29,13,13,1.344828,0,0,8,10,false,false,true,0.996,0.004
312,341,-29,19.5,21.3125,-29,1075,878,197,0,1,0,0.0625,-10,16,16,-3.3,0,0,5,4,false,false,false,0.078,0.922
212,189,23,15.142857,13.5,23,671,638,33,0,0,0,0,12,14,14,4.083333,0,1,13,24,false,false,true,0.694,0.306
263,344,-81,15.470588,21.5,-81,736,791,-55,0,0,0,0,-15,17,16,-2.533333,0,0,9,4,false,false,false,0,1
92,107,-15,18.4,26.75,-15,804,1080,-276,0,0,0,0,64,5,4,0.53125,0,0,8,16,false,false,false,0.099,0.901
299,428,-129,18.6875,26.75,-129,732,868,-136,0,1,0,0.0625,-13,16,16,-2.461538,0,0,2,2,true,false,false,0,1
49,56,-7,12.25,14,-7,526,502,24,0,0,0,0,74,4,4,0.675676,0,0,18,17,false,false,true,0.645,0.355
280,401,-121,15.555556,23.588235,-121,1193,1177,16,0,1,0,0.058824,-12,18,17,-2.916667,0,0,1,2,true,false,false,0,1
65,56,9,16.25,18.666667,9,1161,1176,-15,0,0,0,0,75,4,3,0.506667,0,0,10,7,false,false,false,0.391,0.609
58,62,-4,14.5,15.5,-4,720,437,283,0,0,0,0,78,4,4,0.538462,0,0,17,19,false,false,true,0.514,0.486
163,243,-80,16.3,24.3,-80,1493,1453,40,0,0,0,0,31,10,10,1.129032,0,0,15,10,false,false,false,0.03,0.97
58,65,-7,9.666667,13,-7,1037,913,124,0,0,0,0,77,6,5,0.493506,1,0,8,17,false,false,true,0.52,0.48
247,294,-47,19,24.5,-47,1633,1620,13,0,0,0,0,6,13,12,6,0,0,11,7,false,false,false,0.013,0.987
34,0,34,34,0,34,500,532,-32,0,0,0,0,95,1,0,0.431579,0,0,9,0,false,false,true,0.556,0.444
122,130,-8,13.555556,16.25,-8,1040,1364,-324,0,0,0,0,38,9,8,0.947368,0,1,18,13,false,false,false,0.096,0.904
302,316,-14,12.583333,13.73913,-14,671,638,33,0,0,0,0,-34,24,23,-1.441176,0,0,2,1,false,false,true,0.674,0.326
202,158,44,25.25,22.571429,44,540,498,42,1,0,0.125,0,46,8,7,1,0,0,10,21,false,false,true,0.744,0.256
223,187,36,17.153846,14.384615,36,670,576,94,0,0,0,0,15,13,13,2.733333,1,1,6,19,false,false,true,0.857,0.143
78,90,-12,15.6,22.5,-12,818,826,-8,0,0,0,0,75,5,4,0.706667,1,0,6,15,false,false,false,0.258,0.742
117,159,-42,16.714286,26.5,-42,736,791,-55,0,0,0,0,54,7,6,0.703704,0,0,9,10,false,false,false,0.059,0.941
12,0,12,12,0,12,306,302,4,0,0,0,0,97,1,0,0.42268,1,0,8,0,false,false,true,0.758,0.242
257,324,-67,19.769231,27,-67,1232,1281,-49,0,2,0,0.166667,4,13,12,7.75,0,0,16,18,false,false,false,0,1
122,218,-96,10.166667,19.818182,-96,651,567,84,0,0,0,0,26,12,11,2.115385,0,0,7,9,false,false,false,0.069,0.931
0,0,0,0,0,0,95,453,-358,0,0,0,0,100,1,1,0.39,0,0,0,15,false,false,false,0.218,0.782
249,260,-11,14.647059,15.294118,-11,1182,1075,107,0,1,0,0.058824,-14,17,17,-2.785714,0,1,15,15,false,false,false,0.072,0.928
119,83,36,17,13.833333,36,1168,1216,-48,0,0,0,0,69,7,6,0.478261,0,0,15,20,false,false,false,0.177,0.823
171,258,-87,12.214286,18.428571,-87,613,525,88,0,0,0,0,16,14,14,2.625,0,1,13,8,false,false,false,0,1
109,162,-53,18.166667,27,-53,804,1080,-276,0,0,0,0,55,6,6,0.618182,0,0,8,20,false,false,false,0.069,0.931
183,285,-102,22.875,35.625,-102,1003,1004,-1,0,1,0,0.125,41,8,8,0.853659,0,1,9,12,false,false,false,0.014,0.986
257,334,-77,19.769231,25.692308,-77,1232,1281,-49,0,2,0,0.153846,1,13,13,31,0,0,16,13,false,false,false,0,1
216,341,-125,16.615385,26.230769,-125,915,971,-56,0,0,0,0,7,13,13,4.714286,0,0,11,9,false,false,false,0,1
243,303,-60,16.2,20.2,-60,889,855,34,0,1,0,0.066667,5,15,15,8,0,1,10,6,false,false,false,0.001,0.999
127,109,18,21.166667,21.8,18,1071,1181,-110,0,0,0,0,66,6,5,0.515152,0,0,8,10,false,false,false,0.158,0.842
235,265,-30,12.368421,13.947368,-30,808,749,59,0,0,0,0,-25,19,19,-1.68,0,0,5,6,false,false,false,0.115,0.885
69,70,-1,13.8,17.5,-1,344,315,29,1,0,0.2,0,60,5,4,0.666667,0,0,9,10,false,false,true,0.61,0.39
170,174,-4,24.285714,29,-4,1793,1869,-76,0,1,0,0.166667,50,7,6,0.6,0,0,21,10,false,false,false,0.3,0.7
244,312,-68,12.842105,17.333333,-68,830,787,43,0,0,0,0,-23,19,18,-1.652174,0,0,2,1,false,false,false,0,1
263,347,-84,15.470588,20.411765,-84,736,791,-55,0,0,0,0,-17,17,17,-2.235294,0,0,9,3,false,false,false,0,1
228,260,-32,19,23.636364,-32,1210,1162,48,0,0,0,0,23,12,11,1.391304,1,1,15,11,false,false,false,0.059,0.941
299,370,-71,14.238095,18.5,-71,1305,1307,-2,0,1,0,0.05,-28,21,20,-1.464286,0,1,1,3,true,false,false,0,1
96,133,-37,16,26.6,-37,518,461,57,0,0,0,0,63,6,5,0.571429,1,1,15,9,false,false,false,0.231,0.769
163,257,-94,16.3,25.7,-94,700,820,-120,0,1,0,0.1,29,10,10,1.310345,1,0,22,10,false,false,false,0.059,0.941
71,69,2,17.75,23,2,999,1283,-284,0,0,0,0,74,4,3,0.445946,0,1,18,15,false,false,false,0.195,0.805
327,345,-18,19.235294,20.294118,-18,1344,1314,30,0,2,0,0.117647,-13,17,17,-2.615385,0,0,7,4,true,false,false,0.354,0.646
101,141,-40,14.428571,20.142857,-40,668,771,-103,0,0,0,0,52,7,7,0.769231,0,0,14,20,false,false,false,0.072,0.928
54,35,19,18,11.666667,19,1188,1334,-146,0,0,0,0,79,3,3,0.379747,0,0,20,9,false,false,false,0.288,0.712
292,340,-48,29.2,34,-48,1431,1399,32,0,2,0,0.2,6,10,10,4.166667,0,0,13,14,false,false,false,0.049,0.951
148,211,-63,13.454545,21.1,-63,977,1100,-123,0,1,0,0.1,40,11,10,1.025,0,0,16,7,false,false,false,0.067,0.933
132,166,-34,16.5,23.714286,-34,926,973,-47,0,0,0,0,43,8,7,0.813953,0,1,11,21,false,false,false,0.027,0.973
154,169,-15,19.25,21.125,-15,796,800,-4,1,0,0.125,0,47,8,8,1.021277,0,0,13,8,false,false,false,0.405,0.595
189,191,-2,21,21.222222,-2,1197,1156,41,0,1,0,0.111111,38,9,9,0.921053,0,0,15,11,false,false,false,0.429,0.571
260,178,82,28.888889,22.25,82,1552,1803,-251,2,0,0.222222,0,36,9,8,0.916667,0,1,21,10,false,false,true,0.533,0.467
145,171,-26,18.125,21.375,-26,1439,1428,11,0,0,0,0,53,8,8,0.754717,0,0,9,12,false,false,false,0.265,0.735
155,173,-18,17.222222,21.625,-18,1161,1030,131,0,1,0,0.125,39,9,8,0.974359,0,0,14,12,false,false,false,0.288,0.712
323,366,-43,17.944444,21.529412,-43,1452,1388,64,0,1,0,0.058824,-13,18,17,-2.692308,0,0,6,1,true,false,false,0,1
26,20,6,8.666667,10,6,797,796,1,0,0,0,0,91,3,2,0.538462,0,0,15,16,false,false,false,0.283,0.717
40,51,-11,13.333333,17,-11,775,786,-11,0,0,0,0,80,3,3,0.5375,0,0,7,16,false,false,false,0.342,0.658
241,349,-108,24.1,38.777778,-108,1689,1777,-88,1,1,0.1,0.111111,21,10,9,1.428571,0,0,9,7,false,false,false,0,1
306,342,-36,15.3,17.1,-36,480,518,-38,0,0,0,0,-22,20,20,-1.818182,0,0,2,1,true,false,false,0,1
32,16,16,10.666667,8,16,526,502,24,0,0,0,0,86,3,2,0.581395,0,1,18,22,false,false,false,0.345,0.655
170,276,-106,12.142857,21.230769,-106,1305,1307,-2,0,1,0,0.076923,12,14,13,3.416667,0,1,8,10,false,false,false,0,1
368,301,67,23,20.066667,67,1168,1216,-48,1,0,0.0625,0,1,16,15,33,0,0,11,7,false,false,true,0.999,0.001
254,210,44,23.090909,21,44,1691,1510,181,0,1,0,0.1,23,11,10,1.304348,1,0,9,19,false,false,true,0.878,0.122
237,273,-36,21.545455,24.818182,-36,1341,1606,-265,1,0,0.090909,0,13,11,11,2.538462,0,0,13,12,false,false,false,0.069,0.931
319,423,-104,11.392857,15.666667,-104,1037,1016,21,1,0,0.035714,0,-29,28,27,-2,1,0,0,5,false,false,false,0,1
54,47,7,18,23.5,7,689,804,-115,0,0,0,0,78,3,2,0.448718,1,0,15,17,false,false,false,0.315,0.685
218,191,27,19.818182,17.363636,27,952,870,82,0,0,0,0,24,11,11,1.541667,1,0,6,32,false,false,true,0.87,0.13
216,273,-57,24,30.333333,-57,732,868,-136,0,1,0,0.111111,28,9,9,1.142857,0,0,14,10,false,false,false,0.065,0.935
230,316,-86,17.692308,26.333333,-86,1315,1331,-16,0,0,0,0,9,13,12,3.666667,0,0,10,10,false,false,false,0,1
276,326,-50,13.142857,15.52381,-50,951,976,-25,0,0,0,0,-23,21,21,-1.913043,0,0,1,1,false,false,false,0,1
45,63,-18,15,21,-18,653,1004,-351,0,0,0,0,77,3,3,0.376623,0,0,7,7,false,false,false,0.212,0.788
104,82,22,14.857143,11.714286,22,491,651,-160,0,0,0,0,59,7,7,0.508475,0,1,11,6,false,false,true,0.582,0.418
155,189,-34,25.833333,31.5,-34,1173,1256,-83,1,0,0.166667,0,58,6,6,0.534483,0,1,11,6,false,false,false,0.001,0.999
70,64,6,17.5,16,6,1047,1127,-80,0,0,0,0,71,4,4,0.380282,1,1,9,6,false,false,true,0.533,0.467
10,0,10,10,0,10,1368,1452,-84,0,0,0,0,97,1,0,0.329897,1,0,8,0,false,false,true,0.571,0.429
137,170,-33,17.125,21.25,-33,805,918,-113,0,0,0,0,40,8,8,0.9,0,0,8,20,false,false,false,0.07,0.93
298,325,-27,17.529412,20.3125,-27,689,804,-115,0,1,0,0.0625,-15,17,16,-2.333333,0,1,2,4,false,false,false,0.002,0.998
265,301,-36,17.666667,20.066667,-36,450,624,-174,0,0,0,0,-11,15,15,-3,1,0,4,6,false,false,false,0.048,0.952
221,311,-90,13.8125,20.733333,-90,913,1037,-124,0,2,0,0.133333,11,16,15,3.727273,0,1,20,11,false,false,false,0,1
364,386,-22,21.411765,22.705882,-22,1093,1173,-80,1,1,0.058824,0.058824,-11,17,17,-3.909091,0,0,5,10,false,false,false,0.005,0.995
149,166,-17,14.9,18.444444,-17,613,525,88,0,0,0,0,39,10,9,1.076923,0,1,10,10,false,false,false,0.367,0.633
277,332,-55,15.388889,18.444444,-55,889,855,34,0,1,0,0.055556,-16,18,18,-2.5,0,0,5,1,false,false,false,0,1
351,393,-42,23.4,26.2,-42,1173,1256,-83,2,0,0.133333,0,-10,15,15,-3.1,0,1,1,3,false,false,false,0,1
36,12,24,18,12,24,818,826,-8,0,0,0,0,91,2,1,0.582418,1,0,9,19,false,false,true,0.715,0.285
354,325,29,23.6,21.666667,29,1156,1279,-123,2,0,0.133333,0,-2,15,15,-20,0,0,11,6,false,false,true,0.999,0.001
62,57,5,20.666667,28.5,5,804,1080,-276,0,0,0,0,80,3,2,0.425,1,0,8,12,false,false,false,0.22,0.78
127,155,-28,10.583333,12.916667,-28,925,1000,-75,0,0,0,0,26,12,12,1.692308,0,0,16,17,false,false,false,0.106,0.894
197,318,-121,17.909091,28.909091,-121,724,398,326,1,1,0.090909,0.090909,34,11,11,1.147059,1,1,9,6,false,false,false,0.004,0.996
128,144,-16,21.333333,24,-16,1110,1123,-13,0,1,0,0.166667,48,6,6,0.6875,0,0,17,15,false,false,false,0.31,0.69
108,202,-94,15.428571,33.666667,-94,653,1004,-351,0,0,0,0,50,7,6,0.58,1,0,11,9,false,false,false,0.009,0.991
328,348,-20,18.222222,20.470588,-20,1055,840,215,0,1,0,0.058824,-18,18,17,-2,0,0,3,1,false,false,false,0.078,0.922
263,231,32,20.230769,19.25,32,1168,1062,106,0,0,0,0,24,13,12,1.791667,1,0,11,9,false,false,true,0.603,0.397
218,226,-8,19.818182,22.6,-8,964,1003,-39,0,1,0,0.1,29,11,10,1.344828,1,0,12,24,false,false,false,0.258,0.742
97,206,-109,16.166667,41.2,-109,1334,1486,-152,0,0,0,0,68,6,5,0.426471,1,0,6,17,false,false,false,0.007,0.993
238,303,-65,15.866667,20.2,-65,1439,1428,11,0,0,0,0,9,15,15,4.444444,1,0,19,9,false,false,false,0.027,0.973
25,16,9,12.5,16,9,814,830,-16,0,0,0,0,89,2,1,0.460674,0,0,7,11,false,false,true,0.512,0.488
252,230,22,28,28.75,22,714,820,-106,1,0,0.111111,0,38,9,8,0.815789,0,0,11,9,false,false,false,0.331,0.669
48,26,22,24,26,22,1537,1539,-2,0,0,0,0,88,2,1,0.386364,0,1,10,6,false,false,false,0.49,0.51
275,343,-68,18.333333,22.866667,-68,503,527,-24,0,1,0,0.066667,-16,15,15,-2.0625,0,0,4,3,false,false,false,0.003,0.997
12,0,12,12,0,12,1484,1556,-72,0,0,0,0,95,1,0,0.326316,0,0,8,0,false,false,true,0.562,0.438
211,259,-48,21.1,28.777778,-48,1454,1479,-25,1,0,0.1,0,28,10,9,1.107143,0,0,19,23,false,false,false,0.012,0.988
180,213,-33,15,19.363636,-33,775,786,-11,0,0,0,0,27,12,11,1.592593,1,0,9,19,false,false,false,0.101,0.899
77,57,20,25.666667,28.5,20,1159,1131,28,0,0,0,0,83,3,2,0.445783,0,1,9,8,false,false,false,0.464,0.536
247,322,-75,15.4375,20.125,-75,1037,1016,21,1,0,0.0625,0,13,16,16,4.461538,1,0,15,8,false,false,false,0.003,0.997
263,343,-80,9.740741,13.192308,-80,818,826,-8,0,0,0,0,-45,27,26,-1.177778,0,0,2,4,true,false,false,0,1
14,0,14,14,0,14,991,1063,-72,0,0,0,0,97,1,0,0.391753,0,0,14,0,false,false,true,0.536,0.464
61,57,4,20.333333,19,4,1232,1448,-216,0,0,0,0,75,3,3,0.466667,0,0,18,10,false,false,false,0.214,0.786
186,279,-93,14.307692,23.25,-93,542,605,-63,0,0,0,0,15,13,12,2.4,0,0,8,9,false,false,false,0,1
177,203,-26,19.666667,22.555556,-26,939,969,-30,0,0,0,0,31,9,9,1.064516,1,0,9,14,false,false,false,0.307,0.693
16,8,8,16,8,8,1561,1495,66,0,0,0,0,94,1,1,0.351064,1,0,9,18,false,false,true,0.723,0.277
179,234,-55,25.571429,39,-55,1925,1885,40,1,1,0.142857,0.166667,38,7,6,0.657895,1,0,15,7,false,false,false,0.103,0.897
357,456,-99,22.3125,28.5,-99,1699,1803,-104,1,1,0.0625,0.0625,-1,16,16,-35,0,0,8,3,false,false,false,0,1
112,118,-6,22.4,23.6,-6,999,1283,-284,0,0,0,0,64,5,5,0.515625,0,1,13,16,false,false,false,0.223,0.777
170,162,8,17,18,8,1633,1556,77,0,0,0,0,29,10,9,1.137931,0,0,19,19,false,false,false,0.279,0.721
142,149,-7,15.777778,16.555556,-7,995,965,30,0,0,0,0,41,9,9,0.97561,0,1,26,10,false,false,false,0.332,0.668
64,71,-7,12.8,17.75,-7,758,904,-146,0,0,0,0,66,5,4,0.515152,1,0,7,21,false,false,false,0.15,0.85
83,100,-17,16.6,25,-17,1193,1177,16,0,0,0,0,70,5,4,0.5,0,0,10,18,false,false,false,0.268,0.732
111,183,-72,12.333333,22.875,-72,343,570,-227,0,0,0,0,34,9,8,1.058824,1,0,25,7,false,false,false,0.093,0.907
194,198,-4,19.4,19.8,-4,1302,1351,-49,0,0,0,0,34,10,10,1.088235,0,0,9,12,false,false,false,0.268,0.732
275,332,-57,18.333333,23.714286,-57,503,527,-24,0,1,0,0.071429,-13,15,14,-2.538462,0,0,4,6,false,false,false,0.013,0.987
137,179,-42,17.125,25.571429,-42,1003,1018,-15,0,0,0,0,44,8,7,0.840909,0,0,11,12,false,false,false,0.164,0.836
272,355,-83,24.727273,35.5,-83,1388,1455,-67,0,0,0,0,9,11,10,3.111111,1,0,17,17,false,false,false,0,1
332,378,-46,20.75,25.2,-46,921,1045,-124,0,1,0,0.066667,-3,16,15,-11.666667,0,1,3,9,false,false,false,0,1
155,261,-106,17.222222,32.625,-106,473,683,-210,0,0,0,0,37,9,8,1.027027,0,0,8,7,false,false,false,0,1
14,0,14,14,0,14,1094,1041,53,0,0,0,0,96,1,0,0.395833,1,0,8,0,false,false,true,0.576,0.424
328,319,9,16.4,16.789474,9,897,996,-99,0,0,0,0,-19,20,19,-2.052632,0,0,2,7,true,false,true,0.98,0.02
291,304,-13,12.125,13.217391,-13,797,796,1,0,0,0,0,-24,24,23,-2.041667,0,0,5,4,false,false,false,0.104,0.896
235,299,-64,16.785714,23,-64,344,315,29,1,1,0.071429,0.076923,-7,14,13,-5.714286,0,0,19,7,false,false,false,0,1
155,195,-40,17.222222,21.666667,-40,965,1078,-113,0,0,0,0,41,9,9,0.902439,0,0,9,8,false,false,false,0.07,0.93
288,353,-65,18,22.0625,-65,1055,1019,36,0,0,0,0,-19,16,16,-1.736842,0,0,2,1,false,false,false,0,1
282,397,-115,14.1,19.85,-115,1037,1016,21,1,0,0.05,0,-10,20,20,-5.8,1,0,12,9,false,false,false,0,1
18,0,18,18,0,18,668,771,-103,0,0,0,0,95,1,0,0.421053,0,0,16,0,false,false,false,0.225,0.775
161,287,-126,17.888889,31.888889,-126,1193,1177,16,0,1,0,0.111111,39,9,9,0.897436,0,0,15,8,false,false,false,0,1
199,237,-38,12.4375,15.8,-38,808,749,59,0,0,0,0,-3,16,15,-14,0,0,12,9,false,false,false,0.09,0.91
216,276,-60,15.428571,21.230769,-60,1101,1130,-29,1,1,0.071429,0.076923,20,14,13,2.25,0,1,11,10,false,false,false,0.001,0.999
156,146,10,19.5,18.25,10,1432,1452,-20,0,0,0,0,42,8,8,0.857143,1,0,18,8,false,false,true,0.715,0.285
89,120,-31,14.833333,24,-31,668,363,305,0,0,0,0,67,6,5,0.701493,0,0,8,9,false,false,false,0.141,0.859
297,278,19,21.214286,19.857143,19,1197,1156,41,0,1,0,0.071429,4,14,14,8.75,0,0,8,14,false,false,true,0.827,0.173
79,65,14,19.75,16.25,14,1197,1156,41,0,0,0,0,70,4,4,0.5,0,1,13,15,false,false,false,0.498,0.502
20,0,20,20,0,20,1270,1261,9,0,0,0,0,95,1,0,0.389474,1,0,9,0,false,false,true,0.697,0.303
114,122,-8,12.666667,15.25,-8,391,542,-151,1,0,0.111111,0,42,9,8,1.095238,0,0,7,8,false,false,false,0.391,0.609
79,132,-53,15.8,26.4,-53,1803,1658,145,0,0,0,0,60,5,5,0.55,2,0,17,7,false,false,false,0.437,0.563
326,288,38,32.6,28.8,38,1777,1689,88,1,1,0.1,0.1,13,10,10,2.076923,0,1,19,11,false,false,true,0.909,0.091
415,501,-86,27.666667,33.4,-86,1699,1580,119,3,2,0.2,0.133333,-11,15,15,-2.727273,0,0,1,1,true,false,false,0,1
152,167,-15,13.818182,16.7,-15,361,413,-52,0,0,0,0,31,11,10,1.322581,2,0,8,11,false,false,true,0.574,0.426
36,72,-36,18,36,-36,1636,1796,-160,0,0,0,0,84,2,2,0.321429,0,0,18,10,false,false,false,0.284,0.716
234,353,-119,13,20.764706,-119,542,605,-63,0,0,0,0,-18,18,17,-2,0,0,5,5,false,false,false,0,1
176,216,-40,22,27,-40,1173,1256,-83,1,0,0.125,0,43,8,8,0.72093,1,1,8,16,false,false,false,0.002,0.998
69,98,-29,23,49,-29,1537,1539,-2,0,1,0,0.5,77,3,2,0.441558,0,0,8,16,false,false,false,0.271,0.729
325,330,-5,20.3125,20.625,-5,1561,1495,66,1,0,0.0625,0,-22,16,16,-1.5,0,0,2,3,false,false,false,0.468,0.532
244,307,-63,17.428571,21.928571,-63,691,704,-13,0,1,0,0.071429,4,14,14,9.5,0,0,18,21,false,false,false,0,1
229,250,-21,12.722222,13.888889,-21,342,53,289,0,0,0,0,-21,18,18,-1.952381,0,0,4,4,false,false,false,0.215,0.785
161,196,-35,13.416667,17.818182,-35,1220,1202,18,0,0,0,0,27,12,11,1.851852,0,0,26,9,false,false,false,0.267,0.733
260,267,-7,17.333333,17.8,-7,1037,1009,28,0,0,0,0,16,15,15,2.75,1,1,10,13,false,false,false,0.24,0.76
137,180,-43,17.125,22.5,-43,518,414,104,0,1,0,0.125,47,8,8,0.808511,0,0,17,11,false,false,true,0.514,0.486
168,221,-53,14,18.416667,-53,951,976,-25,0,0,0,0,30,12,12,1.466667,0,0,10,7,false,false,false,0.067,0.933
263,275,-12,18.785714,19.642857,-12,500,509,-9,0,0,0,0,9,14,14,4.555556,0,0,7,12,false,false,false,0.265,0.735
135,135,0,12.272727,13.5,0,342,53,289,0,0,0,0,30,11,10,1.366667,1,1,10,14,false,false,false,0.394,0.606
313,357,-44,14.227273,16.227273,-44,1037,1009,28,0,0,0,0,-18,22,22,-2.444444,0,0,1,1,true,false,false,0,1
30,43,-13,15,43,-13,1415,1361,54,0,0,0,0,92,2,1,0.336957,0,0,13,18,false,false,false,0.128,0.872
135,217,-82,19.285714,36.166667,-82,1777,1500,277,0,1,0,0.166667,48,7,6,0.583333,1,0,8,10,false,false,true,0.933,0.067
38,23,15,38,23,15,1793,1957,-164,0,0,0,0,92,1,1,0.315217,0,0,12,16,false,false,true,0.592,0.408
52,35,17,17.333333,11.666667,17,561,633,-72,0,0,0,0,81,3,3,0.432099,1,1,6,12,false,false,false,0.216,0.784
284,362,-78,14.947368,19.052632,-78,341,416,-75,0,0,0,0,-23,19,19,-1.695652,0,0,1,1,false,false,false,0,1
180,224,-44,16.363636,22.4,-44,822,845,-23,0,0,0,0,32,11,10,1.09375,1,0,15,12,false,false,false,0.096,0.904
12,0,12,12,0,12,952,870,82,0,0,0,0,97,1,0,0.381443,0,0,10,0,false,false,true,0.578,0.422
303,394,-91,23.307692,30.307692,-91,1556,1616,-60,0,0,0,0,-4,13,13,-7.25,0,0,4,1,false,false,false,0,1
266,266,0,16.625,17.733333,0,1203,1270,-67,1,0,0.0625,0,8,16,15,5.5,1,0,9,10,false,false,false,0.401,0.599
158,248,-90,17.555556,27.555556,-90,1572,1777,-205,0,1,0,0.111111,29,9,9,1.137931,0,1,17,11,false,false,false,0,1
125,135,-10,17.857143,19.285714,-10,500,532,-32,0,0,0,0,50,7,7,0.82,0,0,7,10,false,false,false,0.424,0.576
315,407,-92,26.25,33.916667,-92,1253,1324,-71,0,2,0,0.166667,5,12,12,5.8,0,1,11,5,false,false,false,0,1
276,276,0,16.235294,16.235294,0,1203,1270,-67,1,0,0.058824,0,1,17,17,44,1,1,11,11,false,false,false,0.235,0.765
242,286,-44,16.133333,19.066667,-44,1176,1211,-35,0,1,0,0.066667,-12,15,15,-2.75,0,0,8,1,false,false,false,0.048,0.952
132,295,-163,8.25,19.666667,-163,651,567,84,0,0,0,0,12,16,15,4.583333,0,1,8,9,false,false,false,0,1
250,337,-87,16.666667,24.071429,-87,1193,1177,16,0,1,0,0.071429,8,15,14,4.375,1,1,8,13,false,false,false,0.001,0.999
29,21,8,14.5,10.5,8,786,885,-99,0,0,0,0,88,2,2,0.386364,0,0,11,23,false,false,false,0.21,0.79
226,247,-21,15.066667,17.642857,-21,500,532,-32,0,0,0,0,1,15,14,41,0,2,28,8,false,false,false,0,1
377,448,-71,19.842105,24.888889,-71,724,398,326,1,1,0.052632,0.055556,-24,19,18,-1.625,0,0,5,5,false,false,false,0,1
41,23,18,20.5,23,18,450,503,-53,0,0,0,0,88,2,1,0.443182,0,0,24,9,false,false,false,0.397,0.603
191,275,-84,21.222222,30.555556,-84,1436,1489,-53,1,1,0.111111,0.111111,40,9,9,0.925,0,0,11,7,false,false,false,0.03,0.97
87,112,-25,14.5,18.666667,-25,278,1,277,0,0,0,0,52,6,6,0.711538,0,0,17,10,false,false,true,0.515,0.485
147,147,0,16.333333,18.375,0,526,502,24,0,0,0,0,51,9,8,0.980392,0,0,12,7,false,false,false,0.491,0.509
122,169,-47,12.2,18.777778,-47,503,668,-165,0,0,0,0,40,10,9,0.925,0,0,10,8,false,false,false,0.069,0.931
77,63,14,19.25,21,14,1691,1510,181,0,0,0,0,74,4,3,0.405405,0,0,18,22,false,false,false,0.407,0.593
125,95,30,20.833333,19,30,758,904,-146,1,0,0.166667,0,57,6,5,0.596491,0,0,19,12,false,false,false,0.352,0.648
190,222,-32,11.176471,13.058824,-32,542,390,152,0,0,0,0,16,17,17,3.125,1,0,6,10,false,false,false,0.211,0.789
195,267,-72,21.666667,29.666667,-72,991,1063,-72,0,1,0,0.111111,39,9,9,0.974359,0,0,12,10,false,false,false,0.053,0.947
222,249,-27,17.076923,19.153846,-27,615,542,73,0,0,0,0,19,13,13,2.210526,0,0,10,9,false,false,false,0.325,0.675
26,0,26,26,0,26,820,718,102,0,0,0,0,94,1,1,0.297872,0,1,20,8,false,false,true,0.76,0.24
163,318,-155,13.583333,26.5,-155,473,683,-210,0,0,0,0,23,12,12,1.652174,1,0,15,10,false,false,false,0,1
105,119,-14,17.5,19.833333,-14,1232,1448,-216,0,0,0,0,59,6,6,0.59322,0,0,12,7,false,false,false,0.135,0.865
234,254,-20,15.6,18.142857,-20,450,503,-53,0,0,0,0,7,15,14,5.571429,1,0,6,12,false,false,false,0.095,0.905
77,129,-52,9.625,18.428571,-52,1078,983,95,0,0,0,0,60,8,7,0.8,1,0,7,11,false,false,false,0.242,0.758
42,36,6,21,18,6,704,523,181,0,0,0,0,84,2,2,0.416667,0,0,13,16,false,false,true,0.744,0.256
0,0,0,0,0,0,1315,1331,-16,0,0,0,0,100,1,0,0.33,0,0,15,0,false,false,true,0.546,0.454
17,12,5,8.5,12,5,1047,1253,-206,0,0,0,0,93,2,1,0.397849,1,0,13,12,false,false,false,0.228,0.772
273,317,-44,30.333333,35.222222,-44,1431,1399,32,0,2,0,0.222222,14,9,9,1.785714,0,0,10,7,false,false,false,0.108,0.892
191,304,-113,21.222222,33.777778,-113,1334,1486,-152,2,1,0.222222,0.111111,35,9,9,0.828571,0,0,9,14,false,false,false,0,1
0,0,0,0,0,0,1064,1397,-333,0,0,0,0,100,2,2,0.43,0,0,26,10,false,false,false,0.215,0.785
108,92,16,21.6,23,16,1606,1593,13,0,0,0,0,69,5,4,0.42029,0,0,17,18,false,false,false,0.3,0.7
300,330,-30,17.647059,19.411765,-30,824,830,-6,1,0,0.058824,0,0,17,17,0,0,0,9,12,false,false,false,0.008,0.992
360,392,-32,27.692308,32.666667,-32,1388,1455,-67,0,0,0,0,-4,13,12,-7,0,0,3,9,false,false,true,0.929,0.071
221,311,-90,12.277778,17.277778,-90,595,662,-67,0,1,0,0.055556,-13,18,18,-3.384615,0,0,6,11,false,false,false,0,1
259,194,65,21.583333,17.636364,65,1043,1003,40,0,0,0,0,20,12,11,1.9,0,1,13,13,false,false,true,0.925,0.075
145,216,-71,13.181818,21.6,-71,813,698,115,1,0,0.090909,0,38,11,10,1.263158,0,1,20,10,false,false,false,0.013,0.987
157,183,-26,31.4,36.6,-26,1164,1161,3,0,1,0,0.2,53,5,5,0.433962,0,0,10,12,false,false,false,0.283,0.717
32,26,6,16,26,6,360,371,-11,0,0,0,0,87,2,1,0.425287,0,0,14,11,false,false,true,0.604,0.396
129,138,-9,21.5,27.6,-9,965,1078,-113,0,0,0,0,58,6,5,0.637931,0,0,9,13,false,false,false,0.079,0.921
285,324,-39,15.833333,19.058824,-39,306,468,-162,1,0,0.055556,0,-9,18,17,-4.111111,0,0,7,2,false,false,false,0,1
160,392,-232,12.307692,32.666667,-232,1093,1100,-7,0,2,0,0.166667,20,13,12,1.75,0,0,9,17,false,false,false,0,1
80,86,-6,13.333333,17.2,-6,361,413,-52,0,0,0,0,61,6,5,0.672131,0,0,23,8,false,false,false,0.24,0.76
198,323,-125,24.75,40.375,-125,1777,1500,277,1,2,0.125,0.25,31,8,8,0.903226,0,0,7,18,false,false,false,0.109,0.891
212,335,-123,19.272727,30.454545,-123,999,1283,-284,0,2,0,0.181818,21,11,11,1.571429,0,0,10,7,false,false,false,0,1
150,192,-42,21.428571,32,-42,1003,1004,-1,0,1,0,0.166667,56,7,6,0.625,0,1,15,9,false,false,false,0.222,0.778
220,401,-181,22,44.555556,-181,1539,1891,-352,0,2,0,0.222222,13,10,9,1.923077,1,0,16,9,false,false,false,0,1
152,117,35,19,16.714286,35,704,523,181,0,0,0,0,42,8,7,0.833333,0,0,10,15,false,false,true,0.623,0.377
130,165,-35,18.571429,23.571429,-35,653,820,-167,0,0,0,0,43,7,7,0.883721,0,0,14,20,false,false,false,0.076,0.924
191,303,-112,15.916667,27.545455,-112,926,973,-47,0,0,0,0,17,12,11,2.058824,0,0,14,20,false,false,false,0,1
400,454,-54,28.571429,34.923077,-54,1777,1500,277,2,2,0.142857,0.153846,-11,14,13,-2.545455,0,0,1,4,false,false,false,0.135,0.865
36,18,18,18,18,18,694,658,36,0,0,0,0,89,2,1,0.41573,0,0,7,14,false,false,true,0.713,0.287
76,109,-33,15.2,27.25,-33,1253,1324,-71,0,0,0,0,67,5,4,0.432836,0,0,16,12,false,false,false,0.254,0.746
50,16,34,25,16,34,1030,998,32,0,0,0,0,85,2,1,0.435294,0,0,7,12,false,false,true,0.584,0.416
70,55,15,11.666667,11,15,670,576,94,0,0,0,0,60,6,5,0.683333,0,0,19,10,false,false,true,0.663,0.337
86,102,-16,17.2,20.4,-16,1203,1270,-67,0,0,0,0,70,5,5,0.628571,1,0,6,12,false,false,false,0.352,0.648
143,228,-85,15.888889,28.5,-85,1397,1309,88,1,0,0.111111,0,51,9,8,0.705882,0,1,7,10,false,false,false,0.025,0.975
257,310,-53,25.7,31,-53,1253,1324,-71,0,1,0,0.1,21,10,10,1.380952,0,0,23,10,false,false,false,0.012,0.988
178,168,10,19.777778,21,10,971,635,336,0,0,0,0,39,9,8,0.820513,0,0,19,12,false,false,true,0.508,0.492
132,135,-3,18.857143,22.5,-3,926,973,-47,0,0,0,0,48,7,6,0.729167,0,1,11,11,false,false,false,0.233,0.767
115,199,-84,11.5,19.9,-84,830,787,43,0,0,0,0,34,10,10,1.117647,1,0,16,7,false,false,false,0.124,0.876
297,392,-95,16.5,21.777778,-95,889,895,-6,0,1,0,0.055556,-17,18,18,-2.176471,0,1,3,6,false,false,false,0,1
221,252,-31,15.785714,18,-31,402,448,-46,0,0,0,0,6,14,14,6.166667,0,1,18,12,false,false,false,0.085,0.915
47,41,6,11.75,13.666667,6,999,1165,-166,0,0,0,0,76,4,3,0.605263,0,0,15,13,false,false,false,0.171,0.829
242,404,-162,11.52381,20.2,-162,977,1100,-123,0,1,0,0.05,-19,21,20,-2.157895,0,0,3,2,true,false,false,0,1
115,184,-69,12.777778,20.444444,-69,500,509,-9,0,0,0,0,37,9,9,1.108108,1,0,9,10,false,false,false,0.141,0.859
307,359,-52,17.055556,21.117647,-52,668,771,-103,0,0,0,0,-8,18,17,-5,0,1,1,2,false,false,false,0,1
266,276,-10,16.625,17.25,-10,1203,1270,-67,1,0,0.0625,0,4,16,16,11,1,0,9,10,false,false,false,0.469,0.531
67,47,20,22.333333,23.5,20,1245,1148,97,0,0,0,0,82,3,2,0.426829,0,0,19,13,false,false,false,0.407,0.593
369,374,-5,18.45,18.7,-5,1156,1279,-123,2,0,0.1,0,-17,20,20,-2.352941,0,0,2,1,true,false,false,0,1
334,489,-155,33.4,54.333333,-155,1398,1431,-33,0,0,0,0,3,10,9,9.333333,0,0,13,28,false,false,false,0,1
272,361,-89,14.315789,20.055556,-89,595,412,183,0,1,0,0.055556,-7,19,18,-7.428571,0,0,10,12,false,false,false,0,1
264,326,-62,16.5,20.375,-62,1281,1268,13,0,0,0,0,4,16,16,10.5,1,0,7,7,false,false,false,0.033,0.967
189,273,-84,15.75,22.75,-84,341,416,-75,0,0,0,0,22,12,12,1.772727,0,0,7,9,false,false,false,0.007,0.993
188,184,4,18.8,20.444444,4,1334,1439,-105,1,0,0.1,0,50,10,9,0.72,0,0,9,12,false,false,false,0.083,0.917
241,338,-97,9.64,13.52,-97,818,826,-8,0,0,0,0,-40,25,25,-1.325,0,0,3,4,false,false,false,0,1
48,48,0,24,24,0,796,800,-4,0,0,0,0,88,2,2,0.545455,0,0,21,7,false,false,true,0.61,0.39
23,31,-8,11.5,15.5,-8,226,361,-135,0,0,0,0,85,2,2,0.517647,0,1,11,6,false,false,false,0.008,0.992
126,238,-112,15.75,29.75,-112,1101,1115,-14,0,0,0,0,45,8,8,0.666667,0,1,16,11,false,false,false,0,1
15,30,-15,7.5,15,-15,1422,1510,-88,0,0,0,0,92,2,2,0.423913,0,0,10,11,false,false,false,0.274,0.726
258,266,-8,17.2,17.733333,-8,1203,1270,-67,1,0,0.066667,0,13,15,15,3.384615,1,0,9,10,false,false,false,0.409,0.591
282,318,-36,20.142857,24.461538,-36,1101,1237,-136,1,0,0.071429,0,9,14,13,3.777778,1,0,26,12,false,false,false,0.006,0.994
38,0,38,38,0,38,1417,1482,-65,0,0,0,0,95,1,0,0.347368,0,0,24,0,false,false,true,0.734,0.266
280,315,-35,21.538462,26.25,-35,1164,1261,-97,0,1,0,0.083333,25,13,12,1.68,0,0,12,8,false,false,false,0.04,0.96
120,546,-426,5.714286,27.3,-426,1164,1149,15,0,3,0,0.15,6,21,20,7.833333,0,1,12,20,false,false,false,0,1
34,27,7,17,27,7,1699,1803,-104,0,0,0,0,90,2,1,0.388889,0,1,10,9,false,false,false,0.288,0.712
119,198,-79,14.875,24.75,-79,837,844,-7,0,0,0,0,55,8,8,0.745455,1,1,6,8,false,false,false,0.006,0.994
72,69,3,18,23,3,1266,1339,-73,0,0,0,0,79,4,3,0.443038,0,0,11,18,false,false,false,0.161,0.839
287,443,-156,31.888889,49.222222,-156,1885,1908,-23,1,3,0.111111,0.333333,3,9,9,7.666667,0,0,12,12,false,false,false,0,1
344,380,-36,20.235294,22.352941,-36,1691,1551,140,1,0,0.058824,0,-15,17,17,-2.466667,0,0,3,2,false,false,false,0.018,0.982
314,437,-123,18.470588,27.3125,-123,999,1283,-284,0,2,0,0.125,-15,17,16,-2.2,0,0,1,2,true,false,false,0,1
239,293,-54,18.384615,24.416667,-54,1047,1253,-206,1,1,0.076923,0.083333,17,13,12,2.176471,1,0,10,12,false,false,false,0.031,0.969
120,195,-75,15,24.375,-75,1195,1397,-202,0,1,0,0.125,48,8,8,0.833333,0,0,10,14,false,false,false,0.066,0.934
151,165,-14,16.777778,18.333333,-14,595,538,57,0,0,0,0,37,9,9,1.027027,0,1,16,16,false,false,true,0.525,0.475
42,58,-16,8.4,14.5,-16,632,603,29,0,0,0,0,69,5,4,0.550725,1,0,13,28,false,false,false,0.37,0.63
222,252,-30,17.076923,21,-30,568,570,-2,0,0,0,0,18,13,12,2.055556,0,0,12,12,false,false,false,0.081,0.919
126,160,-34,11.454545,14.545455,-34,391,542,-151,1,0,0.090909,0,32,11,11,1.4375,0,0,10,7,false,false,false,0.258,0.742
150,249,-99,16.666667,31.125,-99,976,995,-19,0,1,0,0.125,43,9,8,0.883721,0,0,8,11,false,false,false,0.027,0.973
308,327,-19,16.210526,18.166667,-19,576,602,-26,0,0,0,0,-18,19,18,-2.333333,0,0,1,2,false,false,false,0.023,0.977
239,215,24,23.9,23.888889,24,1305,1194,111,1,0,0.1,0,28,10,9,1.178571,0,0,9,10,false,false,false,0.407,0.593
115,103,12,16.428571,17.166667,12,1344,1208,136,0,0,0,0,59,7,6,0.508475,0,0,18,9,false,false,false,0.409,0.591
53,78,-25,13.25,26,-25,1432,1452,-20,0,0,0,0,73,4,3,0.493151,0,0,23,8,false,false,false,0.282,0.718
145,344,-199,20.714286,49.142857,-199,1632,2020,-388,0,2,0,0.285714,39,7,7,0.794872,0,1,9,8,false,false,false,0,1
221,262,-41,18.416667,21.833333,-41,1220,1185,35,0,1,0,0.083333,25,12,12,1.88,0,0,18,20,false,false,false,0.216,0.784
167,175,-8,18.555556,19.444444,-8,480,518,-38,0,0,0,0,34,9,9,1.176471,0,1,10,6,false,false,false,0.264,0.736
362,348,14,17.238095,17.4,14,907,910,-3,0,1,0,0.05,-16,21,20,-2.6875,0,0,6,4,false,false,true,0.936,0.064
297,346,-49,21.214286,24.714286,-49,921,1045,-124,0,1,0,0.071429,6,14,14,5.833333,0,1,10,21,false,false,false,0,1
46,51,-5,15.333333,25.5,-5,995,965,30,0,0,0,0,79,3,2,0.506329,0,0,12,10,false,false,false,0.282,0.718
67,116,-49,16.75,29,-49,1586,1633,-47,1,0,0.25,0,80,4,4,0.425,0,0,17,9,false,false,false,0.384,0.616
51,91,-40,17,30.333333,-40,1167,1245,-78,0,0,0,0,76,3,3,0.302632,0,0,8,16,false,false,false,0.204,0.796
52,79,-27,10.4,15.8,-27,970,1030,-60,0,0,0,0,64,5,5,0.625,0,1,28,7,false,false,false,0.284,0.716
230,313,-83,23,34.777778,-83,1793,1957,-164,0,1,0,0.111111,28,10,9,1.035714,0,0,10,7,false,false,false,0,1
336,340,-4,16.8,17.894737,-4,1168,1062,106,0,0,0,0,-11,20,19,-3.909091,0,0,2,2,false,false,false,0.132,0.868
214,209,5,19.454545,20.9,5,576,602,-26,0,0,0,0,35,11,10,1.2,1,0,6,16,false,false,false,0.198,0.802
167,133,34,16.7,14.777778,34,797,796,1,0,0,0,0,48,10,9,1.020833,1,1,6,16,false,false,false,0.349,0.651
76,62,14,19,15.5,14,388,542,-154,0,0,0,0,67,4,4,0.552239,0,0,16,15,false,false,false,0.438,0.562
40,24,16,20,12,16,1045,1082,-37,0,0,0,0,88,2,2,0.511364,0,1,16,15,false,false,false,0.452,0.548
151,194,-43,18.875,27.714286,-43,1473,1500,-27,0,2,0,0.285714,46,8,7,0.847826,0,0,15,20,false,false,false,0.271,0.729
32,13,19,32,13,19,518,461,57,0,0,0,0,93,1,1,0.387097,0,0,12,16,false,false,true,0.801,0.199
124,228,-104,8.857143,17.538462,-104,651,996,-345,0,1,0,0.076923,12,14,13,3.75,0,2,33,5,false,false,false,0,1
127,82,45,25.4,20.5,45,1047,1253,-206,1,0,0.2,0,69,5,4,0.536232,0,0,7,10,false,false,true,0.573,0.427
259,293,-34,18.5,20.928571,-34,952,870,82,0,0,0,0,2,14,14,18.5,0,0,13,19,false,false,false,0.096,0.904
339,439,-100,26.076923,33.769231,-100,2143,2219,-76,1,0,0.076923,0,-6,13,13,-5.166667,0,0,7,6,false,false,false,0,1
167,205,-38,15.181818,20.5,-38,450,427,23,0,1,0,0.1,26,11,10,1.423077,0,0,13,16,false,false,false,0.401,0.599
30,68,-38,15,34,-38,1415,1361,54,0,0,0,0,89,2,2,0.348315,0,0,13,16,false,false,false,0.24,0.76
8,26,-18,8,26,-18,1131,1030,101,0,0,0,0,93,1,1,0.322581,0,0,7,16,false,false,false,0.275,0.725
56,23,33,28,23,33,450,624,-174,0,0,0,0,86,2,1,0.383721,1,0,6,15,false,false,false,0.226,0.774
148,205,-57,18.5,29.285714,-57,561,633,-72,0,1,0,0.142857,50,8,7,0.7,0,0,13,7,false,false,false,0.102,0.898
225,278,-53,14.0625,18.533333,-53,683,859,-176,0,0,0,0,13,16,15,3.461538,0,0,10,17,false,false,false,0,1
58,0,58,29,0,58,820,718,102,0,0,0,0,88,2,1,0.318182,0,1,18,8,false,false,true,0.817,0.183
305,238,67,16.944444,14,67,1030,998,32,0,0,0,0,-7,18,17,-5.285714,0,1,13,9,false,false,true,1,0
18,0,18,18,0,18,503,527,-24,0,0,0,0,96,1,0,0.34375,0,0,12,0,false,false,true,0.529,0.471
198,198,0,16.5,16.5,0,1203,1270,-67,0,0,0,0,34,12,12,1.294118,1,0,8,24,false,false,false,0.238,0.762
284,342,-58,20.285714,26.307692,-58,653,1004,-351,0,0,0,0,-4,14,13,-7.25,0,0,16,4,false,false,false,0,1
105,86,19,21,21.5,19,985,1062,-77,0,0,0,0,65,5,4,0.569231,0,0,13,23,false,false,false,0.124,0.876
298,374,-76,11.461538,14.384615,-76,595,412,183,0,1,0,0.038462,-22,26,26,-2.363636,0,0,10,11,true,false,false,0,1
134,121,13,19.142857,20.166667,13,711,746,-35,0,0,0,0,58,7,6,0.655172,0,0,7,22,false,false,false,0.163,0.837
214,285,-71,19.454545,25.909091,-71,1572,1777,-205,0,1,0,0.090909,15,11,11,2.2,0,1,9,9,false,false,false,0,1
221,270,-49,17,22.5,-49,653,820,-167,0,0,0,0,7,13,12,5.428571,0,0,7,17,false,false,false,0.007,0.993
132,160,-28,16.5,20,-28,889,895,-6,0,1,0,0.125,44,8,8,0.840909,0,1,20,12,false,false,false,0.378,0.622
268,335,-67,16.75,20.9375,-67,1071,1181,-110,0,0,0,0,-1,16,16,-34,0,1,5,5,false,false,false,0,1
138,195,-57,11.5,17.727273,-57,907,878,29,0,0,0,0,45,12,11,0.955556,1,0,12,12,false,false,false,0.07,0.93
24,153,-129,12,76.5,-129,786,848,-62,0,1,0,0.5,87,2,2,0.356322,1,0,14,12,false,false,false,0.034,0.966
229,417,-188,12.722222,23.166667,-188,1075,1189,-114,0,0,0,0,-13,18,18,-3.076923,0,0,4,2,false,false,false,0,1
116,120,-4,19.333333,20,-4,1021,1094,-73,1,0,0.166667,0,59,6,6,0.627119,0,0,11,12,false,false,false,0.24,0.76
209,328,-119,12.294118,19.294118,-119,1305,1307,-2,0,1,0,0.058824,-9,17,17,-4.555556,0,1,10,9,false,false,false,0,1
337,371,-34,22.466667,24.733333,-34,691,695,-4,1,0,0.066667,0,-12,15,15,-2.666667,0,0,2,2,false,false,false,0.135,0.865
77,96,-19,11,16,-19,1075,1189,-114,0,0,0,0,58,7,6,0.689655,0,0,10,14,false,false,false,0.074,0.926
183,168,15,20.333333,21,15,1131,1030,101,0,0,0,0,41,9,8,0.731707,1,0,12,18,false,false,true,0.642,0.358
186,292,-106,16.909091,26.545455,-106,1407,1473,-66,0,2,0,0.181818,17,11,11,1.823529,0,0,9,17,false,false,false,0,1
62,196,-134,7.75,24.5,-134,1037,913,124,0,1,0,0.125,57,8,8,0.666667,1,0,8,9,false,false,false,0.027,0.973
354,444,-90,19.666667,26.117647,-90,1334,1439,-105,1,1,0.055556,0.058824,-11,18,17,-3.272727,0,0,3,2,false,false,false,0,1
144,170,-26,18,24.285714,-26,1493,1453,40,0,0,0,0,49,8,7,0.714286,0,0,12,19,false,false,false,0.227,0.773
240,214,26,18.461538,16.461538,26,720,437,283,0,0,0,0,25,13,13,1.68,0,0,10,16,false,false,true,0.832,0.168
266,309,-43,16.625,20.6,-43,758,791,-33,0,0,0,0,-8,16,15,-4.875,0,0,10,10,false,false,false,0,1
281,349,-68,11.24,13.96,-68,651,700,-49,0,0,0,0,-44,25,25,-1.272727,0,0,14,10,false,false,false,0,1
99,118,-19,14.142857,19.666667,-19,360,371,-11,0,0,0,0,51,7,6,0.72549,0,0,20,8,false,false,false,0.408,0.592
247,316,-69,9.88,13.166667,-69,1220,1202,18,0,0,0,0,-26,25,24,-1.923077,0,1,26,11,false,false,false,0,1
179,221,-42,25.571429,31.571429,-42,1071,1065,6,0,0,0,0,39,7,7,0.794872,0,0,20,10,false,false,false,0.311,0.689
10,21,-11,10,21,-11,803,786,17,0,0,0,0,94,1,1,0.340426,0,1,10,11,false,false,false,0.401,0.599
214,241,-27,26.75,30.125,-27,1885,1842,43,0,2,0,0.25,31,8,8,0.870968,0,0,8,14,false,false,false,0.27,0.73
105,84,21,17.5,16.8,21,1232,1448,-216,0,0,0,0,61,6,5,0.57377,0,0,12,16,false,false,false,0.175,0.825
0,0,0,0,0,0,1473,1500,-27,0,0,0,0,100,1,0,0.39,0,0,16,0,false,false,true,0.536,0.464
45,46,-1,22.5,23,-1,1539,1891,-352,0,0,0,0,85,2,2,0.294118,0,0,17,14,false,false,false,0.235,0.765
233,414,-181,11.65,20.7,-181,1078,983,95,1,0,0.05,0,-16,20,20,-3,0,0,10,12,false,false,false,0,1
189,221,-32,23.625,31.571429,-32,1793,1957,-164,0,0,0,0,42,8,7,0.690476,0,1,14,10,false,false,false,0.05,0.95
244,292,-48,17.428571,22.461538,-48,452,698,-246,0,1,0,0.076923,9,14,13,4.555556,0,0,15,10,false,false,false,0.002,0.998
85,88,-3,17,22,-3,889,895,-6,0,1,0,0.25,68,5,4,0.544118,0,0,10,15,false,false,false,0.286,0.714
301,320,-19,23.153846,26.666667,-19,1188,1334,-146,1,1,0.076923,0.083333,4,13,12,7.5,1,0,9,10,false,false,false,0.164,0.836
206,211,-5,12.875,14.066667,-5,1220,1202,18,0,0,0,0,10,16,15,5,0,2,29,8,false,false,false,0,1
122,243,-121,12.2,24.3,-121,503,668,-165,0,1,0,0.1,33,10,10,1.121212,0,0,10,9,false,false,false,0.002,0.998
175,263,-88,17.5,26.3,-88,1349,1203,146,0,1,0,0.1,33,10,10,0.969697,0,1,8,7,false,false,false,0.027,0.973
135,247,-112,13.5,24.7,-112,563,523,40,0,0,0,0,33,10,10,1.121212,0,0,10,17,false,false,false,0.013,0.987
140,127,13,17.5,18.142857,13,1417,1482,-65,0,0,0,0,58,8,7,0.568966,0,0,18,13,false,false,false,0.24,0.76
328,391,-63,21.866667,27.928571,-63,1101,1115,-14,1,1,0.066667,0.071429,-12,15,14,-2.5,1,0,8,5,false,false,false,0.015,0.985
336,342,-6,19.764706,21.375,-6,1043,1003,40,0,1,0,0.0625,-9,17,16,-4.222222,0,0,3,12,false,false,false,0.094,0.906
159,198,-39,15.9,19.8,-39,721,757,-36,0,1,0,0.1,36,10,10,1.055556,0,0,20,9,false,false,false,0.395,0.605
53,80,-27,13.25,20,-27,278,1,277,0,0,0,0,65,4,4,0.569231,0,0,13,9,false,false,true,0.52,0.48
288,301,-13,16.941176,18.8125,-13,599,448,151,0,0,0,0,-7,17,16,-5.142857,0,1,3,13,false,false,false,0.085,0.915
12,15,-3,12,15,-3,278,1,277,0,0,0,0,91,1,1,0.406593,0,0,11,7,false,false,true,0.768,0.232
131,153,-22,16.375,19.125,-22,603,721,-118,0,0,0,0,47,8,8,0.914894,0,0,10,24,false,false,false,0.084,0.916
268,280,-12,17.866667,20,-12,1270,1261,9,1,0,0.066667,0,18,15,14,2.055556,0,0,13,7,false,false,false,0.134,0.866
159,256,-97,13.25,23.272727,-97,563,523,40,0,0,0,0,23,12,11,1.608696,0,0,17,15,false,false,false,0,1
298,322,-24,17.529412,18.941176,-24,1245,1148,97,0,0,0,0,-19,17,17,-1.842105,0,0,10,2,false,false,false,0.016,0.984
306,384,-78,25.5,32,-78,1770,1745,25,2,1,0.166667,0.083333,11,12,12,3,0,0,14,18,false,false,false,0,1
258,328,-70,15.176471,20.5,-70,1432,1452,-20,0,1,0,0.0625,-13,17,16,-2.769231,1,0,1,17,false,false,false,0.018,0.982
290,270,20,20.714286,20.769231,20,1094,1041,53,1,0,0.071429,0,3,14,13,12.666667,0,0,17,7,false,false,true,0.556,0.444
362,332,30,18.1,17.473684,30,907,910,-3,0,1,0,0.052632,-13,20,19,-3.307692,0,0,6,9,false,false,true,0.993,0.007
18,104,-86,9,52,-86,964,1003,-39,0,1,0,0.5,83,2,2,0.46988,0,0,18,14,false,false,false,0.27,0.73
109,153,-44,18.166667,30.6,-44,1110,1399,-289,0,1,0,0.2,56,6,5,0.607143,0,0,20,14,false,false,false,0.072,0.928
51,26,25,25.5,26,25,1691,1510,181,0,0,0,0,89,2,1,0.337079,0,0,13,12,false,false,false,0.44,0.56
299,444,-145,21.357143,31.714286,-145,1633,1680,-47,0,2,0,0.142857,-14,14,14,-2,1,0,5,10,true,false,false,0,1
79,78,1,15.8,15.6,1,720,437,283,0,0,0,0,72,5,5,0.583333,0,0,17,17,false,false,true,0.516,0.484
170,246,-76,13.076923,20.5,-76,977,1100,-123,0,1,0,0.083333,28,13,12,1.464286,0,0,12,13,false,false,false,0.005,0.995
271,261,10,33.875,32.625,10,820,718,102,0,2,0,0.25,29,8,8,0.965517,0,0,10,9,false,false,true,0.872,0.128
94,11,83,47,5.5,83,1237,1265,-28,1,0,0.5,0,81,2,2,0.444444,0,1,22,7,false,false,true,0.563,0.437
14,6,8,14,6,8,1452,1388,64,0,0,0,0,94,1,1,0.37234,0,0,14,15,false,false,true,0.527,0.473
322,385,-63,20.125,25.666667,-63,991,1063,-72,0,1,0,0.066667,-6,16,15,-6.333333,0,0,9,10,false,false,false,0,1
48,25,23,48,25,23,1071,1181,-110,0,0,0,0,92,1,1,0.369565,0,0,7,9,false,false,true,0.529,0.471
170,128,42,21.25,18.285714,42,1078,1095,-17,1,0,0.125,0,49,8,7,0.755102,0,1,18,10,false,false,true,0.799,0.201
263,313,-50,16.4375,19.5625,-50,1040,1364,-324,0,0,0,0,-12,16,16,-3,0,0,6,13,false,false,false,0,1
347,370,-23,21.6875,24.666667,-23,1110,1399,-289,0,1,0,0.066667,-1,16,15,-34,0,0,1,8,false,false,false,0.008,0.992
57,75,-18,14.25,18.75,-18,480,739,-259,0,0,0,0,72,4,4,0.541667,0,0,7,10,false,false,false,0.211,0.789
135,235,-100,27,47,-100,1431,1399,32,0,1,0,0.2,52,5,5,0.480769,0,0,10,13,false,false,false,0.027,0.973
202,158,44,18.363636,15.8,44,1281,1268,13,0,0,0,0,34,11,10,1.235294,0,0,8,16,false,false,true,0.759,0.241
304,423,-119,11.692308,16.269231,-119,1037,1016,21,1,0,0.038462,0,-21,26,26,-2.761905,1,0,2,5,false,false,false,0,1
18,0,18,18,0,18,1572,1777,-205,0,0,0,0,96,1,0,0.34375,0,0,8,0,false,false,false,0.228,0.772
240,302,-62,24,30.2,-62,1495,1597,-102,0,1,0,0.1,24,10,10,1.333333,0,0,10,11,false,false,false,0.053,0.947
107,85,22,17.833333,17,22,1229,1220,9,0,0,0,0,60,6,5,0.616667,0,1,19,17,false,false,false,0.317,0.683
292,387,-95,19.466667,25.8,-95,835,786,49,0,0,0,0,-21,15,15,-1.619048,0,0,2,2,false,false,false,0,1
284,314,-30,17.75,19.625,-30,785,892,-107,0,0,0,0,-1,16,16,-37,0,0,7,4,false,false,false,0.025,0.975
34,43,-9,17,21.5,-9,668,363,305,0,0,0,0,83,2,2,0.566265,0,0,10,24,false,false,true,0.511,0.489
223,286,-63,15.928571,22,-63,595,412,183,0,1,0,0.076923,17,14,13,3.058824,0,0,11,12,false,false,false,0.074,0.926
239,335,-96,14.9375,20.9375,-96,595,412,183,0,1,0,0.0625,3,16,16,17.333333,0,0,13,10,false,false,false,0,1
180,251,-71,20,31.375,-71,1127,995,132,0,1,0,0.125,38,9,8,0.868421,0,0,9,10,false,false,false,0.028,0.972
60,65,-5,20,32.5,-5,1232,1281,-49,0,1,0,0.5,73,3,2,0.424658,0,0,10,18,false,false,false,0.273,0.727
104,111,-7,13,15.857143,-7,361,413,-52,0,0,0,0,50,8,7,0.82,1,0,18,7,false,false,false,0.427,0.573
126,156,-30,18,26,-30,1349,1203,146,0,1,0,0.166667,51,7,6,0.627451,0,0,12,9,false,false,false,0.266,0.734
184,333,-149,7.36,13.32,-149,651,567,84,0,0,0,0,-19,25,25,-2.894737,0,0,5,13,false,false,false,0,1
181,262,-81,12.066667,18.714286,-81,651,700,-49,0,0,0,0,7,15,14,8,1,0,6,13,false,false,false,0.013,0.987
161,143,18,20.125,20.428571,18,1493,1413,80,0,0,0,0,49,8,7,0.734694,0,1,18,19,false,false,false,0.272,0.728
122,204,-82,11.090909,18.545455,-82,818,826,-8,0,0,0,0,41,11,11,1.292683,1,0,8,18,false,false,false,0.015,0.985
36,102,-66,18,51,-66,732,868,-136,0,1,0,0.5,82,2,2,0.390244,0,0,10,12,false,false,false,0.267,0.733
176,412,-236,19.555556,51.5,-236,1632,2020,-388,0,2,0,0.25,27,9,8,1.148148,0,0,10,14,false,false,false,0,1
271,258,13,15.055556,15.176471,13,361,413,-52,0,0,0,0,-19,18,17,-2.157895,0,0,8,6,false,false,true,0.874,0.126
29,11,18,14.5,11,18,1030,1014,16,0,0,0,0,92,2,1,0.358696,1,0,6,18,false,false,true,0.621,0.379
325,340,-15,16.25,17,-15,720,437,283,0,0,0,0,-17,20,20,-2.470588,0,0,3,2,false,false,false,0.196,0.804
0,0,0,0,0,0,1064,1397,-333,0,0,0,0,100,2,1,0.43,0,0,26,8,false,false,false,0.211,0.789
266,407,-141,16.625,27.133333,-141,1484,1556,-72,0,2,0,0.133333,-13,16,15,-2.384615,0,0,4,3,true,false,false,0,1
139,205,-66,19.857143,29.285714,-66,561,633,-72,0,1,0,0.142857,54,7,7,0.648148,0,0,11,7,false,false,false,0.109,0.891
148,153,-5,18.5,21.857143,-5,450,624,-174,0,0,0,0,42,8,7,0.785714,0,0,22,11,false,false,false,0.203,0.797
64,108,-44,12.8,21.6,-44,1302,1351,-49,0,0,0,0,65,5,5,0.569231,1,0,7,11,false,false,false,0.273,0.727
191,249,-58,12.733333,16.6,-58,1182,1075,107,0,1,0,0.066667,-3,15,15,-13,0,1,24,6,false,false,false,0,1
295,340,-45,15.526316,18.888889,-45,568,570,-2,0,0,0,0,-14,19,18,-2.642857,0,0,1,1,true,false,false,0,1
70,25,45,70,25,45,824,830,-6,1,0,1,0,89,1,1,0.494382,0,0,15,21,false,false,true,0.561,0.439
53,59,-6,13.25,19.666667,-6,613,525,88,0,0,0,0,75,4,3,0.56,0,2,16,9,false,false,false,0.023,0.977
15,14,1,7.5,14,1,1422,1510,-88,0,0,0,0,94,2,1,0.414894,0,0,10,12,false,false,false,0.273,0.727
86,109,-23,17.2,21.8,-23,1168,1062,106,0,0,0,0,68,5,5,0.632353,0,1,10,13,false,false,false,0.259,0.741
265,207,58,17.666667,14.785714,58,1030,998,32,0,0,0,0,7,15,14,5.285714,0,0,17,13,false,false,true,0.97,0.03
170,315,-145,21.25,39.375,-145,1556,1656,-100,0,2,0,0.25,28,8,8,1.071429,0,0,10,30,false,false,false,0,1
168,228,-60,18.666667,28.5,-60,971,800,171,0,1,0,0.125,21,9,8,1.380952,0,0,8,12,false,false,false,0.032,0.968
167,224,-57,12.846154,17.230769,-57,651,700,-49,0,0,0,0,18,13,13,3.111111,1,0,9,16,false,false,false,0.05,0.95
307,365,-58,16.157895,20.277778,-58,668,771,-103,0,0,0,0,-10,19,18,-4,0,1,1,1,false,false,false,0,1
104,130,-26,26,32.5,-26,1554,1685,-131,0,1,0,0.25,73,4,4,0.438356,0,0,10,16,false,false,false,0.271,0.729
287,401,-114,17.9375,26.733333,-114,1038,917,121,1,2,0.0625,0.133333,-12,16,15,-2.916667,0,0,6,4,false,false,false,0,1
162,211,-49,18,23.444444,-49,725,668,57,0,0,0,0,39,9,9,0.897436,0,0,21,11,false,false,false,0.454,0.546
213,244,-31,17.75,22.181818,-31,1432,1452,-20,0,1,0,0.090909,19,12,11,1.894737,1,0,6,17,false,false,false,0.132,0.868
216,198,18,24,22,18,1070,814,256,1,1,0.111111,0.111111,29,9,9,1.137931,0,1,14,13,false,false,true,0.836,0.164
202,208,-6,22.444444,26,-6,1452,1388,64,0,1,0,0.125,38,9,8,0.921053,0,0,16,10,false,false,false,0.272,0.728
258,301,-43,19.846154,25.083333,-43,1493,1413,80,0,1,0,0.083333,14,13,12,2.571429,0,0,9,12,false,false,false,0.029,0.971
30,39,-9,10,19.5,-9,540,498,42,0,0,0,0,85,3,2,0.541176,0,1,16,6,false,false,false,0.349,0.651
340,402,-62,24.285714,30.923077,-62,1331,1432,-101,0,1,0,0.076923,-6,14,13,-4.5,0,1,7,7,true,false,false,0,1
72,46,26,18,15.333333,26,1040,1091,-51,0,0,0,0,74,4,3,0.635135,0,0,11,19,false,false,false,0.445,0.555
58,151,-93,11.6,37.75,-93,1220,1202,18,0,0,0,0,69,5,4,0.724638,0,0,23,9,false,false,false,0.03,0.97
266,258,8,15.647059,16.125,8,1045,1082,-37,0,0,0,0,-4,17,16,-11.25,0,0,9,14,false,false,true,0.588,0.412
102,125,-23,25.5,41.666667,-23,1071,1065,6,0,0,0,0,61,4,3,0.508197,0,0,17,12,false,false,false,0.182,0.818
72,82,-10,36,82,-10,1354,1210,144,0,1,0,1,88,2,1,0.375,0,0,23,18,false,false,true,0.76,0.24
325,388,-63,18.055556,21.555556,-63,1021,897,124,0,2,0,0.111111,-24,18,18,-1.541667,0,0,10,1,false,false,false,0,1
127,90,37,18.142857,15,37,1220,1185,35,0,0,0,0,60,7,6,0.783333,0,1,27,6,false,false,true,0.674,0.326
225,288,-63,11.842105,15.157895,-63,391,542,-151,1,0,0.052632,0,-20,19,19,-2.3,0,0,11,16,false,false,false,0,1
338,387,-49,16.9,20.368421,-49,1164,1261,-97,0,1,0,0.052632,-19,20,19,-2.210526,0,0,6,4,false,false,false,0,1
255,214,41,18.214286,16.461538,41,720,437,283,0,0,0,0,23,14,13,1.826087,0,0,8,16,false,false,true,0.839,0.161
192,225,-33,16,20.454545,-33,343,570,-227,0,0,0,0,13,12,11,2.769231,0,0,19,10,false,false,false,0.071,0.929
258,345,-87,13.578947,18.157895,-87,642,952,-310,0,0,0,0,-20,19,19,-2.2,0,0,1,3,false,false,false,0,1
90,140,-50,18,28,-50,642,952,-310,0,0,0,0,64,5,5,0.6875,0,0,7,23,false,false,false,0.07,0.93
46,39,7,23,39,7,971,635,336,0,0,0,0,91,2,1,0.351648,0,0,7,10,false,false,false,0.155,0.845
56,160,-104,14,40,-104,595,412,183,0,1,0,0.25,72,4,4,0.722222,0,1,14,10,false,false,false,0.027,0.973
293,398,-105,20.928571,30.615385,-105,1636,1702,-66,0,1,0,0.076923,-1,14,13,-29,0,0,5,8,false,false,false,0,1
41,48,-7,13.666667,24,-7,1310,1477,-167,0,0,0,0,81,3,2,0.444444,1,0,16,10,false,false,false,0.369,0.631
167,146,21,20.875,20.857143,21,785,892,-107,0,0,0,0,47,8,7,0.787234,0,0,14,10,false,false,false,0.248,0.752
123,145,-22,15.375,18.125,-22,651,700,-49,0,0,0,0,46,8,8,1.217391,1,0,9,21,false,false,false,0.189,0.811
75,123,-48,18.75,30.75,-48,1636,1796,-160,0,0,0,0,70,4,4,0.385714,0,0,15,7,false,false,false,0.21,0.79
231,222,9,16.5,15.857143,9,670,576,94,0,0,0,0,6,14,14,6.833333,1,0,10,16,false,false,true,0.841,0.159
346,357,-11,20.352941,21,-11,1563,1539,24,0,1,0,0.058824,-23,17,17,-1.521739,0,0,1,2,false,false,false,0.05,0.95
30,39,-9,15,19.5,-9,1885,1842,43,0,0,0,0,86,2,2,0.313953,0,0,9,12,false,false,false,0.284,0.716
153,176,-23,21.857143,25.142857,-23,1176,1133,43,1,0,0.142857,0,57,7,7,0.596491,0,0,12,14,false,false,false,0.295,0.705
208,276,-68,18.909091,27.6,-68,1315,1334,-19,0,1,0,0.1,25,11,10,1.44,0,1,11,16,false,false,false,0.005,0.995
178,279,-101,14.833333,23.25,-101,542,605,-63,0,0,0,0,18,12,12,2,0,0,10,9,false,false,false,0,1
27,24,3,13.5,12,3,306,302,4,0,0,0,0,87,2,2,0.471264,1,0,13,16,false,false,true,0.613,0.387
10,0,10,10,0,10,1699,1803,-104,0,0,0,0,97,1,0,0.360825,0,0,13,0,false,false,true,0.561,0.439
14,0,14,14,0,14,163,346,-183,0,0,0,0,94,1,0,0.414894,0,0,13,0,false,false,false,0.212,0.788
354,380,-26,19.666667,22.352941,-26,1691,1551,140,1,0,0.055556,0,-20,18,17,-1.85,0,0,1,2,false,false,false,0.046,0.954
210,255,-45,14,18.214286,-45,813,698,115,1,0,0.066667,0,17,15,14,2.823529,0,0,12,10,false,false,false,0.033,0.967
40,113,-73,13.333333,37.666667,-73,1270,1424,-154,0,1,0,0.333333,77,3,3,0.454545,0,0,12,11,false,false,false,0.268,0.732
66,152,-86,16.5,38,-86,732,868,-136,0,1,0,0.25,69,4,4,0.463768,0,0,7,17,false,false,false,0.045,0.955
157,162,-5,15.7,18,-5,1310,1477,-167,0,0,0,0,29,10,9,1.241379,1,0,16,11,false,false,false,0.133,0.867
276,486,-210,15.333333,28.588235,-210,1093,1100,-7,0,2,0,0.117647,-13,18,17,-2.692308,0,0,20,8,true,false,false,0,1
89,113,-24,17.8,22.6,-24,1037,1009,28,0,0,0,0,67,5,5,0.656716,0,1,19,8,false,false,false,0.279,0.721
112,88,24,28,22,24,1281,1268,13,0,0,0,0,68,4,4,0.617647,0,0,9,10,false,false,true,0.562,0.438
136,124,12,17,17.714286,12,1229,1220,9,0,0,0,0,51,8,7,0.72549,0,1,16,10,false,false,false,0.279,0.721
297,311,-14,22.846154,23.923077,-14,1645,1636,9,0,1,0,0.076923,-3,13,13,-11,0,0,9,9,false,false,false,0.204,0.796
10,19,-9,10,19,-9,568,570,-2,0,0,0,0,94,1,1,0.393617,0,0,11,18,false,false,false,0.428,0.572
218,318,-100,19.818182,28.909091,-100,1576,1556,20,0,1,0,0.090909,14,11,11,2.142857,1,0,8,10,false,false,false,0.027,0.973
132,193,-61,11,17.545455,-61,226,361,-135,0,0,0,0,20,12,11,2.2,0,0,11,7,false,false,false,0.04,0.96
144,131,13,28.8,26.2,13,1063,1134,-71,1,0,0.2,0,64,5,5,0.6875,0,0,7,17,false,false,false,0.225,0.775
287,342,-55,16.882353,21.375,-55,387,683,-296,0,0,0,0,-22,17,16,-1.545455,1,0,3,4,false,false,false,0,1
260,419,-159,17.333333,27.933333,-159,1045,1100,-55,0,1,0,0.066667,-3,15,15,-11.333333,1,0,9,7,false,false,false,0,1
16,70,-54,16,70,-54,1583,1403,180,0,0,0,0,87,1,1,0.367816,0,0,8,11,false,false,false,0.038,0.962
211,327,-116,11.722222,18.166667,-116,1078,983,95,1,0,0.055556,0,1,18,18,48,0,1,9,6,false,false,false,0,1
205,203,2,17.083333,18.454545,2,1094,1041,53,0,0,0,0,22,12,11,1.727273,1,1,6,9,false,false,false,0.257,0.743
260,357,-97,23.636364,35.7,-97,1689,1777,-88,1,1,0.090909,0.1,13,11,10,2.307692,0,0,19,9,false,false,false,0,1
149,203,-54,21.285714,29,-54,842,926,-84,0,0,0,0,40,7,7,0.75,0,0,7,10,false,false,false,0.036,0.964
96,114,-18,16,22.8,-18,341,416,-75,0,0,0,0,67,6,5,0.58209,0,0,12,8,false,false,false,0.089,0.911
12,17,-5,12,17,-5,1123,1062,61,0,0,0,0,93,1,1,0.473118,0,0,9,25,false,false,false,0.311,0.689
101,178,-77,20.2,35.6,-77,1583,1403,180,0,0,0,0,54,5,5,0.592593,0,0,14,15,false,false,false,0.029,0.971
266,407,-141,17.733333,27.133333,-141,1484,1556,-72,0,2,0,0.133333,-13,15,15,-2.384615,0,0,4,3,false,false,false,0,1
14,20,-6,14,20,-6,760,976,-216,0,0,0,0,93,1,1,0.387097,0,1,14,9,false,false,false,0.211,0.789
229,333,-104,20.818182,33.3,-104,1636,1702,-66,0,1,0,0.1,23,11,10,1.26087,0,0,14,18,false,false,false,0,1
328,367,-39,17.263158,20.388889,-39,1063,1134,-71,1,0,0.052632,0,-5,19,18,-8.8,0,0,6,5,false,false,false,0,1
121,128,-7,12.1,12.8,-7,1045,948,97,0,0,0,0,30,10,10,1.133333,0,0,9,11,false,false,true,0.538,0.462
196,114,82,21.777778,14.25,82,675,570,105,0,0,0,0,40,9,8,0.875,0,0,10,21,false,false,true,0.988,0.012
284,253,31,23.666667,23,31,1070,814,256,1,1,0.083333,0.090909,14,12,11,2.357143,0,1,9,11,false,false,true,0.565,0.435
234,352,-118,13.764706,20.705882,-118,632,603,29,0,1,0,0.058824,-21,17,17,-1.809524,0,0,6,5,false,false,false,0,1
240,295,-55,24,29.5,-55,1021,897,124,0,2,0,0.2,21,10,10,1.761905,0,0,14,15,false,false,false,0.048,0.952
12,6,6,12,6,6,491,651,-160,0,0,0,0,94,1,1,0.319149,0,1,13,11,false,false,false,0.206,0.794
279,248,31,21.461538,20.666667,31,1197,1156,41,0,1,0,0.083333,14,13,12,2.5,0,0,11,7,false,false,true,0.705,0.295
93,94,-1,13.285714,15.666667,-1,542,390,152,0,0,0,0,72,7,6,0.694444,0,0,14,11,false,false,true,0.516,0.484
24,70,-46,12,70,-46,1583,1403,180,0,0,0,0,81,2,1,0.395062,0,0,7,11,false,false,false,0.032,0.968
52,55,-3,10.4,13.75,-3,970,1030,-60,0,0,0,0,68,5,4,0.588235,0,1,28,11,false,false,false,0.216,0.784
185,245,-60,18.5,24.5,-60,1656,1580,76,0,1,0,0.1,30,10,10,1.1,2,0,8,10,false,false,false,0.171,0.829
55,65,-10,11,13,-10,1037,913,124,0,0,0,0,79,5,5,0.481013,1,0,8,17,false,false,true,0.527,0.473
274,443,-169,16.117647,27.6875,-169,1399,1210,189,0,1,0,0.0625,-12,17,16,-2.916667,0,0,2,2,false,false,false,0,1
173,210,-37,13.307692,16.153846,-37,1045,1082,-37,0,0,0,0,19,13,13,2.368421,1,0,16,16,false,false,false,0.269,0.731
316,402,-86,16.631579,22.333333,-86,710,758,-48,1,1,0.052632,0.055556,-18,19,18,-2.055556,0,0,10,5,true,false,false,0,1
140,135,5,20,22.5,5,1407,1473,-66,0,1,0,0.166667,54,7,6,0.574074,0,0,10,8,false,false,false,0.293,0.707
215,280,-65,21.5,28,-65,835,786,49,0,0,0,0,16,10,10,2.125,0,0,9,17,false,false,false,0.042,0.958
170,218,-48,18.888889,24.222222,-48,595,733,-138,1,1,0.111111,0.111111,31,9,9,1.258065,0,1,29,13,false,false,false,0.003,0.997
18,0,18,18,0,18,691,704,-13,0,0,0,0,97,1,0,0.391753,1,0,10,0,false,false,true,0.602,0.398
98,167,-69,7.538462,12.846154,-69,288,359,-71,0,0,0,0,33,13,13,0.818182,0,0,15,10,false,false,false,0.143,0.857
50,100,-50,16.666667,33.333333,-50,1633,1739,-106,0,0,0,0,81,3,3,0.419753,0,0,8,7,false,false,false,0.241,0.759
79,62,17,11.285714,10.333333,17,1045,948,97,0,0,0,0,55,7,6,0.618182,0,0,11,24,false,false,true,0.534,0.466
78,110,-32,15.6,22,-32,818,826,-8,0,0,0,0,72,5,5,0.736111,1,1,6,16,false,false,false,0.09,0.91
133,154,-21,16.625,22,-21,1203,1270,-67,0,0,0,0,54,8,7,0.814815,1,0,12,11,false,false,false,0.221,0.779
44,82,-38,11,20.5,-38,813,698,115,0,0,0,0,71,4,4,0.676056,1,1,11,9,false,false,false,0.318,0.682
12,0,12,12,0,12,1093,1100,-7,0,0,0,0,97,1,0,0.319588,0,0,10,0,false,false,true,0.562,0.438
83,37,46,16.6,9.25,46,1168,1216,-48,0,0,0,0,80,5,4,0.4125,0,0,13,27,false,false,false,0.228,0.772
41,25,16,20.5,12.5,16,1341,1606,-265,0,0,0,0,83,2,2,0.39759,2,0,8,11,false,false,true,0.656,0.344
14,38,-24,4.666667,12.666667,-24,1344,1208,136,0,0,0,0,85,3,3,0.352941,0,0,7,19,false,false,false,0.329,0.671
142,131,11,17.75,18.714286,11,1334,1439,-105,1,0,0.125,0,65,8,7,0.553846,0,0,16,9,false,false,false,0.165,0.835
192,233,-41,24,29.125,-41,1793,1869,-76,0,1,0,0.125,39,8,8,0.769231,0,0,28,10,false,false,false,0.426,0.574
168,155,13,15.272727,15.5,13,1030,998,32,0,0,0,0,30,11,10,1.233333,0,0,9,8,false,false,false,0.475,0.525
20,0,20,20,0,20,999,1165,-166,0,0,0,0,96,1,0,0.479167,0,0,15,0,false,false,false,0.212,0.788
168,224,-56,16.8,22.4,-56,822,845,-23,0,0,0,0,35,10,10,1,1,0,18,12,false,false,false,0.205,0.795
27,64,-37,9,21.333333,-37,813,698,115,0,0,0,0,79,3,3,0.607595,1,0,14,12,false,false,true,0.526,0.474
299,367,-68,16.611111,20.388889,-68,954,939,15,1,0,0.055556,0,-21,18,18,-1.714286,0,0,1,1,true,false,false,0,1
185,198,-13,16.818182,18,-13,1203,1270,-67,0,0,0,0,37,11,11,1.189189,1,0,7,22,false,false,false,0.09,0.91
143,118,25,15.888889,14.75,25,1344,1314,30,0,1,0,0.125,43,9,8,0.790698,0,0,11,18,false,false,true,0.698,0.302
224,234,-10,16,18,-10,561,688,-127,0,0,0,0,21,14,13,2.190476,0,0,16,13,false,false,false,0.291,0.709
86,96,-10,14.333333,16,-10,526,502,24,0,0,0,0,63,6,6,0.793651,0,0,18,11,false,false,true,0.609,0.391
258,367,-109,19.846154,28.230769,-109,1232,1448,-216,0,2,0,0.153846,8,13,13,4.375,0,0,7,9,false,false,false,0,1
115,164,-49,14.375,20.5,-49,721,757,-36,0,1,0,0.125,48,8,8,0.791667,0,0,13,12,false,false,false,0.27,0.73
57,78,-21,11.4,15.6,-21,503,668,-165,0,0,0,0,67,5,5,0.552239,0,0,7,13,false,false,false,0.141,0.859
292,312,-20,19.466667,20.8,-20,664,786,-122,0,0,0,0,-5,15,15,-6.6,1,0,8,2,false,false,false,0.115,0.885
371,430,-59,30.916667,35.833333,-59,1777,1500,277,2,2,0.166667,0.166667,-4,12,12,-7,0,0,4,6,false,false,false,0.05,0.95
326,396,-70,20.375,24.75,-70,1422,1798,-376,0,2,0,0.125,-9,16,16,-3.555556,0,0,2,2,true,false,false,0,1
40,62,-22,13.333333,20.666667,-22,1030,1014,16,0,0,0,0,83,3,3,0.39759,1,0,9,18,false,false,false,0.323,0.677
134,136,-2,19.142857,22.666667,-2,796,800,-4,0,0,0,0,57,7,6,0.842105,0,0,10,13,false,false,false,0.283,0.717
219,217,2,15.642857,15.5,2,306,302,4,0,0,0,0,6,14,14,6.833333,0,0,7,14,false,false,true,0.757,0.243
44,13,31,14.666667,6.5,31,1127,995,132,0,0,0,0,87,3,2,0.37931,0,1,15,7,false,false,true,0.576,0.424
295,316,-21,14.75,15.8,-21,970,1030,-60,0,1,0,0.05,-28,20,20,-1.428571,1,0,1,1,true,false,true,0.802,0.198
105,152,-47,17.5,30.4,-47,473,683,-210,0,0,0,0,59,6,5,0.644068,0,0,13,23,false,false,false,0.059,0.941
111,136,-25,13.875,19.428571,-25,388,542,-154,0,0,0,0,44,8,7,0.840909,0,0,11,14,false,false,false,0.075,0.925
281,384,-103,16.529412,22.588235,-103,1003,1018,-15,0,0,0,0,-32,17,17,-1.15625,0,0,2,2,false,false,false,0,1
60,107,-47,20,35.666667,-47,452,698,-246,0,1,0,0.333333,78,3,3,0.525641,0,0,22,7,false,false,false,0.162,0.838
113,61,52,22.6,15.25,52,1652,1473,179,1,0,0.2,0,62,5,4,0.483871,0,0,15,11,false,false,true,0.762,0.238
205,198,7,13.666667,14.142857,7,999,1071,-72,0,0,0,0,8,15,14,5,2,0,13,20,false,false,true,0.874,0.126
286,320,-34,15.888889,18.823529,-34,561,688,-127,0,0,0,0,-3,18,17,-15.333333,0,0,15,14,false,false,false,0,1
282,304,-22,18.8,21.714286,-22,689,804,-115,0,0,0,0,1,15,14,35,0,1,7,10,false,false,false,0.003,0.997
278,303,-25,17.375,18.9375,-25,803,786,17,1,0,0.0625,0,-7,16,16,-4.571429,0,0,17,5,true,false,false,0.001,0.999
317,322,-5,21.133333,21.466667,-5,1561,1495,66,1,0,0.066667,0,-15,15,15,-2.2,0,0,5,3,false,false,false,0.273,0.727
162,168,-6,20.25,21,-6,1131,1030,101,0,0,0,0,44,8,8,0.681818,1,0,9,18,false,false,true,0.581,0.419
148,168,-20,18.5,24,-20,971,635,336,0,0,0,0,43,8,7,0.744186,0,0,22,10,false,false,false,0.456,0.544
280,330,-50,13.333333,15.714286,-50,1040,1091,-51,0,0,0,0,-28,21,21,-1.678571,0,0,6,2,false,false,false,0,1
48,39,9,16,19.5,9,1885,1842,43,0,0,0,0,83,3,2,0.325301,0,0,7,12,false,false,false,0.287,0.713
26,71,-45,13,35.5,-45,615,542,73,0,0,0,0,87,2,2,0.482759,0,0,8,15,false,false,false,0.098,0.902
339,347,-8,18.833333,20.411765,-8,1094,1041,53,1,0,0.055556,0,-22,18,17,-1.727273,0,0,2,2,false,false,false,0.077,0.923
147,217,-70,13.363636,19.727273,-70,683,859,-176,0,0,0,0,35,11,11,1.285714,1,0,10,16,false,false,false,0.045,0.955
34,103,-69,5.666667,17.166667,-69,1078,983,95,0,0,0,0,69,6,6,0.695652,1,0,9,13,false,false,false,0.302,0.698
156,173,-17,13,14.416667,-17,306,302,4,0,0,0,0,22,12,12,1.863636,0,0,7,28,false,false,false,0.348,0.652
324,340,-16,23.142857,26.153846,-16,1656,1580,76,1,1,0.071429,0.076923,3,14,13,11,0,0,10,17,false,false,false,0.034,0.966
235,273,-38,29.375,34.125,-38,1047,1127,-80,0,1,0,0.125,28,8,8,0.964286,0,0,13,9,false,false,false,0.29,0.71
249,263,-14,24.9,29.222222,-14,1388,1455,-67,0,0,0,0,21,10,9,1.333333,1,1,8,10,false,false,false,0.123,0.877
285,312,-27,12.391304,14.181818,-27,999,1165,-166,0,0,0,0,-17,23,22,-2.705882,1,1,17,6,false,false,false,0.022,0.978
85,110,-25,17,22,-25,566,742,-176,0,0,0,0,64,5,5,0.5,0,0,20,17,false,false,false,0.132,0.868
268,375,-107,12.761905,18.75,-107,907,878,29,0,0,0,0,-12,21,20,-3.583333,0,0,4,5,false,false,false,0,1
214,242,-28,16.461538,18.615385,-28,796,800,-4,1,0,0.076923,0,21,13,13,2.285714,0,0,11,10,false,false,false,0.091,0.909
88,128,-40,12.571429,21.333333,-40,1580,1629,-49,0,0,0,0,57,7,6,0.649123,0,0,22,10,false,false,false,0.272,0.728
61,54,7,15.25,18,7,736,791,-55,0,0,0,0,76,4,3,0.5,1,0,14,20,false,false,false,0.287,0.713
86,120,-34,17.2,30,-34,594,648,-54,1,1,0.2,0.25,66,5,4,0.606061,0,1,12,10,false,false,false,0.001,0.999
87,125,-38,29,41.666667,-38,1071,1065,6,0,0,0,0,65,3,3,0.476923,0,0,8,12,false,false,false,0.046,0.954
236,193,43,21.454545,19.3,43,664,786,-122,0,0,0,0,29,11,10,1.137931,1,0,11,9,false,false,true,0.642,0.358
317,369,-52,18.647059,21.705882,-52,1397,1309,88,2,0,0.117647,0,-9,17,17,-4,0,0,3,5,false,false,false,0,1
267,216,51,14.833333,12.705882,51,671,638,33,0,0,0,0,-5,18,17,-9.8,0,0,8,21,false,false,true,0.991,0.009
131,251,-120,13.1,27.888889,-120,760,976,-216,0,1,0,0.111111,32,10,9,1.125,0,0,13,9,false,false,false,0,1
24,28,-4,12,14,-4,1439,1428,11,0,0,0,0,89,2,2,0.449438,0,0,8,14,false,false,false,0.299,0.701
242,323,-81,13.444444,19,-81,714,892,-178,0,2,0,0.117647,-8,18,17,-5.25,0,0,12,8,false,false,false,0,1
255,308,-53,13.421053,16.210526,-53,615,542,73,0,0,0,0,-12,19,19,-3.5,0,0,11,8,false,false,false,0,1
0,12,-12,0,12,-12,1793,1869,-76,0,0,0,0,97,1,1,0.309278,0,0,8,12,false,false,false,0.279,0.721
269,347,-78,24.454545,34.7,-78,1415,1361,54,0,1,0,0.1,19,11,10,1.631579,0,0,10,18,false,false,false,0,1
127,255,-128,15.875,31.875,-128,1093,1100,-7,0,1,0,0.125,46,8,8,0.76087,0,0,10,9,false,false,false,0.022,0.978
122,87,35,20.333333,17.4,35,691,704,-13,0,0,0,0,68,6,5,0.558824,0,0,7,9,false,false,true,0.778,0.222
122,201,-79,24.4,40.2,-79,1556,1616,-60,0,0,0,0,67,5,5,0.432836,0,2,12,10,false,false,false,0,1
243,256,-13,16.2,18.285714,-13,595,538,57,0,0,0,0,3,15,14,12.666667,0,1,10,9,false,false,false,0.124,0.876
47,20,27,23.5,20,27,653,820,-167,0,0,0,0,87,2,1,0.436782,0,0,7,17,false,false,false,0.226,0.774
264,306,-42,22,27.818182,-42,1274,1394,-120,0,1,0,0.090909,10,12,11,3,0,0,15,20,false,false,false,0.002,0.998
127,40,87,42.333333,20,87,691,695,-4,1,0,0.333333,0,77,3,2,0.415584,0,0,11,16,false,false,true,0.856,0.144
31,4,27,7.75,1.333333,27,913,1037,-124,0,0,0,0,90,4,3,0.455556,0,0,28,9,false,false,false,0.255,0.745
393,393,0,20.684211,21.833333,0,964,1003,-39,0,1,0,0.055556,-23,19,18,-1.695652,0,0,3,2,false,false,false,0.122,0.878
257,375,-118,14.277778,22.058824,-118,711,746,-35,0,0,0,0,-10,18,17,-3.8,0,0,2,3,false,false,false,0,1
299,365,-66,14.95,18.25,-66,603,721,-118,0,0,0,0,-23,20,20,-1.869565,1,0,2,1,false,false,false,0,1
59,62,-3,11.8,12.4,-3,808,749,59,0,0,0,0,63,5,5,0.666667,0,1,9,16,false,false,false,0.396,0.604
172,323,-151,7.818182,15.380952,-151,651,567,84,0,0,0,0,-12,22,21,-4.583333,0,0,7,11,false,false,false,0,1
159,323,-164,7.95,16.15,-164,651,567,84,0,0,0,0,-5,20,20,-11,0,0,8,11,false,false,false,0,1
40,14,26,40,14,26,1556,1513,43,0,0,0,0,92,1,1,0.336957,0,0,18,7,false,false,true,0.735,0.265
167,152,15,33.4,30.4,15,824,830,-6,1,0,0.2,0,62,5,5,0.709677,0,0,12,11,false,false,true,0.511,0.489
166,190,-24,13.833333,15.833333,-24,970,1030,-60,0,0,0,0,20,12,12,2,0,0,20,9,false,false,false,0.256,0.744
76,66,10,19,22,10,1021,1094,-73,1,0,0.25,0,73,4,3,0.506849,0,0,9,15,false,false,false,0.318,0.682
167,209,-42,11.928571,14.928571,-42,1220,1202,18,0,0,0,0,15,14,14,3.333333,0,2,31,7,false,false,false,0,1
233,301,-68,25.888889,33.444444,-68,1253,1324,-71,0,1,0,0.111111,29,9,9,1,0,0,24,7,false,false,false,0.004,0.996
243,225,18,24.3,22.5,18,1070,814,256,1,1,0.1,0.1,23,10,10,1.434783,0,1,11,11,false,false,true,0.812,0.188
133,196,-63,26.6,39.2,-63,1331,1432,-101,0,0,0,0,48,5,5,0.5625,0,0,13,7,false,false,false,0.057,0.943
125,113,12,15.625,16.142857,12,1248,1220,28,0,1,0,0.142857,56,8,7,0.928571,1,0,9,23,false,false,true,0.64,0.36
206,249,-43,17.166667,22.636364,-43,653,820,-167,0,0,0,0,12,12,11,3.166667,0,0,7,15,false,false,false,0.019,0.981
216,257,-41,13.5,17.133333,-41,830,787,43,0,0,0,0,-2,16,15,-19,0,0,7,8,false,false,false,0.071,0.929
139,190,-51,12.636364,19,-51,1182,1075,107,0,1,0,0.1,26,11,10,1.5,0,1,24,6,false,false,false,0.211,0.789
340,331,9,26.153846,27.583333,9,1331,1432,-101,0,0,0,0,1,13,12,27,0,1,7,7,false,false,true,0.775,0.225
267,394,-127,19.071429,30.307692,-127,999,1283,-284,0,2,0,0.153846,3,14,13,11,0,0,16,7,false,false,false,0,1
73,60,13,18.25,20,13,451,448,3,0,0,0,0,79,4,3,0.468354,0,1,13,6,false,false,false,0.448,0.552
234,307,-73,21.272727,27.909091,-73,1164,1261,-97,0,1,0,0.090909,32,11,11,1.3125,0,0,16,7,false,false,false,0.012,0.988
181,207,-26,22.625,25.875,-26,1439,1314,125,0,0,0,0,42,8,8,0.666667,0,0,13,8,false,false,false,0.244,0.756
58,85,-27,14.5,21.25,-27,500,509,-9,0,0,0,0,73,4,4,0.561644,0,0,7,25,false,false,false,0.173,0.827
171,176,-5,19,19.555556,-5,785,892,-107,0,0,0,0,39,9,9,0.948718,0,0,15,17,false,false,false,0.112,0.888
67,58,9,16.75,19.333333,9,527,954,-427,0,0,0,0,77,4,3,0.454545,0,0,19,10,false,false,false,0.412,0.588
398,468,-70,30.615385,36,-70,2010,2219,-209,1,2,0.076923,0.153846,-9,13,13,-2.888889,0,0,7,1,true,false,false,0,1
56,24,32,28,24,32,451,448,3,0,0,0,0,92,2,1,0.402174,0,1,16,6,false,false,true,0.74,0.26
124,122,2,24.8,24.4,2,1102,1245,-143,0,0,0,0,55,5,5,0.527273,0,0,13,11,false,false,false,0.295,0.705
361,387,-26,30.083333,35.181818,-26,1761,1770,-9,1,1,0.083333,0.090909,-5,12,11,-5.2,0,0,2,5,false,false,true,0.629,0.371
24,2,22,12,2,22,1315,1334,-19,0,0,0,0,89,2,1,0.404494,0,0,10,18,false,false,true,0.543,0.457
130,115,15,26,23,15,1636,1727,-91,0,1,0,0.2,63,5,5,0.47619,0,0,8,8,false,false,true,0.586,0.414
86,73,13,17.2,18.25,13,742,868,-126,0,0,0,0,68,5,4,0.485294,0,0,17,19,false,false,false,0.177,0.823
304,423,-119,12.16,17.625,-119,1037,1016,21,1,0,0.04,0,-21,25,24,-2.761905,1,0,2,5,false,false,false,0,1
266,328,-62,20.461538,25.230769,-62,1110,1399,-289,0,1,0,0.076923,19,13,13,1.789474,0,0,8,16,false,false,false,0,1
209,230,-21,13.933333,16.428571,-21,830,787,43,0,0,0,0,7,15,14,5.428571,0,1,10,10,false,false,false,0.089,0.911
288,377,-89,16.941176,22.176471,-89,691,704,-13,0,1,0,0.058824,-15,17,17,-2.533333,0,0,2,2,false,false,false,0,1
216,241,-25,18,21.909091,-25,785,892,-107,0,0,0,0,25,12,11,1.48,0,0,9,8,false,false,false,0.06,0.94
206,238,-32,12.117647,14.875,-32,1220,1202,18,0,0,0,0,6,17,16,8.333333,0,1,29,11,false,false,false,0,1
158,171,-13,12.153846,14.25,-13,999,1071,-72,0,0,0,0,21,13,12,1.904762,1,0,15,17,false,false,false,0.171,0.829
26,0,26,26,0,26,1312,1334,-22,0,0,0,0,94,1,0,0.414894,0,0,14,0,false,false,true,0.568,0.432
195,175,20,21.666667,19.444444,20,1691,1510,181,0,1,0,0.111111,35,9,9,0.857143,0,0,17,14,false,false,true,0.573,0.427
60,82,-22,12,20.5,-22,813,698,115,0,0,0,0,68,5,4,0.705882,1,1,7,9,false,false,false,0.317,0.683
178,165,13,16.181818,16.5,13,595,538,57,0,0,0,0,29,11,10,1.310345,0,1,17,16,false,false,true,0.742,0.258
239,320,-81,14.9375,21.333333,-81,595,412,183,0,1,0,0.066667,6,16,15,8.666667,0,0,13,10,false,false,false,0,1
16,0,16,16,0,16,1159,1131,28,0,0,0,0,97,1,0,0.381443,0,0,12,0,false,false,true,0.562,0.438
219,263,-44,10.95,13.842105,-44,1220,1202,18,0,0,0,0,-7,20,19,-7.142857,0,1,29,13,false,false,false,0,1
329,347,-18,23.5,24.785714,-18,1436,1489,-53,1,1,0.071429,0.071429,8,14,14,4.625,0,0,14,11,false,false,false,0.484,0.516
28,0,28,28,0,28,804,1074,-270,0,0,0,0,97,1,0,0.329897,0,0,14,0,false,false,false,0.214,0.786
188,247,-59,17.090909,22.454545,-59,771,668,103,0,0,0,0,18,11,11,2.111111,0,0,7,23,false,false,false,0.075,0.925
214,296,-82,15.285714,21.142857,-82,848,976,-128,0,1,0,0.071429,12,14,14,3.333333,1,0,14,14,false,false,false,0.007,0.993
82,144,-62,13.666667,24,-62,1030,1014,16,0,0,0,0,64,6,6,0.515625,1,1,9,11,false,false,false,0.082,0.918
320,338,-18,16,16.9,-18,561,688,-127,0,0,0,0,-17,20,20,-2.705882,0,0,1,5,false,false,false,0.015,0.985
104,88,16,17.333333,17.6,16,952,870,82,0,0,0,0,61,6,5,0.606557,0,0,8,29,false,false,true,0.514,0.486
274,372,-98,18.266667,24.8,-98,965,1078,-113,1,1,0.066667,0.066667,-2,15,15,-18.5,1,0,7,17,false,false,false,0,1
173,149,24,24.714286,21.285714,24,804,1074,-270,0,0,0,0,51,7,7,0.627451,0,1,8,8,false,false,true,0.55,0.45
164,193,-29,20.5,27.571429,-29,1606,1593,13,0,0,0,0,45,8,7,0.644444,0,2,7,6,false,false,false,0.03,0.97
139,145,-6,15.444444,18.125,-6,651,700,-49,0,0,0,0,43,9,8,1.302326,1,0,6,21,false,false,false,0.192,0.808
341,374,-33,15.5,17.809524,-33,1063,1134,-71,1,0,0.045455,0,-19,22,21,-2.315789,0,0,1,1,false,false,false,0,1
157,137,20,31.4,34.25,20,1164,1161,3,0,1,0,0.25,56,5,4,0.410714,0,0,10,21,false,false,false,0.383,0.617
0,0,0,0,0,0,1422,1510,-88,0,0,0,0,100,1,0,0.39,0,0,12,0,false,false,true,0.55,0.45
334,364,-30,15.181818,17.333333,-30,1220,1185,35,0,1,0,0.047619,-25,22,21,-1.88,0,0,8,4,false,false,false,0,1
12,0,12,12,0,12,1885,1842,43,0,0,0,0,95,1,0,0.284211,0,0,9,0,false,false,true,0.576,0.424
170,252,-82,13.076923,19.384615,-82,907,878,29,0,0,0,0,34,13,13,1.264706,1,0,9,8,false,false,false,0.025,0.975
226,232,-6,16.142857,17.846154,-6,450,503,-53,0,0,0,0,13,14,13,3,1,0,9,10,false,false,false,0.207,0.793
318,349,-31,22.714286,26.846154,-31,1495,1597,-102,0,1,0,0.076923,3,14,13,10.666667,0,1,10,9,false,false,false,0,1
197,236,-39,24.625,29.5,-39,724,398,326,1,1,0.125,0.125,42,8,8,0.928571,0,0,7,14,false,false,false,0.072,0.928
18,0,18,18,0,18,1248,1220,28,0,0,0,0,96,1,0,0.541667,0,0,10,0,false,false,true,0.562,0.438
286,300,-14,22,25,-14,1452,1388,64,0,1,0,0.083333,10,13,12,3.5,0,0,14,15,false,false,false,0.149,0.851
268,375,-107,17.866667,26.785714,-107,1038,917,121,1,2,0.066667,0.142857,-7,15,14,-5,0,0,11,10,false,false,false,0,1
316,390,-74,17.555556,22.941176,-74,710,758,-48,1,1,0.055556,0.058824,-13,18,17,-2.846154,0,0,10,5,false,false,false,0,1
12,74,-62,6,37,-62,1454,1479,-25,0,0,0,0,82,2,2,0.378049,1,0,6,11,false,false,false,0.055,0.945
97,96,1,16.166667,16,1,797,796,1,0,0,0,0,67,6,6,0.731343,0,0,7,14,false,false,false,0.463,0.537
248,312,-64,19.076923,24,-64,1055,1019,36,0,0,0,0,1,13,13,33,1,0,7,4,false,false,false,0.067,0.933
182,166,16,14,13.833333,16,808,749,59,0,0,0,0,11,13,12,3.818182,0,0,7,17,false,false,true,0.784,0.216
156,261,-105,15.6,29,-105,976,995,-19,0,1,0,0.111111,36,10,9,1.055556,0,0,11,9,false,false,false,0.02,0.98
191,341,-150,15.916667,28.416667,-150,926,973,-47,0,0,0,0,15,12,12,2.333333,0,0,14,16,false,false,false,0,1
12,14,-2,12,14,-2,561,688,-127,0,0,0,0,92,1,1,0.5,1,0,8,11,false,false,false,0.217,0.783
192,270,-78,16,22.5,-78,1493,1453,40,0,0,0,0,18,12,12,1.944444,0,1,14,10,false,false,false,0,1
243,411,-168,16.2,27.4,-168,926,973,-47,0,0,0,0,-3,15,15,-11.666667,0,0,5,3,false,false,false,0,1
177,241,-64,25.285714,34.428571,-64,1021,897,124,0,2,0,0.285714,41,7,7,0.902439,0,0,15,13,false,false,false,0.174,0.826
378,380,-2,22.235294,23.75,-2,1110,1123,-13,1,2,0.058824,0.125,-19,17,16,-1.736842,0,0,3,3,true,false,true,0.66,0.34
217,259,-42,18.083333,21.583333,-42,725,668,57,0,0,0,0,20,12,12,1.75,0,0,7,12,false,false,false,0.1,0.9
217,368,-151,31,52.571429,-151,2010,2219,-209,1,1,0.142857,0.142857,34,7,7,0.764706,0,0,8,10,false,false,false,0,1
27,6,21,13.5,6,21,491,651,-160,0,0,0,0,91,2,1,0.32967,0,1,14,11,false,false,false,0.217,0.783
289,328,-39,19.266667,23.428571,-39,621,786,-165,0,0,0,0,-17,15,14,-1.764706,0,0,1,2,false,false,false,0.003,0.997
172,242,-70,13.230769,20.166667,-70,1248,1220,28,0,1,0,0.083333,30,13,12,1.733333,1,0,9,9,false,false,false,0.031,0.969
162,201,-39,18,25.125,-39,725,668,57,0,0,0,0,43,9,8,0.813953,0,0,21,10,false,false,false,0.39,0.61
268,444,-176,12.181818,20.181818,-176,1078,983,95,1,0,0.045455,0,-28,22,22,-1.714286,0,0,6,4,false,false,false,0,1
314,318,-4,16.526316,17.666667,-4,1021,1094,-73,1,0,0.052632,0,-17,19,18,-2.176471,1,1,1,3,true,false,false,0.075,0.925
354,346,8,23.6,23.066667,8,1305,1194,111,1,1,0.066667,0.066667,-10,15,15,-3.3,0,0,10,5,false,false,true,0.7,0.3
206,234,-28,18.727273,21.272727,-28,1161,1030,131,0,1,0,0.090909,22,11,11,1.727273,0,0,23,9,false,false,false,0.327,0.673
159,238,-79,15.9,23.8,-79,642,952,-310,0,0,0,0,33,10,10,1.333333,0,0,7,12,false,false,false,0.025,0.975
197,307,-110,21.888889,34.111111,-110,1636,1727,-91,0,2,0,0.222222,26,9,9,1.153846,1,0,12,17,false,false,false,0.023,0.977
101,72,29,16.833333,14.4,29,1220,1185,35,0,0,0,0,66,6,5,0.712121,0,1,27,6,false,false,true,0.533,0.467
76,73,3,25.333333,24.333333,3,892,856,36,0,0,0,0,79,3,3,0.443038,0,0,9,9,false,false,true,0.576,0.424
86,119,-33,12.285714,19.833333,-33,907,1070,-163,0,0,0,0,55,7,6,0.636364,0,0,19,18,false,false,false,0.072,0.928
27,26,1,13.5,26,1,1075,878,197,0,0,0,0,89,2,1,0.370787,0,0,19,17,false,false,true,0.508,0.492
52,51,1,13,17,1,775,786,-11,0,0,0,0,76,4,3,0.565789,0,0,9,16,false,false,false,0.288,0.712
248,354,-106,20.666667,29.5,-106,1636,1796,-160,0,0,0,0,2,12,12,13.5,0,1,7,6,false,false,false,0,1
146,173,-27,20.857143,28.833333,-27,907,910,-3,0,1,0,0.166667,60,7,6,0.716667,1,0,6,19,false,false,false,0.265,0.735
244,222,22,24.4,24.666667,22,1344,1208,136,1,1,0.1,0.111111,32,10,9,0.9375,0,1,10,9,false,false,true,0.654,0.346
83,115,-32,13.833333,19.166667,-32,1270,1261,9,0,0,0,0,66,6,6,0.560606,1,0,6,17,false,false,false,0.273,0.727
217,260,-43,13.5625,17.333333,-43,1278,1101,177,0,1,0,0.066667,8,16,15,4.625,0,0,23,13,false,false,false,0.006,0.994
70,101,-31,14,25.25,-31,1101,1115,-14,0,0,0,0,71,5,4,0.422535,0,0,10,14,false,false,false,0.26,0.74
23,26,-3,7.666667,13,-3,940,947,-7,0,0,0,0,83,3,2,0.421687,0,0,11,7,false,false,false,0.358,0.642
47,39,8,15.666667,19.5,8,1349,1203,146,0,0,0,0,83,3,2,0.385542,0,1,11,6,false,false,false,0.282,0.718
160,247,-87,17.777778,27.444444,-87,1656,1649,7,0,0,0,0,34,9,9,0.941176,0,0,16,12,false,false,false,0.02,0.98
256,336,-80,11.636364,15.272727,-80,651,700,-49,0,0,0,0,-29,22,22,-1.931034,0,0,21,13,false,false,false,0,1
216,174,42,21.6,17.4,42,675,570,105,0,0,0,0,28,10,10,1.25,0,0,11,16,false,false,true,0.945,0.055
63,131,-68,15.75,32.75,-68,1305,1194,111,0,0,0,0,72,4,4,0.458333,0,0,16,16,false,false,false,0.045,0.955
196,179,17,17.818182,17.9,17,387,683,-296,0,0,0,0,17,11,10,2,1,0,8,21,false,false,true,0.657,0.343
29,49,-20,9.666667,16.333333,-20,206,346,-140,0,0,0,0,81,3,3,0.530864,0,0,13,16,false,false,false,0.2,0.8
76,99,-23,12.666667,16.5,-23,814,830,-16,0,0,0,0,60,6,6,0.683333,0,0,12,11,false,false,false,0.281,0.719
217,246,-29,18.083333,22.363636,-29,725,668,57,0,0,0,0,24,12,11,1.458333,0,0,7,9,false,false,false,0.121,0.879
56,43,13,18.666667,21.5,13,603,721,-118,0,0,0,0,86,3,2,0.5,0,0,17,10,false,false,false,0.22,0.78
12,70,-58,12,70,-58,1182,1075,107,0,1,0,1,90,1,1,0.433333,0,0,17,10,false,false,false,0.308,0.692
229,394,-165,13.470588,23.176471,-165,473,683,-210,0,0,0,0,-12,17,17,-3.166667,0,0,2,2,false,false,false,0,1
173,201,-28,17.3,20.1,-28,1176,1211,-35,0,0,0,0,19,10,10,1.736842,1,0,7,10,false,false,false,0.278,0.722
366,328,38,26.142857,25.230769,38,1093,1100,-7,3,0,0.214286,0,8,14,13,3.875,0,0,10,15,false,false,true,0.95,0.05
268,290,-22,17.866667,20.714286,-22,576,602,-26,0,0,0,0,2,15,14,21,0,0,14,16,false,false,false,0.062,0.938
215,267,-52,21.5,29.666667,-52,991,1063,-72,0,1,0,0.111111,36,10,9,1.055556,0,0,10,10,false,false,false,0.049,0.951
79,49,30,19.75,16.333333,30,1197,1156,41,0,0,0,0,73,4,3,0.479452,0,1,13,8,false,false,true,0.548,0.452
263,267,-4,17.533333,19.071429,-4,803,786,17,1,0,0.066667,0,0,15,14,0,0,0,18,18,false,false,false,0.244,0.756
66,71,-5,9.428571,10.142857,-5,925,1000,-75,0,0,0,0,53,7,7,0.830189,0,1,10,8,false,false,false,0.235,0.765
245,394,-149,16.333333,28.142857,-149,1399,1210,189,0,1,0,0.071429,2,15,14,17.5,0,0,9,7,false,false,false,0,1
255,244,11,23.181818,24.4,11,1422,1798,-376,0,1,0,0.1,26,11,10,1.230769,0,1,7,8,false,false,false,0.49,0.51
296,321,-25,21.142857,22.928571,-25,786,885,-99,1,1,0.071429,0.071429,10,14,14,3.4,0,0,7,13,false,false,false,0.149,0.851
192,189,3,19.2,21,3,1417,1482,-65,0,0,0,0,42,10,9,0.785714,0,1,9,6,false,false,false,0.214,0.786
8,0,8,8,0,8,430,542,-112,0,0,0,0,96,1,0,0.5,0,0,8,0,false,false,false,0.212,0.788
32,17,15,16,17,15,1063,1134,-71,0,0,0,0,92,2,1,0.478261,0,0,7,15,false,false,false,0.32,0.68
68,181,-113,13.6,36.2,-113,595,412,183,0,1,0,0.2,66,5,5,0.787879,0,1,15,8,false,false,false,0.027,0.973
14,9,5,14,9,5,721,757,-36,0,0,0,0,93,1,1,0.408602,0,0,12,20,false,false,false,0.275,0.725
12,0,12,12,0,12,822,845,-23,0,0,0,0,97,1,0,0.360825,0,0,23,0,false,false,true,0.561,0.439
35,14,21,17.5,7,21,726,818,-92,0,0,0,0,86,2,2,0.406977,0,1,7,8,false,false,false,0.228,0.772
316,409,-93,16.631579,21.526316,-93,935,995,-60,1,1,0.052632,0.052632,-25,19,19,-1.56,0,0,6,1,false,false,false,0,1
137,218,-81,22.833333,43.6,-81,1633,1680,-47,0,1,0,0.2,45,6,5,0.622222,0,0,9,14,false,false,false,0.028,0.972
198,257,-59,28.285714,36.714286,-59,1761,1770,-9,0,1,0,0.142857,38,7,7,0.684211,0,0,9,10,false,false,false,0.052,0.948
20,16,4,20,16,4,796,800,-4,0,0,0,0,94,1,1,0.510638,1,0,29,14,false,false,true,0.785,0.215
44,33,11,22,16.5,11,1388,1366,22,0,0,0,0,86,2,2,0.372093,0,0,8,14,false,false,true,0.517,0.483
55,30,25,27.5,30,25,1417,1482,-65,0,0,0,0,89,2,1,0.370787,0,0,26,15,false,false,true,0.691,0.309
285,314,-29,15.833333,17.444444,-29,360,371,-11,0,0,0,0,-29,18,18,-1.275862,0,0,1,1,false,false,false,0.1,0.9
210,265,-55,19.090909,24.090909,-55,1205,1216,-11,0,0,0,0,24,11,11,1.375,0,0,16,12,false,false,false,0.105,0.895
346,396,-50,20.352941,24.75,-50,921,1045,-124,0,1,0,0.0625,-8,17,16,-4.375,0,1,1,5,false,false,false,0,1
248,268,-20,19.076923,20.615385,-20,907,910,-3,0,1,0,0.076923,26,13,13,1.653846,0,0,11,9,false,false,true,0.606,0.394
44,78,-34,8.8,15.6,-34,1344,1208,136,0,0,0,0,70,5,5,0.428571,0,0,22,13,false,false,false,0.301,0.699
204,284,-80,17,23.666667,-80,344,315,29,1,0,0.083333,0,7,12,12,5.714286,0,0,19,8,false,false,false,0,1
20,26,-6,10,13,-6,1344,1314,30,0,1,0,0.5,82,2,2,0.414634,0,0,8,12,false,false,false,0.308,0.692
242,367,-125,18.615385,28.230769,-125,1572,1777,-205,0,2,0,0.153846,-4,13,13,-8.25,0,0,21,15,false,false,false,0,1
73,96,-23,14.6,19.2,-23,1045,1082,-37,0,0,0,0,67,5,5,0.671642,1,0,20,8,false,false,true,0.642,0.358
289,291,-2,18.0625,19.4,-2,1021,1094,-73,1,0,0.0625,0,-1,16,15,-37,1,0,6,7,false,false,false,0.414,0.586
0,0,0,0,0,0,1168,1216,-48,0,0,0,0,100,1,0,0.33,0,0,23,0,false,false,true,0.558,0.442
329,364,-35,16.45,18.2,-35,1439,1428,11,0,0,0,0,-18,20,20,-2.222222,1,0,2,1,true,false,false,0.026,0.974
300,322,-22,23.076923,26.833333,-22,1556,1513,43,0,0,0,0,4,13,12,7.75,0,0,11,9,false,false,false,0.046,0.954
384,372,12,25.6,26.571429,12,1552,1803,-251,3,0,0.2,0,-9,15,14,-3.666667,0,0,7,4,false,false,true,0.872,0.128
167,206,-39,18.555556,22.888889,-39,1561,1495,66,1,0,0.111111,0,29,9,9,1.137931,1,0,6,11,false,false,false,0.105,0.895
63,102,-39,15.75,34,-39,1349,1203,146,0,1,0,0.333333,72,4,3,0.444444,0,0,9,11,false,false,false,0.271,0.729
0,10,-10,0,10,-10,795,786,9,0,0,0,0,97,1,1,0.391753,0,0,10,19,false,false,false,0.308,0.692
169,168,1,15.363636,16.8,1,450,503,-53,0,0,0,0,31,11,10,1.258065,1,0,19,14,false,false,false,0.251,0.749
339,430,-91,21.1875,28.666667,-91,1537,1539,-2,0,1,0,0.066667,-15,16,15,-2.266667,0,1,1,5,false,false,false,0,1
312,345,-33,17.333333,20.294118,-33,1439,1428,11,0,0,0,0,-5,18,17,-8,1,0,4,8,false,false,false,0.03,0.97
254,315,-61,21.166667,26.25,-61,1164,1261,-97,0,1,0,0.083333,28,12,12,1.5,0,0,13,8,false,false,false,0.019,0.981
226,329,-103,22.6,32.9,-103,1586,1633,-47,1,0,0.1,0,34,10,10,1,0,1,17,8,false,false,false,0,1
56,79,-23,14,26.333333,-23,561,688,-127,0,0,0,0,74,4,3,0.621622,0,1,8,9,false,false,false,0.041,0.959
301,413,-112,17.705882,25.8125,-112,1038,917,121,1,2,0.058824,0.125,-18,17,16,-1.944444,0,0,2,2,false,false,false,0,1
71,88,-17,17.75,22,-17,971,635,336,0,0,0,0,69,4,4,0.463768,0,0,12,13,false,false,true,0.502,0.498
71,124,-53,11.833333,20.666667,-53,95,453,-358,0,0,0,0,67,6,6,0.58209,0,1,7,9,false,false,false,0,1
44,60,-16,11,15,-16,830,787,43,0,0,0,0,73,4,4,0.520548,0,0,30,12,false,false,false,0.436,0.564
255,290,-35,11.590909,13.181818,-35,668,363,305,0,0,0,0,-25,22,22,-1.88,0,0,10,1,false,false,false,0.001,0.999
203,215,-12,16.916667,19.545455,-12,1439,1428,11,0,0,0,0,30,12,11,1.333333,0,0,19,11,false,false,false,0.27,0.73
291,282,9,19.4,18.8,9,675,570,105,0,0,0,0,-12,15,15,-2.916667,0,0,20,4,false,false,true,0.824,0.176
29,71,-42,9.666667,23.666667,-42,907,1070,-163,0,0,0,0,80,3,3,0.4375,0,0,22,7,false,false,false,0.08,0.92
252,290,-38,22.909091,29,-38,1071,1065,6,0,0,0,0,16,11,10,1.9375,0,0,9,9,false,false,false,0.033,0.967
145,269,-124,20.714286,44.833333,-124,1632,2020,-388,0,1,0,0.166667,46,7,6,0.673913,0,0,9,8,false,false,false,0,1
266,354,-88,20.461538,29.5,-88,1636,1796,-160,0,0,0,0,-1,13,12,-27,0,1,6,6,false,false,false,0,1
189,186,3,23.625,26.571429,3,1063,1134,-71,1,0,0.125,0,55,8,7,0.8,0,0,9,14,false,false,false,0.143,0.857
304,463,-159,21.714286,33.071429,-159,1556,1656,-100,0,2,0,0.142857,-13,14,14,-2.307692,0,0,2,1,false,false,false,0,1
135,147,-12,12.272727,13.363636,-12,1278,1101,177,0,0,0,0,35,11,11,1.057143,1,1,18,11,false,false,true,0.509,0.491
12,0,12,12,0,12,835,786,49,0,0,0,0,97,1,0,0.350515,0,0,15,0,false,false,true,0.572,0.428
202,244,-42,18.363636,22.181818,-42,1432,1452,-20,0,1,0,0.090909,23,11,11,1.565217,1,0,8,17,false,false,false,0.194,0.806
334,364,-30,14.521739,16.545455,-30,1220,1185,35,0,1,0,0.045455,-25,23,22,-1.88,0,0,8,4,false,false,false,0,1
58,78,-20,19.333333,39,-20,1182,1075,107,0,1,0,0.5,78,3,2,0.5,0,0,15,9,false,false,false,0.272,0.728
193,240,-47,10.722222,13.333333,-47,542,390,152,0,0,0,0,10,18,18,5,1,0,6,10,false,false,false,0.115,0.885
281,450,-169,17.5625,28.125,-169,976,995,-19,1,2,0.0625,0.125,-10,16,16,-3.8,1,0,6,4,false,false,false,0,1
60,41,19,15,10.25,19,797,796,1,0,0,0,0,80,4,4,0.6125,0,0,13,19,false,false,true,0.723,0.277
215,286,-71,19.545455,28.6,-71,1110,1399,-289,0,1,0,0.1,32,11,10,1.0625,0,0,18,7,false,false,false,0,1
234,349,-115,19.5,29.083333,-115,1334,1439,-105,1,1,0.083333,0.083333,27,12,12,1.333333,0,0,16,10,false,false,false,0,1
155,166,-11,11.923077,13.833333,-11,391,542,-151,1,0,0.076923,0,18,13,12,2.555556,0,0,7,14,false,false,true,0.71,0.29
268,328,-60,16.75,21.866667,-60,1071,1181,-110,0,0,0,0,2,16,15,17,0,1,5,9,false,false,false,0,1
210,273,-63,12.352941,17.0625,-63,595,540,55,0,0,0,0,-2,17,16,-21.5,0,0,11,17,false,false,false,0,1
52,65,-13,17.333333,21.666667,-13,480,518,-38,0,0,0,0,77,3,3,0.519481,0,1,14,11,false,false,false,0.205,0.795
316,342,-26,19.75,21.375,-26,1094,1041,53,1,0,0.0625,0,-14,16,16,-2.714286,0,0,9,3,false,false,false,0.019,0.981
97,88,9,16.166667,17.6,9,797,796,1,0,0,0,0,70,6,5,0.7,0,0,7,13,false,false,false,0.341,0.659
275,374,-99,16.176471,23.375,-99,1270,1424,-154,0,2,0,0.125,-10,17,16,-3.5,0,0,4,3,false,false,false,0,1
187,210,-23,17,19.090909,-23,1633,1556,77,0,0,0,0,19,11,11,1.736842,0,0,18,10,false,false,false,0.268,0.732
31,59,-28,10.333333,19.666667,-28,342,53,289,0,0,0,0,79,3,3,0.518987,0,0,10,17,false,false,true,0.503,0.497
153,172,-19,30.6,43,-19,1761,1770,-9,0,1,0,0.25,60,5,4,0.433333,0,0,11,8,false,false,false,0.274,0.726
242,279,-37,22,27.9,-37,991,1063,-72,0,1,0,0.1,27,11,10,1.407407,1,0,8,11,false,false,false,0.135,0.865
27,52,-25,9,17.333333,-25,1561,1495,66,0,0,0,0,80,3,3,0.4125,1,0,10,14,false,false,false,0.317,0.683
30,24,6,10,12,6,1037,913,124,0,0,0,0,90,3,2,0.422222,0,0,10,19,false,false,true,0.505,0.495
309,339,-30,15.45,16.95,-30,995,965,30,0,1,0,0.05,-22,20,20,-1.818182,0,0,1,1,true,false,false,0.016,0.984
53,94,-41,10.6,18.8,-41,651,567,84,0,0,0,0,66,5,5,0.833333,0,0,9,25,false,false,false,0.493,0.507
109,124,-15,18.166667,20.666667,-15,500,532,-32,0,0,0,0,56,6,6,0.732143,0,0,8,10,false,false,false,0.372,0.628
333,347,-14,14.478261,15.772727,-14,430,542,-112,0,1,0,0.045455,-33,23,22,-1.454545,0,0,1,1,false,false,false,0.008,0.992
212,238,-26,21.2,26.444444,-26,1645,1636,9,0,1,0,0.111111,24,10,9,1.375,0,0,16,8,false,false,false,0.264,0.736
186,222,-36,16.909091,20.181818,-36,500,532,-32,0,0,0,0,24,11,11,1.708333,0,1,15,8,false,false,false,0.057,0.943
106,160,-54,15.142857,22.857143,-54,1176,1211,-35,0,0,0,0,43,7,7,0.767442,1,0,7,13,false,false,false,0.227,0.773
28,22,6,14,11,6,670,576,94,0,0,0,0,81,2,2,0.506173,0,0,9,11,false,false,true,0.781,0.219
129,87,42,14.333333,10.875,42,491,651,-160,0,0,0,0,51,9,8,0.588235,0,1,10,7,false,false,true,0.586,0.414
150,189,-39,13.636364,17.181818,-39,840,1055,-215,0,0,0,0,28,11,11,1.25,0,1,21,15,false,false,false,0.064,0.936
145,198,-53,20.714286,28.285714,-53,503,527,-24,0,1,0,0.142857,42,7,7,0.785714,0,0,7,9,false,false,false,0.232,0.768
192,249,-57,16,20.75,-57,343,570,-227,0,0,0,0,10,12,12,3.6,0,0,19,7,false,false,false,0.005,0.995
80,41,39,26.666667,20.5,39,1071,1181,-110,0,0,0,0,81,3,2,0.419753,0,0,7,13,false,false,false,0.31,0.69
187,146,41,20.777778,18.25,41,1432,1452,-20,0,0,0,0,40,9,8,0.9,1,0,9,8,false,false,true,0.768,0.232
186,191,-5,20.666667,23.875,-5,694,658,36,0,1,0,0.125,40,9,8,0.925,0,1,25,6,false,false,true,0.628,0.372
86,70,16,43,70,16,1086,926,160,0,1,0,1,82,2,1,0.341463,1,0,20,13,false,false,true,0.77,0.23
144,232,-88,18,29,-88,594,648,-54,1,1,0.125,0.125,42,8,8,0.952381,0,0,14,16,false,false,false,0.007,0.993
44,60,-16,8.8,15,-16,1344,1208,136,0,0,0,0,74,5,4,0.405405,0,0,22,12,false,false,false,0.29,0.71
185,128,57,30.833333,21.333333,57,1563,1539,24,0,0,0,0,50,6,6,0.7,0,2,9,5,false,false,true,0.787,0.213
260,282,-22,17.333333,18.8,-22,1310,1477,-167,0,0,0,0,-11,15,15,-3.272727,0,0,16,7,false,false,false,0,1
76,105,-29,19,26.25,-29,518,461,57,0,0,0,0,73,4,4,0.493151,0,0,10,13,false,false,true,0.504,0.496
326,268,58,32.6,29.777778,58,1777,1689,88,1,1,0.1,0.111111,17,10,9,1.588235,0,1,19,13,false,false,true,0.91,0.09
148,198,-50,21.142857,28.285714,-50,1315,1334,-19,0,1,0,0.142857,49,7,7,0.734694,0,1,7,6,false,false,false,0.156,0.844
14,17,-3,14,17,-3,1168,1062,106,0,0,0,0,93,1,1,0.462366,0,1,11,11,false,false,false,0.389,0.611
181,214,-33,13.923077,16.461538,-33,1193,1220,-27,0,0,0,0,18,13,13,2.388889,1,0,8,12,false,false,false,0.288,0.712
142,132,10,17.75,18.857143,10,995,965,30,0,0,0,0,47,8,7,0.851064,0,1,25,13,false,false,false,0.299,0.701
286,297,-11,13.619048,14.142857,-11,797,796,1,0,0,0,0,-19,21,21,-2.578947,0,0,7,5,false,false,false,0.059,0.941
219,272,-53,10.95,13.6,-53,1220,1202,18,0,0,0,0,-10,20,20,-5,0,1,29,12,false,false,false,0,1
310,333,-23,20.666667,22.2,-23,786,885,-99,1,1,0.066667,0.066667,3,15,15,11.333333,0,0,5,7,false,false,false,0.128,0.872
196,263,-67,13.066667,17.533333,-67,595,540,55,0,0,0,0,7,15,15,6.142857,0,0,10,19,false,false,false,0.013,0.987
255,296,-41,11.086957,12.869565,-41,668,363,305,0,0,0,0,-28,23,23,-1.678571,0,0,10,1,false,false,false,0,1
314,411,-97,34.888889,51.375,-97,1398,1431,-33,0,0,0,0,14,9,8,2,0,1,13,11,false,false,false,0,1
307,277,30,23.615385,21.307692,30,1373,1334,39,1,1,0.076923,0.076923,12,13,13,2.666667,1,1,6,9,false,false,true,0.857,0.143
322,348,-26,16.947368,19.333333,-26,824,830,-6,1,0,0.052632,0,-10,19,18,-4.4,0,0,7,8,false,false,false,0,1
131,211,-80,18.714286,35.166667,-80,976,995,-19,0,1,0,0.166667,54,7,6,0.703704,0,0,9,16,false,false,false,0.029,0.971
12,19,-7,6,19,-7,1210,1162,48,0,0,0,0,88,2,1,0.363636,0,0,7,14,false,false,false,0.272,0.728
167,209,-42,27.833333,34.833333,-42,1415,1361,54,0,0,0,0,53,6,6,0.584906,0,1,11,8,false,false,false,0.033,0.967
6,0,6,6,0,6,1220,1202,18,0,0,0,0,97,1,0,0.515464,0,0,19,0,false,false,true,0.561,0.439
178,290,-112,14.833333,24.166667,-112,944,1095,-151,0,1,0,0.083333,29,12,12,1.344828,0,2,14,5,false,false,false,0,1
142,98,44,20.285714,16.333333,44,704,523,181,0,0,0,0,51,7,6,0.686275,0,0,7,11,false,false,true,0.78,0.22
107,108,-1,13.375,13.5,-1,999,1071,-72,0,0,0,0,46,8,8,0.869565,1,0,9,17,false,false,true,0.518,0.482
43,34,9,14.333333,17,9,1037,1009,28,0,0,0,0,84,3,2,0.52381,0,0,18,9,false,false,false,0.419,0.581
174,132,42,19.333333,14.666667,42,1168,1216,-48,0,0,0,0,52,9,9,0.634615,0,0,15,17,false,false,true,0.742,0.258
324,413,-89,21.6,27.533333,-89,724,398,326,1,1,0.066667,0.066667,4,15,15,9.75,0,0,9,9,false,false,false,0.002,0.998
89,190,-101,9.888889,21.111111,-101,595,662,-67,0,1,0,0.111111,36,9,9,1.222222,0,1,28,6,false,false,false,0,1
22,0,22,22,0,22,1422,1583,-161,0,0,0,0,95,1,0,0.431579,0,0,16,0,false,false,false,0.355,0.645
327,348,-21,21.8,24.857143,-21,804,1074,-270,0,0,0,0,-10,15,14,-3.2,0,0,1,2,false,false,false,0.016,0.984
265,244,21,24.090909,24.4,21,1305,1194,111,1,0,0.090909,0,21,11,10,1.571429,0,0,16,7,false,false,false,0.389,0.611
10,25,-15,10,25,-15,1305,1194,111,0,0,0,0,94,1,1,0.351064,0,0,7,20,false,false,false,0.274,0.726
256,252,4,16,16.8,4,430,542,-112,0,1,0,0.066667,7,16,15,6.857143,0,0,16,15,false,false,true,0.531,0.469
288,347,-59,18,21.6875,-59,1063,1134,-71,1,0,0.0625,0,10,16,16,4.4,0,0,10,8,false,false,false,0,1
231,357,-126,15.4,23.8,-126,711,746,-35,0,0,0,0,1,15,15,38,0,0,11,7,false,false,false,0,1
283,295,-12,16.647059,18.4375,-12,704,523,181,0,0,0,0,-22,17,16,-1.590909,0,0,1,3,false,false,false,0.079,0.921
38,45,-7,12.666667,22.5,-7,1270,1261,9,0,0,0,0,84,3,2,0.440476,1,0,10,21,false,false,false,0.326,0.674
298,374,-76,11.461538,14.96,-76,595,412,183,0,1,0,0.04,-22,26,25,-2.363636,0,0,10,11,false,false,false,0,1
261,302,-41,18.642857,23.230769,-41,1633,1620,13,0,0,0,0,-1,14,13,-36,0,0,18,10,false,false,false,0,1
176,226,-50,17.6,22.6,-50,1123,1062,61,0,0,0,0,33,10,10,1.333333,0,0,16,15,false,false,false,0.174,0.826
71,128,-57,23.666667,64,-57,1388,1455,-67,0,0,0,0,73,3,2,0.383562,0,0,14,8,false,false,false,0.029,0.971
144,169,-25,16,18.777778,-25,840,1055,-215,0,0,0,0,39,9,9,0.897436,0,0,12,7,false,false,false,0.087,0.913
50,99,-49,25,49.5,-49,1633,1680,-47,0,1,0,0.5,77,2,2,0.363636,0,0,10,8,false,false,false,0.273,0.727
145,99,46,13.181818,9,46,491,651,-160,0,0,0,0,37,11,11,0.810811,0,1,10,6,false,false,true,0.6,0.4
305,371,-66,20.333333,24.733333,-66,1232,1281,-49,0,2,0,0.133333,-16,15,15,-1.9375,0,0,2,5,false,false,false,0,1
411,492,-81,29.357143,37.846154,-81,1699,1580,119,3,2,0.214286,0.153846,-5,14,13,-6,0,0,1,5,false,false,false,0,1
175,206,-31,17.5,22.888889,-31,1561,1495,66,1,0,0.1,0,26,10,9,1.269231,1,0,6,11,false,false,false,0.075,0.925
367,468,-101,21.588235,27.529412,-101,1699,1803,-104,1,1,0.058824,0.058824,-8,17,17,-4.375,0,0,6,3,false,false,false,0,1
287,427,-140,15.944444,25.117647,-140,1315,1334,-19,0,2,0,0.117647,-17,18,17,-2.117647,0,0,1,4,false,false,false,0,1
20,0,20,20,0,20,1195,1397,-202,0,0,0,0,95,1,0,0.421053,0,0,9,0,false,false,false,0.212,0.788
117,150,-33,19.5,25,-33,1495,1597,-102,0,0,0,0,59,6,6,0.542373,0,1,10,10,false,false,false,0.134,0.866
69,92,-23,17.25,23,-23,402,448,-46,0,0,0,0,72,4,4,0.513889,0,1,7,7,false,false,false,0.049,0.951
264,295,-31,17.6,21.071429,-31,944,1095,-151,0,1,0,0.071429,14,15,14,2.785714,0,2,9,8,false,false,false,0,1
228,269,-41,25.333333,29.888889,-41,1885,1842,43,0,2,0,0.222222,22,9,9,1.227273,0,1,16,9,false,false,false,0.209,0.791
196,163,33,21.777778,18.111111,33,664,786,-122,0,0,0,0,38,9,9,0.868421,1,0,14,13,false,false,true,0.688,0.312
335,308,27,33.5,34.222222,27,1699,1580,119,3,1,0.3,0.111111,20,10,9,1.5,0,0,20,14,false,false,true,0.974,0.026
166,161,5,12.769231,13.416667,5,342,53,289,0,0,0,0,18,13,12,2.277778,0,1,10,10,false,false,false,0.31,0.69
253,323,-70,14.882353,19,-70,642,952,-310,0,0,0,0,-7,17,17,-6.285714,0,0,4,5,false,false,false,0,1
28,13,15,14,13,15,977,1100,-123,0,0,0,0,89,2,1,0.460674,0,0,9,9,false,false,false,0.234,0.766
119,182,-63,14.875,26,-63,837,844,-7,0,0,0,0,58,8,7,0.706897,1,1,6,7,false,false,false,0.007,0.993
211,251,-40,14.066667,16.733333,-40,526,502,24,0,0,0,0,10,15,15,5,0,0,10,22,false,false,false,0.029,0.971
73,178,-105,10.428571,25.428571,-105,1368,1452,-84,0,0,0,0,58,7,7,0.551724,1,0,7,15,false,false,false,0.007,0.993
57,37,20,28.5,18.5,20,1885,1908,-23,0,1,0,0.5,82,2,2,0.280488,1,1,12,9,false,false,true,0.728,0.272
245,377,-132,14.411765,22.176471,-132,450,427,23,1,1,0.058824,0.058824,-20,17,17,-1.85,0,0,5,5,false,false,false,0,1
229,225,4,15.266667,15,4,306,302,4,0,0,0,0,2,15,15,20.5,0,0,7,12,false,false,true,0.865,0.135
187,260,-73,12.466667,17.333333,-73,1278,1101,177,0,1,0,0.066667,12,15,15,3.083333,0,0,23,13,false,false,false,0,1
302,316,-14,13.130435,13.73913,-14,671,638,33,0,0,0,0,-34,23,23,-1.441176,0,0,2,1,false,false,true,0.68,0.32
147,290,-143,14.7,29,-143,1699,1803,-104,1,1,0.1,0.1,44,10,10,0.795455,0,0,19,18,false,false,false,0,1
157,103,54,13.083333,8.583333,54,491,651,-160,0,0,0,0,32,12,12,0.9375,1,1,9,6,false,false,true,0.764,0.236
96,163,-67,12,20.375,-67,1071,1000,71,0,0,0,0,53,8,8,0.886792,1,1,6,8,false,false,false,0.034,0.966
265,289,-24,17.666667,20.642857,-24,450,624,-174,0,0,0,0,-8,15,14,-4.125,1,0,4,17,false,false,false,0.032,0.968
273,292,-19,24.818182,26.545455,-19,1436,1489,-53,1,1,0.090909,0.090909,25,11,11,1.48,0,0,9,7,false,false,false,0.346,0.654
119,159,-40,14.875,22.714286,-40,683,859,-176,0,0,0,0,54,8,7,0.833333,1,0,15,10,false,false,false,0.077,0.923
245,354,-109,18.846154,29.5,-109,1101,1115,-14,0,1,0,0.083333,6,13,12,5,1,0,6,8,false,false,false,0.007,0.993
47,15,32,15.666667,7.5,32,1195,1397,-202,0,0,0,0,85,3,2,0.470588,0,1,7,15,false,false,false,0.214,0.786
14,0,14,14,0,14,1925,1885,40,0,0,0,0,96,1,0,0.260417,0,0,13,0,false,false,true,0.602,0.398
291,422,-131,15.315789,23.444444,-131,1229,1220,9,0,1,0,0.055556,-13,19,18,-2.846154,0,0,1,2,true,false,false,0,1
294,402,-108,24.5,36.545455,-108,1586,1633,-47,1,1,0.083333,0.090909,17,12,11,2,0,0,12,13,false,false,false,0,1
274,309,-35,27.4,34.333333,-35,1086,926,160,0,2,0,0.222222,20,10,9,1.4,0,0,9,19,false,false,false,0.03,0.97
215,303,-88,9.772727,13.772727,-88,542,390,152,0,0,0,0,-9,22,22,-5.555556,1,0,6,7,false,false,false,0,1
352,428,-76,23.466667,30.571429,-76,1689,1777,-88,1,1,0.066667,0.071429,-15,15,14,-2,0,0,5,2,false,false,false,0,1
132,266,-134,16.5,38,-134,1399,1210,189,0,1,0,0.142857,47,8,7,0.744681,0,0,16,17,false,false,false,0,1
192,201,-9,24,28.714286,-9,1793,1869,-76,0,1,0,0.142857,42,8,7,0.714286,0,0,28,12,false,false,false,0.437,0.563
60,106,-46,10,21.2,-46,813,698,115,0,0,0,0,65,6,5,0.738462,1,1,8,9,false,false,false,0.115,0.885
280,330,-50,21.538462,25.384615,-50,1164,1261,-97,0,1,0,0.076923,20,13,13,2.1,0,0,12,8,false,false,false,0.023,0.977
70,94,-24,35,47,-24,1761,1770,-9,0,1,0,0.5,82,2,2,0.317073,0,0,11,18,false,false,false,0.433,0.567
67,91,-24,13.4,22.75,-24,1075,878,197,0,0,0,0,71,5,4,0.464789,0,0,18,12,false,false,true,0.502,0.498
55,48,7,27.5,24,7,921,1045,-124,0,0,0,0,87,2,2,0.402299,0,0,10,11,false,false,false,0.223,0.777
272,414,-142,20.923077,31.846154,-142,1636,1727,-91,0,2,0,0.153846,-1,13,13,-30,0,0,8,10,false,false,false,0,1
276,308,-32,16.235294,19.25,-32,360,371,-11,0,0,0,0,-22,17,16,-1.681818,0,0,2,2,false,false,false,0.057,0.943
162,328,-166,13.5,27.333333,-166,940,947,-7,0,2,0,0.166667,17,12,12,2.058824,1,0,15,16,false,false,false,0,1
164,204,-40,13.666667,18.545455,-40,306,361,-55,0,0,0,0,16,12,11,2.25,0,1,16,7,false,false,false,0.037,0.963
205,300,-95,15.769231,23.076923,-95,450,427,23,1,1,0.076923,0.076923,5,13,13,7.4,0,0,11,13,false,false,false,0,1
201,273,-72,15.461538,22.75,-72,341,416,-75,0,0,0,0,18,13,12,2.166667,0,0,8,9,false,false,false,0.007,0.993
0,60,-60,0,60,-60,1439,1314,125,0,0,0,0,95,1,1,0.294737,0,0,13,9,false,false,false,0.029,0.971
286,371,-85,13.619048,17.666667,-85,595,412,183,0,1,0,0.047619,-16,21,21,-3.25,0,0,10,11,false,false,false,0,1
215,291,-76,14.333333,19.4,-76,642,952,-310,0,0,0,0,6,15,15,7.333333,0,0,14,14,false,false,false,0,1
209,198,11,29.857143,33,11,1086,926,160,0,1,0,0.166667,46,7,6,0.608696,0,0,9,11,false,false,false,0.387,0.613
290,390,-100,15.263158,20.526316,-100,952,826,126,0,1,0,0.052632,-12,19,19,-3.583333,0,0,8,5,false,false,false,0,1
198,254,-56,14.142857,19.538462,-56,306,361,-55,0,0,0,0,1,14,13,36,0,0,12,11,false,false,false,0.014,0.986
158,280,-122,14.363636,25.454545,-122,915,971,-56,0,0,0,0,18,11,11,1.833333,0,0,11,25,false,false,false,0,1
301,325,-24,20.066667,21.666667,-24,1043,1003,40,0,1,0,0.066667,0,15,15,0,0,0,11,14,false,false,false,0.15,0.85
276,322,-46,23,26.833333,-46,1793,1869,-76,0,1,0,0.083333,10,12,12,3,1,0,8,23,false,false,false,0.057,0.943
56,68,-12,18.666667,34,-12,1415,1361,54,0,0,0,0,87,3,2,0.356322,0,0,11,16,false,false,false,0.256,0.744
259,294,-35,12.95,15.473684,-35,226,361,-135,0,0,0,0,-29,20,19,-1.517241,0,0,1,7,false,false,false,0,1
272,380,-108,16,22.352941,-108,595,733,-138,1,1,0.058824,0.058824,-16,17,17,-2.4375,0,1,22,3,false,false,false,0,1
280,343,-63,15.555556,20.176471,-63,402,448,-46,0,0,0,0,-19,18,17,-1.947368,0,0,2,1,false,false,false,0,1
260,383,-123,13.684211,21.277778,-123,711,746,-35,0,0,0,0,-15,19,18,-2.533333,0,0,2,2,false,false,false,0,1
217,280,-63,13.5625,17.5,-63,1278,1101,177,0,1,0,0.0625,3,16,16,12.333333,0,0,23,12,false,false,false,0,1
199,255,-56,13.266667,18.214286,-56,683,859,-176,0,0,0,0,19,15,14,2.368421,0,0,12,13,false,false,false,0.001,0.999
50,91,-41,12.5,22.75,-41,1075,878,197,0,0,0,0,73,4,4,0.452055,0,0,17,12,false,false,false,0.496,0.504
209,283,-74,16.076923,23.583333,-74,594,648,-54,1,1,0.076923,0.083333,22,13,12,1.818182,0,0,20,8,false,false,false,0,1
185,204,-19,26.428571,29.142857,-19,801,679,122,1,0,0.142857,0,41,7,7,0.707317,0,0,12,7,false,false,false,0.432,0.568
312,321,-9,19.5,20.0625,-9,1803,1658,145,1,0,0.0625,0,-15,16,16,-2.2,0,0,3,3,false,false,false,0.087,0.913
36,112,-76,12,37.333333,-76,1572,1777,-205,0,1,0,0.333333,72,3,3,0.458333,0,0,13,12,false,false,false,0.268,0.732
174,179,-5,19.333333,22.375,-5,999,1283,-284,0,0,0,0,45,9,8,0.733333,0,1,10,8,false,false,false,0.099,0.901
258,316,-58,21.5,28.727273,-58,732,868,-136,0,1,0,0.090909,10,12,11,3.2,0,0,12,22,false,false,false,0,1
297,307,-10,17.470588,18.058824,-10,1021,1094,-73,1,0,0.058824,0,-10,17,17,-3.7,1,1,4,3,false,false,false,0.03,0.97
195,214,-19,13.928571,15.285714,-19,1040,1091,-51,0,0,0,0,19,14,14,2.473684,0,1,12,15,false,false,false,0.13,0.87
13,22,-9,6.5,11,-9,1580,1629,-49,0,0,0,0,89,2,2,0.41573,0,0,14,11,false,false,false,0.303,0.697
194,330,-136,16.166667,30,-136,726,818,-92,0,1,0,0.090909,20,12,11,1.75,0,0,8,11,false,false,false,0,1
290,365,-75,18.125,24.333333,-75,1493,1413,80,0,1,0,0.066667,-12,16,15,-3,0,0,6,4,false,false,false,0,1
97,225,-128,16.166667,45,-128,786,848,-62,0,1,0,0.2,64,6,5,0.484375,1,0,17,11,false,false,false,0.022,0.978
38,17,21,19,17,21,889,855,34,0,0,0,0,89,2,1,0.449438,0,0,13,11,false,false,true,0.581,0.419
244,290,-46,24.4,29,-46,1071,1065,6,0,0,0,0,19,10,10,1.631579,0,0,10,9,false,false,false,0.044,0.956
140,152,-12,20,21.714286,-12,1407,1473,-66,0,1,0,0.142857,50,7,7,0.62,0,0,10,8,false,false,false,0.298,0.702
186,305,-119,8.857143,15.25,-119,818,826,-8,0,0,0,0,-13,21,20,-4.076923,0,0,7,14,false,false,false,0,1
124,115,9,11.272727,11.5,9,925,1000,-75,0,0,0,0,35,11,10,1.257143,0,0,16,21,false,false,false,0.237,0.763
101,103,-2,16.833333,20.6,-2,306,361,-55,0,0,0,0,60,6,5,0.6,0,1,7,9,false,false,false,0.052,0.948
276,322,-46,13.142857,16.1,-46,951,976,-25,0,0,0,0,-21,21,20,-2.095238,0,0,1,3,false,false,false,0,1
46,12,34,23,12,34,621,786,-165,0,0,0,0,86,2,1,0.348837,1,0,20,11,false,false,false,0.367,0.633
70,3,67,70,3,67,1237,1265,-28,1,0,1,0,90,1,1,0.4,0,1,21,7,false,false,true,0.561,0.439
63,86,-23,12.6,21.5,-23,1210,1162,48,0,0,0,0,68,5,4,0.470588,0,0,7,11,false,false,false,0.268,0.732
271,273,-2,19.357143,21,-2,985,1062,-77,0,0,0,0,7,14,13,5.285714,1,0,10,9,false,false,false,0.136,0.864
255,308,-53,12.142857,15.4,-53,615,542,73,0,0,0,0,-12,21,20,-3.5,0,0,11,8,false,false,false,0,1
75,84,-9,18.75,21,-9,1110,1399,-289,0,0,0,0,69,4,4,0.492754,0,1,14,11,false,false,false,0.21,0.79
265,370,-105,15.588235,23.125,-105,1195,1397,-202,0,2,0,0.125,-2,17,16,-20,0,1,12,9,false,false,false,0,1
144,192,-48,18,24,-48,804,766,38,0,1,0,0.125,55,8,8,0.745455,0,1,10,9,false,false,false,0.178,0.822
302,371,-69,17.764706,23.1875,-69,710,758,-48,1,1,0.058824,0.0625,-7,17,16,-5.285714,0,0,11,10,false,false,false,0,1
158,130,28,26.333333,26,28,1633,1739,-106,1,0,0.166667,0,65,6,5,0.523077,0,0,10,8,false,false,false,0.463,0.537
301,354,-53,23.153846,27.230769,-53,1439,1314,125,0,0,0,0,-1,13,13,-28,0,1,3,3,false,false,false,0.02,0.98
12,23,-11,12,23,-11,599,448,151,0,0,0,0,91,1,1,0.395604,0,0,13,18,false,false,true,0.538,0.462
285,432,-147,28.5,43.2,-147,1925,1885,40,1,2,0.1,0.2,1,10,10,25,0,0,9,6,false,false,false,0,1
231,308,-77,16.5,22,-77,1159,1131,28,0,2,0,0.142857,7,14,14,5.285714,0,0,10,24,false,false,false,0.001,0.999
299,236,63,27.181818,21.454545,63,1156,1279,-123,2,0,0.181818,0,20,11,11,2,0,1,9,8,false,false,false,0.003,0.997
192,254,-62,14.769231,21.166667,-62,837,844,-7,0,0,0,0,29,13,12,1.413793,1,1,12,6,false,false,false,0.006,0.994
320,290,30,17.777778,17.058824,30,1065,948,117,0,1,0,0.058824,-1,18,17,-39,0,0,11,12,false,false,true,0.973,0.027
193,211,-18,19.3,23.444444,-18,725,668,57,0,0,0,0,36,10,9,0.972222,0,0,16,11,false,false,false,0.484,0.516
199,192,7,18.090909,17.454545,7,561,688,-127,0,0,0,0,35,11,11,1.314286,0,0,14,9,false,false,false,0.482,0.518
198,225,-27,18,22.5,-27,691,704,-13,0,1,0,0.1,31,11,10,1.225806,0,1,10,6,false,false,false,0.2,0.8
244,309,-65,15.25,20.6,-65,620,698,-78,1,0,0.0625,0,0,16,15,0,0,0,16,10,false,false,false,0,1
258,345,-87,12.9,18.157895,-87,642,952,-310,0,0,0,0,-20,20,19,-2.2,0,0,1,3,false,false,false,0,1
290,368,-78,16.111111,21.647059,-78,795,786,9,1,0,0.055556,0,-9,18,17,-4.222222,0,0,5,3,false,false,false,0,1
262,319,-57,16.375,21.266667,-57,889,895,-6,0,1,0,0.066667,-2,16,15,-18.5,0,1,11,21,false,false,false,0,1
185,288,-103,15.416667,24,-103,1075,878,197,0,1,0,0.083333,23,12,12,1.434783,0,0,10,10,false,false,false,0.039,0.961
146,280,-134,20.857143,40,-134,786,848,-62,0,1,0,0.142857,53,7,7,0.584906,1,0,14,12,false,false,false,0.01,0.99
13,22,-9,6.5,22,-9,1580,1629,-49,0,0,0,0,89,2,1,0.41573,0,0,14,23,false,false,false,0.271,0.729
138,206,-68,34.5,51.5,-68,1398,1431,-33,0,0,0,0,57,4,4,0.491228,0,0,10,15,false,false,false,0.046,0.954
203,333,-130,20.3,33.3,-130,1636,1702,-66,0,1,0,0.1,25,10,10,1.16,0,0,14,18,false,false,false,0,1
111,152,-41,13.875,21.714286,-41,595,540,55,0,0,0,0,45,8,7,0.955556,0,0,12,18,false,false,false,0.368,0.632
230,193,37,16.428571,14.846154,37,897,996,-99,0,0,0,0,16,14,13,2.4375,0,1,15,17,false,false,false,0.328,0.672
171,355,-184,12.214286,25.357143,-184,940,947,-7,0,2,0,0.142857,7,14,14,5,1,0,15,12,false,false,false,0,1
80,156,-76,10,22.285714,-76,530,683,-153,0,1,0,0.142857,60,8,7,0.666667,0,0,11,18,false,false,false,0.063,0.937
231,253,-22,17.769231,19.461538,-22,907,1070,-163,0,0,0,0,18,13,13,1.944444,0,1,11,20,false,false,false,0.093,0.907
12,16,-4,12,16,-4,1885,1842,43,0,0,0,0,92,1,1,0.293478,0,0,9,12,false,false,false,0.288,0.712
108,156,-48,18,26,-48,1349,1203,146,0,1,0,0.166667,54,6,6,0.592593,0,0,7,9,false,false,false,0.24,0.76
244,325,-81,15.25,20.3125,-81,620,698,-78,1,0,0.0625,0,-4,16,16,-10.25,0,0,16,8,false,false,false,0,1
156,126,30,22.285714,21,30,786,885,-99,1,0,0.142857,0,60,7,6,0.566667,0,1,17,10,false,false,false,0.08,0.92
79,117,-38,15.8,29.25,-38,1803,1658,145,0,0,0,0,64,5,4,0.515625,2,0,17,10,false,false,false,0.43,0.57
221,300,-79,18.416667,27.272727,-79,1408,1539,-131,0,1,0,0.090909,8,12,11,4.25,0,1,9,17,false,false,false,0,1
174,249,-75,19.333333,27.666667,-75,999,1283,-284,0,1,0,0.111111,38,9,9,0.868421,0,0,10,9,false,false,false,0.06,0.94
65,45,20,16.25,11.25,20,1188,1334,-146,0,0,0,0,75,4,4,0.4,0,0,19,7,false,false,false,0.31,0.69
339,351,-12,18.833333,19.5,-12,1094,1041,53,1,0,0.055556,0,-24,18,18,-1.583333,0,0,2,1,false,false,false,0.262,0.738
25,79,-54,12.5,39.5,-54,1803,1658,145,0,0,0,0,80,2,2,0.4125,1,0,9,13,false,false,false,0.065,0.935
223,239,-16,17.153846,19.916667,-16,803,786,17,1,0,0.076923,0,15,13,12,2.133333,0,0,8,10,false,false,false,0.096,0.904
192,184,8,14.769231,15.333333,8,671,638,33,0,0,0,0,17,13,12,2.882353,0,0,14,21,false,false,true,0.696,0.304
295,346,-51,14.047619,17.3,-51,814,830,-16,0,0,0,0,-36,21,20,-1.138889,0,0,5,2,true,false,false,0,1
8,7,1,8,7,1,940,947,-7,0,0,0,0,93,1,1,0.376344,0,0,7,10,false,false,true,0.559,0.441
324,450,-126,17.052632,25,-126,976,995,-19,1,2,0.052632,0.111111,-20,19,18,-1.9,1,0,0,4,false,false,false,0,1
136,361,-225,17,45.125,-225,1219,1216,3,1,3,0.125,0.375,22,8,8,1.227273,0,0,10,12,false,false,false,0,1
195,156,39,27.857143,26,39,1047,1127,-80,0,1,0,0.166667,43,7,6,0.627907,0,0,16,16,false,false,true,0.866,0.134
347,381,-34,19.277778,21.166667,-34,980,965,15,0,0,0,0,-17,18,18,-2.235294,0,0,1,2,false,false,false,0.005,0.995
145,174,-29,13.181818,17.4,-29,970,1030,-60,0,0,0,0,29,11,10,1.37931,0,0,22,8,false,false,false,0.214,0.786
391,430,-39,30.076923,35.833333,-39,1777,1500,277,2,2,0.153846,0.166667,-7,13,12,-4,0,0,1,6,false,false,false,0.11,0.89
257,426,-169,15.117647,26.625,-169,926,973,-47,0,0,0,0,-10,17,16,-3.5,0,0,2,1,false,false,false,0,1
211,278,-67,13.1875,18.533333,-67,613,525,88,0,0,0,0,7,16,15,6,0,1,17,6,false,false,false,0,1
155,215,-60,11.923077,17.916667,-60,1182,1075,107,0,1,0,0.083333,14,13,12,2.785714,0,1,22,10,false,false,false,0.001,0.999
22,14,8,22,14,8,1040,1091,-51,0,0,0,0,93,1,1,0.505376,0,0,8,18,false,false,false,0.453,0.547
323,328,-5,17.944444,18.222222,-5,1168,1062,106,0,0,0,0,-5,18,18,-8.6,1,0,2,4,false,false,false,0.309,0.691
274,292,-18,13.7,15.368421,-18,999,1165,-166,0,0,0,0,-9,20,19,-5.111111,1,1,6,8,false,false,false,0.121,0.879
218,254,-36,14.533333,16.933333,-36,1045,1082,-37,0,0,0,0,7,15,15,6.428571,1,0,9,14,false,false,false,0.172,0.828
148,252,-104,14.8,28,-104,1397,1309,88,1,0,0.1,0,45,10,9,0.8,0,1,10,8,false,false,false,0.016,0.984
144,220,-76,12,18.333333,-76,595,662,-67,0,1,0,0.083333,25,12,12,1.76,0,0,13,14,false,false,false,0.019,0.981
53,6,47,26.5,6,47,991,1063,-72,0,0,0,0,92,2,1,0.413043,0,0,14,25,false,false,false,0.249,0.751
26,0,26,26,0,26,1126,1277,-151,0,0,0,0,95,1,0,0.368421,0,0,20,0,false,false,false,0.284,0.716
244,280,-36,15.25,18.666667,-36,518,414,104,0,1,0,0.066667,2,16,15,19,0,0,20,10,false,false,false,0.262,0.738
199,341,-142,12.4375,22.733333,-142,1075,1189,-114,0,0,0,0,0,16,15,0,0,1,7,15,false,false,false,0,1
209,276,-67,19,27.6,-67,1315,1331,-16,0,0,0,0,22,11,10,1.5,0,0,7,20,false,false,false,0.018,0.982
89,35,54,29.666667,17.5,54,804,1074,-270,0,0,0,0,82,3,2,0.390244,0,0,7,17,false,false,true,0.551,0.449
177,202,-25,19.666667,22.444444,-25,576,602,-26,0,0,0,0,47,9,9,0.893617,0,0,10,15,false,false,false,0.161,0.839
141,153,-12,35.25,38.25,-12,1354,1210,144,0,1,0,0.25,67,4,4,0.492537,0,0,12,13,false,false,false,0.306,0.694
239,263,-24,18.384615,20.230769,-24,387,683,-296,0,0,0,0,0,13,13,0,1,1,10,19,false,false,false,0,1
133,166,-33,16.625,20.75,-33,402,448,-46,0,0,0,0,47,8,8,0.787234,0,1,7,12,false,false,false,0.01,0.99
166,135,31,27.666667,27,31,1331,1347,-16,1,0,0.166667,0,51,6,5,0.627451,0,0,9,14,false,false,true,0.582,0.418
293,348,-55,20.928571,24.857143,-55,1164,1261,-97,0,1,0,0.071429,12,14,14,3.5,0,0,14,8,false,false,false,0,1
20,14,6,20,14,6,356,498,-142,0,0,0,0,93,1,1,0.376344,0,0,15,12,false,false,false,0.24,0.76
229,315,-86,17.615385,26.25,-86,1408,1539,-131,0,1,0,0.083333,3,13,12,11.333333,0,1,10,17,false,false,false,0,1
318,356,-38,24.461538,27.384615,-38,1173,1256,-83,2,0,0.153846,0,6,13,13,5.166667,0,1,8,6,false,false,false,0,1
300,322,-22,23.076923,26.833333,-22,1102,1245,-143,0,1,0,0.083333,0,13,12,0,0,0,10,10,false,false,false,0.121,0.879
212,181,31,23.555556,20.111111,31,540,498,42,1,0,0.111111,0,36,9,9,1.277778,0,1,11,17,false,false,false,0.017,0.983
70,114,-44,11.666667,19,-44,1000,960,40,0,0,0,0,62,6,6,0.725806,1,0,13,7,false,false,false,0.291,0.709
157,227,-70,12.076923,17.461538,-70,1278,1101,177,0,1,0,0.076923,23,13,13,1.608696,1,0,26,9,false,false,false,0.394,0.606
151,180,-29,16.777778,22.5,-29,518,414,104,0,1,0,0.125,43,9,8,0.883721,0,0,9,11,false,false,false,0.47,0.53
195,195,0,27.857143,27.857143,0,1047,1127,-80,0,1,0,0.142857,40,7,7,0.675,0,0,16,9,false,false,true,0.737,0.263
206,265,-59,18.727273,26.5,-59,1583,1403,180,0,0,0,0,24,11,10,1.333333,0,1,16,15,false,false,false,0.012,0.988
170,165,5,28.333333,33,5,801,679,122,1,0,0.166667,0,53,6,5,0.54717,0,0,10,11,false,false,false,0.402,0.598
63,109,-46,15.75,36.333333,-46,1305,1194,111,0,0,0,0,75,4,3,0.44,0,0,16,15,false,false,false,0.047,0.953
199,245,-46,12.4375,15.3125,-46,808,749,59,0,0,0,0,-5,16,16,-8.4,0,0,12,9,false,false,false,0.068,0.932
347,419,-72,18.263158,22.052632,-72,991,1063,-72,0,1,0,0.052632,-21,19,19,-1.809524,0,0,1,4,true,false,false,0,1
30,10,20,15,10,20,1037,913,124,0,0,0,0,92,2,1,0.413043,0,0,7,18,false,false,true,0.641,0.359
329,341,-12,19.352941,20.058824,-12,1197,1156,41,0,1,0,0.058824,-14,17,17,-2.5,0,0,1,1,false,false,false,0.114,0.886
209,358,-149,14.928571,27.538462,-149,473,683,-210,0,0,0,0,12,14,13,3.166667,0,0,8,7,false,false,false,0,1
67,109,-42,13.4,21.8,-42,1075,878,197,0,0,0,0,67,5,5,0.492537,0,0,18,9,false,false,false,0.498,0.502
81,61,20,20.25,20.333333,20,926,973,-47,0,0,0,0,74,4,3,0.472973,0,0,7,7,false,false,true,0.55,0.45
26,18,8,26,18,8,653,1004,-351,0,0,0,0,91,1,1,0.318681,0,0,7,12,false,false,false,0.259,0.741
140,181,-41,15.555556,20.111111,-41,1161,1176,-15,0,1,0,0.111111,36,9,9,1.055556,0,0,9,19,false,false,false,0.26,0.74
18,27,-9,18,27,-9,967,856,111,0,0,0,0,92,1,1,0.358696,0,0,11,22,false,false,false,0.479,0.521
191,300,-109,17.363636,27.272727,-109,1408,1539,-131,0,1,0,0.090909,11,11,11,3.090909,0,1,11,17,false,false,false,0,1
111,164,-53,13.875,20.5,-53,595,540,55,0,0,0,0,43,8,8,1,0,0,12,20,false,false,false,0.341,0.659
183,198,-15,13.071429,14.142857,-15,999,1071,-72,0,0,0,0,11,14,14,3.636364,2,0,7,20,false,false,true,0.799,0.201
236,294,-58,19.666667,24.5,-58,1633,1739,-106,1,0,0.083333,0,15,12,12,2.266667,1,0,6,16,false,false,false,0.008,0.992
268,293,-25,17.866667,20.928571,-25,952,870,82,0,0,0,0,-1,15,14,-37,0,0,11,19,false,false,false,0.075,0.925
155,272,-117,14.090909,27.2,-117,473,683,-210,0,0,0,0,34,11,10,1.117647,1,0,7,12,false,false,false,0.001,0.999
309,300,9,30.9,33.333333,9,1761,1770,-9,1,1,0.1,0.111111,17,10,9,1.529412,0,1,13,6,false,false,false,0.493,0.507
169,184,-15,15.363636,16.727273,-15,450,503,-53,0,0,0,0,28,11,11,1.392857,1,1,19,10,false,false,false,0.239,0.761
16,15,1,16,15,1,1045,948,97,0,0,0,0,90,1,1,0.377778,0,0,16,13,false,false,true,0.615,0.385
255,397,-142,15.9375,24.8125,-142,915,971,-56,0,0,0,0,-14,16,16,-2.357143,0,0,1,5,false,false,false,0,1
45,167,-122,6.428571,27.833333,-122,1422,1510,-88,0,1,0,0.166667,67,7,6,0.58209,0,0,17,22,false,false,false,0.007,0.993
196,208,-12,14,16,-12,913,1037,-124,0,1,0,0.076923,25,14,13,1.64,0,1,22,10,false,false,false,0.282,0.718
121,189,-68,17.285714,31.5,-68,1101,1115,-14,0,0,0,0,53,7,6,0.566038,0,1,7,8,false,false,false,0.024,0.976
105,107,-2,21,21.4,-2,480,518,-38,0,0,0,0,62,5,5,0.645161,0,1,13,14,false,false,false,0.229,0.771
160,306,-146,17.777778,34,-146,1045,1100,-55,0,1,0,0.111111,35,9,9,0.971429,0,0,19,7,false,false,false,0,1
294,305,-11,18.375,19.0625,-11,985,1062,-77,0,0,0,0,-10,16,16,-3.7,1,0,9,5,false,false,false,0.297,0.703
41,38,3,13.666667,12.666667,3,163,346,-183,0,0,0,0,73,3,3,0.534247,0,1,11,9,false,false,false,0.009,0.991
168,238,-70,16.8,26.444444,-70,1407,1473,-66,0,2,0,0.222222,28,10,9,1.107143,0,0,12,22,false,false,false,0.073,0.927
233,238,-5,23.3,23.8,-5,1245,1148,97,0,0,0,0,28,10,10,1.25,0,0,17,10,false,false,false,0.423,0.577
64,206,-142,9.142857,29.428571,-142,1101,1130,-29,0,1,0,0.142857,55,7,7,0.818182,0,0,9,10,false,false,false,0.026,0.974
30,99,-69,7.5,24.75,-69,795,786,9,0,0,0,0,83,4,4,0.457831,0,0,12,7,false,false,false,0.227,0.773
8,0,8,8,0,8,603,721,-118,0,0,0,0,97,1,0,0.443299,0,0,28,0,false,false,false,0.214,0.786
92,130,-38,18.4,26,-38,804,1080,-276,0,0,0,0,61,5,5,0.557377,0,0,8,20,false,false,false,0.078,0.922
65,60,5,16.25,20,5,1331,1374,-43,0,0,0,0,69,4,3,0.478261,0,0,11,10,false,false,false,0.329,0.671
253,386,-133,19.461538,32.166667,-133,1368,1452,-84,1,1,0.076923,0.083333,14,13,12,2.285714,0,1,21,6,false,false,false,0,1
228,249,-21,17.538462,20.75,-21,343,570,-227,0,0,0,0,5,13,12,7.2,0,0,13,7,false,false,false,0.09,0.91
215,276,-61,19.545455,25.090909,-61,954,939,15,1,0,0.090909,0,18,11,11,2,0,1,10,7,false,false,false,0,1
208,222,-14,17.333333,18.5,-14,306,468,-162,0,0,0,0,28,12,12,1.321429,1,0,7,9,false,false,false,0.323,0.677
258,275,-17,18.428571,21.153846,-17,1055,840,215,0,1,0,0.076923,7,14,13,5.142857,1,0,12,24,false,false,false,0.1,0.9
316,315,1,18.588235,19.6875,1,664,786,-122,0,0,0,0,-11,17,16,-3,0,0,4,2,true,false,false,0.183,0.817
199,371,-172,12.4375,23.1875,-172,1075,1189,-114,0,0,0,0,-4,16,16,-10,0,0,7,10,false,false,false,0,1
246,291,-45,15.375,18.1875,-45,450,503,-53,0,0,0,0,-4,16,16,-9.75,0,0,17,7,false,false,false,0,1
296,394,-98,19.733333,28.142857,-98,1232,1448,-216,0,2,0,0.142857,-3,15,14,-11.666667,0,0,9,7,false,false,false,0,1
361,435,-74,25.785714,31.071429,-74,1770,1745,25,2,1,0.142857,0.071429,-2,14,14,-16.5,0,0,11,4,false,false,false,0,1
231,272,-41,12.833333,15.111111,-41,999,1165,-166,0,0,0,0,2,18,18,23,1,1,15,8,false,false,false,0,1
76,25,51,19,6.25,51,1193,1220,-27,0,0,0,0,73,4,4,0.589041,1,1,7,24,false,false,true,0.554,0.446
50,141,-91,12.5,47,-91,1220,1202,18,0,0,0,0,75,4,3,0.666667,0,0,23,9,false,false,false,0.03,0.97
69,75,-6,11.5,15,-6,1075,1189,-114,0,0,0,0,64,6,5,0.625,0,0,13,14,false,false,false,0.078,0.922
298,321,-23,21.285714,24.692308,-23,1167,1245,-78,2,0,0.142857,0,-9,14,13,-3.111111,1,0,4,5,false,false,false,0.212,0.788
167,121,46,23.857143,17.285714,46,1197,1156,41,0,0,0,0,51,7,7,0.686275,0,1,12,6,false,false,true,0.827,0.173
164,287,-123,16.4,31.888889,-123,1193,1177,16,0,1,0,0.111111,36,10,9,0.972222,0,0,17,8,false,false,false,0,1
303,469,-166,17.823529,27.588235,-166,1003,1004,-1,0,2,0,0.117647,-15,17,17,-2.333333,0,0,1,2,false,false,false,0,1
176,239,-63,25.142857,34.142857,-63,1388,1455,-67,0,0,0,0,38,7,7,0.736842,1,1,14,10,false,false,false,0.068,0.932
248,342,-94,19.076923,28.5,-94,1656,1649,7,0,0,0,0,9,13,12,3.555556,0,0,11,12,false,false,false,0,1
74,79,-5,14.8,15.8,-5,1699,1803,-104,0,0,0,0,78,5,5,0.448718,0,2,7,7,false,false,false,0.108,0.892
321,352,-31,16.894737,19.555556,-31,1439,1428,11,0,0,0,0,-11,19,18,-3.636364,1,0,2,4,false,false,false,0.032,0.968
117,104,13,19.5,20.8,13,892,856,36,0,0,0,0,65,6,5,0.538462,1,0,7,7,false,false,true,0.694,0.306
8,0,8,8,0,8,518,414,104,0,0,0,0,97,1,0,0.391753,0,0,15,0,false,false,true,0.779,0.221
68,12,56,34,12,56,1633,1556,77,0,0,0,0,85,2,1,0.388235,0,0,22,13,false,false,true,0.738,0.262
60,68,-8,20,22.666667,-8,668,363,305,0,0,0,0,78,3,3,0.602564,0,0,8,17,false,false,true,0.509,0.491
115,128,-13,14.375,18.285714,-13,1064,1397,-333,0,1,0,0.142857,68,8,7,0.632353,1,0,13,7,false,false,false,0.169,0.831
180,301,-121,20,37.625,-121,786,848,-62,0,1,0,0.125,41,9,8,0.756098,1,0,15,10,false,false,false,0.007,0.993
69,71,-2,8.625,10.142857,-2,925,1000,-75,0,0,0,0,50,8,7,0.88,0,1,13,8,false,false,false,0.14,0.86
139,92,47,23.166667,18.4,47,1257,1176,81,1,0,0.166667,0,68,6,5,0.5,0,0,19,10,false,false,true,0.622,0.378
80,41,39,40,20.5,39,1488,1428,60,1,0,0.5,0,83,2,2,0.445783,0,0,10,11,false,false,true,0.723,0.277
0,0,0,0,0,0,1173,1256,-83,0,0,0,0,100,1,0,0.31,0,0,13,0,false,false,true,0.545,0.455
238,275,-37,14,16.176471,-37,500,532,-32,0,0,0,0,-11,17,17,-3.727273,0,2,28,5,false,false,false,0,1
145,220,-75,13.181818,20,-75,595,540,55,0,0,0,0,32,11,11,1.34375,0,0,13,12,false,false,false,0.073,0.927
235,259,-24,18.076923,19.923077,-24,518,461,57,0,0,0,0,8,13,13,4.5,0,1,7,9,false,false,false,0.103,0.897
14,11,3,14,11,3,804,766,38,0,0,0,0,93,1,1,0.44086,0,1,17,6,false,false,true,0.562,0.438
280,305,-25,15.555556,16.944444,-25,450,503,-53,0,0,0,0,-17,18,18,-2.294118,0,0,5,3,false,false,false,0.075,0.925
14,63,-49,14,63,-49,1803,1658,145,0,0,0,0,89,1,1,0.370787,1,0,10,12,false,false,false,0.095,0.905
149,167,-18,12.416667,13.916667,-18,1045,948,97,0,0,0,0,14,12,12,2.428571,0,1,14,7,false,false,false,0.398,0.602
111,105,6,18.5,21,6,1606,1890,-284,0,0,0,0,59,6,5,0.474576,1,0,13,15,false,false,false,0.326,0.674
174,333,-159,7.25,13.875,-159,651,567,84,0,0,0,0,-17,24,24,-3.235294,0,0,7,13,false,false,false,0,1
162,163,-1,18,18.111111,-1,771,668,103,0,0,0,0,29,9,9,1.310345,0,0,10,31,false,false,true,0.513,0.487
224,247,-23,20.363636,24.7,-23,1110,1123,-13,0,1,0,0.1,24,11,10,1.375,0,1,9,17,false,false,false,0.071,0.929
155,295,-140,14.090909,26.818182,-140,473,683,-210,0,0,0,0,30,11,11,1.266667,1,0,7,10,false,false,false,0,1
10,6,4,10,6,4,1037,1016,21,0,0,0,0,96,1,1,0.604167,0,1,7,8,false,false,true,0.558,0.442
103,146,-43,17.166667,29.2,-43,1193,1177,16,0,0,0,0,65,6,5,0.538462,0,0,9,11,false,false,false,0.108,0.892
141,223,-82,11.75,20.272727,-82,388,542,-154,0,0,0,0,21,12,11,1.761905,0,0,8,15,false,false,false,0.006,0.994
195,234,-39,16.25,19.5,-39,804,766,38,0,1,0,0.083333,34,12,12,1.205882,0,1,18,10,false,false,false,0.485,0.515
219,165,54,19.909091,15,54,742,594,148,0,0,0,0,28,11,11,1.392857,1,1,19,14,false,false,true,0.948,0.052
44,59,-15,14.666667,19.666667,-15,613,525,88,0,0,0,0,77,3,3,0.545455,0,2,16,9,false,false,false,0.017,0.983
314,307,7,17.444444,18.058824,7,1021,1094,-73,1,0,0.055556,0,-13,18,17,-2.846154,1,1,1,3,false,false,false,0.054,0.946
98,69,29,49,69,29,1689,1777,-88,1,0,0.5,0,80,2,1,0.375,0,0,7,17,false,false,false,0.13,0.87
55,150,-95,11,30,-95,1454,1479,-25,0,0,0,0,63,5,5,0.492063,1,0,8,16,false,false,false,0.032,0.968
88,53,35,22,13.25,35,675,570,105,0,0,0,0,69,4,4,0.507246,0,0,7,30,false,false,true,0.834,0.166
307,326,-19,17.055556,18.111111,-19,451,448,3,0,0,0,0,-18,18,18,-2.055556,0,0,4,1,false,false,false,0.216,0.784
30,0,30,30,0,30,921,1045,-124,0,0,0,0,95,1,0,0.368421,0,0,11,0,false,false,false,0.228,0.772
231,231,0,21,23.1,0,1270,1261,9,1,0,0.090909,0,35,11,10,1.057143,0,0,7,10,false,false,false,0.222,0.778
324,433,-109,24.923077,36.083333,-109,1586,1633,-47,1,1,0.076923,0.083333,11,13,12,3.090909,0,0,11,15,false,false,false,0,1
205,308,-103,15.769231,23.692308,-103,1003,1018,-15,0,0,0,0,1,13,13,37,0,0,8,8,false,false,false,0,1
216,173,43,16.615385,14.416667,43,1030,998,32,0,0,0,0,17,13,12,2.176471,0,1,21,17,false,false,true,0.838,0.162
270,323,-53,20.769231,24.846154,-53,980,965,15,0,0,0,0,8,13,13,4.75,0,0,7,11,false,false,false,0.029,0.971
172,121,51,24.571429,20.166667,51,1691,1551,140,0,0,0,0,56,7,6,0.660714,0,1,7,23,false,false,false,0.294,0.706
233,271,-38,17.923077,20.846154,-38,576,602,-26,0,0,0,0,14,13,13,3,1,1,6,8,false,false,false,0.012,0.988
301,324,-23,16.722222,19.058824,-23,576,602,-26,0,0,0,0,-12,18,17,-3.5,0,0,6,4,false,false,false,0.01,0.99
178,270,-92,14.833333,24.545455,-92,542,605,-63,0,0,0,0,22,12,11,1.636364,0,0,10,10,false,false,false,0.001,0.999
84,103,-19,16.8,25.75,-19,1539,1891,-352,0,1,0,0.25,65,5,4,0.384615,0,0,17,12,false,false,false,0.076,0.924
175,222,-47,21.875,27.75,-47,1428,1361,67,0,0,0,0,35,8,8,0.942857,0,0,7,10,false,false,false,0.043,0.957
108,77,31,18,15.4,31,306,468,-162,0,0,0,0,70,6,5,0.528571,1,0,9,14,false,false,false,0.419,0.581
159,184,-25,19.875,26.285714,-25,1038,917,121,1,1,0.125,0.142857,46,8,7,0.76087,0,0,13,21,false,false,false,0.222,0.778
225,278,-53,14.0625,17.375,-53,683,859,-176,0,0,0,0,13,16,16,3.461538,0,0,10,17,false,false,false,0,1
292,330,-38,16.222222,19.411765,-38,599,448,151,0,0,0,0,-15,18,17,-2.4,0,1,3,5,false,false,false,0.003,0.997
62,21,41,31,21,41,1563,1539,24,0,0,0,0,89,2,1,0.393258,0,0,12,10,false,false,true,0.618,0.382
90,232,-142,8.181818,23.2,-142,1101,1130,-29,0,1,0,0.1,43,11,10,1.046512,0,1,8,7,false,false,false,0,1
316,339,-23,19.75,21.1875,-23,1473,1500,-27,1,2,0.0625,0.125,-11,16,16,-3.545455,1,0,7,13,false,false,true,0.756,0.244
287,376,-89,16.882353,23.5,-89,935,995,-60,1,1,0.058824,0.0625,-7,17,16,-5.571429,0,0,12,7,false,false,false,0,1
291,326,-35,15.315789,17.157895,-35,1045,1082,-37,0,0,0,0,-18,19,19,-2.5,0,0,5,3,false,false,false,0,1
287,302,-15,20.5,23.230769,-15,1428,1361,67,0,0,0,0,3,14,13,11,1,0,9,9,false,false,false,0.148,0.852
0,0,0,0,0,0,915,971,-56,0,0,0,0,100,1,0,0.33,0,0,11,0,false,false,true,0.54,0.46
262,326,-64,21.833333,27.166667,-64,1699,1803,-104,1,1,0.083333,0.083333,28,12,12,1.25,0,0,21,22,false,false,false,0,1
44,39,5,14.666667,13,5,1093,1100,-7,0,0,0,0,82,3,3,0.378049,1,0,16,16,false,false,true,0.735,0.265
62,34,28,20.666667,17,28,1065,948,117,0,0,0,0,81,3,2,0.481481,1,0,17,11,false,false,true,0.883,0.117
325,330,-5,19.117647,20.625,-5,1561,1495,66,1,0,0.058824,0,-22,17,16,-1.5,0,0,2,3,true,false,false,0.067,0.933
135,131,4,22.5,21.833333,4,1269,1477,-208,1,0,0.166667,0,57,6,6,0.614035,0,1,16,9,false,false,false,0.215,0.785
211,309,-98,19.181818,28.090909,-98,1101,1115,-14,0,0,0,0,20,11,11,1.5,0,1,11,14,false,false,false,0,1
176,218,-42,17.6,21.8,-42,758,791,-33,0,0,0,0,29,10,10,1.344828,0,0,8,21,false,false,false,0.044,0.956
78,0,78,78,0,78,714,820,-106,1,0,1,0,93,1,0,0.333333,0,0,11,0,false,false,false,0.243,0.757
248,295,-47,22.545455,29.5,-47,1021,897,124,0,2,0,0.2,17,11,10,2.176471,0,0,14,15,false,false,false,0.037,0.963
37,89,-52,12.333333,44.5,-52,1583,1403,180,0,0,0,0,73,3,2,0.438356,0,0,12,19,false,false,false,0.028,0.972
28,89,-61,28,89,-61,1331,1432,-101,0,0,0,0,87,1,1,0.310345,0,0,11,13,false,false,false,0.029,0.971
144,247,-103,14.4,27.444444,-103,342,263,79,0,0,0,0,28,10,9,1.214286,0,0,8,7,false,false,false,0.065,0.935
176,186,-10,19.555556,23.25,-10,518,461,57,0,0,0,0,43,9,8,0.837209,0,1,17,11,false,false,false,0.395,0.605
41,35,6,13.666667,17.5,6,727,820,-93,0,1,0,0.5,78,3,2,0.448718,0,0,12,21,false,false,false,0.354,0.646
272,280,-8,22.666667,23.333333,-8,804,1074,-270,0,0,0,0,11,12,12,2.909091,0,1,11,13,false,false,false,0.057,0.943
225,315,-90,18.75,26.25,-90,1127,995,132,0,1,0,0.083333,16,12,12,2.0625,0,0,9,10,false,false,false,0.021,0.979
83,54,29,41.5,27,29,1173,1256,-83,1,0,0.5,0,83,2,2,0.373494,0,1,13,20,false,false,false,0.166,0.834
109,91,18,21.8,22.75,18,1691,1551,140,0,0,0,0,67,5,4,0.552239,0,0,11,20,false,false,false,0.286,0.714
396,446,-50,26.4,29.733333,-50,1770,1745,25,2,1,0.133333,0.066667,-7,15,15,-4.714286,0,0,5,1,false,false,false,0,1
64,91,-27,12.8,22.75,-27,1071,1000,71,0,0,0,0,74,5,4,0.635135,1,0,6,9,false,false,false,0.277,0.723
176,145,31,25.142857,24.166667,31,1633,1739,-106,1,0,0.142857,0,57,7,6,0.596491,0,0,11,15,false,false,false,0.283,0.717
72,110,-38,14.4,22,-38,500,509,-9,0,0,0,0,65,5,5,0.630769,0,0,13,24,false,false,false,0.166,0.834
114,179,-65,12.666667,22.375,-65,95,453,-358,0,0,0,0,49,9,8,0.795918,0,0,14,16,false,false,false,0,1
290,246,44,26.363636,24.6,44,691,695,-4,1,0,0.090909,0,20,11,10,1.6,0,0,7,21,false,false,true,0.799,0.201
39,13,26,19.5,13,26,1188,1334,-146,0,0,0,0,87,2,1,0.344828,0,0,12,11,false,false,false,0.237,0.763
111,168,-57,15.857143,24,-57,642,952,-310,0,0,0,0,51,7,7,0.862745,0,0,9,24,false,false,false,0.07,0.93
90,83,7,15,16.6,7,542,605,-63,0,0,0,0,60,6,5,0.6,0,1,12,6,false,false,false,0.224,0.776
26,16,10,26,16,10,1633,1680,-47,0,0,0,0,88,1,1,0.318182,0,0,8,9,false,false,true,0.561,0.439
25,42,-17,12.5,21,-17,683,859,-176,0,0,0,0,86,2,2,0.523256,0,1,12,20,false,false,false,0.138,0.862
150,135,15,18.75,19.285714,15,939,969,-30,0,0,0,0,42,8,7,0.785714,0,1,13,12,false,false,false,0.349,0.651
16,0,16,16,0,16,1488,1403,85,0,0,0,0,97,1,0,0.350515,0,0,17,0,false,false,true,0.565,0.435
119,111,8,23.8,27.75,8,1055,840,215,0,0,0,0,64,5,4,0.5625,0,0,7,7,false,false,true,0.506,0.494
90,88,2,22.5,29.333333,2,1102,1245,-143,0,0,0,0,71,4,3,0.408451,1,0,13,9,false,false,false,0.472,0.528
34,18,16,17,18,16,1101,1237,-136,0,0,0,0,87,2,1,0.390805,0,0,9,8,false,false,false,0.312,0.688
42,24,18,21,24,18,704,523,181,0,0,0,0,87,2,1,0.402299,0,0,13,10,false,false,true,0.722,0.278
155,147,8,19.375,21,8,480,518,-38,0,0,0,0,44,8,7,0.909091,0,1,13,7,false,false,false,0.245,0.755
275,450,-175,19.642857,34.615385,-175,842,926,-84,0,1,0,0.076923,-8,14,13,-3.75,0,0,3,5,false,false,false,0,1
62,87,-25,15.5,21.75,-25,1000,960,40,0,0,0,0,72,4,4,0.625,1,0,7,10,false,false,false,0.358,0.642
95,150,-55,13.571429,21.428571,-55,1302,1351,-49,0,0,0,0,53,7,7,0.698113,1,0,8,12,false,false,false,0.254,0.746
261,332,-71,18.642857,25.538462,-71,1349,1203,146,0,1,0,0.076923,13,14,13,2.461538,0,1,13,15,false,false,false,0,1
294,292,2,21,22.461538,2,742,868,-126,0,1,0,0.076923,6,14,13,5.5,0,0,8,21,false,false,false,0.266,0.734
53,42,11,13.25,14,11,710,758,-48,0,0,0,0,81,4,3,0.45679,0,1,12,13,false,false,false,0.17,0.83
128,158,-30,18.285714,26.333333,-30,1253,1324,-71,0,0,0,0,54,7,6,0.537037,1,0,6,9,false,false,false,0.251,0.749
133,133,0,14.777778,16.625,0,613,525,88,0,0,0,0,45,9,8,0.933333,0,1,8,16,false,false,false,0.497,0.503
343,442,-99,22.866667,31.571429,-99,1770,1751,19,0,1,0,0.071429,-15,15,14,-1.933333,0,0,1,2,true,false,false,0,1
61,128,-67,30.5,64,-67,1164,1261,-97,0,1,0,0.5,82,2,2,0.512195,0,0,24,12,false,false,false,0.402,0.598
331,370,-39,16.55,19.473684,-39,824,830,-6,1,0,0.05,0,-16,20,19,-2.75,0,0,4,9,false,false,false,0,1
75,102,-27,15,25.5,-27,1305,1211,94,0,0,0,0,73,5,4,0.452055,0,0,11,26,false,false,false,0.235,0.765
248,345,-97,15.5,21.5625,-97,1064,1397,-333,0,2,0,0.125,10,16,16,4.3,1,1,8,7,false,false,false,0,1
284,385,-101,14.947368,21.388889,-101,595,733,-138,1,1,0.052632,0.055556,-23,19,18,-1.695652,0,1,20,2,false,false,false,0,1
44,0,44,44,0,44,1563,1539,24,0,0,0,0,95,1,0,0.368421,0,0,9,0,false,false,true,0.72,0.28
297,303,-6,17.470588,18.9375,-6,1021,1094,-73,1,0,0.058824,0,-7,17,16,-5.285714,1,1,4,5,false,false,false,0.012,0.988
12,38,-26,6,19,-26,1368,1452,-84,0,0,0,0,90,2,2,0.355556,1,0,9,13,false,false,false,0.299,0.701
255,319,-64,19.615385,24.538462,-64,694,658,36,0,1,0,0.076923,14,13,13,2.642857,0,0,13,10,false,false,false,0.028,0.972
292,373,-81,19.466667,26.642857,-81,835,786,49,0,0,0,0,-19,15,14,-1.789474,0,0,2,4,false,false,false,0,1
297,392,-95,24.75,32.666667,-95,1537,1539,-2,0,1,0,0.083333,6,12,12,5.666667,0,1,7,9,false,false,false,0,1
0,0,0,0,0,0,1586,1633,-47,0,0,0,0,100,2,2,0.34,0,0,8,0,false,false,false,0.489,0.511
25,12,13,12.5,12,13,306,361,-55,0,0,0,0,87,2,1,0.413793,0,1,16,7,false,false,false,0.204,0.796
233,407,-174,11.65,21.421053,-174,1078,983,95,1,0,0.05,0,-13,20,19,-3.692308,0,0,10,12,false,false,false,0,1
19,44,-25,6.333333,14.666667,-25,822,845,-23,0,0,0,0,85,3,3,0.411765,0,0,21,21,false,false,false,0.099,0.901
267,326,-59,19.071429,25.076923,-59,976,995,-19,1,1,0.071429,0.076923,10,14,13,3.8,0,1,9,9,false,false,false,0,1
160,272,-112,17.777778,30.222222,-112,1576,1556,20,0,1,0,0.111111,29,9,9,1.034483,0,0,20,17,false,false,false,0,1
82,39,43,27.333333,19.5,43,1495,1531,-36,0,0,0,0,82,3,2,0.45122,0,0,14,12,false,false,true,0.588,0.412
256,345,-89,18.285714,24.642857,-89,1417,1482,-65,0,1,0,0.071429,12,14,14,2.75,0,1,14,7,false,false,false,0,1
127,43,84,31.75,14.333333,84,1341,1606,-265,1,0,0.25,0,67,4,3,0.492537,0,0,7,7,false,false,true,0.847,0.153
148,229,-81,18.5,28.625,-81,954,939,15,0,0,0,0,41,8,8,0.878049,1,1,10,8,false,false,false,0.027,0.973
120,398,-278,9.230769,33.166667,-278,1164,1149,15,0,2,0,0.166667,37,13,12,1.27027,0,0,12,7,false,false,false,0,1
120,171,-51,13.333333,21.375,-51,542,605,-63,0,0,0,0,41,9,8,0.878049,0,0,12,13,false,false,false,0.053,0.947
241,340,-99,15.0625,22.666667,-99,503,668,-165,0,1,0,0.066667,-2,16,15,-18.5,1,0,8,18,false,false,false,0,1
284,350,-66,16.705882,20.588235,-66,1422,1583,-161,0,1,0,0.058824,-5,17,17,-8.2,1,0,3,15,false,false,false,0.001,0.999
196,238,-42,16.333333,21.636364,-42,727,820,-93,0,1,0,0.090909,17,12,11,2.058824,0,0,8,13,false,false,false,0.052,0.948
256,328,-72,11.636364,15.619048,-72,651,700,-49,0,0,0,0,-27,22,21,-2.074074,0,0,21,14,false,false,false,0,1
329,342,-13,15.666667,16.285714,-13,430,542,-112,0,1,0,0.047619,-26,21,21,-1.846154,0,0,2,2,false,false,false,0.149,0.851
47,34,13,23.5,17,13,653,820,-167,0,0,0,0,81,2,2,0.469136,0,0,7,26,false,false,false,0.232,0.768
250,333,-83,16.666667,22.2,-83,1075,878,197,0,1,0,0.066667,0,15,15,0,0,0,17,4,false,false,false,0,1
360,429,-69,24,30.642857,-69,1253,1324,-71,0,2,0,0.142857,-7,15,14,-4.142857,0,0,1,1,true,false,false,0,1
159,178,-19,19.875,22.25,-19,967,856,111,0,0,0,0,43,8,8,0.767442,0,0,17,15,false,false,true,0.507,0.493
57,64,-7,11.4,16,-7,503,668,-165,0,0,0,0,69,5,4,0.536232,0,0,7,16,false,false,false,0.113,0.887
126,181,-55,18,25.857143,-55,892,856,36,0,1,0,0.142857,53,7,7,0.660377,2,0,9,10,false,false,false,0.46,0.54
75,73,2,18.75,24.333333,2,1493,1453,40,0,0,0,0,77,4,3,0.454545,0,0,9,19,false,false,false,0.271,0.729
296,387,-91,14.8,20.368421,-91,1195,1397,-202,0,2,0,0.105263,-21,20,19,-1.904762,0,1,4,2,false,false,false,0,1
149,143,6,21.285714,23.833333,6,842,926,-84,0,0,0,0,48,7,6,0.625,0,1,7,8,false,false,false,0.184,0.816
66,30,36,33,30,36,2147,2219,-72,0,0,0,0,87,2,1,0.275862,0,0,9,9,false,false,true,0.647,0.353
264,247,17,22,22.454545,17,824,830,-6,1,0,0.083333,0,25,12,11,1.76,0,0,7,18,false,false,false,0.209,0.791
255,296,-41,10.625,12.869565,-41,668,363,305,0,0,0,0,-28,24,23,-1.678571,0,0,10,1,true,false,false,0,1
174,207,-33,13.384615,15.923077,-33,306,302,4,0,0,0,0,14,13,13,2.928571,0,0,13,19,false,false,false,0.205,0.795
198,299,-101,24.75,42.714286,-101,1777,1500,277,1,2,0.125,0.285714,34,8,7,0.823529,0,0,7,21,false,false,false,0.106,0.894
184,93,91,26.285714,15.5,91,1101,1237,-136,1,0,0.142857,0,51,7,6,0.666667,0,1,22,7,false,false,true,0.596,0.404
120,161,-41,20,26.833333,-41,1164,1149,15,0,0,0,0,62,6,6,0.758065,0,1,12,7,false,false,false,0.192,0.808
146,229,-83,14.6,22.9,-83,542,605,-63,0,0,0,0,32,10,10,1.125,0,0,10,16,false,false,false,0.007,0.993
324,267,57,23.142857,20.538462,57,1093,1173,-80,1,0,0.071429,0,13,14,13,3.307692,0,0,11,7,false,false,true,0.895,0.105
55,77,-22,13.75,19.25,-22,700,820,-120,0,0,0,0,72,4,4,0.527778,0,0,18,11,false,false,false,0.147,0.853
210,173,37,26.25,21.625,37,1188,1334,-146,1,0,0.125,0,32,8,8,0.9375,1,0,18,7,false,false,true,0.86,0.14
326,411,-85,19.176471,25.6875,-85,1232,1448,-216,0,2,0,0.125,-18,17,16,-1.944444,0,0,2,1,false,false,false,0,1
286,307,-21,13,13.954545,-21,1123,1062,61,0,0,0,0,-19,22,22,-2.315789,0,0,3,10,true,false,false,0.001,0.999
90,84,6,18,21,6,1110,1399,-289,0,0,0,0,66,5,4,0.515152,0,1,14,11,false,false,false,0.203,0.797
74,57,17,18.5,19,17,1232,1448,-216,0,0,0,0,73,4,3,0.479452,0,0,16,10,false,false,false,0.208,0.792
344,374,-30,20.235294,23.375,-30,1237,1265,-28,1,0,0.058824,0,-22,17,16,-1.636364,0,0,2,5,false,false,false,0,1
224,283,-59,14,17.6875,-59,814,830,-16,0,0,0,0,-6,16,16,-6.833333,0,0,10,14,false,false,false,0,1
127,179,-52,18.142857,25.571429,-52,1003,1018,-15,0,0,0,0,49,7,7,0.755102,0,0,13,12,false,false,false,0.221,0.779
31,45,-14,10.333333,15,-14,1495,1597,-102,0,0,0,0,84,3,3,0.380952,0,0,17,14,false,false,false,0.24,0.76
144,197,-53,14.4,21.888889,-53,1064,1397,-333,0,2,0,0.222222,50,10,9,0.86,1,0,22,9,false,false,false,0.081,0.919
238,386,-148,19.833333,32.166667,-148,1368,1452,-84,1,1,0.083333,0.083333,17,12,12,1.882353,0,1,12,6,false,false,false,0,1
280,357,-77,16.470588,21,-77,1159,1131,28,0,2,0,0.117647,-13,17,17,-2.846154,0,0,2,2,false,false,false,0,1
51,80,-29,8.5,16,-29,595,662,-67,0,0,0,0,62,6,5,0.709677,0,1,22,6,false,false,false,0.078,0.922
179,307,-128,16.272727,27.909091,-128,965,1078,-113,0,1,0,0.090909,24,11,11,1.541667,0,0,11,15,false,false,false,0,1
287,308,-21,16.882353,19.25,-21,1000,960,40,0,0,0,0,-8,17,16,-5.625,1,0,12,8,false,false,false,0.172,0.828
83,75,8,13.833333,15,8,480,739,-259,0,0,0,0,66,6,5,0.590909,0,1,7,9,false,false,false,0.213,0.787
175,212,-37,29.166667,35.333333,-37,1164,1161,3,0,1,0,0.166667,43,6,6,0.534884,0,0,7,9,false,false,false,0.242,0.758
85,141,-56,12.142857,23.5,-56,714,892,-178,0,0,0,0,59,7,6,0.711864,1,1,8,8,false,false,false,0.037,0.963
186,252,-66,13.285714,19.384615,-66,907,878,29,0,0,0,0,31,14,13,1.387097,1,0,8,8,false,false,false,0.022,0.978
56,76,-20,18.666667,25.333333,-20,1415,1361,54,0,0,0,0,85,3,3,0.364706,0,1,11,22,false,false,false,0.265,0.735
238,253,-15,14,15.8125,-15,925,1000,-75,0,0,0,0,-1,17,16,-44,0,1,15,8,false,false,false,0.001,0.999
268,297,-29,24.363636,27,-29,1167,1245,-78,1,0,0.090909,0,9,11,11,3.111111,1,0,8,12,false,false,false,0.191,0.809
228,350,-122,12,18.421053,-122,1248,1220,28,0,1,0,0.052632,-1,19,19,-52,1,0,8,10,false,false,false,0,1
189,358,-169,14.538462,27.538462,-169,473,683,-210,0,0,0,0,14,13,13,2.714286,0,0,11,7,false,false,false,0,1
169,190,-21,28.166667,38,-21,1761,1770,-9,0,1,0,0.2,52,6,5,0.5,0,0,8,10,false,false,false,0.261,0.739
73,95,-22,12.166667,19,-22,1473,1500,-27,0,1,0,0.2,68,6,5,0.573529,0,1,10,8,false,false,false,0.271,0.729
12,24,-12,6,24,-12,1368,1452,-84,0,0,0,0,92,2,1,0.347826,1,0,9,14,false,false,false,0.285,0.715
302,335,-33,15.894737,18.611111,-33,1281,1268,13,0,0,0,0,-11,19,18,-3.818182,0,0,2,4,false,false,false,0,1
38,0,38,38,0,38,1431,1399,32,0,0,0,0,97,1,0,0.257732,0,0,13,0,false,false,true,0.717,0.283
86,101,-15,43,50.5,-15,1086,926,160,0,1,0,0.5,78,2,2,0.358974,1,0,20,17,false,false,true,0.694,0.306
340,372,-32,20,23.25,-32,1101,1237,-136,1,0,0.058824,0,-9,17,16,-3.777778,0,0,5,2,false,false,false,0,1
80,107,-27,20,26.75,-27,804,1080,-276,0,0,0,0,68,4,4,0.5,0,0,11,16,false,false,false,0.153,0.847
226,343,-117,20.545455,31.181818,-117,1636,1796,-160,0,0,0,0,9,11,11,3,0,1,11,6,false,false,false,0,1
102,199,-97,11.333333,24.875,-97,1305,1307,-2,0,1,0,0.125,38,9,8,1.078947,0,0,11,17,false,false,false,0.028,0.972
53,92,-39,13.25,23,-39,613,525,88,0,0,0,0,72,4,4,0.583333,0,1,16,7,false,false,false,0.28,0.72
216,375,-159,12.705882,23.4375,-159,948,998,-50,0,0,0,0,-15,17,16,-2.466667,0,0,4,5,false,false,false,0,1
301,374,-73,18.8125,23.375,-73,480,739,-259,1,0,0.0625,0,-2,16,16,-19.5,0,0,7,7,false,false,false,0,1
37,75,-38,7.4,18.75,-38,1793,1869,-76,0,0,0,0,76,5,4,0.394737,0,0,13,9,false,false,false,0.271,0.729
221,193,28,17,14.846154,28,897,996,-99,0,0,0,0,20,13,13,1.95,0,1,15,17,false,false,false,0.321,0.679
235,222,13,16.785714,17.076923,13,704,523,181,0,0,0,0,-2,14,13,-17.5,0,0,16,12,false,false,true,0.559,0.441
296,323,-27,18.5,21.533333,-27,804,1080,-276,1,0,0.0625,0,-6,16,15,-5.666667,0,0,4,8,false,false,false,0.001,0.999
101,85,16,20.2,21.25,16,1388,1366,22,0,0,0,0,67,5,4,0.477612,0,1,11,9,false,false,false,0.318,0.682
108,123,-15,15.428571,20.5,-15,306,468,-162,0,0,0,0,66,7,6,0.560606,1,0,9,11,false,false,false,0.168,0.832
53,69,-16,10.6,17.25,-16,977,1100,-123,0,0,0,0,73,5,4,0.561644,1,0,13,11,false,false,false,0.107,0.893
14,0,14,14,0,14,1040,1364,-324,0,0,0,0,96,1,0,0.375,0,0,10,0,false,false,false,0.211,0.789
281,351,-70,14.789474,18.473684,-70,603,721,-118,0,0,0,0,-16,19,19,-2.6875,1,0,6,3,false,false,false,0,1
329,273,56,23.5,19.5,56,1305,1194,111,1,0,0.071429,0,1,14,14,33,1,1,9,6,false,false,true,1,0
191,303,-112,17.363636,27.545455,-112,926,973,-47,0,0,0,0,17,11,11,2.058824,0,0,12,20,false,false,false,0,1
177,234,-57,12.642857,18,-57,595,540,55,0,0,0,0,17,14,13,2.529412,0,1,12,11,false,false,false,0.021,0.979
236,188,48,18.153846,15.666667,48,1344,1314,30,0,1,0,0.083333,18,13,12,1.888889,0,1,16,16,false,false,true,0.673,0.327
387,398,-11,27.642857,28.428571,-11,1793,1957,-164,1,2,0.071429,0.142857,-12,14,14,-2.416667,0,0,3,3,false,false,true,0.803,0.197
296,392,-96,15.578947,21.777778,-96,563,523,40,0,0,0,0,-16,19,18,-2.3125,0,0,2,1,true,false,false,0,1
83,107,-24,20.75,26.75,-24,1415,1361,54,0,0,0,0,76,4,4,0.407895,0,1,11,16,false,false,false,0.252,0.748
160,306,-146,16,34,-146,1045,1100,-55,0,1,0,0.111111,35,10,9,0.971429,0,0,19,7,false,false,false,0,1
84,242,-158,9.333333,26.888889,-158,1422,1510,-88,0,1,0,0.111111,51,9,9,0.764706,0,0,21,7,false,false,false,0,1
320,350,-30,22.857143,25,-30,1102,1245,-143,0,1,0,0.071429,-12,14,14,-2.416667,0,0,5,3,false,false,false,0.097,0.903
314,361,-47,22.428571,25.785714,-47,1556,1513,43,0,0,0,0,-5,14,14,-6.2,0,0,6,2,false,false,false,0.008,0.992
318,371,-53,22.714286,26.5,-53,1495,1597,-102,0,1,0,0.071429,-3,14,14,-10.666667,0,0,10,6,false,false,false,0,1
180,268,-88,12.857143,20.615385,-88,977,1100,-123,0,1,0,0.076923,21,14,13,1.952381,0,1,11,16,false,false,false,0,1
53,72,-19,10.6,14.4,-19,206,346,-140,0,0,0,0,67,5,5,0.641791,0,0,10,14,false,false,false,0.206,0.794
271,232,39,33.875,33.142857,39,820,718,102,0,2,0,0.285714,32,8,7,0.875,0,0,10,16,false,false,true,0.896,0.104
22,10,12,11,10,12,939,969,-30,0,0,0,0,88,2,1,0.375,0,0,11,10,false,false,true,0.55,0.45
43,20,23,21.5,20,23,1691,1551,140,0,0,0,0,89,2,1,0.41573,0,0,10,18,false,false,false,0.286,0.714
149,153,-4,21.285714,25.5,-4,1439,1314,125,0,0,0,0,54,7,6,0.518519,0,0,14,11,false,false,false,0.276,0.724
113,232,-119,16.142857,33.142857,-119,473,683,-210,0,0,0,0,49,7,7,0.77551,0,0,10,10,false,false,false,0,1
140,109,31,17.5,15.571429,31,720,437,283,0,0,0,0,56,8,7,0.75,0,0,13,9,false,false,true,0.542,0.458
117,195,-78,16.714286,27.857143,-78,1656,1580,76,0,1,0,0.142857,50,7,7,0.66,0,0,13,8,false,false,false,0.106,0.894
37,44,-7,12.333333,22,-7,1075,878,197,0,0,0,0,84,3,2,0.392857,0,0,18,14,false,false,true,0.506,0.494
216,230,-14,14.4,16.428571,-14,913,1037,-124,0,1,0,0.071429,21,15,14,1.952381,0,1,20,8,false,false,false,0.248,0.752
264,336,-72,11.478261,15.272727,-72,651,700,-49,0,0,0,0,-32,23,22,-1.75,0,0,18,13,false,false,false,0,1
163,244,-81,14.818182,24.4,-81,1195,1397,-202,0,1,0,0.1,33,11,10,1.212121,0,0,11,9,false,false,false,0.011,0.989
204,212,-8,18.545455,21.2,-8,917,856,61,0,1,0,0.1,29,11,10,1.137931,0,1,7,14,false,false,false,0.204,0.796
0,0,0,0,0,0,1586,1633,-47,0,0,0,0,100,1,0,0.34,0,0,8,0,false,false,true,0.515,0.485
261,420,-159,18.642857,30,-159,1315,1334,-19,0,2,0,0.142857,-5,14,14,-7.2,0,0,7,9,false,false,false,0,1
251,411,-160,15.6875,27.4,-160,926,973,-47,0,0,0,0,-5,16,15,-7,0,0,3,3,false,false,false,0,1
34,77,-43,11.333333,25.666667,-43,566,742,-176,0,0,0,0,78,3,3,0.410256,0,1,10,13,false,false,false,0.006,0.994
267,398,-131,22.25,36.181818,-131,1633,1680,-47,0,2,0,0.181818,1,12,11,28,1,0,9,13,false,false,false,0,1
26,0,26,26,0,26,818,826,-8,0,0,0,0,96,1,0,0.552083,1,0,10,0,false,false,true,0.734,0.266
224,285,-61,18.666667,25.909091,-61,1572,1777,-205,0,1,0,0.090909,10,12,11,3.3,0,1,9,9,false,false,false,0,1
255,290,-35,11.086957,13.181818,-35,668,363,305,0,0,0,0,-25,23,22,-1.88,0,0,10,1,false,false,false,0,1
10,0,10,10,0,10,1408,1539,-131,0,0,0,0,97,1,0,0.350515,0,0,17,0,false,false,true,0.522,0.478
219,261,-42,18.25,21.75,-42,595,733,-138,1,1,0.083333,0.083333,13,12,12,3,0,1,22,18,false,false,false,0,1
202,227,-25,16.833333,20.636364,-25,599,448,151,0,0,0,0,20,12,11,1.8,0,0,15,7,false,false,false,0.328,0.672
290,308,-18,16.111111,17.111111,-18,1310,1477,-167,0,0,0,0,-27,18,18,-1.333333,0,0,3,2,true,false,false,0,1
276,273,3,18.4,19.5,3,1037,913,124,2,1,0.133333,0.071429,10,15,14,3.8,0,0,14,11,false,false,true,0.917,0.083
167,209,-42,11.133333,14.928571,-42,1220,1202,18,0,0,0,0,15,15,14,3.333333,0,2,33,7,false,false,false,0,1
104,60,44,14.857143,10,44,491,651,-160,0,0,0,0,62,7,6,0.483871,0,1,11,9,false,false,true,0.585,0.415
16,0,16,16,0,16,1583,1403,180,0,0,0,0,95,1,0,0.336842,0,0,8,0,false,false,true,0.584,0.416
266,360,-94,26.6,36,-94,1537,1539,-2,0,1,0,0.1,20,10,10,1.7,0,1,8,20,false,false,false,0,1
59,80,-21,11.8,20,-21,653,1004,-351,0,0,0,0,66,5,4,0.439394,1,0,11,13,false,false,false,0.21,0.79
46,75,-29,23,37.5,-29,1636,1727,-91,0,1,0,0.5,81,2,2,0.37037,0,0,17,11,false,false,false,0.335,0.665
159,157,2,22.714286,22.428571,2,967,856,111,0,0,0,0,46,7,7,0.717391,0,0,9,15,false,false,true,0.532,0.468
132,166,-34,18.857143,23.714286,-34,926,973,-47,0,0,0,0,43,7,7,0.813953,0,1,11,21,false,false,false,0.059,0.941
65,28,37,16.25,9.333333,37,889,895,-6,0,0,0,0,77,4,3,0.480519,0,1,13,6,false,false,true,0.583,0.417
90,116,-26,18,29,-26,642,952,-310,0,0,0,0,67,5,4,0.656716,0,0,7,24,false,false,false,0.073,0.927
14,0,14,14,0,14,1063,1134,-71,0,0,0,0,97,1,0,0.453608,0,0,10,0,false,false,true,0.55,0.45
116,153,-37,23.2,38.25,-37,1071,1065,6,0,0,0,0,55,5,4,0.563636,0,0,24,9,false,false,false,0.365,0.635
93,142,-49,18.6,35.5,-49,1399,1210,189,0,1,0,0.25,66,5,4,0.530303,0,1,20,28,false,false,false,0.141,0.859
141,108,33,15.666667,12,33,670,576,94,0,0,0,0,39,9,9,1.051282,1,0,9,12,false,false,true,0.973,0.027
106,233,-127,21.2,46.6,-127,1632,2020,-388,0,1,0,0.2,56,5,5,0.553571,0,0,7,15,false,false,false,0,1
82,80,2,16.4,16,2,1094,1041,53,0,0,0,0,61,5,5,0.622951,1,0,13,13,false,false,true,0.77,0.23
95,108,-13,31.666667,54,-13,2147,2219,-72,0,1,0,0.5,74,3,2,0.324324,0,1,13,7,false,false,false,0.313,0.687
223,291,-68,15.928571,20.785714,-68,1439,1428,11,0,0,0,0,15,14,14,2.666667,1,0,12,7,false,false,false,0.037,0.963
147,211,-64,16.333333,26.375,-64,1699,1803,-104,1,0,0.111111,0,55,9,8,0.636364,0,0,12,7,false,false,false,0.014,0.986
266,295,-29,20.461538,24.583333,-29,1397,1309,88,2,0,0.153846,0,22,13,12,1.636364,0,0,9,10,false,false,false,0.03,0.97
210,253,-43,17.5,23,-43,804,1080,-276,0,0,0,0,22,12,11,1.545455,1,0,9,12,false,false,false,0.066,0.934
69,81,-12,17.25,20.25,-12,1176,1211,-35,0,0,0,0,66,4,4,0.5,1,0,6,16,false,false,false,0.484,0.516
255,319,-64,17,21.266667,-64,795,786,9,1,0,0.066667,0,8,15,15,4.75,1,0,10,14,false,false,false,0.006,0.994
314,377,-63,19.625,23.5625,-63,700,820,-120,0,1,0,0.0625,-13,16,16,-2.923077,1,0,14,6,false,false,false,0,1
183,254,-71,14.076923,19.538462,-71,306,361,-55,0,0,0,0,5,13,13,7.2,0,0,13,11,false,false,false,0.01,0.99
177,255,-78,12.642857,18.214286,-78,683,859,-176,0,0,0,0,22,14,14,2.045455,0,0,11,13,false,false,false,0,1
331,365,-34,15.761905,17.380952,-34,540,498,42,1,0,0.047619,0,-35,21,21,-1.314286,0,0,3,3,false,false,false,0,1
260,383,-123,13.684211,20.157895,-123,711,746,-35,0,0,0,0,-15,19,19,-2.533333,0,0,2,2,true,false,false,0,1
247,277,-30,17.642857,19.785714,-30,1161,1030,131,0,1,0,0.071429,-1,14,14,-38,0,1,17,6,false,false,false,0.057,0.943
79,48,31,26.333333,24,31,921,1045,-124,0,0,0,0,82,3,2,0.426829,0,0,11,11,false,false,false,0.242,0.758
252,437,-185,21,39.727273,-185,1539,1891,-352,0,2,0,0.181818,-1,12,11,-25,1,1,8,8,false,false,false,0,1
4,0,4,4,0,4,1045,1082,-37,0,0,0,0,98,1,0,0.459184,0,0,17,0,false,false,true,0.561,0.439
290,297,-7,26.363636,27,-7,714,820,-106,1,0,0.090909,0,20,11,11,1.55,0,0,10,12,false,false,false,0.116,0.884
39,50,-11,7.8,12.5,-11,288,359,-71,0,0,0,0,75,5,4,0.36,0,0,16,11,false,false,false,0.151,0.849
236,307,-71,13.111111,18.058824,-71,830,787,43,0,0,0,0,-17,18,17,-2.235294,0,0,2,2,false,false,false,0,1
336,337,-1,16.8,16.85,-1,206,346,-140,1,0,0.05,0,-28,20,20,-1.535714,0,0,11,2,false,false,false,0.001,0.999
246,357,-111,13.666667,19.833333,-111,632,603,29,0,1,0,0.055556,-27,18,18,-1.407407,0,0,1,1,false,false,false,0,1
90,99,-9,12.857143,16.5,-9,814,830,-16,0,0,0,0,57,7,6,0.719298,0,0,11,11,false,false,false,0.273,0.727
251,314,-63,11.952381,14.952381,-63,391,542,-151,1,0,0.047619,0,-31,21,21,-1.483871,0,0,2,7,false,false,false,0,1
132,203,-71,18.857143,33.833333,-71,1399,1210,189,0,1,0,0.166667,50,7,6,0.7,0,0,17,23,false,false,false,0.03,0.97
267,330,-63,15.705882,19.411765,-63,1037,1009,28,0,0,0,0,4,17,17,11,1,0,15,7,false,false,false,0.019,0.981
182,159,23,18.2,17.666667,23,1043,1003,40,0,0,0,0,35,10,9,1.085714,0,0,20,13,false,false,true,0.546,0.454
116,111,5,19.333333,18.5,5,387,683,-296,0,0,0,0,54,6,6,0.62963,1,0,9,7,false,false,false,0.242,0.758
143,205,-62,14.3,20.5,-62,500,509,-9,0,0,0,0,30,10,10,1.366667,0,0,26,11,false,false,false,0.205,0.795
169,133,36,28.166667,26.6,36,1237,1265,-28,1,0,0.166667,0,50,6,5,0.72,0,0,23,11,false,false,true,0.577,0.423
237,207,30,21.545455,20.7,30,1803,1658,145,1,0,0.090909,0,21,11,10,1.571429,0,0,14,18,false,false,false,0.316,0.684
248,379,-131,11.272727,18.047619,-131,1248,1220,28,0,1,0,0.047619,-12,22,21,-4.333333,1,0,5,10,false,false,false,0,1
319,326,-7,16.789474,18.111111,-7,720,437,283,0,0,0,0,-8,19,18,-5.25,0,0,5,7,false,false,false,0.096,0.904
0,0,0,0,0,0,1064,1397,-333,0,0,0,0,100,1,0,0.43,0,0,25,0,false,false,false,0.211,0.789
163,295,-132,13.583333,26.818182,-132,473,683,-210,0,0,0,0,26,12,11,1.461538,1,0,15,10,false,false,false,0,1
274,300,-26,16.117647,18.75,-26,500,509,-9,0,0,0,0,-4,17,16,-10.25,0,0,8,9,false,false,false,0.021,0.979
64,57,7,21.333333,19,7,518,461,57,0,0,0,0,80,3,3,0.45,0,0,11,21,false,false,true,0.76,0.24
99,148,-49,16.5,24.666667,-49,775,786,-11,0,0,0,0,57,6,6,0.754386,0,0,10,7,false,false,false,0.248,0.752
278,267,11,21.384615,22.25,11,540,498,42,1,0,0.076923,0,11,13,12,4.181818,0,0,7,7,false,false,true,0.567,0.433
98,96,2,16.333333,19.2,2,874,868,6,0,0,0,0,58,6,5,0.568966,0,0,16,15,false,false,false,0.315,0.685
136,98,38,15.111111,12.25,38,1040,1091,-51,0,0,0,0,49,9,8,0.959184,0,1,10,24,false,false,false,0.257,0.743
35,20,15,17.5,20,15,642,952,-310,0,0,0,0,89,2,1,0.494382,0,0,13,11,false,false,false,0.229,0.771
231,238,-7,21,21.636364,-7,1270,1261,9,1,0,0.090909,0,31,11,11,1.193548,0,0,7,8,false,false,false,0.275,0.725
155,151,4,17.222222,18.875,4,965,1078,-113,0,0,0,0,46,9,8,0.804348,0,0,9,12,false,false,false,0.076,0.924
166,144,22,23.714286,24,22,1110,1123,-13,0,1,0,0.166667,45,7,6,0.733333,0,0,8,15,false,false,true,0.507,0.493
156,167,-11,26,27.833333,-11,1063,1134,-71,1,0,0.166667,0,59,6,6,0.745763,0,0,16,13,false,false,false,0.214,0.786
313,342,-29,19.5625,21.375,-29,1227,1189,38,0,0,0,0,-13,16,16,-2.692308,0,0,4,2,false,false,false,0.029,0.971
18,0,18,18,0,18,480,518,-38,0,0,0,0,96,1,0,0.416667,0,0,10,0,false,false,false,0.411,0.589
180,120,60,20,15,60,1065,948,117,0,0,0,0,49,9,8,0.795918,0,0,17,8,false,false,true,0.932,0.068
124,127,-3,20.666667,25.4,-3,921,1045,-124,0,0,0,0,60,6,5,0.583333,0,0,7,13,false,false,false,0.084,0.916
275,326,-51,21.153846,27.166667,-51,1274,1394,-120,0,1,0,0.083333,3,13,12,10,0,0,18,17,false,false,false,0,1
262,257,5,16.375,17.133333,5,796,800,-4,1,0,0.0625,0,10,16,15,4.8,0,1,10,6,false,false,false,0.186,0.814
97,60,37,24.25,20,37,1493,1413,80,0,0,0,0,78,4,3,0.461538,0,0,23,11,false,false,true,0.669,0.331
271,315,-44,14.263158,17.5,-44,1040,1091,-51,0,0,0,0,-16,19,18,-2.9375,0,0,11,10,false,false,false,0,1
299,434,-135,23,36.166667,-135,1606,1593,13,1,1,0.076923,0.083333,0,13,12,0,0,0,5,3,false,false,false,0,1
102,85,17,25.5,21.25,17,967,856,111,0,0,0,0,68,4,4,0.485294,0,0,10,16,false,false,true,0.752,0.248
18,26,-8,18,26,-8,1537,1539,-2,0,0,0,0,92,1,1,0.369565,0,1,11,6,false,false,false,0.338,0.662
20,13,7,20,13,7,771,668,103,0,0,0,0,93,1,1,0.408602,0,0,11,8,false,false,true,0.778,0.222
85,55,30,28.333333,18.333333,30,691,704,-13,0,0,0,0,79,3,3,0.481013,0,0,13,12,false,false,true,0.86,0.14
324,376,-52,19.058824,22.117647,-52,1266,1339,-73,0,1,0,0.058824,-8,17,17,-4.375,0,0,1,2,false,false,false,0,1
258,260,-2,14.333333,15.294118,-2,1182,1075,107,0,1,0,0.058824,-17,18,17,-2.294118,0,1,15,15,false,false,false,0.017,0.983
199,177,22,22.111111,22.125,22,1093,1173,-80,0,0,0,0,45,9,8,0.955556,0,0,17,16,false,false,false,0.112,0.888
192,186,6,24,26.571429,6,689,804,-115,0,0,0,0,40,8,7,0.875,0,0,7,18,false,false,false,0.105,0.895
196,293,-97,19.6,29.3,-97,1038,917,121,1,2,0.1,0.2,26,10,10,1.346154,0,0,11,16,false,false,false,0.027,0.973
6,0,6,6,0,6,964,1003,-39,0,0,0,0,97,1,0,0.402062,0,0,18,0,false,false,true,0.561,0.439
112,92,20,18.666667,18.4,20,1561,1495,66,1,0,0.166667,0,54,6,5,0.611111,1,0,9,20,false,false,true,0.92,0.08
282,373,-91,14.842105,20.722222,-91,1580,1629,-49,0,1,0,0.055556,-21,19,18,-1.761905,0,0,1,1,true,false,false,0,1
286,307,-21,13,14.619048,-21,1123,1062,61,0,0,0,0,-19,22,21,-2.315789,0,0,3,10,false,false,false,0,1
207,182,25,29.571429,30.333333,25,824,830,-6,1,0,0.142857,0,53,7,6,0.830189,0,0,8,16,false,false,false,0.268,0.732
119,194,-75,19.833333,38.8,-75,1397,1309,88,1,0,0.166667,0,66,6,5,0.545455,0,1,8,10,false,false,false,0.015,0.985
238,297,-59,17,21.214286,-59,595,733,-138,1,1,0.071429,0.071429,0,14,14,0,0,1,23,12,false,false,false,0,1
298,356,-58,21.285714,25.428571,-58,1030,1014,16,0,1,0,0.071429,4,14,14,8.25,0,0,11,7,false,false,false,0.003,0.997
157,270,-113,19.625,38.571429,-113,2143,2219,-76,0,0,0,0,42,8,7,0.738095,0,0,12,23,false,false,false,0,1
187,358,-171,20.777778,39.777778,-171,1556,1656,-100,0,2,0,0.222222,21,9,9,1.428571,0,0,16,26,false,false,false,0,1
249,383,-134,14.647059,22.529412,-134,530,683,-153,0,1,0,0.058824,0,17,17,0,0,0,17,12,false,false,false,0,1
252,270,-18,21,22.5,-18,964,1003,-39,0,1,0,0.083333,20,12,12,1.95,1,0,12,20,false,false,false,0.273,0.727
258,270,-12,17.2,19.285714,-12,1000,960,40,0,0,0,0,5,15,14,9,1,0,6,10,false,false,false,0.237,0.763
55,102,-47,13.75,25.5,-47,1305,1211,94,0,0,0,0,76,4,4,0.434211,0,0,16,26,false,false,false,0.256,0.744
109,95,14,21.8,19,14,1197,1156,41,0,0,0,0,64,5,5,0.546875,0,1,11,8,false,false,true,0.525,0.475
134,113,21,22.333333,22.6,21,1417,1482,-65,0,0,0,0,63,6,5,0.52381,0,0,20,9,false,false,false,0.442,0.558
153,111,42,19.125,15.857143,42,1633,1556,77,0,0,0,0,44,8,7,0.75,0,0,19,7,false,false,false,0.369,0.631
336,364,-28,19.764706,21.411765,-28,1043,1003,40,0,1,0,0.058824,-11,17,17,-3.454545,0,0,3,3,false,false,false,0.049,0.951
150,257,-107,13.636364,23.363636,-107,503,668,-165,0,1,0,0.090909,27,11,11,1.37037,0,0,15,18,false,false,false,0,1
102,67,35,14.571429,11.166667,35,1193,1220,-27,0,0,0,0,54,7,6,0.796296,1,1,11,20,false,false,true,0.522,0.478
75,86,-11,15,21.5,-11,563,523,40,0,0,0,0,70,5,4,0.528571,0,0,8,21,false,false,false,0.442,0.558
203,200,3,20.3,20,3,1257,1176,81,1,0,0.1,0,37,10,10,0.918919,1,0,9,20,false,false,true,0.562,0.438
18,8,10,9,8,10,808,749,59,0,0,0,0,89,2,1,0.47191,0,1,12,19,false,false,false,0.453,0.547
179,181,-2,29.833333,30.166667,-2,1556,1513,43,0,0,0,0,48,6,6,0.645833,0,0,17,16,false,false,false,0.448,0.552
286,371,-85,13,16.863636,-85,595,412,183,0,1,0,0.045455,-16,22,22,-3.25,0,0,10,11,false,false,false,0,1
223,335,-112,15.928571,23.928571,-112,1305,1254,51,0,1,0,0.071429,-4,14,14,-8,0,0,16,11,false,false,false,0,1
127,98,29,25.4,19.6,29,1047,1253,-206,1,0,0.2,0,66,5,5,0.560606,0,0,7,11,false,false,true,0.515,0.485
225,261,-36,18.75,23.727273,-36,1656,1580,76,0,1,0,0.090909,21,12,11,1.571429,2,0,8,19,false,false,false,0.137,0.863
233,269,-36,15.533333,17.933333,-36,1312,1334,-22,0,0,0,0,-4,15,15,-9.75,0,0,13,12,false,false,false,0.014,0.986
67,93,-26,16.75,23.25,-26,527,954,-427,0,0,0,0,73,4,4,0.479452,0,1,19,9,false,false,false,0,1
68,53,15,17,13.25,15,1065,948,117,0,0,0,0,73,4,4,0.534247,1,0,17,20,false,false,true,0.878,0.122
74,79,-5,18.5,19.75,-5,1699,1803,-104,0,0,0,0,78,4,4,0.448718,0,2,7,7,false,false,false,0.223,0.777
286,300,-14,22,25,-14,1030,1014,16,0,1,0,0.083333,16,13,12,2.0625,0,0,9,10,false,false,false,0.144,0.856
175,242,-67,21.875,34.571429,-67,1633,1680,-47,0,1,0,0.142857,31,8,7,0.903226,0,0,21,11,false,false,false,0.06,0.94
127,133,-6,14.111111,16.625,-6,568,570,-2,0,0,0,0,45,9,8,0.822222,0,0,12,18,false,false,false,0.23,0.77
156,201,-45,17.333333,22.333333,-45,775,786,-11,0,0,0,0,37,9,9,1.162162,1,0,10,19,false,false,false,0.19,0.81
329,365,-36,23.5,26.071429,-36,691,695,-4,1,0,0.071429,0,-6,14,14,-5.333333,0,0,4,3,false,false,false,0.045,0.955
134,101,33,22.333333,20.2,33,804,1074,-270,0,0,0,0,61,6,5,0.52459,0,0,12,16,false,false,false,0.479,0.521
288,335,-47,24,30.454545,-47,1495,1597,-102,0,1,0,0.090909,12,12,11,2.666667,0,0,8,8,false,false,false,0.022,0.978
126,148,-22,12.6,14.8,-22,391,542,-151,1,0,0.1,0,34,10,10,1.352941,0,0,7,8,false,false,true,0.556,0.444
118,148,-30,16.857143,21.142857,-30,725,668,57,0,0,0,0,53,7,7,0.660377,0,1,23,15,false,false,false,0.311,0.689
264,353,-89,16.5,22.0625,-89,1159,1131,28,0,2,0,0.125,-7,16,16,-5.285714,0,0,5,5,false,false,false,0,1
11,14,-3,5.5,14,-3,1636,1702,-66,0,0,0,0,94,2,1,0.308511,0,0,19,12,false,false,false,0.275,0.725
26,11,15,13,11,15,948,998,-50,0,0,0,0,85,2,1,0.435294,1,0,12,15,false,false,true,0.582,0.418
264,465,-201,16.5,29.0625,-201,1093,1100,-7,0,2,0,0.125,-4,16,16,-8.75,0,0,26,8,false,false,false,0,1
173,111,62,24.714286,18.5,62,1341,1606,-265,1,0,0.142857,0,46,7,6,0.717391,0,0,10,10,false,false,true,0.92,0.08
216,232,-16,16.615385,17.846154,-16,450,503,-53,0,0,0,0,15,13,13,2.6,1,0,11,10,false,false,false,0.22,0.78
379,448,-69,31.583333,40.727273,-69,2010,2219,-209,1,2,0.083333,0.181818,-2,12,11,-13,0,0,7,4,false,false,false,0,1
158,170,-12,17.555556,21.25,-12,1021,1094,-73,1,0,0.111111,0,42,9,8,0.880952,1,0,9,13,false,false,false,0.217,0.783
146,175,-29,18.25,21.875,-29,1075,878,197,0,0,0,0,50,8,8,0.66,0,0,10,12,false,false,false,0.385,0.615
275,362,-87,18.333333,24.133333,-87,700,820,-120,0,1,0,0.066667,-6,15,15,-6.333333,0,0,20,11,false,false,false,0,1
199,221,-22,24.875,31.571429,-22,1071,1065,6,0,0,0,0,36,8,7,0.861111,0,0,17,10,false,false,false,0.246,0.754
8,0,8,8,0,8,940,947,-7,0,0,0,0,96,1,0,0.364583,0,0,7,0,false,false,true,0.562,0.438
140,175,-35,15.555556,21.875,-35,1161,1176,-15,0,1,0,0.125,39,9,8,0.974359,0,0,9,10,false,false,false,0.263,0.737
216,219,-3,16.615385,18.25,-3,561,688,-127,0,0,0,0,28,13,12,1.642857,0,0,16,11,false,false,false,0.275,0.725
257,383,-126,14.277778,21.277778,-126,711,746,-35,0,0,0,0,-13,18,18,-2.923077,0,0,2,2,false,false,false,0,1
136,95,41,27.2,19,41,1281,1268,13,0,0,0,0,62,5,5,0.677419,0,0,7,10,false,false,true,0.604,0.396
41,29,12,13.666667,14.5,12,1047,1127,-80,0,0,0,0,80,3,2,0.3375,1,1,16,16,false,false,false,0.283,0.717
230,298,-68,13.529412,18.625,-68,613,525,88,0,0,0,0,2,17,16,21,0,1,15,7,false,false,false,0,1
204,259,-55,15.692308,21.583333,-55,727,820,-93,0,1,0,0.083333,12,13,12,2.916667,0,0,7,11,false,false,false,0.012,0.988
22,24,-2,22,24,-2,704,523,181,0,0,0,0,92,1,1,0.380435,0,0,12,10,false,false,true,0.731,0.269
14,11,3,14,11,3,948,998,-50,0,0,0,0,91,1,1,0.406593,0,0,9,15,false,false,true,0.513,0.487
26,14,12,13,14,12,1075,1189,-114,0,0,0,0,87,2,1,0.45977,0,0,13,12,false,false,false,0.292,0.708
209,259,-50,34.833333,43.166667,-50,1431,1399,32,0,2,0,0.333333,37,6,6,0.675676,0,0,9,13,false,false,false,0.177,0.823
35,16,19,11.666667,8,19,970,1030,-60,0,0,0,0,83,3,2,0.481928,0,1,27,7,false,false,false,0.487,0.513
105,217,-112,17.5,36.166667,-112,1777,1500,277,0,1,0,0.166667,53,6,6,0.528302,1,0,8,10,false,false,true,0.964,0.036
239,244,-5,23.9,24.4,-5,1305,1194,111,1,0,0.1,0,26,10,10,1.269231,0,0,9,7,false,false,false,0.291,0.709
211,197,14,30.142857,32.833333,14,1699,1580,119,2,0,0.285714,0,46,7,6,0.652174,0,0,11,7,false,false,false,0.444,0.556
346,342,4,23.066667,22.8,4,1563,1539,24,0,1,0,0.066667,-18,15,15,-1.944444,0,0,1,3,false,false,false,0.15,0.85
288,319,-31,18,19.9375,-31,576,602,-26,0,0,0,0,-4,16,16,-10.5,0,0,11,5,false,false,false,0.04,0.96
43,56,-13,14.333333,18.666667,-13,1037,1009,28,0,0,0,0,79,3,3,0.556962,0,0,18,12,false,false,false,0.322,0.678
0,0,0,0,0,0,1127,995,132,0,0,0,0,100,1,1,0.33,0,0,11,9,false,false,true,0.578,0.422
187,238,-51,14.384615,19.833333,-51,518,414,104,0,1,0,0.083333,18,13,12,2.111111,0,0,7,10,false,false,false,0.078,0.922
94,243,-149,11.75,30.375,-149,935,995,-60,0,1,0,0.125,50,8,8,0.78,2,0,16,21,false,false,false,0.013,0.987
64,36,28,21.333333,18,28,1030,998,32,0,0,0,0,78,3,2,0.474359,0,0,7,10,false,false,true,0.565,0.435
311,358,-47,16.368421,18.842105,-47,1220,1185,35,0,1,0,0.052632,-12,19,19,-3.916667,0,0,13,6,false,false,false,0,1
185,306,-121,18.5,30.6,-121,1232,1448,-216,0,2,0,0.2,25,10,10,1.4,0,0,10,9,false,false,false,0,1
271,319,-48,18.066667,21.266667,-48,1633,1620,13,0,0,0,0,-10,15,15,-3.6,0,0,9,8,false,false,false,0,1
255,359,-104,36.428571,59.833333,-104,1398,1431,-33,0,0,0,0,29,7,6,0.965517,0,1,10,11,false,false,false,0,1
111,127,-16,12.333333,15.875,-16,977,1100,-123,0,0,0,0,55,9,8,0.745455,0,0,25,12,false,false,false,0.074,0.926
181,177,4,30.166667,35.4,4,1793,1957,-164,0,0,0,0,52,6,5,0.557692,0,0,7,17,false,false,false,0.155,0.845
92,83,9,30.666667,27.666667,9,1770,1745,25,1,0,0.333333,0,79,3,3,0.417722,0,0,12,13,false,false,true,0.569,0.431
365,371,-6,22.8125,24.733333,-6,1305,1211,94,2,0,0.125,0,-7,16,15,-4.714286,0,1,5,4,false,false,false,0.021,0.979
110,118,-8,22,23.6,-8,1110,1123,-13,0,1,0,0.2,56,5,5,0.589286,0,0,10,24,false,false,false,0.295,0.705
237,293,-56,13.166667,17.235294,-56,683,859,-176,0,0,0,0,5,18,17,9,0,0,9,17,false,false,false,0,1
36,37,-1,18,18.5,-1,1493,1413,80,0,0,0,0,88,2,2,0.409091,1,0,25,11,false,false,true,0.708,0.292
205,237,-32,17.083333,19.75,-32,356,498,-142,0,1,0,0.083333,17,12,12,2.058824,1,0,9,14,false,false,false,0.151,0.849
71,103,-32,11.833333,20.6,-32,95,453,-358,0,0,0,0,73,6,5,0.534247,0,0,7,7,false,false,false,0.008,0.992
156,222,-66,17.333333,24.666667,-66,1488,1403,85,0,1,0,0.111111,33,9,9,1.030303,0,0,7,9,false,false,false,0.039,0.961
117,204,-87,23.4,40.8,-87,1388,1455,-67,0,0,0,0,54,5,5,0.518519,1,0,13,10,false,false,false,0.059,0.941
190,236,-46,12.666667,16.857143,-46,1078,983,95,1,0,0.066667,0,15,15,14,3.2,0,1,7,14,false,false,false,0.023,0.977
237,311,-74,14.8125,20.733333,-74,603,721,-118,0,0,0,0,8,16,15,5.375,0,0,11,9,false,false,false,0,1
188,135,53,23.5,19.285714,53,1691,1551,140,0,0,0,0,48,8,7,0.770833,0,1,7,24,false,false,false,0.317,0.683
28,57,-29,9.333333,19,-29,1656,1580,76,0,0,0,0,79,3,3,0.417722,0,0,18,10,false,false,false,0.272,0.728
65,60,5,13,15,5,306,302,4,0,0,0,0,72,5,4,0.569444,0,0,15,10,false,false,true,0.588,0.412
252,425,-173,12.6,21.25,-173,1075,1189,-114,0,0,0,0,-22,20,20,-1.818182,0,0,1,1,true,false,false,0,1
161,142,19,23,23.666667,19,999,1283,-284,0,0,0,0,56,7,6,0.589286,0,1,8,14,false,false,false,0.29,0.71
167,200,-33,12.846154,16.666667,-33,1220,1202,18,0,0,0,0,21,13,12,2.380952,0,0,27,9,false,false,false,0.239,0.761
211,298,-87,13.1875,18.625,-87,613,525,88,0,0,0,0,5,16,16,8.4,0,1,17,7,false,false,false,0,1
174,224,-50,12.428571,17.230769,-50,651,700,-49,0,0,0,0,14,14,13,4,1,0,6,16,false,false,false,0.022,0.978
27,120,-93,13.5,60,-93,1220,1202,18,0,0,0,0,83,2,2,0.60241,0,0,16,10,false,false,false,0.027,0.973
279,292,-13,21.461538,22.461538,-13,742,868,-126,0,1,0,0.076923,10,13,13,3.3,0,0,7,21,false,false,false,0.253,0.747
271,370,-99,15.055556,20.555556,-99,805,918,-113,0,0,0,0,-22,18,18,-1.636364,0,0,1,4,true,false,false,0,1
383,373,10,21.277778,21.941176,10,964,1003,-39,0,1,0,0.058824,-17,18,17,-2.294118,0,0,8,8,false,false,false,0.39,0.61
281,312,-31,11.708333,13,-31,542,390,152,1,0,0.041667,0,-23,24,24,-2.173913,0,0,2,6,false,false,false,0.001,0.999
279,245,34,19.928571,18.846154,34,675,570,105,0,0,0,0,-2,14,13,-17.5,0,0,17,11,false,false,true,0.853,0.147
125,166,-41,13.888889,20.75,-41,1182,1075,107,0,1,0,0.125,40,9,8,0.975,0,1,24,6,false,false,false,0.267,0.733
310,306,4,17.222222,17,4,540,498,42,1,0,0.055556,0,-20,18,18,-2.3,0,0,7,14,false,false,true,0.837,0.163
146,196,-50,14.6,21.777778,-50,542,605,-63,0,0,0,0,35,10,9,1.028571,0,0,10,19,false,false,false,0.024,0.976
311,409,-98,25.916667,34.083333,-98,1770,1751,19,0,1,0,0.083333,2,12,12,14.5,0,0,11,10,false,false,false,0,1
124,75,49,31,18.75,49,1552,1803,-251,1,0,0.25,0,73,4,4,0.452055,0,0,10,11,false,false,true,0.617,0.383
32,33,-1,16,33,-1,1071,1000,71,0,0,0,0,89,2,1,0.52809,0,0,8,10,false,false,false,0.27,0.73
282,367,-85,15.666667,21.588235,-85,1580,1629,-49,0,1,0,0.058824,-19,18,17,-1.947368,0,0,1,1,false,false,false,0,1
67,56,11,13.4,14,11,1220,1185,35,0,0,0,0,71,5,4,0.661972,0,1,33,9,false,false,false,0.351,0.649
49,78,-29,16.333333,26,-29,1432,1452,-20,0,0,0,0,77,3,3,0.467532,0,0,16,8,false,false,false,0.274,0.726
298,359,-61,15.684211,19.944444,-61,694,658,36,0,1,0,0.055556,-17,19,18,-2.176471,0,0,5,1,true,false,false,0,1
120,524,-404,6.666667,29.111111,-404,1164,1149,15,0,3,0,0.166667,14,18,18,3.357143,0,1,12,10,false,false,false,0,1
138,143,-5,19.714286,20.428571,-5,1493,1413,80,0,0,0,0,53,7,7,0.679245,0,1,21,19,false,false,false,0.272,0.728
131,204,-73,16.375,25.5,-73,952,826,126,0,1,0,0.125,52,8,8,0.826923,0,0,10,9,false,false,false,0.047,0.953
69,121,-52,13.8,24.2,-52,518,414,104,0,1,0,0.2,65,5,5,0.584615,0,0,14,13,false,false,false,0.475,0.525
215,269,-54,19.545455,24.454545,-54,621,786,-165,0,0,0,0,11,11,11,2.727273,0,0,13,10,false,false,false,0.044,0.956
69,88,-19,17.25,22,-19,615,542,73,0,0,0,0,75,4,4,0.56,0,0,14,15,false,false,true,0.525,0.475
182,276,-94,18.2,27.6,-94,1576,1556,20,0,1,0,0.1,21,10,10,1.428571,0,0,15,17,false,false,false,0,1
229,279,-50,22.9,31,-50,1770,1745,25,1,0,0.1,0,33,10,9,1,0,0,8,11,false,false,false,0.028,0.972
246,291,-45,15.375,19.4,-45,642,952,-310,0,0,0,0,4,16,15,11,0,0,8,14,false,false,false,0,1
114,203,-89,11.4,20.3,-89,1071,1000,71,0,0,0,0,41,10,10,1.146341,1,1,24,13,false,false,false,0.05,0.95
317,329,-12,12.68,13.708333,-12,526,502,24,0,0,0,0,-36,25,24,-1.388889,0,0,13,13,false,false,false,0.116,0.884
187,274,-87,12.466667,18.266667,-87,951,976,-25,0,0,0,0,10,15,15,4.4,0,0,9,10,false,false,false,0,1
269,397,-128,15.823529,24.8125,-128,1408,1539,-131,0,1,0,0.0625,-21,17,16,-1.619048,0,0,2,2,false,false,false,0,1
42,45,-3,14,15,-3,671,638,33,0,0,0,0,78,3,3,0.628205,0,0,15,10,false,false,true,0.708,0.292
340,354,-14,22.666667,25.285714,-14,1373,1334,39,1,2,0.066667,0.142857,-1,15,14,-32,1,0,3,11,false,false,false,0.287,0.713
209,235,-26,23.222222,29.375,-26,1793,1957,-164,0,0,0,0,37,9,8,0.783784,0,1,11,7,false,false,false,0.055,0.945
319,334,-15,22.785714,23.857143,-15,1354,1210,144,0,1,0,0.071429,-1,14,14,-33,0,1,19,7,false,false,false,0.041,0.959
30,84,-54,15,42,-54,944,1095,-151,0,1,0,0.5,85,2,2,0.458824,0,0,16,18,false,false,false,0.231,0.769
231,246,-15,14.4375,16.4,-15,999,1165,-166,0,0,0,0,10,16,15,4.6,1,1,15,6,false,false,false,0.071,0.929
179,339,-160,22.375,42.375,-160,1539,1891,-352,0,2,0,0.25,30,8,8,0.833333,1,0,19,8,false,false,false,0,1
40,70,-30,10,23.333333,-30,1580,1629,-49,0,0,0,0,79,4,3,0.468354,0,0,14,13,false,false,false,0.27,0.73
60,60,0,20,20,0,704,523,181,0,0,0,0,77,3,3,0.454545,1,0,12,10,false,false,true,0.854,0.146
276,254,22,21.230769,21.166667,22,939,969,-30,0,0,0,0,5,13,12,6.6,0,0,11,7,false,false,false,0.417,0.583
133,228,-95,16.625,28.5,-95,1397,1309,88,1,0,0.125,0,54,8,8,0.666667,0,1,9,10,false,false,false,0.024,0.976
60,77,-17,20,25.666667,-17,1232,1281,-49,0,1,0,0.333333,70,3,3,0.442857,0,0,10,15,false,false,false,0.283,0.717
83,186,-103,10.375,23.25,-103,595,662,-67,0,1,0,0.125,42,8,8,1.047619,0,1,21,6,false,false,false,0.046,0.954
325,414,-89,23.214286,31.846154,-89,1537,1539,-2,0,1,0,0.076923,-2,14,13,-17,0,1,7,9,false,false,false,0,1
14,26,-12,14,26,-12,1075,878,197,0,0,0,0,93,1,1,0.354839,0,0,19,17,false,false,true,0.512,0.488
36,143,-107,6,28.6,-107,1422,1510,-88,0,1,0,0.2,74,6,5,0.527027,0,0,18,28,false,false,false,0.029,0.971
247,309,-62,27.444444,34.333333,-62,1086,926,160,0,2,0,0.222222,22,9,9,1.272727,0,0,10,19,false,false,false,0.028,0.972
99,223,-124,12.375,27.875,-124,760,976,-216,0,1,0,0.125,42,8,8,0.857143,0,0,10,12,false,false,false,0.004,0.996
285,396,-111,23.75,36,-111,1164,1161,3,1,2,0.083333,0.181818,-6,12,11,-3.833333,0,1,19,12,true,false,false,0,1
72,88,-16,18,22,-16,1266,1339,-73,0,0,0,0,75,4,4,0.466667,0,0,11,18,false,false,false,0.161,0.839
108,88,20,36,44,20,714,820,-106,1,0,0.333333,0,80,3,2,0.3875,0,0,15,8,false,false,false,0.175,0.825
131,137,-6,21.833333,22.833333,-6,450,624,-174,0,0,0,0,53,6,6,0.622642,0,0,9,16,false,false,false,0.239,0.761
143,252,-109,15.888889,28,-109,1397,1309,88,1,0,0.111111,0,47,9,9,0.765957,0,1,7,8,false,false,false,0.021,0.979
152,139,13,25.333333,23.166667,13,1586,1633,-47,1,0,0.166667,0,64,6,6,0.53125,0,0,24,18,false,false,true,0.536,0.464
76,95,-19,15.2,23.75,-19,714,892,-178,0,0,0,0,68,5,4,0.617647,1,1,10,17,false,false,false,0.114,0.886
300,325,-25,20,21.666667,-25,1257,1176,81,2,0,0.133333,0,4,15,15,8.5,0,0,9,7,false,false,false,0.065,0.935
358,466,-108,23.866667,31.066667,-108,2143,2219,-76,1,0,0.066667,0,-21,15,15,-1.47619,0,0,3,1,false,false,false,0.001,0.999
85,106,-21,21.25,26.5,-21,1439,1314,125,0,0,0,0,73,4,4,0.383562,0,0,25,11,false,false,false,0.444,0.556
140,141,-1,28,35.25,-1,1173,1256,-83,1,0,0.2,0,68,5,4,0.455882,0,1,11,8,false,false,false,0.014,0.986
20,0,20,20,0,20,1493,1413,80,0,0,0,0,97,1,0,0.371134,0,0,26,0,false,false,true,0.732,0.268
130,135,-5,13,13.5,-5,342,53,289,0,0,0,0,33,10,10,1.242424,1,1,12,14,false,false,false,0.491,0.509
281,368,-87,16.529412,23,-87,1003,1018,-15,0,0,0,0,-27,17,16,-1.37037,0,0,2,3,false,false,false,0,1
39,65,-26,13,21.666667,-26,342,263,79,0,0,0,0,77,3,3,0.441558,0,1,10,18,false,false,false,0.446,0.554
174,202,-28,14.5,18.363636,-28,603,721,-118,0,0,0,0,27,12,11,1.592593,0,0,15,19,false,false,false,0.081,0.919
151,183,-32,18.875,22.875,-32,1488,1428,60,1,0,0.125,0,43,8,8,0.860465,0,0,23,14,false,false,false,0.272,0.728
33,83,-50,8.25,20.75,-50,95,453,-358,0,0,0,0,82,4,4,0.47561,0,0,7,9,false,false,false,0.002,0.998
43,42,1,14.333333,21,1,837,844,-7,0,0,0,0,85,3,2,0.482353,0,1,11,18,false,false,false,0.147,0.853
320,308,12,17.777778,17.111111,12,1065,948,117,0,1,0,0.055556,-5,18,18,-7.8,0,0,11,6,false,false,true,0.924,0.076
171,166,5,17.1,18.444444,5,1037,1016,21,1,0,0.1,0,44,10,9,1.318182,1,0,26,20,false,false,false,0.317,0.683
27,17,10,13.5,17,10,542,390,152,0,0,0,0,92,2,1,0.543478,0,0,10,10,false,false,true,0.695,0.305
206,272,-66,17.166667,22.666667,-66,691,704,-13,0,1,0,0.083333,21,12,12,1.809524,0,0,10,14,false,false,false,0.029,0.971
63,130,-67,21,43.333333,-67,964,1003,-39,0,1,0,0.333333,76,3,3,0.513158,0,0,12,11,false,false,false,0.268,0.732
91,120,-29,13,17.142857,-29,568,570,-2,0,0,0,0,55,7,7,0.672727,0,0,14,20,false,false,false,0.205,0.795
146,216,-70,16.222222,27,-70,1094,1159,-65,0,0,0,0,38,9,8,1,1,0,15,13,false,false,false,0.04,0.96
147,302,-155,13.363636,27.454545,-155,710,758,-48,0,1,0,0.090909,32,11,11,1.15625,0,0,12,9,false,false,false,0,1
72,85,-13,14.4,17,-13,1229,1220,9,0,0,0,0,63,5,5,0.587302,0,1,19,17,false,false,false,0.275,0.725
165,198,-33,20.625,28.285714,-33,1315,1334,-19,0,1,0,0.142857,46,8,7,0.782609,0,1,7,6,false,false,false,0.173,0.827
14,26,-12,7,13,-12,288,359,-71,0,0,0,0,89,2,2,0.303371,0,1,9,7,false,false,false,0.114,0.886
237,293,-56,12.473684,16.277778,-56,683,859,-176,0,0,0,0,5,19,18,9,0,0,9,17,false,false,false,0,1
330,355,-25,18.333333,20.882353,-25,1473,1500,-27,1,2,0.055556,0.117647,-22,18,17,-1.772727,1,0,1,7,false,false,false,0.324,0.676
123,125,-2,20.5,20.833333,-2,985,1062,-77,0,0,0,0,56,6,6,0.660714,0,0,12,13,false,false,false,0.292,0.708
228,243,-15,20.727273,24.3,-15,1691,1551,140,0,0,0,0,31,11,10,1.193548,1,0,6,11,false,false,false,0.12,0.88
332,381,-49,20.75,23.8125,-49,892,856,36,1,1,0.0625,0.0625,-20,16,16,-1.75,0,0,5,1,false,false,false,0.001,0.999
186,307,-121,14.307692,25.583333,-121,760,976,-216,0,1,0,0.083333,10,13,12,3.6,0,1,13,19,false,false,false,0,1
220,280,-60,16.923077,21.538462,-60,1037,1016,21,1,0,0.076923,0,26,13,13,2.230769,1,0,16,7,false,false,false,0.03,0.97
8,14,-6,8,14,-6,500,509,-9,0,0,0,0,93,1,1,0.44086,0,0,9,24,false,false,false,0.321,0.679
70,0,70,70,0,70,1237,1265,-28,1,0,1,0,93,1,0,0.387097,0,0,21,0,false,false,true,0.589,0.411
291,295,-4,15.315789,16.388889,-4,1045,1082,-37,0,0,0,0,-15,19,18,-3,0,0,5,10,false,false,false,0.141,0.859
44,57,-13,22,28.5,-13,1633,1739,-106,0,0,0,0,88,2,2,0.386364,0,0,8,14,false,false,false,0.274,0.726
187,186,1,26.714286,31,1,1554,1685,-131,0,1,0,0.166667,53,7,6,0.603774,0,0,13,7,false,false,false,0.3,0.7
82,188,-106,16.4,37.6,-106,1656,1649,7,0,0,0,0,58,5,5,0.551724,0,0,15,11,false,false,false,0.028,0.972
136,98,38,17,12.25,38,1040,1091,-51,0,0,0,0,49,8,8,0.959184,0,1,10,24,false,false,false,0.476,0.524
112,81,31,28,27,31,1331,1347,-16,1,0,0.25,0,68,4,3,0.470588,0,0,7,19,false,false,true,0.648,0.352
297,359,-62,18.5625,23.933333,-62,710,758,-48,1,1,0.0625,0.066667,0,16,15,0,0,0,13,10,false,false,false,0,1
345,385,-40,23,27.5,-40,1454,1479,-25,1,0,0.066667,0,-7,15,14,-4.428571,0,0,9,6,false,false,false,0,1
290,381,-91,24.166667,31.75,-91,1415,1361,54,0,1,0,0.083333,9,12,12,3.444444,0,0,12,18,false,false,false,0,1
182,225,-43,16.545455,22.5,-43,343,570,-227,0,0,0,0,18,11,10,2,1,0,18,7,false,false,false,0.114,0.886
15,34,-19,7.5,34,-19,935,995,-60,0,0,0,0,92,2,1,0.423913,2,0,11,15,false,false,true,0.515,0.485
291,336,-45,20.785714,24,-45,561,633,-72,0,1,0,0.071429,6,14,14,5.833333,0,0,7,10,false,false,false,0.013,0.987
284,403,-119,17.75,26.866667,-119,1656,1649,7,0,0,0,0,-13,16,15,-2.461538,0,0,1,4,false,false,false,0,1
163,174,-11,10.866667,12.428571,-11,542,390,152,0,0,0,0,32,15,14,1.5625,0,0,10,19,false,false,true,0.564,0.436
259,356,-97,12.95,17.8,-97,714,892,-178,0,2,0,0.1,-22,20,20,-1.909091,0,0,6,3,false,false,false,0,1
301,398,-97,16.722222,23.411765,-97,935,995,-60,1,1,0.055556,0.058824,-15,18,17,-2.6,0,0,8,2,false,false,false,0,1
221,383,-162,27.625,47.875,-162,1885,1908,-23,1,3,0.125,0.375,16,8,8,1.4375,0,0,7,19,false,false,false,0,1
96,106,-10,16,21.2,-10,803,786,17,0,0,0,0,65,6,5,0.492308,0,0,7,10,false,false,false,0.294,0.706
192,202,-10,17.454545,20.2,-10,1417,1482,-65,0,0,0,0,39,11,10,0.846154,0,1,9,6,false,false,false,0.126,0.874
252,269,-17,18,19.214286,-17,451,448,3,0,0,0,0,7,14,14,5.285714,0,0,8,7,false,false,false,0.419,0.581
226,332,-106,20.545455,33.2,-106,1003,1004,-1,0,1,0,0.1,26,11,10,1.346154,0,1,13,9,false,false,false,0,1
8,21,-13,8,21,-13,1245,1148,97,0,0,0,0,93,1,1,0.376344,0,0,20,20,false,false,false,0.277,0.723
16,0,16,16,0,16,1101,1130,-29,0,0,0,0,97,1,0,0.463918,0,0,7,0,false,false,true,0.562,0.438
140,135,5,20,19.285714,5,939,969,-30,0,0,0,0,46,7,7,0.717391,0,1,11,12,false,false,false,0.472,0.528
279,396,-117,17.4375,26.4,-117,1229,1220,9,0,1,0,0.066667,-2,16,15,-18.5,0,0,6,5,false,false,false,0,1
270,323,-53,12.272727,15.380952,-53,595,662,-67,0,1,0,0.047619,-28,22,21,-1.571429,0,0,1,9,false,false,false,0,1
331,384,-53,25.461538,32,-53,1770,1745,25,2,1,0.153846,0.083333,8,13,12,4.125,0,0,14,18,false,false,false,0,1
106,101,5,17.666667,16.833333,5,1334,1439,-105,1,0,0.166667,0,74,6,6,0.486486,0,0,10,15,false,false,false,0.268,0.732
266,290,-24,17.733333,19.333333,-24,518,461,57,0,0,0,0,-4,15,15,-9,0,1,7,6,false,false,false,0.098,0.902
297,392,-95,15.631579,21.777778,-95,889,895,-6,0,1,0,0.055556,-17,19,18,-2.176471,0,1,3,6,true,false,false,0,1
97,135,-38,9.7,15,-38,1045,1082,-37,0,0,0,0,41,10,9,1.097561,1,0,17,7,false,false,false,0.269,0.731
286,285,1,15.052632,15,1,361,413,-52,0,0,0,0,-27,19,19,-1.518519,0,0,3,2,false,false,true,0.925,0.075
85,94,-9,17,18.8,-9,603,721,-118,0,0,0,0,70,5,5,0.614286,0,1,14,9,false,false,false,0.216,0.784
224,192,32,24.888889,24,32,1344,1208,136,1,1,0.111111,0.125,39,9,8,0.769231,0,0,9,13,false,false,true,0.818,0.182
294,319,-25,17.294118,19.9375,-25,576,602,-26,0,0,0,0,-7,17,16,-6,0,0,8,5,false,false,false,0.015,0.985
32,51,-19,16,25.5,-19,344,315,29,0,0,0,0,81,2,2,0.493827,1,0,7,10,false,false,true,0.777,0.223
286,309,-23,19.066667,20.6,-23,1245,1148,97,0,0,0,0,-9,15,15,-3.888889,0,0,13,3,false,false,false,0.17,0.83
22,26,-4,11,26,-4,1101,1115,-14,0,0,0,0,94,2,1,0.319149,0,0,10,12,false,false,false,0.273,0.727
49,61,-12,16.333333,20.333333,-12,714,892,-178,0,0,0,0,78,3,3,0.538462,1,1,9,17,false,false,false,0.205,0.795
280,351,-71,14.736842,19.5,-71,1101,1130,-29,1,1,0.052632,0.055556,-9,19,18,-5,0,1,5,7,false,false,false,0,1
291,317,-26,12.125,13.208333,-26,796,800,-4,1,0,0.041667,0,-16,24,24,-3,0,0,12,3,true,false,false,0,1
238,227,11,19.833333,20.636364,11,758,904,-146,1,0,0.083333,0,11,12,11,3.090909,0,1,10,9,false,false,false,0.022,0.978
195,256,-61,24.375,32,-61,1388,1455,-67,0,0,0,0,31,8,8,0.903226,1,1,11,10,false,false,false,0.037,0.963
76,57,19,19,19,19,518,461,57,0,0,0,0,77,4,3,0.467532,0,0,10,21,false,false,true,0.663,0.337
86,56,30,14.333333,11.2,30,450,427,23,0,0,0,0,62,6,5,0.596774,0,2,15,11,false,false,false,0.311,0.689
127,142,-15,18.142857,23.666667,-15,1003,1018,-15,0,0,0,0,54,7,6,0.685185,0,0,13,15,false,false,false,0.26,0.74
32,89,-57,16,44.5,-57,1021,897,124,0,1,0,0.5,83,2,2,0.445783,0,0,16,16,false,false,false,0.275,0.725
219,238,-19,12.882353,14,-19,342,53,289,0,0,0,0,-15,17,17,-2.733333,0,0,10,9,false,false,false,0.187,0.813
194,207,-13,13.857143,15.923077,-13,995,965,30,0,0,0,0,16,14,13,2.5,1,0,18,7,false,false,true,0.52,0.48
0,0,0,0,0,0,980,965,15,0,0,0,0,100,1,0,0.38,0,0,9,0,false,false,true,0.555,0.445
224,256,-32,16,18.285714,-32,561,688,-127,0,0,0,0,18,14,14,2.555556,0,0,16,13,false,false,false,0.241,0.759
12,0,12,12,0,12,1075,1189,-114,0,0,0,0,96,1,0,0.416667,0,0,7,0,false,false,false,0.392,0.608
8,10,-2,8,10,-2,1278,1101,177,0,0,0,0,92,1,1,0.402174,0,0,17,10,false,false,false,0.488,0.512
24,12,12,12,12,12,1043,1003,40,0,0,0,0,88,2,1,0.431818,1,0,25,9,false,false,true,0.74,0.26
311,253,58,18.294118,15.8125,58,897,996,-99,0,0,0,0,-3,17,16,-13,0,0,7,16,false,false,true,1,0
69,112,-43,11.5,18.666667,-43,907,878,29,0,0,0,0,71,6,6,0.605634,0,0,8,11,false,false,false,0.275,0.725
236,370,-134,14.75,23.125,-134,450,427,23,1,1,0.0625,0.0625,-14,16,16,-2.642857,0,0,8,7,false,false,false,0,1
195,205,-10,17.727273,18.636364,-10,306,468,-162,0,0,0,0,33,11,11,1.121212,1,0,7,12,false,false,false,0.375,0.625
213,188,25,17.75,17.090909,25,1037,1009,28,0,0,0,0,32,12,11,1.375,1,1,7,7,false,false,false,0.387,0.613
250,286,-36,16.666667,19.066667,-36,822,845,-23,0,0,0,0,2,15,15,17.5,0,0,15,8,false,false,false,0.146,0.854
38,64,-26,12.666667,32,-26,1038,917,121,0,0,0,0,84,3,2,0.416667,0,1,7,6,false,false,false,0.063,0.937
178,215,-37,16.181818,19.545455,-37,1040,1364,-324,0,0,0,0,19,11,11,1.894737,0,0,23,11,false,false,false,0.014,0.986
210,248,-38,15,19.076923,-38,813,698,115,1,0,0.071429,0,21,14,13,2.285714,0,0,10,13,false,false,false,0.034,0.966
191,274,-83,15.916667,24.909091,-83,1003,1018,-15,0,0,0,0,17,12,11,2.176471,0,0,9,7,false,false,false,0.011,0.989
310,314,-4,20.666667,22.428571,-4,1428,1361,67,0,0,0,0,-2,15,14,-16.5,1,0,9,10,false,false,false,0.351,0.649
284,393,-109,14.2,20.684211,-109,595,733,-138,1,1,0.05,0.052632,-26,20,19,-1.5,0,1,20,2,true,false,false,0,1
56,60,-4,18.666667,20,-4,1493,1413,80,0,0,0,0,81,3,3,0.444444,1,0,22,11,false,false,true,0.647,0.353
248,228,20,24.8,22.8,20,1397,1405,-8,1,0,0.1,0,22,10,10,1.318182,1,1,10,10,false,false,true,0.566,0.434
269,371,-102,24.454545,33.727273,-102,1415,1361,54,0,1,0,0.090909,16,11,11,1.9375,0,0,10,18,false,false,false,0,1
293,425,-132,20.928571,30.357143,-132,1636,1702,-66,0,1,0,0.071429,-6,14,14,-4.833333,0,0,5,8,false,false,false,0,1
12,0,12,12,0,12,683,859,-176,0,0,0,0,96,1,0,0.46875,0,0,9,0,false,false,false,0.211,0.789
129,133,-4,21.5,26.6,-4,1227,1189,38,0,0,0,0,56,6,5,0.625,0,0,11,17,false,false,false,0.27,0.73
72,80,-8,24,40,-8,1164,1161,3,0,1,0,0.5,76,3,2,0.302632,0,0,7,24,false,false,false,0.273,0.727
273,351,-78,15.166667,19.5,-78,1101,1130,-29,1,1,0.055556,0.055556,-6,18,18,-7.5,0,1,8,7,false,false,false,0,1
182,180,2,18.2,18,2,1043,1003,40,0,0,0,0,32,10,10,1.1875,0,0,20,15,false,false,true,0.54,0.46
274,324,-50,16.117647,19.058824,-50,500,509,-9,0,0,0,0,-8,17,17,-5.125,0,1,8,6,false,false,false,0,1
327,367,-40,19.235294,22.9375,-40,1164,1261,-97,0,1,0,0.0625,-5,17,16,-8.4,0,0,9,7,false,false,false,0,1
31,6,25,15.5,6,25,874,868,6,0,0,0,0,90,2,1,0.366667,1,0,21,12,false,false,true,0.801,0.199
151,161,-10,15.1,16.1,-10,1000,960,40,0,0,0,0,33,10,10,1.363636,0,0,11,19,false,false,true,0.512,0.488
151,204,-53,16.777778,22.666667,-53,1270,1424,-154,0,1,0,0.111111,46,9,9,0.76087,0,1,14,9,false,false,false,0.072,0.928
228,352,-124,19,29.333333,-124,1232,1448,-216,0,2,0,0.166667,14,12,12,2.5,0,0,14,12,false,false,false,0,1
127,153,-26,21.166667,25.5,-26,1439,1314,125,0,0,0,0,57,6,6,0.491228,0,0,22,11,false,false,false,0.406,0.594
281,372,-91,15.611111,21.882353,-91,952,826,126,0,1,0,0.058824,-2,18,17,-21.5,0,0,12,7,false,false,false,0,1
156,90,66,31.2,22.5,66,1397,1405,-8,1,0,0.2,0,59,5,4,0.491525,0,0,12,19,false,false,true,0.789,0.211
304,340,-36,25.333333,28.333333,-36,691,695,-4,1,0,0.083333,0,7,12,12,4.571429,0,0,7,7,false,false,false,0.004,0.996
240,345,-105,16,24.642857,-105,563,523,40,0,0,0,0,1,15,14,37,0,0,10,17,false,false,false,0,1
367,339,28,33.363636,33.9,28,1699,1580,119,3,1,0.272727,0.1,16,11,10,1.875,0,1,17,6,false,false,false,0.496,0.504
224,280,-56,17.230769,21.538462,-56,725,668,57,0,0,0,0,15,13,13,2.333333,0,0,7,8,false,false,false,0.076,0.924
72,20,52,24,10,52,1070,814,256,0,0,0,0,85,3,2,0.388235,0,0,9,8,false,false,true,0.784,0.216
100,163,-63,16.666667,27.166667,-63,1488,1403,85,0,1,0,0.166667,57,6,6,0.596491,0,0,18,8,false,false,false,0.268,0.732
242,265,-23,20.166667,24.090909,-23,1428,1361,67,0,0,0,0,15,12,11,2.2,1,0,8,9,false,false,false,0.092,0.908
255,325,-70,23.181818,29.545455,-70,1422,1798,-376,0,2,0,0.181818,19,11,11,1.684211,0,0,7,21,false,false,false,0,1
63,83,-20,12.6,20.75,-20,913,1037,-124,0,1,0,0.25,80,5,4,0.5125,0,0,22,8,false,false,false,0.157,0.843
70,92,-22,17.5,30.666667,-22,1182,1075,107,0,1,0,0.333333,72,4,3,0.541667,0,0,14,7,false,false,false,0.271,0.729
147,142,5,24.5,28.4,5,576,602,-26,0,0,0,0,62,6,5,0.677419,0,0,8,10,false,false,false,0.249,0.751
162,197,-35,18,21.888889,-35,758,791,-33,0,0,0,0,36,9,9,1.083333,0,0,11,12,false,false,false,0.147,0.853
26,57,-31,13,28.5,-31,1331,1347,-16,0,0,0,0,82,2,2,0.390244,1,0,6,26,false,false,false,0.285,0.715
176,203,-27,22,29,-27,1173,1256,-83,1,0,0.125,0,47,8,7,0.659574,1,1,8,6,false,false,false,0.012,0.988
282,239,43,23.5,19.916667,43,1331,1374,-43,0,0,0,0,9,12,12,3.666667,0,0,23,7,false,false,true,0.874,0.126
296,344,-48,17.411765,21.5,-48,694,658,36,0,1,0,0.0625,-7,17,16,-5.285714,0,0,6,2,false,false,false,0.014,0.986
216,338,-122,14.4,24.142857,-122,1003,1018,-15,0,0,0,0,-12,15,14,-3.083333,0,0,10,9,false,false,false,0,1
54,106,-52,10.8,21.2,-52,948,998,-50,0,0,0,0,63,5,5,0.587302,1,1,14,9,false,false,false,0.229,0.771
115,137,-22,16.428571,19.571429,-22,402,448,-46,0,0,0,0,54,7,7,0.685185,0,1,10,14,false,false,false,0.052,0.948
272,290,-18,17,19.333333,-18,907,1070,-163,0,0,0,0,8,16,15,4.375,0,1,7,12,false,false,false,0.004,0.996
265,282,-17,24.090909,28.2,-17,1188,1334,-146,1,1,0.090909,0.1,16,11,10,1.875,1,0,7,13,false,false,false,0.239,0.761
291,313,-22,20.785714,22.357143,-22,1652,1473,179,1,1,0.071429,0.071429,-4,14,14,-7.5,0,0,8,4,false,false,false,0.043,0.957
333,347,-14,14.478261,15.086957,-14,430,542,-112,0,1,0,0.043478,-33,23,23,-1.454545,0,0,1,1,false,false,false,0.044,0.956
175,102,73,35,20.4,73,1777,1689,88,1,0,0.2,0,53,5,5,0.509434,0,0,22,8,false,false,true,0.792,0.208
293,419,-126,14.65,22.052632,-126,530,683,-153,0,1,0,0.052632,-15,20,19,-2.666667,0,0,3,3,false,false,false,0,1
18,0,18,18,0,18,1220,1185,35,0,0,0,0,95,1,0,0.494737,0,0,19,0,false,false,true,0.568,0.432
317,273,44,31.7,30.333333,44,1167,1245,-78,2,0,0.2,0,6,10,9,3.833333,0,1,14,17,false,false,true,0.578,0.422
214,263,-49,16.461538,21.916667,-49,805,918,-113,0,0,0,0,9,13,12,4,0,1,10,20,false,false,false,0,1
156,136,20,15.6,15.111111,20,1030,998,32,0,0,0,0,34,10,9,1.088235,0,0,8,8,false,false,false,0.477,0.523
283,307,-24,21.769231,23.615385,-24,1407,1473,-66,1,2,0.076923,0.153846,0,13,13,0,0,0,26,15,false,false,false,0.012,0.988
285,300,-15,21.923077,23.076923,-15,1341,1606,-265,1,0,0.076923,0,1,13,13,33,0,0,21,9,false,false,false,0,1
132,141,-9,22,23.5,-9,689,804,-115,0,0,0,0,51,6,6,0.686275,0,0,15,23,false,false,false,0.13,0.87
16,0,16,16,0,16,732,868,-136,0,0,0,0,97,1,0,0.329897,0,0,9,0,false,false,false,0.212,0.788
28,0,28,28,0,28,1093,1173,-80,0,0,0,0,96,1,0,0.447917,0,0,22,0,false,false,true,0.695,0.305
261,284,-23,15.352941,16.705882,-23,595,538,57,0,0,0,0,-9,17,17,-4.222222,0,0,4,3,false,false,false,0.161,0.839
415,501,-86,27.666667,35.785714,-86,1699,1580,119,3,2,0.2,0.142857,-11,15,14,-2.727273,0,0,1,1,false,false,false,0,1
238,165,73,26.444444,20.625,73,804,1074,-270,0,0,0,0,36,9,8,0.888889,0,1,9,9,false,false,true,0.604,0.396
255,326,-71,25.5,36.222222,-71,1415,1361,54,0,1,0,0.111111,25,10,9,1.24,0,0,10,14,false,false,false,0.02,0.98
256,327,-71,15.058824,19.235294,-71,95,453,-358,0,0,0,0,-10,17,17,-3.9,0,0,3,4,false,false,false,0,1
203,254,-51,16.916667,23.090909,-51,795,786,9,1,0,0.083333,0,28,12,11,1.357143,0,0,18,14,false,false,false,0.014,0.986
69,114,-45,13.8,22.8,-45,1094,1159,-65,0,0,0,0,62,5,5,0.612903,0,0,16,15,false,false,false,0.215,0.785
96,113,-17,16,18.833333,-17,1691,1510,181,0,0,0,0,58,6,6,0.517241,0,0,19,13,false,false,false,0.345,0.655
158,189,-31,17.555556,21,-31,1417,1482,-65,0,0,0,0,46,9,9,0.717391,0,1,16,6,false,false,false,0.201,0.799
118,152,-34,19.666667,30.4,-34,1167,1245,-78,0,0,0,0,50,6,5,0.46,0,0,11,10,false,false,false,0.239,0.761
26,18,8,13,18,8,2143,2219,-76,0,0,0,0,89,2,1,0.348315,0,1,8,21,false,false,false,0.271,0.729
219,219,0,24.333333,27.375,0,801,679,122,1,0,0.111111,0,27,9,8,1.074074,1,0,17,12,false,false,true,0.61,0.39
283,283,0,28.3,31.444444,0,1047,1127,-80,0,1,0,0.111111,17,10,9,1.588235,0,0,11,14,false,false,false,0.346,0.654
276,312,-36,16.235294,18.352941,-36,360,371,-11,0,0,0,0,-24,17,17,-1.541667,0,0,2,1,false,false,false,0.068,0.932
62,34,28,20.666667,17,28,653,820,-167,0,0,0,0,76,3,2,0.5,0,0,7,26,false,false,false,0.227,0.773
251,291,-40,13.210526,16.166667,-40,526,502,24,0,0,0,0,-8,19,18,-6.25,1,0,17,17,false,false,false,0.003,0.997
229,279,-50,28.625,34.875,-50,1086,926,160,0,1,0,0.125,32,8,8,0.875,0,0,9,8,false,false,false,0.031,0.969
131,180,-49,26.2,36,-49,724,398,326,1,1,0.2,0.2,62,5,5,0.629032,0,0,23,12,false,false,false,0.152,0.848
124,138,-14,17.714286,19.714286,-14,1232,1448,-216,0,0,0,0,53,7,7,0.660377,0,0,13,7,false,false,false,0.112,0.888
302,295,7,27.454545,29.5,7,1047,1127,-80,0,1,0,0.1,11,11,10,2.454545,0,0,10,14,false,false,false,0.406,0.594
219,315,-96,15.642857,22.5,-96,480,739,-259,0,0,0,0,13,14,14,3,1,0,6,19,false,false,false,0.001,0.999
52,61,-9,13,15.25,-9,805,918,-113,0,0,0,0,70,4,4,0.514286,0,1,32,8,false,false,false,0.23,0.77
76,82,-6,15.2,16.4,-6,999,1071,-72,0,0,0,0,64,5,5,0.625,1,0,9,9,false,false,true,0.561,0.439
113,119,-6,18.833333,19.833333,-6,1493,1413,80,0,0,0,0,61,6,6,0.590164,0,0,23,17,false,false,false,0.39,0.61
290,301,-11,20.714286,23.153846,-11,1237,1265,-28,1,0,0.071429,0,-3,14,13,-12,0,0,7,13,false,false,false,0.05,0.95
97,116,-19,16.166667,23.2,-19,599,448,151,0,0,0,0,59,6,5,0.610169,0,0,8,10,false,false,false,0.478,0.522
79,128,-49,13.166667,21.333333,-49,1580,1629,-49,0,0,0,0,60,6,6,0.616667,0,0,14,10,false,false,false,0.269,0.731
80,109,-29,20,27.25,-29,1407,1473,-66,0,1,0,0.25,71,4,4,0.43662,0,0,13,12,false,false,false,0.272,0.728
254,306,-52,21.166667,27.818182,-52,1126,1277,-151,0,0,0,0,3,12,11,11.666667,0,0,7,31,false,false,false,0,1
193,276,-83,21.444444,34.5,-83,1633,1680,-47,0,1,0,0.125,25,9,8,1.12,0,0,18,16,false,false,false,0,1
198,247,-49,16.5,22.454545,-49,889,895,-6,0,1,0,0.090909,21,12,11,1.761905,0,1,11,22,false,false,false,0.018,0.982
65,105,-40,21.666667,35,-40,503,527,-24,0,1,0,0.333333,72,3,3,0.458333,0,0,9,19,false,false,false,0.278,0.722
18,0,18,18,0,18,1777,1689,88,0,0,0,0,96,1,0,0.28125,0,0,10,0,false,false,true,0.583,0.417
242,277,-35,17.285714,19.785714,-35,822,845,-23,0,0,0,0,10,14,14,3.5,0,0,10,9,false,false,false,0.092,0.908
196,239,-43,16.333333,19.916667,-43,803,786,17,0,0,0,0,22,12,12,1.454545,1,0,8,10,false,false,false,0.275,0.725
203,233,-30,18.454545,23.3,-30,804,1080,-276,0,0,0,0,28,11,10,1.214286,1,0,9,15,false,false,false,0.074,0.926
206,170,36,25.75,24.285714,36,1495,1597,-102,0,0,0,0,45,8,7,0.711111,0,1,7,7,false,false,true,0.505,0.495
336,372,-36,16.8,19.578947,-36,1473,1500,-27,1,2,0.05,0.105263,-31,20,19,-1.258065,0,0,1,1,true,false,false,0,1
30,36,-6,15,18,-6,1488,1403,85,0,0,0,0,87,2,2,0.390805,0,1,17,11,false,false,false,0.291,0.709
120,101,19,30,25.25,19,1770,1745,25,1,0,0.25,0,74,4,4,0.445946,0,0,9,19,false,false,true,0.577,0.423
21,30,-9,10.5,15,-9,1561,1495,66,0,0,0,0,86,2,2,0.383721,1,0,8,20,false,false,false,0.346,0.654
164,231,-67,16.4,23.1,-67,1633,1620,13,0,0,0,0,30,10,10,1.2,0,0,7,10,false,false,false,0.032,0.968
118,174,-56,16.857143,29,-56,1572,1777,-205,0,1,0,0.166667,46,7,6,0.717391,0,1,8,13,false,false,false,0.076,0.924
218,399,-181,15.571429,28.5,-181,1484,1556,-72,0,2,0,0.142857,-6,14,14,-5.166667,1,0,15,3,false,false,false,0,1
111,103,8,22.2,20.6,8,1428,1361,67,0,0,0,0,62,5,5,0.532258,0,1,16,15,false,false,false,0.314,0.686
63,92,-29,12.6,23,-29,668,771,-103,0,0,0,0,68,5,4,0.588235,0,0,22,18,false,false,false,0.072,0.928
164,269,-105,14.909091,24.454545,-105,944,1095,-151,0,1,0,0.090909,33,11,11,1.181818,0,1,7,7,false,false,false,0,1
268,218,50,26.8,24.222222,50,1373,1334,39,1,1,0.1,0.111111,31,10,9,1.032258,0,0,16,19,false,false,true,0.937,0.063
360,362,-2,25.714286,27.846154,-2,1047,1127,-80,0,1,0,0.076923,-11,14,13,-2.454545,0,0,9,6,true,false,false,0.443,0.557
221,386,-165,11.631579,21.444444,-165,948,998,-50,0,0,0,0,-22,19,18,-1.681818,0,0,2,1,true,false,false,0,1
340,336,4,21.25,22.4,4,1428,1361,67,0,0,0,0,-12,16,15,-2.75,1,0,1,1,false,false,true,0.978,0.022
177,348,-171,14.75,29,-171,1399,1210,189,0,1,0,0.083333,22,12,12,1.590909,0,0,18,8,false,false,false,0,1
14,0,14,14,0,14,1167,1245,-78,0,0,0,0,96,1,0,0.239583,0,0,11,0,false,false,true,0.557,0.443
177,112,65,25.285714,18.666667,65,1156,1279,-123,1,0,0.142857,0,53,7,6,0.754717,1,0,7,13,false,false,true,0.793,0.207
123,145,-22,20.5,24.166667,-22,1484,1556,-72,0,1,0,0.166667,50,6,6,0.62,1,0,14,9,false,false,true,0.534,0.466
105,144,-39,13.125,20.571429,-39,500,509,-9,0,0,0,0,49,8,7,0.836735,1,0,9,10,false,false,false,0.294,0.706
215,210,5,26.875,30,5,1770,1751,19,0,1,0,0.142857,36,8,7,0.805556,0,0,14,19,false,false,false,0.272,0.728
210,285,-75,12.352941,16.764706,-75,595,540,55,0,0,0,0,-4,17,17,-10.75,0,0,11,15,false,false,false,0,1
314,362,-48,19.625,24.133333,-48,700,820,-120,0,1,0,0.066667,-9,16,15,-4.222222,1,0,14,11,false,false,false,0.002,0.998
211,295,-84,19.181818,26.818182,-84,1127,995,132,0,1,0,0.090909,21,11,11,1.571429,0,0,11,13,false,false,false,0.027,0.973
278,339,-61,18.533333,22.6,-61,1055,1019,36,0,0,0,0,-15,15,15,-2.2,1,0,3,1,false,false,false,0.033,0.967
181,322,-141,13.923077,26.833333,-141,710,758,-48,0,1,0,0.083333,25,13,12,1.48,0,0,9,11,false,false,false,0,1
189,196,-7,14.538462,16.333333,-7,913,1037,-124,0,1,0,0.083333,32,13,12,1.28125,0,0,19,15,false,false,false,0.298,0.702
281,364,-83,10.035714,13,-83,651,700,-49,0,0,0,0,-49,28,28,-1.142857,0,0,14,9,true,false,false,0.001,0.999
63,47,16,21,15.666667,16,1652,1473,179,0,0,0,0,76,3,3,0.394737,0,0,18,10,false,false,true,0.528,0.472
219,210,9,21.9,21,9,1493,1413,80,0,0,0,0,31,10,10,1.16129,0,1,10,10,false,false,false,0.268,0.732
186,226,-40,16.909091,20.545455,-40,450,624,-174,0,0,0,0,19,11,11,1.736842,0,0,18,9,false,false,false,0.078,0.922
38,14,24,19,14,24,785,892,-107,0,0,0,0,89,2,1,0.41573,1,0,10,11,false,false,false,0.251,0.749
135,151,-16,16.875,21.571429,-16,1484,1556,-72,0,1,0,0.142857,40,8,7,0.775,1,0,12,9,false,false,false,0.304,0.696
46,26,20,15.333333,13,20,1040,1364,-324,0,0,0,0,81,3,2,0.444444,0,0,13,12,false,false,false,0.216,0.784
247,314,-67,12.35,16.526316,-67,651,700,-49,0,0,0,0,-17,20,19,-3.294118,0,1,12,10,false,false,false,0,1
379,468,-89,31.583333,39,-89,2010,2219,-209,1,2,0.083333,0.166667,-5,12,12,-5.2,0,0,7,1,false,false,false,0,1
86,93,-7,17.2,18.6,-7,742,868,-126,0,0,0,0,64,5,5,0.515625,0,0,17,14,false,false,false,0.192,0.808
37,63,-26,18.5,31.5,-26,1167,1245,-78,0,0,0,0,84,2,2,0.27381,0,0,9,21,false,false,false,0.161,0.839
165,91,74,27.5,18.2,74,1156,1279,-123,1,0,0.166667,0,58,6,5,0.689655,1,0,6,17,false,false,true,0.789,0.211
332,430,-98,22.133333,28.666667,-98,1537,1539,-2,0,1,0,0.066667,-11,15,15,-3.090909,0,1,5,5,false,false,false,0,1
20,0,20,20,0,20,452,698,-246,0,0,0,0,96,1,0,0.427083,0,0,31,0,false,false,false,0.337,0.663
213,284,-71,14.2,20.285714,-71,714,892,-178,0,2,0,0.142857,5,15,14,8.4,0,0,14,7,false,false,false,0,1
237,299,-62,11.85,15.736842,-62,683,859,-176,0,0,0,0,2,20,19,22.5,0,0,9,17,false,false,false,0,1
285,357,-72,19,23.8,-72,1131,1030,101,0,0,0,0,-7,15,15,-4.285714,0,0,2,2,true,false,false,0,1
294,359,-65,18.375,22.4375,-65,1397,1309,88,2,0,0.125,0,-2,16,16,-18,0,0,5,9,false,false,false,0,1
20,13,7,20,13,7,651,700,-49,0,0,0,0,93,1,1,0.602151,0,0,14,15,false,false,false,0.271,0.729
285,312,-27,12.954545,14.857143,-27,999,1165,-166,0,0,0,0,-17,22,21,-2.705882,1,1,17,6,false,false,false,0.002,0.998
90,100,-10,15,16.666667,-10,542,605,-63,0,0,0,0,56,6,6,0.642857,0,0,12,28,false,false,false,0.186,0.814
67,92,-25,13.4,18.4,-25,1257,1176,81,0,0,0,0,75,5,5,0.453333,0,0,8,10,false,false,false,0.275,0.725
87,102,-15,14.5,17,-15,1344,1314,30,0,1,0,0.166667,59,6,6,0.576271,0,0,11,9,false,false,false,0.278,0.722
322,369,-47,20.125,23.0625,-47,1266,1339,-73,0,1,0,0.0625,-4,16,16,-8.75,0,0,2,2,false,false,false,0.009,0.991
267,299,-32,15.705882,17.588235,-32,450,503,-53,0,0,0,0,-11,17,17,-3.545455,0,0,14,7,false,false,false,0.001,0.999
168,155,13,15.272727,14.090909,13,1030,998,32,0,0,0,0,30,11,11,1.233333,0,0,9,15,false,false,true,0.74,0.26
79,63,16,15.8,15.75,16,758,791,-33,0,0,0,0,67,5,4,0.58209,0,0,24,10,false,false,true,0.557,0.443
205,219,-14,22.777778,27.375,-14,1388,1366,22,0,1,0,0.125,33,9,8,0.969697,0,0,11,19,false,false,false,0.259,0.741
247,357,-110,14.529412,22.3125,-110,342,263,79,0,0,0,0,-24,17,16,-1.416667,1,0,1,1,false,false,false,0,1
125,123,2,12.5,13.666667,2,999,1071,-72,0,0,0,0,38,10,9,1.052632,1,0,15,15,false,false,false,0.247,0.753
222,285,-63,11.1,15,-63,595,540,55,0,0,0,0,-10,20,19,-4.3,0,0,7,15,false,false,false,0,1
260,284,-24,13.684211,15.777778,-24,500,532,-32,0,0,0,0,-20,19,18,-2.05,0,2,16,3,false,false,false,0.01,0.99
148,125,23,21.142857,20.833333,23,985,1062,-77,0,0,0,0,51,7,6,0.72549,0,0,7,13,false,false,false,0.357,0.643
41,96,-55,20.5,48,-55,1422,1798,-376,0,1,0,0.5,82,2,2,0.390244,1,0,8,12,false,false,false,0.126,0.874
148,302,-154,21.142857,43.142857,-154,1556,1656,-100,0,2,0,0.285714,35,7,7,0.857143,0,0,12,18,false,false,false,0,1
25,15,10,12.5,15,10,278,1,277,0,0,0,0,87,2,1,0.425287,0,0,12,7,false,false,true,0.745,0.255
181,203,-22,25.857143,33.833333,-22,1793,1957,-164,0,0,0,0,49,7,6,0.591837,0,1,7,11,false,false,false,0.028,0.972
324,357,-33,19.058824,22.3125,-33,917,856,61,1,1,0.058824,0.0625,-9,17,16,-3.666667,0,0,1,2,true,false,false,0.121,0.879
130,178,-48,21.666667,29.666667,-48,964,1003,-39,0,1,0,0.166667,58,6,6,0.672414,0,0,8,9,false,false,false,0.266,0.734
231,232,-1,17.769231,19.333333,-1,907,1070,-163,0,0,0,0,21,13,12,1.666667,0,1,11,18,false,false,false,0.139,0.861
125,200,-75,13.888889,22.222222,-75,388,542,-154,0,0,0,0,32,9,9,1.15625,0,0,10,17,false,false,false,0.022,0.978
300,288,12,20,20.571429,12,1094,1041,53,1,0,0.066667,0,-2,15,14,-19,0,0,16,7,false,false,true,0.524,0.476
243,248,-5,22.090909,22.545455,-5,1488,1428,60,1,0,0.090909,0,26,11,11,1.423077,0,1,11,7,false,false,false,0.222,0.778
142,185,-43,14.2,18.5,-43,568,570,-2,0,0,0,0,36,10,10,1.027778,0,0,10,17,false,false,false,0.147,0.853
121,192,-71,15.125,24,-71,642,952,-310,0,0,0,0,47,8,8,0.93617,0,1,11,14,false,false,false,0,1
170,240,-70,12.142857,17.142857,-70,226,361,-135,0,0,0,0,1,14,14,44,0,0,8,11,false,false,false,0.012,0.988
162,270,-108,14.727273,24.545455,-108,542,605,-63,0,0,0,0,25,11,11,1.44,0,0,10,10,false,false,false,0.001,0.999
114,165,-51,11.4,18.333333,-51,226,361,-135,0,0,0,0,35,10,9,1.257143,0,0,7,11,false,false,false,0.055,0.945
72,65,7,18,16.25,7,848,976,-128,0,0,0,0,74,4,4,0.540541,0,0,7,15,false,false,false,0.211,0.789
278,328,-50,18.533333,23.428571,-50,694,658,36,0,1,0,0.071429,5,15,14,7.4,0,0,14,9,false,false,false,0.008,0.992
145,150,-5,29,37.5,-5,820,718,102,0,2,0,0.5,59,5,4,0.474576,0,0,9,19,false,false,true,0.554,0.446
100,109,-9,16.666667,21.8,-9,1248,1220,28,0,1,0,0.2,65,6,5,0.8,0,0,8,22,false,false,false,0.273,0.727
306,334,-28,21.857143,25.692308,-28,1021,897,124,0,2,0,0.153846,-5,14,13,-7.4,0,0,13,10,false,false,false,0.045,0.955
218,213,5,19.818182,21.3,5,566,742,-176,0,1,0,0.1,21,11,10,1.52381,0,0,14,10,false,false,true,0.525,0.475
0,82,-82,0,82,-82,1354,1210,144,0,1,0,1,93,1,1,0.354839,0,0,17,18,false,false,false,0,1
253,280,-27,19.461538,23.333333,-27,976,995,-19,1,1,0.076923,0.083333,15,13,12,2.533333,0,0,12,17,false,false,false,0.116,0.884
10,23,-13,10,23,-13,480,739,-259,0,0,0,0,91,1,1,0.428571,0,0,8,15,false,false,false,0.21,0.79
300,346,-46,23.076923,26.615385,-46,1556,1513,43,0,0,0,0,1,13,13,31,0,0,11,4,false,false,false,0.006,0.994
115,132,-17,14.375,16.5,-17,1064,1397,-333,0,1,0,0.125,64,8,8,0.671875,1,0,13,7,false,false,false,0.364,0.636
125,123,2,20.833333,20.5,2,758,904,-146,1,0,0.166667,0,55,6,6,0.618182,0,0,19,9,false,false,false,0.244,0.756
221,298,-77,15.785714,22.923077,-77,711,746,-35,0,0,0,0,12,14,13,3.166667,0,0,9,17,false,false,false,0,1
285,305,-20,15,16.944444,-20,450,503,-53,0,0,0,0,-19,19,18,-2.052632,0,0,3,3,false,false,false,0.03,0.97
346,344,2,21.625,21.5,2,1563,1539,24,0,1,0,0.0625,-20,16,16,-1.75,0,0,1,2,false,false,false,0.151,0.849
361,395,-34,30.083333,32.916667,-34,1761,1770,-9,1,1,0.083333,0.083333,-8,12,12,-3.25,0,0,2,2,false,false,true,0.647,0.353
26,70,-44,8.666667,23.333333,-44,1580,1629,-49,0,0,0,0,81,3,3,0.45679,0,0,17,13,false,false,false,0.271,0.729
85,58,27,28.333333,29,27,1281,1268,13,0,0,0,0,78,3,2,0.538462,0,0,11,11,false,false,true,0.516,0.484
346,335,11,23.066667,23.928571,11,1563,1539,24,0,1,0,0.071429,-13,15,14,-2.692308,0,0,1,4,false,false,false,0.097,0.903
191,193,-2,19.1,21.444444,-2,985,1062,-77,0,0,0,0,31,10,9,1.193548,0,0,7,21,false,false,false,0.073,0.927
241,263,-22,18.538462,21.916667,-22,1055,840,215,0,1,0,0.083333,13,13,12,2.769231,1,0,9,20,false,false,false,0.092,0.908
323,363,-40,19,22.6875,-40,1452,1388,64,0,1,0,0.0625,-11,17,16,-3.181818,0,0,6,1,false,false,false,0.001,0.999
202,263,-61,16.833333,21.916667,-61,805,918,-113,0,0,0,0,13,12,12,2.769231,0,1,10,20,false,false,false,0,1
235,265,-30,11.75,13.947368,-30,808,749,59,0,0,0,0,-25,20,19,-1.68,0,0,5,6,false,false,false,0.003,0.997
93,142,-49,23.25,35.5,-49,1399,1210,189,0,1,0,0.25,66,4,4,0.530303,0,1,8,28,false,false,false,0.05,0.95
87,77,10,21.75,25.666667,10,965,1078,-113,0,0,0,0,74,4,3,0.5,0,0,8,20,false,false,false,0.102,0.898
251,377,-126,17.928571,29,-126,1656,1649,7,0,0,0,0,3,14,13,10.666667,0,0,11,9,false,false,false,0,1
82,88,-6,16.4,17.6,-6,797,796,1,0,0,0,0,73,5,5,0.671233,0,0,10,13,false,false,false,0.379,0.621
316,402,-86,17.555556,22.333333,-86,710,758,-48,1,1,0.055556,0.055556,-18,18,18,-2.055556,0,0,10,5,false,false,false,0,1
289,294,-5,13.761905,14.7,-5,361,413,-52,0,0,0,0,-32,21,20,-1.28125,0,0,2,2,true,false,false,0.143,0.857
93,119,-26,11.625,17,-26,1045,1082,-37,0,0,0,0,55,8,7,0.818182,1,0,17,8,false,false,false,0.287,0.713
276,346,-70,18.4,23.066667,-70,721,757,-36,0,2,0,0.133333,0,15,15,0,0,0,13,10,false,false,false,0,1
330,290,40,30,29,40,820,718,102,0,2,0,0.2,11,11,10,2.545455,0,0,13,7,false,false,true,0.884,0.116
259,269,-10,18.5,20.692308,-10,952,870,82,0,0,0,0,6,14,13,6.166667,0,0,13,21,false,false,false,0.233,0.767
247,319,-72,15.4375,21.266667,-72,1037,1016,21,1,0,0.0625,0,16,16,15,3.625,1,0,15,8,false,false,false,0.003,0.997
83,71,12,13.833333,14.2,12,163,346,-183,0,0,0,0,58,6,5,0.672414,0,1,9,8,false,false,false,0.048,0.952
242,284,-42,30.25,35.5,-42,1699,1580,119,2,1,0.25,0.125,33,8,8,0.909091,0,0,10,17,false,false,false,0.041,0.959
121,176,-55,12.1,17.6,-55,668,363,305,0,0,0,0,39,10,10,1.205128,0,0,18,14,false,false,false,0.135,0.865
41,36,5,13.666667,18,5,1488,1403,85,0,0,0,0,85,3,2,0.4,0,1,18,11,false,false,false,0.274,0.726
238,419,-181,19.833333,38.090909,-181,1219,1216,3,1,4,0.083333,0.363636,-5,12,11,-5.4,0,0,8,13,false,false,false,0,1
90,45,45,18,11.25,45,1188,1334,-146,0,0,0,0,70,5,4,0.428571,0,0,9,7,false,false,false,0.36,0.64
206,244,-38,17.166667,22.181818,-38,758,791,-33,0,0,0,0,19,12,11,2.052632,0,0,11,23,false,false,false,0.021,0.979
309,445,-136,22.071429,34.230769,-136,786,848,-62,0,2,0,0.153846,2,14,13,15.5,0,0,6,9,false,false,false,0,1
261,264,-3,12.428571,13.2,-3,306,302,4,0,0,0,0,-28,21,20,-1.464286,0,0,3,1,true,false,true,0.675,0.325
291,322,-31,18.1875,20.125,-31,356,498,-142,0,1,0,0.0625,-8,16,16,-4.375,0,0,10,5,false,false,false,0.128,0.872
277,337,-60,23.083333,28.083333,-60,801,679,122,1,0,0.083333,0,1,12,12,29,1,0,12,14,false,false,false,0.088,0.912
192,252,-60,16,22.909091,-60,1493,1453,40,0,0,0,0,22,12,11,1.590909,0,0,14,8,false,false,false,0.031,0.969
270,261,9,19.285714,18.642857,9,824,830,-6,1,0,0.071429,0,15,14,14,2.933333,0,0,7,20,false,false,false,0.468,0.532
39,49,-10,9.75,16.333333,-10,1101,1130,-29,0,0,0,0,78,4,3,0.576923,0,1,14,9,false,false,false,0.271,0.729
119,197,-78,13.222222,21.888889,-78,948,998,-50,0,0,0,0,36,9,9,1.027778,1,0,7,20,false,false,false,0.009,0.991
79,114,-35,13.166667,19,-35,668,771,-103,0,0,0,0,59,6,6,0.677966,0,0,21,20,false,false,false,0.073,0.927
135,216,-81,16.875,30.857143,-81,1656,1649,7,0,0,0,0,42,8,7,0.761905,0,0,19,10,false,false,false,0.029,0.971
10,79,-69,2.5,19.75,-69,907,878,29,0,0,0,0,83,4,4,0.518072,0,0,20,21,false,false,false,0.205,0.795
24,27,-3,24,27,-3,842,926,-84,0,0,0,0,89,1,1,0.337079,0,0,17,17,false,false,false,0.297,0.703
230,293,-63,13.529412,17.235294,-63,683,859,-176,0,0,0,0,7,17,17,6.428571,0,0,10,17,false,false,false,0,1
177,141,36,16.090909,12.818182,36,1040,1091,-51,0,0,0,0,31,11,11,1.516129,0,1,12,20,false,false,false,0.412,0.588
294,297,-3,24.5,24.75,-3,1563,1539,24,0,1,0,0.083333,8,12,12,4.375,0,0,11,11,false,false,false,0.277,0.723
217,243,-26,21.7,24.3,-26,1691,1551,140,0,0,0,0,33,10,10,1.121212,1,0,6,11,false,false,false,0.18,0.82
286,290,-4,19.066667,19.333333,-4,540,498,42,1,0,0.066667,0,-2,15,15,-23,0,0,10,16,false,false,false,0.362,0.638
297,381,-84,24.75,31.75,-84,1086,926,160,0,2,0,0.166667,-2,12,12,-14,0,0,11,3,false,false,false,0.002,0.998
280,383,-103,15.555556,21.277778,-103,1195,1397,-202,0,2,0,0.111111,-12,18,18,-3.333333,0,1,6,4,false,false,false,0,1
42,22,20,14,11,20,391,542,-151,0,0,0,0,83,3,2,0.554217,0,1,7,9,false,false,false,0.201,0.799
144,266,-122,14.4,26.6,-122,342,263,79,0,0,0,0,25,10,10,1.36,0,0,8,12,false,false,false,0.051,0.949
299,345,-46,14.95,18.157895,-46,344,315,29,1,1,0.05,0.052632,-36,20,19,-1.111111,0,0,1,3,false,false,false,0,1
85,156,-71,10.625,22.285714,-71,651,996,-345,0,1,0,0.142857,46,8,7,0.978261,0,1,12,11,false,false,false,0.062,0.938
288,321,-33,16.941176,18.882353,-33,1161,1030,131,0,1,0,0.058824,-19,17,17,-2,0,0,4,1,false,false,false,0.059,0.941
222,191,31,22.2,21.222222,31,1197,1156,41,0,1,0,0.111111,33,10,9,1.060606,0,0,12,11,false,false,true,0.671,0.329
226,270,-44,15.066667,18,-44,500,532,-32,0,0,0,0,-2,15,15,-20.5,0,2,28,5,false,false,false,0,1
224,307,-83,16,23.615385,-83,736,791,-55,0,0,0,0,3,14,13,12.666667,0,0,9,8,false,false,false,0,1
35,6,29,17.5,6,29,726,818,-92,0,0,0,0,88,2,1,0.397727,0,1,7,6,false,false,false,0.217,0.783
91,67,24,22.75,22.333333,24,1606,1593,13,0,0,0,0,74,4,3,0.391892,0,0,18,12,false,false,false,0.417,0.583
20,4,16,20,4,16,670,576,94,0,0,0,0,91,1,1,0.450549,0,0,8,10,false,false,true,0.784,0.216
266,270,-4,19,20.769231,-4,758,904,-146,1,0,0.071429,0,0,14,13,0,0,1,8,6,false,false,false,0.001,0.999
252,322,-70,14.823529,20.125,-70,1037,1016,21,1,0,0.058824,0,11,17,16,5.272727,1,0,15,8,false,false,false,0.001,0.999
176,315,-139,16,28.636364,-139,1193,1177,16,0,1,0,0.090909,27,11,11,1.296296,0,0,17,11,false,false,false,0,1
387,394,-7,27.642857,30.307692,-7,1793,1957,-164,1,2,0.071429,0.153846,-8,14,13,-3.625,0,0,3,3,false,false,false,0.42,0.58
117,103,14,19.5,20.6,14,450,503,-53,0,0,0,0,61,6,5,0.639344,0,0,20,17,false,false,false,0.432,0.568
279,301,-22,15.5,16.722222,-22,670,576,94,0,0,0,0,-15,18,18,-2.733333,0,0,2,2,false,false,false,0.131,0.869
140,213,-73,14,21.3,-73,683,859,-176,0,0,0,0,42,10,10,1.071429,1,0,6,15,false,false,false,0.025,0.975
30,13,17,10,6.5,17,1168,1216,-48,0,0,0,0,92,3,2,0.358696,0,0,19,24,false,false,false,0.1,0.9
55,73,-18,13.75,18.25,-18,726,818,-92,0,0,0,0,70,4,4,0.5,0,0,8,15,false,false,false,0.113,0.887
210,270,-60,14,18,-60,775,786,-11,0,0,0,0,9,15,15,4.777778,1,0,10,25,false,false,false,0.018,0.982
110,95,15,13.75,13.571429,15,306,302,4,0,0,0,0,49,8,7,0.836735,0,1,7,6,false,false,true,0.723,0.277
42,50,-8,21,25,-8,1021,1094,-73,0,0,0,0,86,2,2,0.430233,0,0,10,16,false,false,false,0.272,0.728
262,284,-22,20.153846,21.846154,-22,1043,1003,40,0,1,0,0.076923,11,13,13,3.454545,0,0,13,11,false,false,false,0.329,0.671
119,106,13,23.8,26.5,13,1245,1148,97,0,0,0,0,66,5,4,0.530303,1,1,18,16,false,false,true,0.56,0.44
199,263,-64,16.583333,23.909091,-64,711,746,-35,0,0,0,0,22,12,11,1.727273,0,0,11,10,false,false,false,0.007,0.993
174,234,-60,13.384615,18,-60,595,540,55,0,0,0,0,19,13,13,2.263158,0,1,10,11,false,false,false,0.041,0.959
131,97,34,26.2,19.4,34,1078,1095,-17,1,0,0.2,0,64,5,5,0.578125,0,1,15,15,false,false,true,0.543,0.457
158,295,-137,14.363636,26.818182,-137,760,976,-216,0,1,0,0.090909,16,11,11,2.25,0,1,13,20,false,false,false,0,1
176,447,-271,19.555556,49.666667,-271,1632,2020,-388,0,2,0,0.222222,23,9,9,1.347826,0,0,10,15,false,false,false,0,1
339,372,-33,16.142857,18.6,-33,1063,1134,-71,1,0,0.047619,0,-15,21,20,-2.933333,0,0,1,2,false,false,false,0,1
168,232,-64,16.8,25.777778,-64,594,648,-54,1,1,0.1,0.111111,40,10,9,1,0,0,9,18,false,false,false,0.007,0.993
108,99,9,36,49.5,9,1689,1777,-88,1,0,0.333333,0,69,3,2,0.434783,0,0,8,19,false,false,false,0.096,0.904
219,252,-33,18.25,21,-33,822,845,-23,0,0,0,0,22,12,12,1.590909,0,0,7,10,false,false,false,0.081,0.919
239,278,-39,19.916667,25.272727,-39,503,527,-24,0,1,0,0.090909,11,12,11,3,0,0,9,11,false,false,false,0.058,0.942
42,119,-77,10.5,29.75,-77,1397,1309,88,0,0,0,0,77,4,4,0.467532,1,1,6,17,false,false,false,0.028,0.972
78,68,10,19.5,22.666667,10,668,363,305,0,0,0,0,76,4,3,0.618421,0,0,8,17,false,false,true,0.509,0.491
0,14,-14,0,14,-14,720,437,283,0,0,0,0,96,1,1,0.4375,0,0,15,10,false,false,true,0.516,0.484
135,171,-36,19.285714,28.5,-36,1422,1798,-376,0,1,0,0.166667,50,7,6,0.64,0,1,18,17,false,false,false,0.072,0.928
344,408,-64,22.933333,29.142857,-64,1699,1803,-104,1,1,0.066667,0.071429,8,15,14,4.375,0,0,11,18,false,false,false,0,1
224,113,111,32,18.833333,111,1552,1803,-251,2,0,0.285714,0,52,7,6,0.634615,0,1,12,10,false,false,true,0.685,0.315
234,344,-110,19.5,28.666667,-110,1576,1556,20,0,1,0,0.083333,7,12,12,4.285714,1,0,9,7,false,false,false,0.007,0.993
283,253,30,14.15,12.65,30,671,638,33,0,0,0,0,-19,20,20,-2.578947,0,0,5,16,false,false,true,1,0
118,164,-46,14.75,20.5,-46,1176,1211,-35,0,0,0,0,36,8,8,0.916667,1,0,16,13,false,false,false,0.361,0.639
102,253,-151,10.2,25.3,-151,530,683,-153,0,1,0,0.1,44,10,10,0.909091,0,0,15,13,false,false,false,0,1
62,57,5,15.5,19,5,1003,1018,-15,0,0,0,0,75,4,3,0.493333,0,0,15,10,false,false,false,0.365,0.635
255,319,-64,15,19.9375,-64,603,721,-118,0,0,0,0,1,17,16,43,1,0,6,9,false,false,false,0.011,0.989
80,156,-76,11.428571,22.285714,-76,530,683,-153,0,1,0,0.142857,60,7,7,0.666667,0,0,9,18,false,false,false,0.068,0.932
100,87,13,16.666667,17.4,13,725,668,57,0,0,0,0,61,6,5,0.57377,0,0,23,31,false,false,true,0.503,0.497
420,503,-83,35,45.727273,-83,2147,2219,-72,1,2,0.083333,0.181818,-9,12,11,-2.666667,0,0,7,1,false,false,false,0,1
46,37,9,15.333333,18.5,9,840,1055,-215,0,0,0,0,81,3,2,0.432099,0,0,14,16,false,false,false,0.205,0.795
239,302,-63,17.071429,21.571429,-63,805,918,-113,0,0,0,0,0,14,14,0,0,1,9,17,false,false,false,0,1
339,407,-68,26.076923,33.916667,-68,1253,1324,-71,0,2,0,0.166667,1,13,12,29,0,1,4,5,false,false,false,0,1
289,356,-67,24.083333,32.363636,-67,1556,1616,-60,0,0,0,0,6,12,11,4.833333,0,0,7,10,false,false,false,0,1
82,77,5,16.4,19.25,5,700,820,-120,0,0,0,0,68,5,4,0.558824,0,0,11,11,false,false,false,0.176,0.824
342,388,-46,16.285714,19.4,-46,824,830,-6,1,0,0.047619,0,-21,21,20,-2.095238,0,0,2,3,false,false,false,0,1
189,333,-144,7.269231,12.807692,-144,651,567,84,0,0,0,0,-23,26,26,-2.391304,0,0,4,13,false,false,false,0,1
204,324,-120,15.692308,24.923077,-120,935,995,-60,1,1,0.076923,0.076923,17,13,13,2.294118,0,0,18,14,false,false,false,0,1
235,268,-33,11.75,13.4,-33,808,749,59,0,0,0,0,-27,20,20,-1.555556,0,0,5,5,false,false,false,0.009,0.991
279,313,-34,13.285714,15.65,-34,670,576,94,0,0,0,0,-19,21,20,-2.157895,0,0,2,1,true,false,false,0,1
107,79,28,26.75,26.333333,28,1055,840,215,0,0,0,0,71,4,3,0.507042,0,0,7,12,false,false,true,0.597,0.403
216,296,-80,12.705882,18.5,-80,388,542,-154,0,0,0,0,-7,17,16,-5.285714,0,1,6,6,false,false,false,0,1
217,233,-16,18.083333,21.181818,-16,518,461,57,0,0,0,0,19,12,11,1.894737,0,1,13,6,false,false,false,0.267,0.733
186,187,-1,20.666667,20.777778,-1,566,742,-176,0,1,0,0.111111,30,9,9,1.066667,0,0,9,11,false,false,true,0.592,0.408
186,226,-40,16.909091,22.6,-40,344,315,29,1,0,0.090909,0,17,11,10,2.352941,0,0,21,11,false,false,false,0.093,0.907
65,81,-16,16.25,20.25,-16,1168,1062,106,0,0,0,0,74,4,4,0.581081,0,1,10,10,false,false,false,0.273,0.727
16,0,16,16,0,16,837,844,-7,0,0,0,0,97,1,0,0.42268,0,0,9,0,false,false,true,0.562,0.438
151,151,0,18.875,21.571429,0,1488,1428,60,1,0,0.125,0,47,8,7,0.787234,0,0,23,15,false,false,false,0.286,0.714
301,368,-67,14.333333,17.52381,-67,603,721,-118,0,0,0,0,-27,21,21,-1.592593,1,0,1,1,false,false,false,0,1
52,35,17,13,11.666667,17,561,633,-72,0,0,0,0,81,4,3,0.432099,1,1,12,12,false,false,false,0.212,0.788
130,291,-161,21.666667,48.5,-161,1556,1656,-100,0,2,0,0.333333,41,6,6,0.731707,0,0,15,16,false,false,false,0,1
108,242,-134,10.8,26.888889,-134,1422,1510,-88,0,1,0,0.111111,48,10,9,0.8125,1,0,16,7,false,false,false,0.015,0.985
95,77,18,19,15.4,18,306,468,-162,0,0,0,0,73,5,5,0.506849,1,0,10,14,false,false,false,0.387,0.613
82,133,-51,10.25,16.625,-51,999,1165,-166,0,0,0,0,52,8,8,0.884615,0,0,20,11,false,false,false,0.072,0.928
125,230,-105,13.888889,25.555556,-105,563,523,40,0,0,0,0,38,9,9,0.973684,0,0,7,11,false,false,false,0.024,0.976
77,72,5,19.25,24,5,1777,1500,277,0,0,0,0,70,4,3,0.4,1,1,6,17,false,false,false,0.32,0.68
49,92,-43,8.166667,15.333333,-43,342,53,289,0,0,0,0,62,6,6,0.66129,0,0,9,20,false,false,false,0.371,0.629
81,123,-42,16.2,24.6,-42,971,635,336,0,0,0,0,63,5,5,0.507937,0,0,13,12,false,false,false,0.214,0.786
29,75,-46,14.5,37.5,-46,452,698,-246,0,1,0,0.5,85,2,2,0.482353,0,0,31,17,false,false,false,0.226,0.774
235,225,10,14.6875,15,10,306,302,4,0,0,0,0,-3,16,15,-13.666667,0,0,7,12,false,false,true,0.761,0.239
105,138,-33,35,69,-33,1398,1431,-33,0,0,0,0,70,3,2,0.4,0,0,10,10,false,false,false,0.038,0.962
312,336,-24,17.333333,19.764706,-24,356,498,-142,0,1,0,0.058824,-16,18,17,-2.1875,0,0,5,5,true,false,false,0.002,0.998
83,172,-89,10.375,24.571429,-89,595,662,-67,0,1,0,0.142857,46,8,7,0.956522,0,1,21,6,false,false,false,0.083,0.917
276,305,-29,21.230769,23.461538,-29,1652,1473,179,1,1,0.076923,0.076923,4,13,13,7.5,0,0,9,7,false,false,false,0.037,0.963
59,48,11,19.666667,24,11,796,800,-4,0,0,0,0,85,3,2,0.564706,0,0,18,7,false,false,true,0.527,0.473
86,147,-61,17.2,36.75,-61,1408,1539,-131,0,1,0,0.25,65,5,4,0.523077,0,0,17,12,false,false,false,0.269,0.731
304,319,-15,16,16.789474,-15,430,542,-112,0,1,0,0.052632,-13,19,19,-3.692308,0,0,10,11,false,false,false,0.093,0.907
215,297,-82,9.772727,14.142857,-82,542,390,152,0,0,0,0,-6,22,21,-8.333333,1,0,6,7,false,false,false,0.001,0.999
339,410,-71,24.214286,31.538462,-71,1415,1361,54,0,1,0,0.076923,-3,14,13,-10.333333,0,1,10,10,false,false,false,0,1
125,160,-35,15.625,20,-35,306,468,-162,0,0,0,0,55,8,8,0.672727,1,0,7,9,false,false,false,0.148,0.852
307,365,-58,17.055556,20.277778,-58,668,771,-103,0,0,0,0,-10,18,18,-4,0,1,1,1,false,false,false,0,1
198,185,13,24.75,26.428571,13,1237,1265,-28,1,0,0.125,0,39,8,7,0.923077,0,0,16,11,false,false,true,0.554,0.446
283,343,-60,18.866667,24.5,-60,566,742,-176,0,1,0,0.071429,-4,15,14,-8,0,0,2,3,false,false,false,0.001,0.999
106,137,-31,17.666667,22.833333,-31,527,954,-427,0,0,0,0,59,6,6,0.59322,0,1,27,10,false,false,false,0.001,0.999
259,336,-77,16.1875,22.4,-77,805,918,-113,0,0,0,0,-8,16,15,-4.5,0,0,4,9,false,false,false,0,1
172,221,-49,14.333333,20.090909,-49,1064,1397,-333,0,2,0,0.181818,37,12,11,1.162162,1,0,30,7,false,false,false,0.169,0.831
186,204,-18,18.6,20.4,-18,1439,1428,11,0,0,0,0,39,10,10,1.025641,0,0,14,11,false,false,false,0.27,0.73
82,80,2,13.666667,16,2,568,570,-2,0,0,0,0,64,6,5,0.578125,0,0,10,26,false,false,false,0.189,0.811
55,117,-62,11,29.25,-62,1454,1479,-25,0,0,0,0,67,5,4,0.462687,1,0,8,15,false,false,false,0.075,0.925
119,161,-42,14.875,23,-42,1270,1424,-154,0,1,0,0.142857,56,8,7,0.625,0,0,12,15,false,false,false,0.075,0.925
34,15,19,17,15,19,1161,1030,131,0,0,0,0,87,2,1,0.436782,0,0,10,26,false,false,true,0.523,0.477
139,224,-85,12.636364,22.4,-85,837,844,-7,0,0,0,0,43,11,10,0.953488,1,1,9,7,false,false,false,0.006,0.994
179,271,-92,16.272727,27.1,-92,965,1078,-113,0,1,0,0.1,28,11,10,1.321429,0,0,11,13,false,false,false,0.001,0.999
44,44,0,14.666667,22,0,668,771,-103,0,0,0,0,78,3,2,0.512821,0,0,14,11,false,false,false,0.198,0.802
195,217,-22,21.666667,24.111111,-22,786,885,-99,1,1,0.111111,0.111111,39,9,9,0.871795,0,0,14,26,false,false,false,0.332,0.668
66,53,13,9.428571,8.833333,13,925,1000,-75,0,0,0,0,56,7,6,0.785714,0,1,10,11,false,false,false,0.154,0.846
175,183,-8,15.909091,18.3,-8,1094,1041,53,0,0,0,0,27,11,10,1.407407,1,1,8,13,false,false,false,0.241,0.759
52,71,-19,13,17.75,-19,758,904,-146,0,0,0,0,70,4,4,0.485714,1,0,7,21,false,false,false,0.187,0.813
279,254,25,23.25,21.166667,25,1488,1428,60,1,0,0.083333,0,20,12,12,1.85,0,1,16,7,false,false,true,0.752,0.248
258,289,-31,17.2,20.642857,-31,1422,1583,-161,0,1,0,0.071429,8,15,14,5.125,1,0,8,16,false,false,false,0.047,0.953
16,27,-11,16,27,-11,1331,1347,-16,0,0,0,0,92,1,1,0.347826,1,0,8,16,false,false,true,0.511,0.489
129,114,15,14.333333,12.666667,15,1193,1220,-27,0,0,0,0,38,9,9,1.131579,1,1,8,21,false,false,false,0.337,0.663
43,17,26,14.333333,5.666667,26,1278,1101,177,0,0,0,0,82,3,3,0.45122,1,0,15,12,false,false,true,0.889,0.111
202,206,-4,16.833333,18.727273,-4,480,518,-38,0,0,0,0,20,12,11,2,0,0,18,7,false,false,false,0.327,0.673
107,111,-4,26.75,27.75,-4,1055,840,215,0,0,0,0,67,4,4,0.537313,0,0,7,7,false,false,true,0.545,0.455
18,22,-4,18,22,-4,1094,1159,-65,0,0,0,0,89,1,1,0.426966,0,0,19,13,false,false,true,0.543,0.457
253,430,-177,16.866667,30.714286,-177,1093,1100,-7,0,2,0,0.142857,4,15,14,8.75,0,0,24,10,false,false,false,0,1
16,0,16,16,0,16,306,361,-55,0,0,0,0,95,1,0,0.378947,0,0,7,0,false,false,false,0.255,0.745
43,172,-129,8.6,34.4,-129,1305,1307,-2,0,1,0,0.2,64,5,5,0.640625,0,0,13,14,false,false,false,0.028,0.972
111,90,21,22.2,22.5,21,1428,1361,67,0,0,0,0,65,5,4,0.507692,0,1,16,17,false,false,false,0.285,0.715
148,160,-12,21.142857,22.857143,-12,1055,1019,36,0,0,0,0,43,7,7,0.767442,1,0,13,11,false,false,true,0.681,0.319
174,185,-11,17.4,20.555556,-11,668,771,-103,0,0,0,0,41,10,9,0.97561,1,0,18,11,false,false,false,0.118,0.882
94,144,-50,11.75,20.571429,-50,1580,1629,-49,0,0,0,0,49,8,7,0.755102,0,0,24,7,false,false,false,0.272,0.728
22,14,8,11,14,8,720,437,283,0,0,0,0,93,2,1,0.451613,0,0,14,10,false,false,true,0.54,0.46
19,17,2,9.5,17,2,822,845,-23,0,0,0,0,91,2,1,0.384615,0,0,22,9,false,false,false,0.479,0.521
209,490,-281,19,44.545455,-281,1632,2020,-388,0,2,0,0.181818,10,11,11,3.1,0,0,24,9,false,false,false,0,1
10,0,10,10,0,10,1305,1194,111,0,0,0,0,97,1,0,0.340206,0,0,7,0,false,false,true,0.559,0.441
82,63,19,20.5,21,19,599,448,151,0,0,0,0,74,4,3,0.486486,0,0,7,9,false,false,true,0.729,0.271
282,261,21,21.692308,21.75,21,1691,1510,181,0,1,0,0.083333,8,13,12,3.75,1,0,6,22,false,false,true,0.718,0.282
152,155,-3,30.4,38.75,-3,1689,1777,-88,1,0,0.2,0,54,5,4,0.555556,0,1,24,15,false,false,true,0.519,0.481
156,168,-12,19.5,21,-12,1422,1583,-161,0,1,0,0.125,48,8,8,0.854167,0,0,10,28,false,false,false,0.105,0.895
250,326,-76,16.666667,23.285714,-76,1075,878,197,0,1,0,0.071429,4,15,14,8.25,0,0,17,10,false,false,false,0,1
225,300,-75,18.75,27.272727,-75,1656,1649,7,0,0,0,0,16,12,11,2,0,0,10,18,false,false,false,0,1
72,153,-81,14.4,30.6,-81,1422,1798,-376,0,1,0,0.2,60,5,5,0.533333,1,0,17,9,false,false,false,0.104,0.896
224,254,-30,12.444444,14.941176,-30,668,363,305,0,0,0,0,2,18,17,23.5,0,1,8,8,false,false,false,0.079,0.921
82,96,-14,16.4,19.2,-14,874,868,6,0,0,0,0,60,5,5,0.55,0,0,19,15,false,false,false,0.339,0.661
18,9,9,18,9,9,1220,1185,35,0,0,0,0,91,1,1,0.516484,0,1,19,11,false,false,true,0.561,0.439
146,118,28,20.857143,19.666667,28,1038,917,121,1,0,0.142857,0,56,7,6,0.625,0,2,7,7,false,false,false,0.015,0.985
161,228,-67,13.416667,20.727273,-67,1037,913,124,1,1,0.083333,0.090909,32,12,11,1.1875,0,0,13,13,false,false,false,0.029,0.971
112,267,-155,22.4,53.4,-155,1556,1656,-100,0,2,0,0.4,49,5,5,0.612245,0,0,7,15,false,false,false,0,1
160,106,54,22.857143,17.666667,54,664,786,-122,0,0,0,0,59,7,6,0.559322,0,0,13,18,false,false,true,0.646,0.354
41,22,19,20.5,22,19,1422,1798,-376,0,0,0,0,89,2,1,0.359551,1,0,8,9,false,false,false,0.316,0.684
121,268,-147,13.444444,33.5,-147,940,947,-7,0,2,0,0.25,34,9,8,1.029412,0,0,7,25,false,false,false,0,1
32,18,14,32,18,14,971,800,171,0,0,0,0,91,1,1,0.318681,0,1,7,7,false,false,true,0.749,0.251
125,200,-75,13.888889,25,-75,563,523,40,0,0,0,0,43,9,8,0.860465,0,1,7,11,false,false,false,0.003,0.997
243,389,-146,14.294118,24.3125,-146,1422,1510,-88,0,2,0,0.125,1,17,16,39,0,0,12,10,false,false,false,0,1
110,103,7,22,25.75,7,1176,1133,43,1,0,0.2,0,72,5,4,0.472222,0,0,12,17,false,false,true,0.552,0.448
109,270,-161,15.571429,38.571429,-161,2143,2219,-76,0,0,0,0,47,7,7,0.659574,0,0,19,23,false,false,false,0,1
28,21,7,14,21,7,736,791,-55,0,0,0,0,90,2,1,0.422222,1,0,13,23,false,false,false,0.259,0.741
243,271,-28,20.25,22.583333,-28,1110,1123,-13,0,1,0,0.083333,13,12,12,2.538462,1,1,6,11,false,false,false,0.082,0.918
319,334,-15,15.190476,15.904762,-15,613,525,88,0,0,0,0,-28,21,21,-1.5,0,0,4,2,true,false,false,0.002,0.998
146,46,100,36.5,15.333333,100,1373,1334,39,1,0,0.25,0,76,4,3,0.421053,0,0,14,13,false,false,true,0.958,0.042
265,333,-68,24.090909,30.272727,-68,1554,1685,-131,0,1,0,0.090909,20,11,11,1.6,0,1,10,7,false,false,false,0,1
275,360,-85,25,36,-85,1537,1539,-2,0,1,0,0.1,16,11,10,2.125,0,1,13,20,false,false,false,0,1
87,98,-11,17.4,19.6,-11,736,791,-55,0,0,0,0,66,5,5,0.575758,1,1,8,15,false,false,false,0.203,0.797
279,301,-22,14.684211,16.722222,-22,670,576,94,0,0,0,0,-15,19,18,-2.733333,0,0,2,2,false,false,false,0.086,0.914
14,0,14,4.666667,0,14,1064,1397,-333,0,0,0,0,98,3,2,0.438776,0,0,22,10,false,false,false,0.215,0.785
247,271,-24,15.4375,18.066667,-24,615,542,73,0,0,0,0,4,16,15,10.5,0,0,7,10,false,false,false,0.087,0.913
120,236,-116,17.142857,33.714286,-116,1164,1149,15,0,1,0,0.142857,55,7,7,0.854545,0,0,12,18,false,false,false,0.027,0.973
311,346,-35,20.733333,23.066667,-35,1237,1265,-28,1,0,0.066667,0,-14,15,15,-2.571429,0,0,9,11,false,false,false,0,1
43,17,26,14.333333,8.5,26,1278,1101,177,0,0,0,0,82,3,2,0.45122,1,0,15,8,false,false,true,0.878,0.122
303,453,-150,21.642857,34.846154,-150,1554,1685,-131,0,2,0,0.153846,-1,14,13,-32,0,0,6,6,false,false,false,0,1
72,60,12,18,20,12,1310,1477,-167,0,0,0,0,73,4,3,0.493151,0,0,11,11,false,false,false,0.187,0.813
63,33,30,21,16.5,30,971,800,171,0,0,0,0,76,3,2,0.381579,1,1,6,9,false,false,true,0.777,0.223
97,131,-34,16.166667,21.833333,-34,1037,1009,28,0,0,0,0,62,6,6,0.709677,0,1,18,6,false,false,false,0.27,0.73
175,188,-13,14.583333,17.090909,-13,714,892,-178,0,0,0,0,32,12,11,1.3125,0,1,8,7,false,false,false,0.098,0.902
256,268,-12,18.285714,19.142857,-12,804,766,38,0,1,0,0.071429,20,14,14,2.05,0,1,9,12,false,false,false,0.385,0.615
100,97,3,20,19.4,3,1159,1131,28,0,0,0,0,67,5,5,0.552239,0,1,7,6,false,false,false,0.429,0.571
46,58,-12,6.571429,9.666667,-12,1037,1016,21,0,0,0,0,72,7,6,0.805556,0,1,13,9,false,false,false,0.261,0.739
228,285,-57,22.8,28.5,-57,1266,1339,-73,0,1,0,0.1,34,10,10,1.029412,0,0,13,12,false,false,false,0.126,0.874
77,29,48,38.5,29,48,1055,840,215,0,0,0,0,88,2,1,0.409091,0,1,8,15,false,false,true,0.795,0.205
32,77,-45,10.666667,25.666667,-45,1176,1133,43,0,0,0,0,83,3,3,0.409639,2,0,9,17,false,false,false,0.45,0.55
55,128,-73,27.5,64,-73,1388,1455,-67,0,0,0,0,77,2,2,0.363636,0,0,16,8,false,false,false,0.049,0.951
14,8,6,14,8,6,542,605,-63,0,0,0,0,91,1,1,0.395604,1,0,13,7,false,false,false,0.424,0.576
230,328,-98,23,32.8,-98,1793,1957,-164,0,1,0,0.1,24,10,10,1.208333,0,0,10,10,false,false,false,0,1
363,403,-40,24.2,26.866667,-40,1793,1869,-76,1,1,0.066667,0.066667,-8,15,15,-3.75,0,0,1,3,true,false,false,0,1
259,361,-102,15.235294,21.235294,-102,595,412,183,0,1,0,0.058824,-3,17,17,-17.333333,0,0,10,12,false,false,false,0,1
6,0,6,6,0,6,1176,1133,43,0,0,0,0,97,1,0,0.350515,1,0,9,0,false,false,true,0.566,0.434
152,250,-98,30.4,50,-98,1689,1777,-88,1,1,0.2,0.2,47,5,5,0.638298,0,0,24,19,false,false,false,0,1
297,257,40,21.214286,19.769231,40,1197,1156,41,0,1,0,0.076923,8,14,13,4.375,0,0,8,7,false,false,true,0.861,0.139
114,117,-3,16.285714,16.714286,-3,1310,1477,-167,0,0,0,0,48,7,7,0.75,1,0,9,10,false,false,false,0.341,0.659
164,179,-15,18.222222,22.375,-15,1331,1374,-43,0,0,0,0,39,9,8,0.846154,0,0,25,8,false,false,false,0.292,0.708
99,191,-92,9.9,21.222222,-92,651,996,-345,0,1,0,0.111111,32,10,9,1.40625,0,1,13,7,false,false,false,0,1
304,479,-175,19,29.9375,-175,1368,1452,-84,1,2,0.0625,0.125,-10,16,16,-3.2,0,0,2,1,true,false,false,0,1
39,79,-40,13,26.333333,-40,1071,1000,71,0,0,0,0,81,3,3,0.580247,0,0,9,10,false,false,false,0.262,0.738
246,178,68,30.75,22.25,68,1552,1803,-251,2,0,0.25,0,41,8,8,0.804878,0,1,9,10,false,false,false,0.21,0.79
200,180,20,28.571429,30,20,1770,1751,19,0,1,0,0.166667,41,7,6,0.707317,0,0,8,23,false,false,false,0.274,0.726
22,23,-1,22,23,-1,1556,1616,-60,0,0,0,0,95,1,1,0.305263,0,0,13,10,false,false,false,0.476,0.524
257,295,-38,21.416667,24.583333,-38,1645,1636,9,0,1,0,0.083333,7,12,12,4.714286,0,0,12,11,false,false,false,0.123,0.877
63,38,25,21,19,25,1777,1500,277,0,0,0,0,77,3,2,0.363636,1,1,8,17,false,false,false,0.487,0.513
246,257,-11,20.5,23.363636,-11,694,658,36,0,1,0,0.090909,24,12,11,1.541667,0,0,13,17,false,false,true,0.622,0.378
280,306,-26,18.666667,21.857143,-26,668,771,-103,0,0,0,0,9,15,14,4.444444,0,1,7,6,false,false,false,0.003,0.997
220,229,-9,20,22.9,-9,967,856,111,0,0,0,0,30,11,10,1.1,0,1,25,11,false,false,false,0.378,0.622
265,311,-46,18.928571,23.923077,-46,527,954,-427,0,1,0,0.076923,11,14,13,3.181818,0,0,17,19,false,false,false,0,1
278,368,-90,16.352941,21.647059,-90,795,786,9,1,0,0.058824,0,-6,17,17,-6.333333,1,0,9,3,false,false,false,0,1
233,259,-26,33.285714,43.166667,-26,1431,1399,32,0,2,0,0.333333,33,7,6,0.757576,0,0,12,13,false,false,false,0.252,0.748
253,318,-65,15.8125,21.2,-65,344,315,29,1,1,0.0625,0.066667,-15,16,15,-2.666667,0,0,13,7,false,false,false,0,1
225,415,-190,13.235294,24.411765,-190,940,947,-7,0,2,0,0.117647,-12,17,17,-2.916667,1,0,7,8,false,false,false,0,1
263,332,-69,16.4375,20.75,-69,480,518,-38,0,0,0,0,-8,16,16,-5,0,0,11,3,false,false,false,0,1
301,327,-26,16.722222,18.166667,-26,576,602,-26,0,0,0,0,-15,18,18,-2.8,0,0,6,2,false,false,false,0.031,0.969
212,263,-51,17.666667,21.916667,-51,1055,840,215,0,1,0,0.083333,17,12,12,2.117647,1,0,7,20,false,false,false,0.076,0.924
78,87,-9,11.142857,14.5,-9,917,856,61,0,0,0,0,65,7,6,0.507692,0,1,21,6,false,false,false,0.274,0.726
14,44,-30,7,22,-30,343,570,-227,0,0,0,0,84,2,2,0.428571,0,0,7,15,false,false,false,0.164,0.836
223,307,-84,13.9375,19.1875,-84,306,361,-55,0,0,0,0,-15,16,16,-2.4,0,0,7,10,false,false,false,0,1
237,288,-51,13.166667,16,-51,278,1,277,0,0,0,0,-14,18,18,-2.642857,0,0,9,1,false,false,false,0.07,0.93
247,302,-55,19,23.230769,-55,1633,1620,13,0,0,0,0,2,13,13,18,0,0,11,10,false,false,false,0.001,0.999
156,87,69,26,17.4,69,1552,1803,-251,1,0,0.166667,0,63,6,5,0.52381,1,0,6,18,false,false,true,0.775,0.225
198,231,-33,16.5,19.25,-33,360,371,-11,0,0,0,0,8,12,12,4.625,1,0,6,11,false,false,false,0.371,0.629
295,355,-60,17.352941,22.1875,-60,1047,1253,-206,1,1,0.058824,0.0625,-9,17,16,-4.111111,1,0,6,16,false,false,false,0,1
131,122,9,21.833333,20.333333,9,1047,1253,-206,1,0,0.166667,0,62,6,6,0.596774,0,0,7,10,false,false,false,0.298,0.702
59,62,-3,14.75,15.5,-3,1312,1334,-22,0,0,0,0,73,4,4,0.534247,0,0,16,24,false,false,false,0.273,0.727
117,86,31,23.4,21.5,31,892,856,36,0,0,0,0,70,5,4,0.5,1,0,7,9,false,false,true,0.777,0.223
64,156,-92,12.8,31.2,-92,561,633,-72,0,1,0,0.2,68,5,5,0.514706,1,0,15,17,false,false,false,0.079,0.921
145,182,-37,13.181818,16.545455,-37,970,1030,-60,0,0,0,0,26,11,11,1.538462,0,0,22,7,false,false,false,0.248,0.752
164,171,-7,14.909091,17.1,-7,526,502,24,0,0,0,0,40,11,10,1.25,0,0,13,10,false,false,false,0.365,0.635
302,348,-46,20.133333,24.857143,-46,1164,1261,-97,0,1,0,0.071429,9,15,14,4.666667,0,0,14,8,false,false,false,0,1
218,310,-92,9.478261,13.478261,-92,542,390,152,0,0,0,0,-14,23,23,-3.571429,1,0,6,7,false,false,false,0,1
136,151,-15,12.363636,13.727273,-15,163,346,-183,0,0,0,0,24,11,11,1.625,0,0,16,10,false,false,true,0.533,0.467
295,425,-130,19.666667,28.333333,-130,999,1283,-284,0,2,0,0.133333,-9,15,15,-3.666667,0,0,4,2,false,false,false,0,1
37,20,17,18.5,20,17,1203,1270,-67,0,0,0,0,90,2,1,0.488889,0,0,11,18,false,false,false,0.384,0.616
134,73,61,26.8,18.25,61,804,1074,-270,0,0,0,0,65,5,4,0.492308,0,0,12,26,false,false,true,0.598,0.402
208,360,-152,11.555556,20,-152,977,1100,-123,0,1,0,0.055556,-4,18,18,-10.25,0,0,9,10,false,false,false,0,1
50,80,-30,12.5,20,-30,980,965,15,0,0,0,0,74,4,4,0.513514,0,1,22,8,false,false,false,0.278,0.722
140,54,86,35,18,86,1793,1957,-164,0,0,0,0,72,4,3,0.402778,0,1,11,15,false,false,true,0.744,0.256
121,117,4,20.166667,23.4,4,842,926,-84,0,0,0,0,55,6,5,0.545455,0,0,9,15,false,false,false,0.133,0.867
141,334,-193,15.666667,37.111111,-193,1093,1100,-7,0,2,0,0.222222,37,9,9,0.945946,0,0,7,13,false,false,false,0,1
241,274,-33,18.538462,21.076923,-33,1220,1185,35,0,1,0,0.076923,19,13,13,2.473684,0,1,17,19,false,false,false,0.112,0.888
87,119,-32,21.75,39.666667,-32,907,910,-3,0,1,0,0.333333,78,4,3,0.551282,0,0,11,12,false,false,false,0.271,0.729
218,303,-85,9.478261,13.772727,-85,542,390,152,0,0,0,0,-12,23,22,-4.166667,1,0,6,7,false,false,false,0,1
372,397,-25,17.714286,18.904762,-25,1093,1173,-80,1,1,0.047619,0.047619,-23,21,21,-1.869565,0,0,2,4,false,false,false,0,1
28,17,11,28,17,11,1428,1361,67,0,0,0,0,90,1,1,0.366667,0,0,12,17,false,false,true,0.572,0.428
36,37,-1,18,18.5,-1,818,826,-8,0,0,0,0,88,2,2,0.602273,1,0,9,19,false,false,true,0.695,0.305
196,247,-51,19.6,24.7,-51,1205,1216,-11,0,0,0,0,30,10,10,1.1,0,0,8,13,false,false,false,0.049,0.951
26,16,10,26,16,10,1312,1334,-22,0,0,0,0,88,1,1,0.443182,0,0,14,16,false,false,true,0.576,0.424
36,18,18,18,18,18,1493,1413,80,0,0,0,0,91,2,1,0.395604,1,0,25,8,false,false,true,0.726,0.274
112,122,-10,18.666667,20.333333,-10,1561,1495,66,1,0,0.166667,0,51,6,6,0.647059,1,0,9,11,false,false,true,0.754,0.246
122,70,52,30.5,17.5,52,1274,1394,-120,0,0,0,0,69,4,4,0.434783,0,0,16,15,false,false,true,0.81,0.19
121,84,37,17.285714,12,37,675,570,105,0,0,0,0,50,7,7,0.7,0,0,14,27,false,false,true,0.92,0.08
175,201,-26,17.5,22.333333,-26,775,786,-11,0,0,0,0,34,10,9,1.264706,1,0,10,19,false,false,false,0.198,0.802
30,51,-21,10,17,-21,540,498,42,0,0,0,0,81,3,3,0.567901,0,1,16,11,false,false,false,0.355,0.645
38,17,21,19,8.5,21,889,855,34,0,0,0,0,89,2,2,0.449438,0,0,13,16,false,false,true,0.76,0.24
333,347,-14,22.2,24.785714,-14,1436,1489,-53,1,1,0.066667,0.071429,6,15,14,6.166667,0,0,15,11,false,false,false,0.159,0.841
288,293,-5,16.941176,18.3125,-5,518,461,57,0,0,0,0,-15,17,16,-2.4,0,0,2,4,false,false,false,0.117,0.883
101,194,-93,25.25,48.5,-93,1633,1680,-47,0,1,0,0.25,56,4,4,0.5,0,0,8,11,false,false,false,0.029,0.971
342,388,-46,19,21.555556,-46,1043,1003,40,0,1,0,0.055556,-19,18,18,-2,0,0,2,2,false,false,false,0,1
130,145,-15,18.571429,24.166667,-15,1484,1556,-72,0,1,0,0.166667,46,7,6,0.673913,1,0,11,9,false,false,false,0.307,0.693
272,317,-45,13.6,16.684211,-45,925,1000,-75,0,0,0,0,-21,20,19,-2.095238,0,0,6,3,false,false,false,0,1
110,73,37,36.666667,24.333333,37,1237,1265,-28,1,0,0.333333,0,70,3,3,0.514286,0,0,22,19,false,false,true,0.577,0.423
10,0,10,10,0,10,480,739,-259,0,0,0,0,96,1,0,0.40625,0,0,8,0,false,false,false,0.211,0.789
299,446,-147,23,34.307692,-147,1606,1593,13,1,1,0.076923,0.076923,-3,13,13,-9.666667,0,0,5,1,false,false,false,0,1
135,230,-95,13.5,25.555556,-95,563,523,40,0,0,0,0,36,10,9,1.027778,0,0,10,11,false,false,false,0.017,0.983
284,307,-23,17.75,20.466667,-23,206,346,-140,1,0,0.0625,0,-7,16,15,-6.142857,0,0,29,10,false,false,false,0,1
194,305,-111,11.411765,17.941176,-111,595,662,-67,0,1,0,0.058824,-7,17,17,-6.285714,0,0,16,13,false,false,false,0,1
161,227,-66,16.1,25.222222,-66,1003,1018,-15,0,0,0,0,32,10,9,1.15625,0,0,17,10,false,false,false,0.051,0.949
119,162,-43,19.833333,27,-43,835,786,49,0,0,0,0,51,6,6,0.666667,0,1,17,7,false,false,false,0.222,0.778
99,210,-111,12.375,30,-111,760,976,-216,0,1,0,0.142857,46,8,7,0.782609,0,0,10,8,false,false,false,0.007,0.993
39,30,9,13,15,9,814,830,-16,0,0,0,0,82,3,2,0.5,0,0,7,16,false,false,false,0.4,0.6
273,403,-130,17.0625,26.866667,-130,1572,1777,-205,0,2,0,0.133333,-22,16,15,-1.5,0,0,15,2,false,false,false,0,1
154,174,-20,22,24.857143,-20,1586,1633,-47,1,0,0.142857,0,60,7,7,0.566667,0,0,24,12,false,false,false,0.28,0.72
159,302,-143,13.25,27.454545,-143,710,758,-48,0,1,0,0.090909,30,12,11,1.233333,0,0,10,9,false,false,false,0,1
39,46,-7,13,15.333333,-7,814,830,-16,0,0,0,0,79,3,3,0.518987,0,0,7,12,false,false,false,0.471,0.529
36,58,-22,9,14.5,-22,632,603,29,0,0,0,0,73,4,4,0.520548,1,0,6,28,false,false,false,0.414,0.586
183,212,-29,14.076923,17.666667,-29,306,361,-55,0,0,0,0,9,13,12,4,0,1,13,15,false,false,false,0.049,0.951
110,122,-12,12.222222,13.555556,-12,306,302,4,0,0,0,0,42,9,9,0.97619,0,1,11,10,false,false,false,0.4,0.6
20,0,20,20,0,20,675,570,105,0,0,0,0,96,1,0,0.364583,1,0,7,0,false,false,true,0.788,0.212
67,29,38,22.333333,14.5,38,1399,1210,189,0,0,0,0,81,3,2,0.432099,0,1,16,11,false,false,true,0.561,0.439
80,61,19,40,30.5,19,824,830,-6,1,0,0.5,0,81,2,2,0.54321,0,0,15,17,false,false,true,0.552,0.448
152,133,19,19,16.625,19,704,523,181,0,0,0,0,38,8,8,0.921053,0,0,10,17,false,false,true,0.61,0.39
230,257,-27,16.428571,19.769231,-27,599,448,151,0,0,0,0,12,14,13,3,0,0,12,17,false,false,false,0.09,0.91
111,135,-24,18.5,22.5,-24,1803,1658,145,0,0,0,0,54,6,6,0.611111,2,0,9,7,false,false,false,0.471,0.529
139,182,-43,15.444444,20.222222,-43,651,700,-49,0,0,0,0,39,9,9,1.435897,1,0,6,15,false,false,false,0.112,0.888
20,0,20,20,0,20,771,668,103,0,0,0,0,96,1,0,0.395833,0,0,11,0,false,false,true,0.767,0.233
38,72,-34,12.666667,24,-34,500,509,-9,0,0,0,0,79,3,3,0.518987,0,0,9,28,false,false,false,0.155,0.845
314,489,-175,34.888889,54.333333,-175,1398,1431,-33,0,0,0,0,6,9,9,4.666667,0,0,13,28,false,false,false,0,1
145,233,-88,13.181818,21.181818,-88,813,698,115,1,0,0.090909,0,36,11,11,1.333333,0,1,20,6,false,false,false,0.007,0.993
259,260,-1,13.631579,13.684211,-1,306,302,4,0,0,0,0,-24,19,19,-1.708333,0,0,4,1,false,false,true,0.954,0.046
274,390,-116,19.571429,27.857143,-116,1334,1439,-105,1,1,0.071429,0.071429,11,14,14,3.272727,0,0,10,12,false,false,false,0,1
122,227,-105,12.2,22.7,-105,948,998,-50,0,0,0,0,30,10,10,1.233333,1,0,9,13,false,false,false,0.008,0.992
30,37,-7,10,12.333333,-7,1037,913,124,0,0,0,0,88,3,3,0.431818,0,0,10,26,false,false,true,0.512,0.488
146,209,-63,16.222222,26.125,-63,1003,1018,-15,0,0,0,0,38,9,8,0.973684,0,0,8,9,false,false,false,0.031,0.969
141,234,-93,15.666667,26,-93,944,1095,-151,0,1,0,0.111111,44,9,9,0.886364,0,1,8,6,false,false,false,0.006,0.994
256,279,-23,16,17.4375,-23,430,542,-112,0,1,0,0.0625,4,16,16,12,0,0,16,12,false,false,false,0.361,0.639
110,74,36,27.5,24.666667,36,595,733,-138,1,0,0.25,0,71,4,3,0.549296,0,0,16,7,false,false,false,0.246,0.754
136,124,12,15.111111,15.5,12,361,413,-52,0,0,0,0,44,9,8,0.931818,1,0,10,7,false,false,true,0.543,0.457
254,375,-121,18.142857,26.785714,-121,1038,917,121,1,2,0.071429,0.142857,-4,14,14,-8.75,0,0,8,10,false,false,false,0,1
68,44,24,34,22,24,1633,1556,77,0,0,0,0,80,2,2,0.4125,0,0,22,9,false,false,true,0.734,0.266
229,222,7,25.444444,24.666667,7,824,830,-6,1,0,0.111111,0,38,9,9,1.157895,0,0,10,17,false,false,false,0.322,0.678
372,397,-25,16.909091,18.904762,-25,1093,1173,-80,1,1,0.045455,0.047619,-23,22,21,-1.869565,0,0,2,4,true,false,false,0,1
120,138,-18,20,23,-18,1168,1062,106,0,0,0,0,62,6,6,0.693548,0,0,9,16,false,false,false,0.426,0.574
286,307,-21,13.619048,14.619048,-21,1123,1062,61,0,0,0,0,-19,21,21,-2.315789,0,0,3,10,false,false,false,0.015,0.985
78,163,-85,15.6,32.6,-85,1572,1777,-205,0,1,0,0.2,57,5,5,0.578947,0,1,11,6,false,false,false,0.194,0.806
36,89,-53,18,44.5,-53,503,527,-24,0,1,0,0.5,81,2,2,0.407407,0,0,10,13,false,false,false,0.272,0.728
158,240,-82,17.555556,26.666667,-82,1656,1580,76,0,1,0,0.111111,36,9,9,0.916667,1,0,13,7,false,false,false,0.056,0.944
230,307,-77,13.529412,18.058824,-77,830,787,43,0,0,0,0,-15,17,17,-2.533333,0,0,4,2,false,false,false,0,1
130,267,-137,21.666667,53.4,-137,1556,1656,-100,0,2,0,0.4,45,6,5,0.666667,0,0,15,15,false,false,false,0,1
98,104,-6,16.333333,20.8,-6,1161,1030,131,0,0,0,0,66,6,5,0.575758,0,0,7,12,false,false,false,0.437,0.563
57,21,36,19,10.5,36,450,427,23,0,0,0,0,81,3,2,0.45679,0,1,15,10,false,false,true,0.768,0.232
341,371,-30,21.3125,23.1875,-30,691,695,-4,1,0,0.0625,0,-15,16,16,-2.133333,0,0,2,2,true,false,false,0.023,0.977
233,256,-23,16.642857,18.285714,-23,595,538,57,0,0,0,0,7,14,14,5.428571,0,1,14,9,false,false,false,0.317,0.683
244,291,-47,13.555556,16.166667,-47,526,502,24,0,0,0,0,-5,18,18,-10,1,0,17,17,false,false,false,0.013,0.987
349,348,1,24.928571,26.769231,1,714,820,-106,1,0,0.071429,0,2,14,13,15.5,0,0,4,5,false,false,false,0.381,0.619
135,117,18,16.875,16.714286,18,1310,1477,-167,0,0,0,0,43,8,7,0.837209,1,0,10,10,false,false,false,0.476,0.524
204,343,-139,17,31.181818,-139,1045,1100,-55,0,1,0,0.090909,24,12,11,1.416667,0,0,10,12,false,false,false,0,1
111,88,23,18.5,17.6,23,758,791,-33,0,0,0,0,60,6,5,0.65,0,0,15,11,false,false,true,0.578,0.422
256,327,-71,15.058824,20.4375,-71,95,453,-358,0,0,0,0,-10,17,16,-3.9,0,0,3,4,false,false,false,0,1
76,101,-25,19,33.666667,-25,1422,1583,-161,0,1,0,0.333333,71,4,3,0.577465,0,0,17,9,false,false,false,0.271,0.729
28,16,12,14,8,12,970,1030,-60,0,0,0,0,86,2,2,0.465116,0,1,29,7,false,false,true,0.528,0.472
286,453,-167,22,34.846154,-167,1554,1685,-131,0,2,0,0.153846,3,13,13,10.666667,0,0,12,6,false,false,false,0,1
26,0,26,26,0,26,971,635,336,0,0,0,0,97,1,0,0.329897,0,0,10,0,false,false,true,0.785,0.215
113,145,-32,18.833333,24.166667,-32,653,820,-167,0,0,0,0,52,6,6,0.730769,0,0,7,21,false,false,false,0.075,0.925
232,265,-33,19.333333,24.090909,-33,1691,1551,140,0,0,0,0,26,12,11,1.423077,1,0,6,13,false,false,false,0.045,0.955
248,389,-141,11.272727,17.681818,-141,1248,1220,28,0,1,0,0.045455,-15,22,22,-3.466667,1,0,5,7,false,false,false,0,1
229,289,-60,13.470588,18.0625,-60,1071,1000,71,0,0,0,0,0,17,16,0,0,0,16,12,false,false,false,0,1
72,39,33,18,13,33,848,976,-128,0,0,0,0,77,4,3,0.519481,0,0,7,18,false,false,false,0.229,0.771
27,28,-1,9,14,-1,1606,1890,-284,0,0,0,0,83,3,2,0.337349,1,0,15,11,false,false,false,0.322,0.678
279,266,13,19.928571,20.461538,13,1227,1189,38,0,0,0,0,1,14,13,35,0,2,9,24,false,false,false,0.091,0.909
56,61,-5,14,15.25,-5,361,413,-52,0,0,0,0,71,4,4,0.577465,0,0,26,11,false,false,false,0.408,0.592
242,237,5,14.235294,13.941176,5,306,302,4,0,0,0,0,-12,17,17,-3.416667,0,0,7,16,false,false,true,0.905,0.095
187,259,-72,13.357143,18.5,-72,775,786,-11,0,0,0,0,14,14,14,3.071429,1,0,13,25,false,false,false,0.018,0.982
264,267,-3,16.5,17.8,-3,1037,1009,28,0,0,0,0,13,16,15,3.384615,1,1,13,13,false,false,false,0.167,0.833
220,130,90,20,11.818182,90,1065,948,117,0,0,0,0,40,11,11,0.975,0,0,12,8,false,false,true,0.995,0.005
27,97,-70,9,32.333333,-70,1305,1307,-2,0,1,0,0.333333,75,3,3,0.546667,0,0,7,21,false,false,false,0.27,0.73
234,312,-78,13,17.333333,-78,1071,1000,71,0,0,0,0,-9,18,18,-5.222222,0,0,15,7,false,false,false,0,1
336,345,-9,16,16.428571,-9,1168,1062,106,0,0,0,0,-16,21,21,-2.6875,0,0,2,1,false,false,true,0.564,0.436
157,234,-77,26.166667,39,-77,1925,1885,40,1,1,0.166667,0.166667,42,6,6,0.595238,1,0,16,7,false,false,false,0.083,0.917
180,152,28,30,30.4,28,824,830,-6,1,0,0.166667,0,60,6,5,0.733333,0,0,12,11,false,false,false,0.481,0.519
148,159,-11,21.142857,22.714286,-11,921,1045,-124,0,0,0,0,48,7,7,0.729167,0,0,24,10,false,false,false,0.183,0.817
224,258,-34,14,16.125,-34,1045,1082,-37,0,0,0,0,1,16,16,45,1,0,9,14,false,false,false,0.302,0.698
8,18,-10,8,18,-10,603,721,-118,0,0,0,0,94,1,1,0.457447,0,0,28,13,false,false,false,0.211,0.789
211,213,-2,21.1,23.666667,-2,1270,1261,9,1,0,0.1,0,40,10,9,0.925,0,0,9,14,false,false,false,0.21,0.79
272,268,4,19.428571,20.615385,4,907,910,-3,0,1,0,0.076923,23,14,13,1.869565,0,0,17,9,false,false,true,0.672,0.328
257,425,-168,21.416667,35.416667,-168,786,848,-62,0,2,0,0.166667,12,12,12,2.583333,0,0,13,9,false,false,false,0,1
34,35,-1,17,35,-1,1229,1220,9,0,0,0,0,88,2,1,0.420455,0,1,9,15,false,false,false,0.248,0.752
53,61,-8,13.25,15.25,-8,542,605,-63,0,0,0,0,69,4,4,0.521739,1,1,11,13,false,false,false,0.22,0.78
381,539,-158,31.75,44.916667,-158,1398,1431,-33,0,0,0,0,-13,12,12,-2.153846,0,0,2,10,false,false,false,0,1
102,140,-38,17,23.333333,-38,1422,1583,-161,0,1,0,0.166667,57,6,6,0.719298,0,0,17,20,false,false,false,0.152,0.848
278,320,-42,23.166667,26.666667,-42,1188,1334,-146,1,1,0.083333,0.083333,7,12,12,4.285714,1,0,10,10,false,false,false,0.135,0.865
66,45,21,13.2,11.25,21,670,576,94,0,0,0,0,65,5,4,0.630769,0,0,19,12,false,false,true,0.752,0.248
214,285,-71,19.454545,25.909091,-71,1030,1014,16,0,1,0,0.090909,27,11,11,1.222222,0,0,18,15,false,false,false,0.037,0.963
17,33,-16,8.5,16.5,-16,724,398,326,0,0,0,0,88,2,2,0.443182,0,0,14,13,false,false,true,0.514,0.486
250,284,-34,13.888889,15.777778,-34,500,532,-32,0,0,0,0,-17,18,18,-2.411765,0,2,25,3,false,false,false,0,1
287,250,37,20.5,19.230769,37,1168,1062,106,0,0,0,0,18,14,13,2.388889,1,0,9,8,false,false,true,0.678,0.322
207,177,30,18.818182,17.7,30,527,954,-427,0,0,0,0,34,11,10,1.029412,0,2,26,12,false,false,false,0.001,0.999
310,310,0,20.666667,22.142857,0,1691,1551,140,1,0,0.066667,0,2,15,14,18.5,0,0,12,15,false,false,false,0.071,0.929
237,299,-62,12.473684,15.736842,-62,683,859,-176,0,0,0,0,2,19,19,22.5,0,0,9,17,false,false,false,0,1
59,73,-14,14.75,24.333333,-14,952,870,82,0,0,0,0,73,4,3,0.506849,0,0,11,18,false,false,false,0.344,0.656
242,409,-167,17.285714,29.214286,-167,1045,1100,-55,0,1,0,0.071429,2,14,14,17,1,0,14,12,false,false,false,0,1
36,76,-40,18,76,-40,1656,1649,7,0,0,0,0,83,2,1,0.385542,0,0,10,18,false,false,false,0.027,0.973
178,173,5,19.777778,21.625,5,206,346,-140,1,0,0.111111,0,40,9,8,1.075,0,1,12,6,false,false,false,0.001,0.999
167,129,38,20.875,16.125,38,1197,1156,41,0,0,0,0,47,8,8,0.744681,0,1,24,6,false,false,true,0.856,0.144
100,47,53,16.666667,9.4,53,1168,1216,-48,0,0,0,0,74,6,5,0.445946,0,0,10,27,false,false,false,0.463,0.537
270,344,-74,20.769231,28.666667,-74,991,1063,-72,0,1,0,0.083333,12,13,12,3.166667,0,0,12,8,false,false,false,0,1
182,167,15,20.222222,18.555556,15,1078,1095,-17,1,0,0.111111,0,40,9,9,0.925,0,2,17,16,false,false,false,0.002,0.998
190,175,15,27.142857,29.166667,15,1885,1842,43,0,1,0,0.166667,44,7,6,0.613636,0,0,11,13,false,false,false,0.278,0.722
70,104,-34,14,20.8,-34,1000,960,40,0,0,0,0,66,5,5,0.681818,1,0,6,8,false,false,false,0.296,0.704
83,139,-56,20.75,34.75,-56,1315,1331,-16,0,0,0,0,69,4,4,0.478261,1,0,14,15,false,false,false,0.326,0.674
146,184,-38,20.857143,26.285714,-38,1038,917,121,1,1,0.142857,0.142857,49,7,7,0.714286,0,0,7,21,false,false,false,0.109,0.891
353,377,-24,20.764706,22.176471,-24,1110,1399,-289,0,1,0,0.058824,-9,17,17,-3.777778,0,0,1,4,true,false,false,0,1
80,211,-131,10,26.375,-131,1699,1803,-104,0,0,0,0,62,8,8,0.564516,0,0,8,7,false,false,false,0.006,0.994
203,202,1,25.375,28.857143,1,732,868,-136,0,1,0,0.142857,40,8,7,0.8,0,0,13,8,false,false,true,0.56,0.44
56,37,19,18.666667,18.5,19,1493,1413,80,0,0,0,0,84,3,2,0.428571,1,0,22,11,false,false,true,0.703,0.297
83,253,-170,11.857143,36.142857,-170,940,947,-7,0,2,0,0.285714,48,7,7,0.729167,0,0,9,12,false,false,false,0,1
41,68,-27,10.25,22.666667,-27,1038,917,121,0,0,0,0,80,4,3,0.4375,0,1,7,8,false,false,false,0.218,0.782
281,427,-146,16.529412,26.6875,-146,1045,1100,-55,0,1,0,0.0625,-14,17,16,-2.428571,0,0,2,4,false,false,false,0,1
125,335,-210,17.857143,47.857143,-210,1219,1216,3,0,3,0,0.428571,34,7,7,0.794118,0,0,8,17,false,false,false,0,1
216,384,-168,12.705882,22.588235,-168,948,998,-50,0,0,0,0,-17,17,17,-2.176471,0,0,4,1,false,false,false,0,1
337,387,-50,19.823529,22.764706,-50,892,856,36,1,1,0.058824,0.058824,-26,17,17,-1.346154,0,0,3,1,false,false,false,0,1
169,275,-106,15.363636,25,-106,480,739,-259,0,0,0,0,28,11,11,1.392857,1,0,20,14,false,false,false,0,1
118,135,-17,19.666667,27,-17,1636,1702,-66,0,1,0,0.2,64,6,5,0.453125,0,1,10,7,false,false,false,0.271,0.729
26,0,26,26,0,26,1071,1065,6,0,0,0,0,95,1,0,0.326316,0,0,9,0,false,false,true,0.563,0.437
101,189,-88,16.833333,31.5,-88,971,800,171,0,1,0,0.166667,40,6,6,0.725,1,0,13,16,false,false,false,0.042,0.958
301,411,-110,16.722222,22.833333,-110,965,1078,-113,1,1,0.055556,0.055556,-23,18,18,-1.608696,1,0,0,1,false,false,false,0,1
122,117,5,17.428571,19.5,5,595,538,57,0,0,0,0,53,7,6,0.716981,0,0,10,13,false,false,true,0.538,0.462
229,323,-94,17.615385,24.846154,-94,1408,1539,-131,0,1,0,0.076923,1,13,13,34,0,1,10,24,false,false,false,0,1
206,279,-73,15.846154,21.461538,-73,758,791,-33,0,0,0,0,12,13,13,3.25,1,0,7,19,false,false,false,0.014,0.986
125,197,-72,15.625,24.625,-72,452,698,-246,0,1,0,0.125,48,8,8,0.854167,0,0,20,9,false,false,false,0.077,0.923
137,202,-65,13.7,22.444444,-65,343,570,-227,0,0,0,0,27,10,9,1.333333,1,0,16,10,false,false,false,0.069,0.931
60,86,-26,12,17.2,-26,391,542,-151,1,0,0.2,0,65,5,5,0.707692,0,0,9,10,false,false,false,0.206,0.794
279,383,-104,17.4375,23.9375,-104,965,1078,-113,1,1,0.0625,0.0625,-7,16,16,-5.285714,1,0,5,13,false,false,false,0,1
129,87,42,18.428571,14.5,42,1633,1556,77,0,0,0,0,52,7,6,0.634615,0,0,16,7,false,false,false,0.403,0.597
196,244,-48,13.066667,17.428571,-48,595,540,55,0,0,0,0,10,15,14,4.3,0,0,10,11,false,false,false,0.071,0.929
259,299,-40,11.772727,14.238095,-40,226,361,-135,0,0,0,0,-31,22,21,-1.419355,0,0,1,3,false,false,false,0,1
339,426,-87,24.214286,30.428571,-87,1415,1361,54,0,1,0,0.071429,-7,14,14,-4.428571,0,1,10,3,false,false,false,0,1
272,370,-98,16,23.125,-98,595,733,-138,1,1,0.058824,0.0625,-14,17,16,-2.785714,0,1,22,6,false,false,false,0,1
133,163,-30,19,23.285714,-30,1075,878,197,0,0,0,0,56,7,7,0.589286,0,0,10,8,false,false,false,0.428,0.572
59,122,-63,11.8,24.4,-63,653,1004,-351,0,0,0,0,62,5,5,0.467742,1,1,11,8,false,false,false,0.001,0.999
118,133,-15,23.6,26.6,-15,1586,1633,-47,1,0,0.2,0,71,5,5,0.478873,0,0,17,9,false,false,true,0.551,0.449
218,284,-66,12.823529,16.705882,-66,1248,1220,28,0,1,0,0.058824,10,17,17,5.2,1,0,6,13,false,false,false,0.038,0.962
215,162,53,17.916667,14.727273,53,897,996,-99,0,0,0,0,31,12,11,1.258065,0,0,10,10,false,false,true,0.849,0.151
257,273,-16,19.769231,21,-16,985,1062,-77,0,0,0,0,10,13,13,3.7,1,0,13,9,false,false,false,0.172,0.828
21,21,0,10.5,21,0,1101,1130,-29,0,0,0,0,90,2,1,0.5,0,1,7,10,false,false,false,0.298,0.702
96,114,-18,16,22.8,-18,620,698,-78,0,0,0,0,68,6,5,0.602941,0,0,29,18,false,false,false,0.084,0.916
78,110,-32,15.6,27.5,-32,668,363,305,0,0,0,0,73,5,4,0.643836,0,0,8,9,false,false,false,0.107,0.893
84,55,29,21,18.333333,29,387,683,-296,0,0,0,0,72,4,3,0.472222,1,0,13,9,false,false,false,0.24,0.76
223,304,-81,15.928571,21.714286,-81,595,412,183,0,1,0,0.071429,15,14,14,3.466667,0,0,11,9,false,false,false,0.07,0.93
146,61,85,36.5,20.333333,85,691,695,-4,1,0,0.25,0,71,4,3,0.450704,0,0,15,19,false,false,true,0.888,0.112
161,189,-28,13.416667,17.181818,-28,840,1055,-215,0,0,0,0,23,12,11,1.521739,0,1,23,15,false,false,false,0.022,0.978
60,68,-8,12,17,-8,391,542,-151,1,0,0.2,0,69,5,4,0.666667,0,1,9,11,false,false,false,0,1
295,329,-34,21.071429,23.5,-34,1452,1388,64,0,1,0,0.071429,2,14,14,17.5,0,0,14,12,false,false,false,0.038,0.962
248,312,-64,16.533333,22.285714,-64,594,648,-54,1,1,0.066667,0.071429,11,15,14,3.636364,0,0,14,15,false,false,false,0,1
144,172,-28,18,21.5,-28,1030,1014,16,0,0,0,0,48,8,8,0.6875,0,1,18,9,false,false,false,0.266,0.734
55,104,-49,18.333333,34.666667,-49,1248,1220,28,0,1,0,0.333333,76,3,3,0.684211,0,0,8,15,false,false,false,0.271,0.729
155,164,-9,15.5,18.222222,-9,1040,1364,-324,0,0,0,0,30,10,9,1.2,0,0,8,12,false,false,false,0.081,0.919
12,17,-5,12,17,-5,542,390,152,0,0,0,0,94,1,1,0.531915,0,0,10,10,false,false,true,0.736,0.264
165,120,45,20.625,15,45,1065,948,117,0,0,0,0,51,8,8,0.764706,0,0,15,8,false,false,true,0.935,0.065
130,106,24,26,26.5,24,1636,1727,-91,0,1,0,0.25,65,5,4,0.461538,0,0,8,8,false,false,false,0.443,0.557
56,71,-15,18.666667,35.5,-15,1422,1583,-161,0,1,0,0.5,78,3,2,0.525641,0,0,14,13,false,false,false,0.272,0.728
143,122,21,20.428571,20.333333,21,1561,1495,66,1,0,0.142857,0,47,7,6,0.702128,1,0,8,11,false,false,true,0.894,0.106
35,136,-101,8.75,45.333333,-101,760,976,-216,0,1,0,0.333333,73,4,3,0.493151,0,0,15,10,false,false,false,0.059,0.941
156,182,-26,19.5,22.75,-26,356,498,-142,0,1,0,0.125,43,8,8,0.813953,1,1,9,16,false,false,false,0.171,0.829
142,117,25,20.285714,16.714286,25,704,523,181,0,0,0,0,46,7,7,0.76087,0,0,7,15,false,false,true,0.729,0.271
75,30,45,25,10,45,742,594,148,0,0,0,0,79,3,3,0.493671,0,0,15,11,false,false,true,0.871,0.129
260,292,-32,13,15.368421,-32,500,532,-32,0,0,0,0,-23,20,19,-1.782609,0,1,16,1,false,false,false,0,1
120,281,-161,12,31.222222,-161,1164,1149,15,0,1,0,0.111111,49,10,9,0.959184,0,0,12,9,false,false,false,0,1
199,234,-35,22.111111,29.25,-35,1101,1237,-136,1,0,0.111111,0,37,9,8,0.918919,0,0,7,8,false,false,false,0.025,0.975
155,227,-72,11.923077,17.461538,-72,1182,1075,107,0,1,0,0.076923,11,13,13,3.545455,0,1,22,6,false,false,false,0,1
83,47,36,16.6,9.4,36,1168,1216,-48,0,0,0,0,76,5,5,0.434211,0,0,13,27,false,false,false,0.443,0.557
286,335,-49,20.428571,23.928571,-49,892,856,36,1,1,0.071429,0.071429,-3,14,14,-11.666667,0,0,17,13,false,false,false,0,1
232,307,-75,15.466667,20.466667,-75,1101,1130,-29,1,1,0.066667,0.066667,11,15,15,4.090909,0,1,9,7,false,false,false,0,1
206,178,28,29.428571,29.666667,28,714,820,-106,1,0,0.142857,0,51,7,6,0.607843,0,0,11,9,false,false,false,0.303,0.697
114,127,-13,14.25,18.142857,-13,848,976,-128,0,0,0,0,52,8,7,0.769231,0,0,19,10,false,false,false,0.074,0.926
27,18,9,13.5,9,9,491,651,-160,0,0,0,0,88,2,2,0.340909,0,1,14,10,false,false,false,0.25,0.75
22,0,22,22,0,22,714,892,-178,0,0,0,0,95,1,0,0.442105,1,0,15,0,false,false,false,0.353,0.647
71,153,-82,23.666667,51,-82,1388,1455,-67,0,0,0,0,69,3,3,0.405797,0,0,14,16,false,false,false,0.031,0.969
302,323,-21,12.583333,13.458333,-21,671,638,33,0,0,0,0,-36,24,24,-1.361111,0,0,2,1,false,false,true,0.627,0.373
228,260,-32,22.8,28.888889,-32,1266,1339,-73,0,1,0,0.111111,39,10,9,0.897436,0,1,13,14,false,false,false,0.059,0.941
29,87,-58,7.25,21.75,-58,907,1070,-163,0,0,0,0,75,4,4,0.466667,0,0,22,16,false,false,false,0.072,0.928
235,299,-64,16.785714,23,-64,1071,1181,-110,0,0,0,0,12,14,13,2.833333,0,0,20,13,false,false,false,0,1
16,27,-11,16,27,-11,1633,1620,13,0,0,0,0,92,1,1,0.391304,0,0,10,27,false,false,false,0.271,0.729
163,81,82,27.166667,16.2,82,540,498,42,1,0,0.166667,0,62,6,5,0.741935,0,1,12,12,false,false,true,0.789,0.211
117,155,-38,19.5,31,-38,1315,1331,-16,0,0,0,0,57,6,5,0.578947,0,0,16,15,false,false,false,0.226,0.774
351,375,-24,23.4,26.785714,-24,1173,1256,-83,2,0,0.133333,0,-6,15,14,-5.166667,0,1,1,3,false,false,false,0,1
359,496,-137,23.933333,35.428571,-137,1586,1633,-47,1,1,0.066667,0.071429,-5,15,14,-6.8,0,0,4,7,false,false,false,0,1
318,304,14,18.705882,19,14,804,766,38,0,1,0,0.0625,3,17,16,13.666667,0,0,11,10,false,false,true,0.832,0.168
180,220,-40,18,22,-40,907,910,-3,0,1,0,0.1,43,10,10,1,0,1,10,18,false,false,false,0.082,0.918
176,229,-53,22,28.625,-53,1422,1798,-376,0,1,0,0.125,39,8,8,0.820513,0,1,18,12,false,false,false,0.008,0.992
84,182,-98,12,26,-98,1220,1202,18,0,0,0,0,53,7,7,0.943396,0,0,20,7,false,false,false,0.057,0.943
199,180,19,19.9,18,19,952,870,82,0,0,0,0,30,10,10,1.233333,1,0,6,34,false,false,true,0.736,0.264
196,347,-151,14,24.785714,-151,710,758,-48,0,1,0,0.071429,15,14,14,2.466667,0,0,9,10,false,false,false,0,1
297,355,-58,15.631579,18.684211,-58,736,791,-55,0,0,0,0,-25,19,19,-1.52,0,0,4,2,true,false,false,0,1
231,227,4,17.769231,18.916667,4,1310,1477,-167,0,0,0,0,7,13,12,5.142857,0,0,17,10,false,false,false,0.089,0.911
80,145,-65,13.333333,29,-65,430,542,-112,0,1,0,0.2,61,6,5,0.786885,0,0,23,10,false,false,false,0.075,0.925
220,255,-35,20,25.5,-35,1055,1019,36,0,0,0,0,16,11,10,2.0625,1,0,6,7,false,false,false,0.05,0.95
208,130,78,20.8,14.444444,78,1065,948,117,0,0,0,0,43,10,9,0.906977,0,0,12,8,false,false,true,0.978,0.022
223,340,-117,14.866667,22.666667,-117,503,668,-165,0,1,0,0.066667,0,15,15,0,2,0,5,18,false,false,false,0.005,0.995
238,281,-43,19.833333,23.416667,-43,566,742,-176,0,1,0,0.083333,10,12,12,3.2,0,0,10,22,false,false,false,0.084,0.916
101,153,-52,12.625,19.125,-52,668,363,305,0,0,0,0,51,8,8,0.921569,0,0,8,9,false,false,false,0.094,0.906
291,325,-34,18.1875,20.3125,-34,689,804,-115,0,1,0,0.0625,-12,16,16,-2.916667,0,1,4,4,false,false,false,0.003,0.997
16,11,5,16,11,5,797,796,1,0,0,0,0,95,1,1,0.515789,0,0,7,7,false,false,true,0.569,0.431
280,298,-18,17.5,19.866667,-18,944,1095,-151,0,1,0,0.066667,7,16,15,5.571429,0,2,9,8,false,false,false,0,1
60,94,-34,30,47,-34,976,995,-19,0,1,0,0.5,84,2,2,0.452381,0,0,7,12,false,false,false,0.275,0.725
24,26,-2,8,13,-2,288,359,-71,0,0,0,0,87,3,2,0.310345,0,1,10,7,false,false,false,0.143,0.857
185,262,-77,12.333333,17.466667,-77,595,662,-67,0,1,0,0.066667,6,15,15,7.333333,0,0,16,14,false,false,false,0,1
263,287,-24,15.470588,16.882353,-24,840,1055,-215,0,0,0,0,-13,17,17,-2.692308,0,0,9,2,false,false,false,0.002,0.998
282,349,-67,15.666667,20.529412,-67,341,416,-75,0,0,0,0,-15,18,17,-2.6,0,1,2,5,false,false,false,0,1
141,255,-114,15.666667,31.875,-114,1093,1100,-7,0,1,0,0.125,44,9,8,0.795455,0,0,7,9,false,false,false,0.026,0.974
78,72,6,15.6,14.4,6,542,390,152,0,0,0,0,77,5,5,0.649351,0,1,10,15,false,false,true,0.6,0.4
136,295,-159,8,18.4375,-159,651,567,84,0,0,0,0,10,17,16,5.5,0,1,11,9,false,false,false,0,1
266,324,-58,17.733333,23.142857,-58,1633,1739,-106,1,0,0.066667,0,1,15,14,34,1,0,9,17,false,false,false,0.001,0.999
173,183,-10,19.222222,22.875,-10,1488,1428,60,1,0,0.111111,0,40,9,8,0.925,0,0,25,14,false,false,false,0.273,0.727
285,427,-142,16.764706,25.117647,-142,1315,1334,-19,0,2,0,0.117647,-15,17,17,-2.4,0,0,1,4,false,false,false,0,1
112,97,15,18.666667,19.4,15,1131,1030,101,0,0,0,0,63,6,5,0.47619,1,0,11,12,false,false,true,0.702,0.298
199,213,-14,18.090909,19.363636,-14,615,542,73,0,0,0,0,32,11,11,1.3125,0,0,13,10,false,false,true,0.541,0.459
186,188,-2,16.909091,18.8,-2,500,532,-32,0,0,0,0,28,11,10,1.464286,0,0,15,14,false,false,false,0.227,0.773
71,54,17,17.75,13.5,17,1030,998,32,0,0,0,0,68,4,4,0.544118,0,0,7,7,false,false,true,0.588,0.412
286,302,-16,19.066667,21.571429,-16,1245,1148,97,0,0,0,0,-6,15,14,-5.833333,0,0,13,5,false,false,false,0.116,0.884
169,219,-50,14.083333,18.25,-50,830,787,43,0,0,0,0,22,12,12,1.727273,0,0,8,8,false,false,false,0.142,0.858
144,118,26,18,16.857143,26,952,870,82,0,0,0,0,44,8,7,0.840909,1,0,12,33,false,false,true,0.639,0.361
2,31,-29,1,15.5,-29,1793,1869,-76,0,0,0,0,92,2,2,0.326087,0,0,11,11,false,false,false,0.272,0.728
297,390,-93,14.85,20.526316,-93,952,826,126,0,1,0,0.052632,-16,20,19,-2.6875,0,0,4,5,false,false,false,0,1
101,134,-33,14.428571,22.333333,-33,948,998,-50,0,0,0,0,52,7,6,0.711538,1,0,7,10,false,false,false,0.252,0.748
230,283,-53,19.166667,23.583333,-53,1205,1216,-11,0,0,0,0,17,12,12,1.941176,0,0,16,12,false,false,false,0.057,0.943
246,252,-6,13.666667,14.823529,-6,999,1071,-72,0,0,0,0,-10,18,17,-4,0,0,6,14,false,false,false,0.299,0.701
150,315,-165,8.823529,19.6875,-165,651,996,-345,0,2,0,0.125,-5,17,16,-9,0,0,26,10,false,false,false,0,1
89,81,8,17.8,20.25,8,599,448,151,0,0,0,0,66,5,4,0.545455,0,0,7,16,false,false,true,0.529,0.471
39,15,24,19.5,7.5,24,1220,1185,35,0,0,0,0,84,2,2,0.559524,0,1,25,11,false,false,true,0.57,0.43
291,289,2,14.55,15.210526,2,796,800,-4,1,0,0.05,0,-6,20,19,-8,0,1,12,8,false,false,false,0,1
83,80,3,16.6,16,3,1310,1477,-167,0,0,0,0,62,5,5,0.580645,0,0,8,8,false,false,false,0.289,0.711
55,59,-4,13.75,19.666667,-4,840,1055,-215,0,0,0,0,74,4,3,0.472973,0,0,15,17,false,false,false,0.131,0.869
255,444,-189,19.615385,37,-189,1219,1216,3,1,4,0.076923,0.333333,-12,13,12,-2.25,0,0,1,5,false,false,false,0,1
14,10,4,7,10,4,1278,1101,177,0,0,0,0,90,2,1,0.411111,1,0,16,10,false,false,true,0.733,0.267
54,79,-25,18,26.333333,-25,1699,1803,-104,0,0,0,0,80,3,3,0.4375,0,1,9,9,false,false,false,0.266,0.734
254,257,-3,25.4,25.7,-3,1354,1210,144,0,1,0,0.1,25,10,10,1.32,0,0,17,12,false,false,false,0.313,0.687
76,47,29,25.333333,23.5,29,892,856,36,0,0,0,0,82,3,2,0.426829,0,0,9,10,false,false,true,0.612,0.388
12,17,-5,12,17,-5,999,1071,-72,0,0,0,0,92,1,1,0.434783,0,0,8,8,false,false,true,0.54,0.46
16,29,-13,16,29,-13,1159,1131,28,0,0,0,0,93,1,1,0.397849,0,1,12,6,false,false,false,0.317,0.683
8,0,8,8,0,8,1439,1428,11,0,0,0,0,96,1,0,0.416667,0,0,7,0,false,false,true,0.559,0.441
56,65,-9,14,16.25,-9,540,498,42,0,0,0,0,75,4,4,0.613333,0,1,12,11,false,false,true,0.523,0.477
22,27,-5,22,27,-5,714,892,-178,0,0,0,0,91,1,1,0.461538,1,1,15,19,false,false,false,0.223,0.777
215,261,-46,12.647059,16.3125,-46,226,361,-135,0,0,0,0,-15,17,16,-2.933333,0,0,18,12,false,false,false,0,1
136,121,15,19.428571,20.166667,15,742,868,-126,0,0,0,0,56,7,6,0.589286,0,0,11,12,false,false,false,0.187,0.813
278,265,13,27.8,29.444444,13,1331,1432,-101,0,0,0,0,18,10,9,1.5,0,1,16,15,false,false,false,0.168,0.832
277,309,-32,17.3125,20.6,-32,568,570,-2,0,0,0,0,0,16,15,0,0,0,5,9,false,false,false,0.018,0.982
317,319,-2,31.7,31.9,-2,1167,1245,-78,2,0,0.2,0,3,10,10,7.666667,0,1,14,7,false,false,false,0.161,0.839
192,198,-6,24,24.75,-6,689,804,-115,0,0,0,0,37,8,8,0.945946,0,0,7,9,false,false,false,0.198,0.802
290,393,-103,17.058824,24.5625,-103,1094,1159,-65,0,0,0,0,-16,17,16,-2.375,1,0,2,3,false,false,false,0,1
178,242,-64,19.777778,26.888889,-64,1473,1500,-27,0,2,0,0.222222,36,9,9,1.083333,0,0,14,19,false,false,false,0.219,0.781
144,184,-40,20.571429,26.285714,-40,804,766,38,0,1,0,0.142857,58,7,7,0.706897,0,1,7,10,false,false,false,0.2,0.8
92,80,12,15.333333,16,12,1310,1477,-167,0,0,0,0,58,6,5,0.62069,1,0,11,8,false,false,false,0.416,0.584
289,285,4,14.45,15,4,361,413,-52,0,0,0,0,-30,20,19,-1.366667,0,0,2,2,false,false,true,0.936,0.064
223,224,-1,17.153846,18.666667,-1,595,538,57,0,0,0,0,17,13,12,2.235294,0,1,10,6,false,false,false,0.447,0.553
108,175,-67,10.8,19.444444,-67,818,826,-8,0,0,0,0,51,10,9,1.039216,1,0,8,20,false,false,false,0.016,0.984
78,110,-32,19.5,27.5,-32,668,363,305,0,0,0,0,73,4,4,0.643836,0,0,8,9,false,false,false,0.219,0.781
64,109,-45,21.333333,36.333333,-45,976,995,-19,0,1,0,0.333333,79,3,3,0.481013,0,0,8,10,false,false,false,0.271,0.729
32,6,26,32,6,26,1636,1727,-91,0,0,0,0,90,1,1,0.333333,0,0,17,9,false,false,true,0.73,0.27
308,332,-24,16.210526,17.473684,-24,576,602,-26,0,0,0,0,-20,19,19,-2.1,0,0,1,1,false,false,false,0.059,0.941
63,25,38,21,12.5,38,1652,1473,179,0,0,0,0,79,3,2,0.379747,0,0,18,9,false,false,true,0.616,0.384
226,254,-28,16.142857,18.142857,-28,450,503,-53,0,0,0,0,10,14,14,3.9,1,0,9,12,false,false,false,0.157,0.843
251,231,20,20.916667,19.25,20,1168,1062,106,0,0,0,0,27,12,12,1.592593,1,0,7,9,false,false,true,0.611,0.389
288,305,-17,16.941176,17.941176,-17,518,461,57,0,0,0,0,-18,17,17,-2,0,0,2,2,false,false,false,0.14,0.86
232,294,-62,19.333333,24.5,-62,1633,1620,13,0,0,0,0,9,12,12,4,0,0,13,7,false,false,false,0.004,0.996
254,326,-72,13.368421,18.111111,-72,1278,1101,177,0,1,0,0.055556,-11,19,18,-3.363636,0,0,10,1,true,false,false,0,1
63,136,-73,12.6,34,-73,1270,1424,-154,0,1,0,0.25,72,5,4,0.486111,0,0,11,11,false,false,false,0.167,0.833
384,385,-1,25.6,25.666667,-1,1552,1803,-251,3,0,0.2,0,-12,15,15,-2.75,0,0,7,2,false,false,false,0.314,0.686
214,209,5,16.461538,17.416667,5,796,800,-4,1,0,0.076923,0,25,13,12,1.92,0,0,11,16,false,false,false,0.298,0.702
313,273,40,20.866667,18.2,40,1488,1428,60,1,0,0.066667,0,5,15,15,7.4,0,1,25,6,false,false,true,0.73,0.27
23,36,-13,11.5,18,-13,700,820,-120,0,0,0,0,87,2,2,0.436782,0,0,17,9,false,false,false,0.206,0.794
127,64,63,31.75,16,63,1341,1606,-265,1,0,0.25,0,62,4,4,0.532258,0,0,7,15,false,false,true,0.837,0.163
202,246,-44,16.833333,22.363636,-44,805,918,-113,0,0,0,0,16,12,11,2.25,0,0,10,24,false,false,false,0.012,0.988
36,17,19,18,17,19,1636,1796,-160,0,0,0,0,88,2,1,0.306818,0,0,18,22,false,false,false,0.164,0.836
224,365,-141,14,24.333333,-141,530,683,-153,0,1,0,0.066667,8,16,15,5,0,0,23,9,false,false,false,0,1
74,117,-43,18.5,39,-43,1408,1539,-131,0,1,0,0.333333,71,4,3,0.478873,0,0,12,12,false,false,false,0.271,0.729
80,60,20,20,20,20,704,523,181,0,0,0,0,73,4,3,0.479452,1,0,12,10,false,false,true,0.828,0.172
243,272,-29,12.789474,14.315789,-29,163,346,-183,0,0,0,0,-33,19,19,-1.181818,0,0,1,4,false,false,false,0.047,0.953
161,182,-21,23,26,-21,576,602,-26,0,0,0,0,53,7,7,0.792453,0,0,8,7,false,false,false,0.182,0.818
384,388,-4,24,24.25,-4,1552,1803,-251,3,0,0.1875,0,-15,16,16,-2.2,0,0,7,2,false,false,false,0.013,0.987
135,147,-12,19.285714,21,-12,1055,840,215,0,0,0,0,51,7,7,0.705882,0,0,9,12,false,false,false,0.498,0.502
241,332,-91,20.083333,27.666667,-91,1583,1403,180,0,0,0,0,13,12,12,2.461538,0,0,14,18,false,false,false,0,1
253,357,-104,13.315789,18.789474,-104,632,603,29,0,1,0,0.052632,-30,19,19,-1.266667,0,0,1,1,true,false,false,0,1
203,253,-50,20.3,25.3,-50,1305,1211,94,1,0,0.1,0,34,10,10,0.970588,1,0,6,7,false,false,false,0.033,0.967
241,275,-34,18.538462,21.153846,-34,1055,840,215,0,1,0,0.076923,10,13,13,3.6,1,0,9,24,false,false,false,0.083,0.917
347,436,-89,20.411765,25.647059,-89,1537,1539,-2,0,1,0,0.058824,-24,17,17,-1.416667,0,1,1,1,true,false,false,0,1
225,415,-190,12.5,24.411765,-190,940,947,-7,0,2,0,0.117647,-12,18,17,-2.916667,1,0,7,8,true,false,false,0,1
197,238,-41,21.888889,26.444444,-41,1305,1211,94,1,0,0.111111,0,41,9,9,0.804878,1,0,6,8,false,false,false,0.046,0.954
337,335,2,24.071429,23.928571,2,1563,1539,24,0,1,0,0.071429,-11,14,14,-3.181818,0,0,2,4,false,false,false,0.16,0.84
242,299,-57,11.52381,14.238095,-57,1220,1202,18,0,0,0,0,-17,21,21,-2.941176,0,1,26,15,false,false,false,0,1
262,323,-61,13.1,16.15,-61,1071,1000,71,0,0,0,0,-22,20,20,-2.136364,0,0,3,2,false,false,false,0,1
338,346,-8,24.142857,26.615385,-8,169,306,-137,2,1,0.142857,0.076923,-13,14,13,-2.384615,0,0,2,8,false,false,false,0.001,0.999
100,116,-16,12.5,16.571429,-16,163,346,-183,0,0,0,0,46,8,7,0.847826,1,1,6,15,false,false,false,0.001,0.999
0,32,-32,0,32,-32,813,698,115,0,0,0,0,95,1,1,0.505263,0,0,7,7,false,false,false,0.245,0.755
63,50,13,21,25,13,985,1062,-77,0,0,0,0,84,3,2,0.440476,0,0,8,16,false,false,false,0.177,0.823
83,76,7,20.75,25.333333,7,1415,1361,54,0,0,0,0,81,4,3,0.382716,0,1,11,22,false,false,false,0.27,0.73
161,158,3,20.125,22.571429,3,1269,1477,-208,1,0,0.125,0,50,8,7,0.7,0,1,11,11,false,false,false,0.19,0.81
316,380,-64,18.588235,22.352941,-64,480,739,-259,1,0,0.058824,0,-7,17,17,-5.571429,0,0,4,5,false,false,false,0,1
194,227,-33,17.636364,20.636364,-33,599,448,151,0,0,0,0,25,11,11,1.44,0,0,10,7,false,false,false,0.238,0.762
27,44,-17,13.5,22,-17,1075,878,197,0,0,0,0,87,2,2,0.37931,0,0,19,14,false,false,true,0.51,0.49
201,221,-20,14.357143,17,-20,430,542,-112,0,1,0,0.076923,18,14,13,2.666667,0,0,32,16,false,false,false,0.127,0.873
184,150,34,30.666667,25,34,1397,1405,-8,1,0,0.166667,0,49,6,6,0.591837,0,0,13,13,false,false,true,0.588,0.412
34,49,-15,17,24.5,-15,1161,1030,131,0,0,0,0,84,2,2,0.452381,0,0,10,19,false,false,false,0.393,0.607
294,347,-53,16.333333,20.411765,-53,452,698,-246,0,1,0,0.058824,-14,18,17,-2.928571,0,0,5,3,false,false,false,0,1
32,56,-24,16,28,-24,1071,1000,71,0,0,0,0,86,2,2,0.546512,0,0,8,10,false,false,false,0.272,0.728
58,24,34,14.5,8,34,491,651,-160,0,0,0,0,78,4,3,0.384615,0,1,12,10,false,false,false,0.431,0.569
264,303,-39,16.5,20.2,-39,1281,1268,13,0,0,0,0,7,16,15,6,1,0,7,14,false,false,false,0.044,0.956
268,386,-118,12.761905,18.380952,-118,907,878,29,0,0,0,0,-17,21,21,-2.529412,0,0,4,5,false,false,false,0,1
30,75,-45,30,75,-45,1556,1656,-100,0,1,0,1,88,1,1,0.340909,0,0,11,7,false,false,false,0.419,0.581
23,14,9,11.5,14,9,561,688,-127,0,0,0,0,87,2,1,0.528736,1,0,11,11,false,false,false,0.218,0.782
323,348,-25,23.071429,24.857143,-25,804,1074,-270,0,0,0,0,-7,14,14,-4.571429,0,0,3,2,false,false,false,0.078,0.922
115,82,33,14.375,11.714286,33,491,651,-160,0,0,0,0,56,8,7,0.535714,0,1,10,6,false,false,true,0.578,0.422
229,360,-131,15.266667,24,-131,450,427,23,1,1,0.066667,0.066667,-9,15,15,-4.111111,0,0,13,12,false,false,false,0,1
191,216,-25,21.222222,27,-25,1173,1256,-83,1,0,0.111111,0,40,9,8,0.775,1,1,8,16,false,false,false,0.005,0.995
95,128,-33,13.571429,21.333333,-33,668,363,305,0,0,0,0,60,7,6,0.783333,0,0,8,12,false,false,false,0.126,0.874
273,391,-118,18.2,27.928571,-118,1656,1649,7,0,0,0,0,-5,15,14,-6.4,0,0,1,7,false,false,false,0,1
182,205,-23,15.166667,17.083333,-23,526,502,24,0,0,0,0,29,12,12,1.724138,0,0,13,10,false,false,false,0.438,0.562
69,69,0,17.25,17.25,0,1040,1364,-324,0,0,0,0,71,4,4,0.507042,0,0,19,18,false,false,false,0.233,0.767
100,120,-20,12.5,17.142857,-20,568,570,-2,0,0,0,0,53,8,7,0.698113,0,0,17,20,false,false,false,0.187,0.813
118,218,-100,9.076923,16.769231,-100,1078,983,95,0,0,0,0,27,13,13,1.777778,1,1,7,14,false,false,false,0.039,0.961
290,397,-107,17.058824,23.352941,-107,1094,1159,-65,0,0,0,0,-19,17,17,-2,1,0,2,1,false,false,false,0,1
153,253,-100,10.928571,19.461538,-100,388,542,-154,0,0,0,0,11,14,13,3.363636,0,1,11,9,false,false,false,0,1
228,357,-129,11.4,17.85,-129,1248,1220,28,0,1,0,0.05,-4,20,20,-13,1,0,8,9,false,false,false,0,1
59,59,0,14.75,19.666667,0,1312,1334,-22,0,0,0,0,76,4,3,0.513158,0,0,16,21,false,false,false,0.27,0.73
170,206,-36,18.888889,25.75,-36,595,733,-138,1,1,0.111111,0.125,34,9,8,1.147059,0,1,29,16,false,false,false,0.001,0.999
33,29,4,11,14.5,4,771,668,103,0,0,0,0,83,3,2,0.457831,1,0,10,7,false,false,true,0.769,0.231
139,128,11,12.636364,12.8,11,1045,948,97,0,0,0,0,25,11,10,1.36,0,0,12,11,false,false,true,0.555,0.445
54,23,31,27,23,31,892,856,36,0,0,0,0,89,2,1,0.393258,0,0,13,10,false,false,true,0.611,0.389
102,106,-4,17,21.2,-4,727,820,-93,0,1,0,0.2,57,6,5,0.614035,0,0,16,13,false,false,false,0.442,0.558
93,111,-18,13.285714,15.857143,-18,361,413,-52,0,0,0,0,52,7,7,0.788462,0,0,21,7,false,false,false,0.344,0.656
41,44,-3,13.666667,14.666667,-3,1488,1403,85,0,0,0,0,81,3,3,0.419753,0,1,18,9,false,false,false,0.301,0.699
243,339,-96,20.25,28.25,-96,1173,1256,-83,1,0,0.083333,0,16,12,12,1.9375,1,1,9,8,false,false,false,0,1
326,396,-70,20.375,26.4,-70,1422,1798,-376,0,2,0,0.133333,-9,16,15,-3.555556,0,0,2,2,false,false,false,0,1
285,355,-70,20.357143,25.357143,-70,1126,1277,-151,0,0,0,0,-12,14,14,-2.916667,0,0,4,8,false,false,false,0,1
297,367,-70,17.470588,21.588235,-70,954,939,15,1,0,0.058824,0,-19,17,17,-1.894737,0,0,1,1,false,false,false,0,1
367,468,-101,20.388889,27.529412,-101,1699,1803,-104,1,1,0.055556,0.058824,-8,18,17,-4.375,0,0,6,3,true,false,false,0,1
133,214,-81,19,30.571429,-81,1110,1399,-289,0,1,0,0.142857,46,7,7,0.73913,0,0,29,9,false,false,false,0,1
258,299,-41,11.727273,13.590909,-41,683,859,-176,0,0,0,0,-2,22,22,-22.5,0,0,9,17,false,false,false,0,1
197,286,-89,21.888889,31.777778,-89,724,398,326,1,1,0.111111,0.111111,39,9,9,1,1,0,6,8,false,false,false,0.045,0.955
97,121,-24,19.4,30.25,-24,1167,1245,-78,0,0,0,0,59,5,4,0.389831,0,0,11,12,false,false,false,0.26,0.74
139,131,8,17.375,18.714286,8,450,503,-53,0,0,0,0,47,8,7,0.829787,1,0,20,10,false,false,true,0.555,0.445
224,276,-52,24.888889,34.5,-52,1164,1261,-97,0,1,0,0.125,42,9,8,1,0,0,13,7,false,false,false,0.1,0.9
150,200,-50,15,20,-50,651,700,-49,0,0,0,0,35,10,10,1.6,1,0,6,12,false,false,false,0.078,0.922
257,303,-46,16.0625,20.2,-46,1439,1428,11,0,0,0,0,6,16,15,6.666667,1,0,12,9,false,false,false,0.035,0.965
256,360,-104,36.571429,51.428571,-104,2147,2219,-72,1,2,0.142857,0.285714,27,7,7,0.888889,0,0,13,22,false,false,false,0,1
263,287,-24,14.611111,16.882353,-24,840,1055,-215,0,0,0,0,-13,18,17,-2.692308,0,0,9,2,true,false,false,0,1
219,283,-64,18.25,25.727273,-64,1229,1220,9,0,1,0,0.090909,22,12,11,1.681818,0,0,9,11,false,false,false,0.028,0.972
284,332,-48,25.818182,30.181818,-48,1253,1324,-71,0,1,0,0.090909,15,11,11,1.933333,0,0,18,8,false,false,false,0.051,0.949
155,157,-2,22.142857,22.428571,-2,621,786,-165,0,0,0,0,37,7,7,0.810811,0,0,18,10,false,false,false,0.246,0.754
22,0,22,22,0,22,1047,1127,-80,0,0,0,0,95,1,0,0.284211,1,0,15,0,false,false,true,0.725,0.275
8,20,-12,8,20,-12,1439,1428,11,0,0,0,0,94,1,1,0.425532,0,0,7,15,false,false,false,0.274,0.726
148,307,-159,14.8,34.111111,-159,1399,1210,189,0,1,0,0.111111,38,10,9,0.921053,0,0,20,7,false,false,false,0,1
151,171,-20,15.1,17.1,-20,526,502,24,0,0,0,0,42,10,10,1.190476,0,0,16,10,false,false,false,0.459,0.541
288,339,-51,18,22.6,-51,1055,1019,36,0,0,0,0,-17,16,15,-1.941176,0,0,2,1,false,false,false,0.002,0.998
24,26,-2,24,26,-2,1197,1156,41,0,0,0,0,89,1,1,0.393258,0,1,14,7,false,false,true,0.532,0.468
249,375,-126,14.647059,22.058824,-126,711,746,-35,0,0,0,0,-6,17,17,-6.333333,0,0,4,3,false,false,false,0,1
270,338,-68,15,18.777778,-68,603,721,-118,0,0,0,0,-10,18,18,-4.3,1,0,6,7,false,false,false,0,1
324,380,-56,20.25,23.75,-56,1417,1482,-65,0,1,0,0.0625,0,16,16,0,0,1,5,3,false,false,false,0,1
191,343,-152,17.363636,31.181818,-152,1045,1100,-55,0,1,0,0.090909,26,11,11,1.307692,0,0,12,12,false,false,false,0,1
40,113,-73,10,37.666667,-73,1270,1424,-154,0,1,0,0.333333,77,4,3,0.454545,0,0,10,11,false,false,false,0.256,0.744
203,240,-37,25.375,30,-37,732,868,-136,0,1,0,0.125,36,8,8,0.888889,0,0,13,9,false,false,false,0.139,0.861
148,141,7,21.142857,23.5,7,1055,1019,36,0,0,0,0,47,7,6,0.702128,1,0,13,11,false,false,true,0.664,0.336
264,346,-82,17.6,23.066667,-82,1633,1556,77,0,0,0,0,-12,15,15,-2.75,0,1,4,2,false,false,false,0,1
243,222,21,27,24.666667,21,1563,1539,24,0,1,0,0.111111,24,9,9,1.458333,0,0,19,17,false,false,true,0.626,0.374
251,300,-49,14.764706,17.647059,-49,615,542,73,0,0,0,0,-4,17,17,-10.5,0,0,11,7,false,false,false,0.007,0.993
252,369,-117,14.823529,21.705882,-117,503,668,-165,0,1,0,0.058824,-11,17,17,-3.363636,1,0,7,2,false,false,false,0,1
223,271,-48,13.9375,18.066667,-48,1071,1000,71,0,0,0,0,4,16,15,11.75,0,0,16,12,false,false,false,0,1
239,249,-10,19.916667,22.636364,-10,971,635,336,0,0,0,0,13,12,11,2.461538,0,0,7,12,false,false,false,0.078,0.922
51,113,-62,10.2,28.25,-62,940,947,-7,0,1,0,0.25,67,5,4,0.522388,0,1,11,8,false,false,false,0.264,0.736
286,332,-46,15.052632,17.473684,-46,889,855,34,0,1,0,0.052632,-19,19,19,-2.105263,0,0,1,1,false,false,false,0.036,0.964
195,333,-138,13.928571,25.615385,-138,760,976,-216,0,1,0,0.076923,3,14,13,12,0,1,10,20,false,false,false,0,1
38,14,24,19,14,24,1040,1091,-51,0,0,0,0,88,2,1,0.534091,0,0,11,18,false,false,false,0.484,0.516
196,237,-41,17.818182,21.545455,-41,356,498,-142,0,1,0,0.090909,20,11,11,1.75,1,0,9,16,false,false,false,0.097,0.903
258,275,-17,18.428571,19.642857,-17,1055,840,215,0,1,0,0.071429,7,14,14,5.142857,1,0,12,24,false,false,false,0.165,0.835
89,186,-97,9.888889,23.25,-97,595,662,-67,0,1,0,0.125,39,9,8,1.128205,0,1,28,6,false,false,false,0,1
14,17,-3,14,17,-3,1040,1364,-324,0,0,0,0,93,1,1,0.387097,0,0,10,13,false,false,false,0.212,0.788
247,291,-44,19,24.25,-44,954,939,15,1,0,0.076923,0,8,13,12,4.5,0,1,8,13,false,false,false,0,1
308,303,5,25.666667,27.545455,5,169,306,-137,2,1,0.166667,0.090909,3,12,11,10.333333,0,0,10,8,false,false,false,0.002,0.998
108,69,39,21.6,17.25,39,991,1063,-72,0,0,0,0,74,5,4,0.513514,0,0,16,21,false,false,false,0.315,0.685
187,237,-50,14.384615,19.75,-50,775,786,-11,0,0,0,0,20,13,12,2.15,1,0,6,20,false,false,false,0.019,0.981
156,131,25,26,26.2,25,1063,1134,-71,1,0,0.166667,0,61,6,5,0.721311,0,0,16,17,false,false,false,0.226,0.774
142,170,-28,17.75,21.25,-28,1334,1439,-105,1,0,0.125,0,61,8,8,0.590164,0,0,16,7,false,false,false,0.083,0.917
252,360,-108,16.8,24,-108,595,733,-138,1,1,0.066667,0.066667,-8,15,15,-4.875,0,1,23,10,false,false,false,0,1
31,34,-3,15.5,17,-3,1037,1009,28,0,0,0,0,87,2,2,0.505747,0,0,7,9,false,false,false,0.486,0.514
80,72,8,16,14.4,8,671,638,33,0,0,0,0,62,5,5,0.790323,0,0,18,16,false,false,true,0.769,0.231
128,216,-88,18.285714,30.857143,-88,1656,1649,7,0,0,0,0,44,7,7,0.727273,0,0,7,10,false,false,false,0.028,0.972
313,349,-36,15.65,18.368421,-36,1037,1009,28,0,0,0,0,-13,20,19,-3.384615,0,0,1,2,false,false,false,0,1
188,218,-30,17.090909,21.8,-30,771,668,103,0,0,0,0,21,11,10,1.809524,0,0,7,24,false,false,false,0.087,0.913
175,219,-44,17.5,24.333333,-44,1349,1203,146,0,1,0,0.111111,35,10,9,0.914286,0,0,8,17,false,false,false,0.036,0.964
59,77,-18,19.666667,25.666667,-18,842,926,-84,0,0,0,0,75,3,3,0.4,0,0,15,7,false,false,false,0.454,0.546
126,140,-14,12.6,15.555556,-14,391,542,-151,1,0,0.1,0,36,10,9,1.277778,0,0,7,10,false,false,false,0.279,0.721
164,188,-24,18.222222,20.888889,-24,1331,1374,-43,0,0,0,0,36,9,9,0.916667,0,0,25,10,false,false,false,0.299,0.701
177,199,-22,19.666667,22.111111,-22,967,856,111,0,0,0,0,38,9,9,0.868421,0,0,18,19,false,false,true,0.504,0.496
191,250,-59,17.363636,22.727273,-59,1488,1403,85,0,1,0,0.090909,17,11,11,2,0,0,11,18,false,false,false,0.035,0.965
248,208,40,24.8,23.111111,40,1397,1405,-8,1,0,0.1,0,26,10,9,1.115385,1,1,10,9,false,false,true,0.566,0.434
182,252,-70,16.545455,22.909091,-70,1161,1176,-15,1,1,0.090909,0.090909,19,11,11,2,0,0,9,25,false,false,false,0.025,0.975
145,216,-71,14.5,21.6,-71,813,698,115,1,0,0.1,0,38,10,10,1.263158,0,1,9,10,false,false,false,0.006,0.994
154,218,-64,14,19.818182,-64,568,570,-2,0,0,0,0,29,11,11,1.275862,0,0,10,14,false,false,false,0.028,0.972
215,245,-30,16.538462,20.416667,-30,1123,1062,61,0,0,0,0,22,13,12,2,0,0,13,11,false,false,false,0.169,0.831
251,310,-59,17.928571,23.846154,-59,1633,1739,-106,1,0,0.071429,0,6,14,13,5.666667,1,0,6,16,false,false,false,0.006,0.994
167,83,84,27.833333,16.6,84,1101,1237,-136,1,0,0.166667,0,58,6,5,0.586207,0,1,11,8,false,false,true,0.589,0.411
255,308,-53,12.75,15.4,-53,615,542,73,0,0,0,0,-12,20,20,-3.5,0,0,11,8,false,false,false,0,1
49,57,-8,24.5,28.5,-8,1159,1131,28,0,0,0,0,86,2,2,0.430233,0,1,12,8,false,false,false,0.406,0.594
228,208,20,25.333333,23.111111,20,1397,1405,-8,1,0,0.111111,0,28,9,9,1.035714,1,1,13,9,false,false,true,0.563,0.437
175,141,34,19.444444,15.666667,34,952,870,82,0,0,0,0,35,9,9,1.057143,1,0,9,42,false,false,true,0.898,0.102
206,222,-16,22.888889,27.75,-16,1606,1890,-284,0,0,0,0,35,9,8,0.8,0,0,8,10,false,false,false,0.072,0.928
153,169,-16,15.3,16.9,-16,1580,1629,-49,0,0,0,0,33,10,10,1.121212,0,0,9,10,false,false,false,0.272,0.728
148,144,4,18.5,20.571429,4,620,698,-78,1,0,0.125,0,51,8,7,0.803922,0,0,23,16,false,false,false,0.312,0.688
194,218,-24,12.125,14.533333,-24,342,53,289,0,0,0,0,-7,16,15,-5.857143,0,0,16,22,false,false,false,0.084,0.916
98,92,6,19.6,18.4,6,1561,1495,66,1,0,0.2,0,58,5,5,0.568966,1,0,9,20,false,false,true,0.91,0.09
262,297,-35,13.1,15.631579,-35,526,502,24,0,0,0,0,-14,20,19,-3.571429,1,0,19,17,false,false,false,0,1
258,275,-17,23.454545,25,-17,1354,1210,144,0,1,0,0.090909,19,11,11,1.736842,0,0,17,9,false,false,false,0.267,0.733
175,207,-32,21.875,29.571429,-32,1428,1361,67,0,0,0,0,38,8,7,0.868421,0,0,7,7,false,false,false,0.05,0.95
266,289,-23,22.166667,24.083333,-23,1652,1473,179,1,1,0.083333,0.083333,11,12,12,2.727273,0,0,10,10,false,false,false,0.058,0.942
58,72,-14,14.5,24,-14,500,509,-9,0,0,0,0,76,4,3,0.539474,0,0,7,28,false,false,false,0.166,0.834
168,199,-31,14,16.583333,-31,361,413,-52,0,0,0,0,22,12,12,1.863636,2,0,11,7,false,false,true,0.559,0.441
46,23,23,15.333333,11.5,23,742,868,-126,0,0,0,0,81,3,2,0.407407,0,0,7,15,false,false,false,0.214,0.786
139,166,-27,11.583333,13.833333,-27,391,542,-151,1,0,0.083333,0,23,12,12,2,0,0,10,14,false,false,true,0.535,0.465
104,167,-63,7.428571,12.846154,-63,288,359,-71,0,0,0,0,31,14,13,0.870968,0,0,17,10,true,false,false,0.047,0.953
63,101,-38,12.6,20.2,-38,913,1037,-124,0,1,0,0.2,76,5,5,0.539474,0,0,22,12,false,false,false,0.099,0.901
207,259,-52,25.875,37,-52,1164,1261,-97,0,1,0,0.142857,49,8,7,0.857143,0,0,8,7,false,false,false,0.056,0.944
320,338,-18,15.238095,16.9,-18,561,688,-127,0,0,0,0,-17,21,20,-2.705882,0,0,1,5,false,false,false,0,1
205,363,-158,13.666667,24.2,-158,760,976,-216,0,1,0,0.066667,-6,15,15,-6,0,0,12,20,false,false,false,0,1
111,156,-45,18.5,26,-45,1606,1890,-284,0,0,0,0,54,6,6,0.518519,1,0,13,13,false,false,false,0.151,0.849
53,61,-8,26.5,61,-8,1071,1065,6,0,0,0,0,81,2,1,0.382716,1,0,17,17,false,false,false,0.062,0.938
69,74,-5,17.25,24.666667,-5,1176,1211,-35,0,0,0,0,69,4,3,0.478261,1,0,6,14,false,false,false,0.367,0.633
35,14,21,17.5,14,21,711,746,-35,0,0,0,0,91,2,1,0.417582,0,1,24,7,false,false,false,0.423,0.577
89,87,2,17.8,21.75,2,1037,1009,28,0,0,0,0,70,5,4,0.628571,0,0,19,10,false,false,false,0.291,0.709
292,366,-74,15.368421,19.263158,-74,594,648,-54,1,1,0.052632,0.052632,-17,19,19,-2.352941,0,0,1,1,false,false,false,0,1
257,406,-149,21.416667,36.909091,-149,786,848,-62,0,2,0,0.181818,16,12,11,1.9375,0,0,13,10,false,false,false,0,1
209,254,-45,20.9,25.4,-45,503,527,-24,0,1,0,0.1,21,10,10,1.571429,0,0,10,17,false,false,false,0.149,0.851
251,331,-80,16.733333,22.066667,-80,1493,1453,40,0,0,0,0,-5,15,15,-7,0,2,8,5,false,false,false,0,1
230,249,-19,20.909091,24.9,-19,1428,1361,67,0,0,0,0,22,11,10,1.5,1,0,10,10,false,false,false,0.252,0.748
297,355,-58,16.5,20.882353,-58,1126,1277,-151,0,0,0,0,-16,18,17,-2.1875,0,0,1,8,true,false,false,0,1
313,284,29,34.777778,35.5,29,1699,1580,119,3,1,0.333333,0.125,26,9,8,1.153846,0,0,21,17,false,false,true,0.935,0.065
192,205,-13,19.2,20.5,-13,742,868,-126,0,0,0,0,34,10,10,0.970588,0,1,12,6,false,false,false,0.131,0.869
44,60,-16,11,20,-16,830,787,43,0,0,0,0,73,4,3,0.520548,0,0,30,12,false,false,false,0.305,0.695
236,273,-37,14.75,17.0625,-37,500,532,-32,0,0,0,0,-7,16,16,-5.857143,0,2,28,5,false,false,false,0,1
22,32,-10,22,32,-10,804,1080,-276,0,0,0,0,88,1,1,0.386364,1,0,7,22,false,false,false,0.242,0.758
322,277,45,23,21.307692,45,1373,1334,39,1,1,0.071429,0.076923,9,14,13,3.555556,1,1,6,9,false,false,true,0.856,0.144
255,226,29,18.214286,16.142857,29,720,437,283,0,0,0,0,19,14,14,2.210526,0,0,8,16,false,false,true,0.844,0.156
266,306,-40,20.461538,25.5,-40,1110,1399,-289,0,1,0,0.083333,23,13,12,1.478261,0,0,8,13,false,false,false,0.043,0.957
290,275,15,26.363636,27.5,15,714,820,-106,1,0,0.090909,0,24,11,10,1.291667,0,0,10,17,false,false,false,0.264,0.736
17,14,3,8.5,14,3,1656,1580,76,0,0,0,0,91,2,1,0.362637,0,0,14,10,false,false,false,0.275,0.725
187,260,-73,26.714286,37.142857,-73,1554,1685,-131,0,1,0,0.142857,45,7,7,0.711111,0,0,13,14,false,false,false,0.084,0.916
90,65,25,22.5,21.666667,25,1205,1216,-11,0,0,0,0,77,4,3,0.428571,0,0,13,16,false,false,false,0.418,0.582
20,18,2,20,18,2,1270,1261,9,0,0,0,0,92,1,1,0.402174,1,1,9,9,false,false,true,0.565,0.435
201,234,-33,14.357143,16.714286,-33,430,542,-112,0,1,0,0.071429,16,14,14,3,0,0,32,15,false,false,false,0.006,0.994
181,213,-32,16.454545,19.363636,-32,1312,1334,-22,0,0,0,0,19,11,11,2.052632,0,0,18,10,false,false,false,0.268,0.732
29,18,11,14.5,18,11,664,786,-122,0,0,0,0,94,2,1,0.351064,0,0,22,10,false,false,false,0.214,0.786
14,45,-31,7,22.5,-31,813,698,115,0,0,0,0,88,2,2,0.545455,0,0,12,9,false,false,false,0.369,0.631
143,354,-211,13,35.4,-211,1093,1100,-7,0,2,0,0.2,32,11,10,1.09375,0,0,8,12,false,false,false,0,1
137,153,-16,15.222222,17,-16,1220,1185,35,0,0,0,0,48,9,9,0.979167,0,1,29,6,false,false,false,0.283,0.717
228,252,-24,15.2,16.8,-24,430,542,-112,0,1,0,0.066667,10,15,15,4.8,0,0,23,15,false,false,false,0.292,0.708
87,88,-1,14.5,17.6,-1,1344,1314,30,0,1,0,0.2,62,6,5,0.548387,0,0,11,8,false,false,false,0.277,0.723
211,285,-74,17.583333,25.909091,-74,1349,1203,146,0,1,0,0.090909,23,12,11,1.391304,0,1,11,12,false,false,false,0.013,0.987
26,0,26,26,0,26,595,412,183,0,0,0,0,97,1,0,0.536082,0,0,8,0,false,false,true,0.784,0.216
153,256,-103,15.3,28.444444,-103,726,818,-92,0,1,0,0.111111,32,10,9,1.09375,0,0,15,11,false,false,false,0,1
194,389,-195,19.4,43.222222,-195,1219,1216,3,1,3,0.1,0.333333,12,10,9,2.25,0,0,20,9,false,false,false,0,1
163,167,-4,12.538462,13.916667,-4,1045,948,97,0,0,0,0,10,13,12,3.4,1,1,17,7,false,false,false,0.486,0.514
48,103,-55,12,25.75,-55,1176,1133,43,0,0,0,0,79,4,4,0.43038,2,0,8,17,false,false,false,0.421,0.579
151,173,-22,15.1,19.222222,-22,450,427,23,0,1,0,0.111111,33,10,9,1.121212,0,0,11,18,false,false,true,0.565,0.435
14,18,-4,14,18,-4,671,638,33,0,0,0,0,91,1,1,0.538462,0,1,13,8,false,false,true,0.557,0.443
144,203,-59,12,18.454545,-59,595,662,-67,0,1,0,0.090909,28,12,11,1.571429,0,1,13,15,false,false,false,0.011,0.989
205,271,-66,13.666667,18.066667,-66,278,1,277,0,0,0,0,-3,15,15,-12.333333,0,0,14,5,false,false,false,0.07,0.93
284,302,-18,17.75,20.133333,-18,785,892,-107,0,0,0,0,2,16,15,18.5,0,1,7,7,false,false,false,0.004,0.996
313,463,-150,20.866667,30.866667,-150,1556,1656,-100,0,2,0,0.133333,-15,15,15,-2,0,0,2,1,true,false,false,0,1
337,387,-50,30.636364,38.7,-50,1777,1500,277,1,2,0.090909,0.2,10,11,10,2.8,0,0,10,10,false,false,false,0.471,0.529
84,164,-80,14,27.333333,-80,944,1095,-151,0,1,0,0.166667,64,6,6,0.609375,0,1,10,17,false,false,false,0.044,0.956
338,387,-49,17.789474,20.368421,-49,1164,1261,-97,0,1,0,0.052632,-19,19,19,-2.210526,0,0,6,4,false,false,false,0,1
301,395,-94,14.333333,19.75,-94,952,826,126,0,1,0,0.05,-23,21,20,-1.869565,0,0,1,2,false,false,false,0,1
196,334,-138,14,25.692308,-138,710,758,-48,0,1,0,0.076923,18,14,13,2.055556,0,0,9,11,false,false,false,0,1
211,226,-15,17.583333,20.545455,-15,450,624,-174,0,0,0,0,16,12,11,2.0625,0,0,17,9,false,false,false,0.093,0.907
42,69,-27,10.5,17.25,-27,977,1100,-123,0,0,0,0,75,4,4,0.546667,1,0,14,11,false,false,false,0.177,0.823
160,200,-40,16,20,-40,727,820,-93,0,1,0,0.1,26,10,10,1.346154,0,0,9,20,false,false,false,0.109,0.891
65,88,-23,16.25,22,-23,889,895,-6,0,1,0,0.25,70,4,4,0.528571,0,0,13,15,false,false,false,0.283,0.717
137,216,-79,17.125,27,-79,1094,1159,-65,0,0,0,0,41,8,8,0.926829,0,0,16,13,false,false,false,0.024,0.976
32,0,32,32,0,32,1636,1727,-91,0,0,0,0,94,1,0,0.319149,0,0,17,0,false,false,true,0.726,0.274
126,229,-103,9.692308,19.083333,-103,651,567,84,0,0,0,0,22,13,12,2.5,0,0,7,8,false,false,false,0.065,0.935
249,281,-32,19.153846,23.416667,-32,1210,1162,48,0,0,0,0,16,13,12,2,1,0,14,9,false,false,false,0.206,0.794
261,320,-59,11.347826,13.913043,-59,391,542,-151,1,0,0.043478,0,-41,23,23,-1.121951,0,0,1,4,true,false,false,0,1
159,223,-64,14.454545,20.272727,-64,1248,1220,28,0,1,0,0.090909,37,11,11,1.405405,1,0,15,10,false,false,false,0.209,0.791
185,187,-2,16.818182,18.7,-2,1203,1270,-67,0,0,0,0,39,11,10,1.128205,1,0,7,13,false,false,false,0.107,0.893
288,333,-45,20.571429,25.615385,-45,1266,1339,-73,0,1,0,0.076923,9,14,13,3.888889,0,0,11,11,false,false,false,0.003,0.997
107,81,26,35.666667,27,26,1331,1347,-16,1,0,0.333333,0,72,3,3,0.444444,0,0,8,19,false,false,true,0.603,0.397
96,80,16,19.2,16,16,897,996,-99,0,0,0,0,68,5,5,0.573529,0,1,9,8,false,false,false,0.287,0.713
377,346,31,23.5625,23.066667,31,1305,1194,111,1,1,0.0625,0.066667,-15,16,15,-2.2,0,0,3,5,false,false,true,0.95,0.05
230,305,-75,13.529412,17.941176,-75,613,525,88,0,0,0,0,-2,17,17,-21,0,1,15,6,false,false,false,0,1
304,304,0,19,19,0,804,766,38,0,1,0,0.0625,6,16,16,6.833333,0,0,8,10,false,false,true,0.79,0.21
285,334,-49,20.357143,25.692308,-49,1232,1281,-49,0,2,0,0.153846,-4,14,13,-7.75,0,0,3,13,false,false,false,0.025,0.975
28,22,6,14,22,6,668,771,-103,0,0,0,0,85,2,1,0.470588,0,0,17,11,false,false,false,0.231,0.769
110,163,-53,18.333333,27.166667,-53,954,939,15,0,0,0,0,53,6,6,0.679245,0,1,12,19,false,false,false,0.043,0.957
242,281,-39,16.133333,20.071429,-39,360,371,-11,0,0,0,0,-10,15,14,-3.7,0,0,9,15,false,false,false,0.014,0.986
184,276,-92,14.153846,21.230769,-92,1101,1130,-29,1,1,0.076923,0.076923,23,13,13,1.956522,0,1,20,10,false,false,false,0,1
307,325,-18,16.157895,17.105263,-18,1000,960,40,0,0,0,0,-20,19,19,-2.25,0,0,6,3,false,false,false,0.029,0.971
141,190,-49,14.1,19,-49,278,1,277,0,0,0,0,27,10,10,1.37037,0,0,28,16,false,false,false,0.449,0.551
76,74,2,19,18.5,2,664,786,-122,0,0,0,0,79,4,4,0.417722,0,0,19,7,false,false,false,0.263,0.737
24,21,3,12,21,3,1770,1745,25,0,0,0,0,92,2,1,0.358696,0,0,9,21,false,false,false,0.272,0.728
254,307,-53,21.166667,27.909091,-53,1164,1261,-97,0,1,0,0.090909,30,12,11,1.4,0,0,13,7,false,false,false,0.019,0.981
93,97,-4,13.285714,16.166667,-4,361,413,-52,0,0,0,0,55,7,6,0.745455,0,0,21,7,false,false,false,0.272,0.728
56,29,27,18.666667,14.5,27,725,668,57,0,0,0,0,84,3,2,0.416667,0,0,11,27,false,false,true,0.681,0.319
315,332,-17,26.25,30.181818,-17,1253,1324,-71,0,1,0,0.090909,12,12,11,2.416667,0,0,11,8,false,false,false,0.193,0.807
355,389,-34,22.1875,24.3125,-34,1495,1597,-102,0,1,0,0.0625,-12,16,16,-2.666667,0,0,6,4,true,false,false,0,1
302,318,-16,20.133333,21.2,-16,1197,1156,41,0,1,0,0.066667,-4,15,15,-8.75,0,0,6,4,false,false,false,0.118,0.882
34,90,-56,17,45,-56,594,648,-54,0,1,0,0.5,85,2,2,0.470588,0,0,12,10,false,false,false,0.272,0.728
171,208,-37,15.545455,20.8,-37,1037,1016,21,1,0,0.090909,0,40,11,10,1.45,1,0,23,10,false,false,false,0.208,0.792
224,267,-43,16,20.538462,-43,889,855,34,0,1,0,0.076923,14,14,13,2.857143,0,0,16,16,false,false,false,0.066,0.934
234,280,-46,15.6,18.666667,-46,518,414,104,0,1,0,0.066667,6,15,15,6.333333,0,0,9,10,false,false,false,0.168,0.832
317,335,-18,18.647059,20.9375,-18,1055,840,215,0,1,0,0.0625,-11,17,16,-3.272727,0,0,3,9,false,false,false,0.078,0.922
317,313,4,21.133333,22.357143,4,1652,1473,179,1,1,0.066667,0.071429,-9,15,14,-3.333333,0,0,2,4,false,false,false,0.092,0.908
152,226,-74,12.666667,18.833333,-74,613,525,88,0,0,0,0,28,12,12,1.5,0,1,10,9,false,false,false,0.063,0.937
128,131,-3,18.285714,18.714286,-3,450,503,-53,0,0,0,0,50,7,7,0.78,1,0,19,10,false,false,true,0.623,0.377
246,352,-106,13.666667,20.705882,-106,632,603,29,0,1,0,0.058824,-24,18,17,-1.583333,0,0,1,5,false,false,false,0,1
412,503,-91,37.454545,45.727273,-91,2147,2219,-72,1,2,0.090909,0.181818,-4,11,11,-6,0,0,7,1,false,false,false,0,1
264,342,-78,20.307692,26.307692,-78,653,1004,-351,0,0,0,0,-2,13,13,-14.5,0,0,20,4,false,false,false,0,1
241,298,-57,21.909091,29.8,-57,732,868,-136,0,1,0,0.1,19,11,10,1.684211,0,0,9,20,false,false,false,0.006,0.994
255,328,-73,15,19.294118,-73,603,721,-118,0,0,0,0,-2,17,17,-21.5,1,0,6,8,false,false,false,0.003,0.997
76,75,1,12.666667,15,1,814,830,-16,0,0,0,0,63,6,5,0.650794,0,0,12,12,false,false,false,0.299,0.701
260,409,-149,17.333333,29.214286,-149,1045,1100,-55,0,1,0,0.071429,-1,15,14,-34,1,0,9,12,false,false,false,0,1
108,129,-21,36,43,-21,1689,1777,-88,1,0,0.333333,0,64,3,3,0.46875,0,0,8,19,false,false,false,0.095,0.905
135,207,-72,19.285714,29.571429,-72,1422,1798,-376,0,1,0,0.142857,45,7,7,0.711111,0,1,18,13,false,false,false,0.001,0.999
141,160,-19,15.666667,20,-19,306,468,-162,0,0,0,0,51,9,8,0.72549,0,0,17,9,false,false,false,0.093,0.907
223,246,-23,13.117647,15.375,-23,163,346,-183,0,0,0,0,-14,17,16,-2.785714,0,0,11,7,false,false,false,0.165,0.835
103,121,-18,34.333333,40.333333,-18,1173,1256,-83,1,0,0.333333,0,75,3,3,0.413333,0,1,9,9,false,false,false,0,1
240,283,-43,24,31.444444,-43,1021,897,124,0,2,0,0.222222,24,10,9,1.541667,0,0,14,13,false,false,false,0.065,0.935
254,329,-75,14.111111,18.277778,-75,814,830,-16,0,0,0,0,-19,18,18,-2.157895,0,0,10,5,false,false,false,0,1
337,381,-44,19.823529,23.8125,-44,892,856,36,1,1,0.058824,0.0625,-23,17,16,-1.521739,0,0,3,1,false,false,false,0,1
311,332,-21,17.277778,19.529412,-21,775,786,-11,1,0,0.055556,0,-11,18,17,-3.909091,1,0,13,20,false,false,false,0.015,0.985
324,392,-68,17.052632,20.631579,-68,771,668,103,2,0,0.105263,0,-32,19,19,-1.1875,0,0,1,2,true,false,false,0,1
138,177,-39,12.545455,17.7,-39,907,878,29,0,0,0,0,47,11,10,0.914894,1,0,11,9,false,false,false,0.39,0.61
305,335,-30,16.944444,19.705882,-30,1220,1185,35,0,1,0,0.058824,-3,18,17,-15.666667,0,0,14,14,false,false,false,0,1
270,314,-44,15,17.444444,-44,518,414,104,0,1,0,0.055556,-12,18,18,-3.166667,0,0,12,4,false,false,false,0.065,0.935
59,74,-15,11.8,14.8,-15,1452,1388,64,0,0,0,0,68,5,5,0.514706,0,0,14,20,false,false,false,0.274,0.726
234,330,-96,18,27.5,-96,1315,1334,-19,0,2,0,0.166667,9,13,12,4,0,0,11,19,false,false,false,0,1
270,343,-73,15.882353,20.176471,-73,725,668,57,0,0,0,0,-14,17,17,-2.5,0,0,1,3,false,false,false,0,1
12,0,12,12,0,12,952,826,126,0,0,0,0,97,1,0,0.443299,1,0,11,0,false,false,true,0.77,0.23
54,38,16,18,19,16,450,503,-53,0,0,0,0,80,3,2,0.4875,0,0,22,9,false,false,false,0.359,0.641
173,169,4,15.727273,15.363636,4,913,1037,-124,0,1,0,0.090909,44,11,11,0.931818,0,0,16,7,false,false,false,0.39,0.61
12,17,-5,12,17,-5,1193,1177,16,0,0,0,0,92,1,1,0.380435,0,0,14,16,false,false,false,0.365,0.635
172,204,-32,19.111111,25.5,-32,804,1080,-276,0,0,0,0,41,9,8,0.829268,1,0,11,14,false,false,false,0.085,0.915
201,280,-79,25.125,35,-79,1554,1685,-131,0,1,0,0.125,38,8,8,0.842105,0,0,16,14,false,false,false,0.02,0.98
207,276,-69,25.875,34.5,-69,1164,1261,-97,0,1,0,0.125,45,8,8,0.933333,0,0,8,7,false,false,false,0.04,0.96
160,238,-78,17.777778,26.444444,-78,1407,1473,-66,0,2,0,0.222222,34,9,9,0.911765,0,0,7,22,false,false,false,0.051,0.949
288,287,1,19.2,20.5,1,1344,1314,30,0,2,0,0.142857,0,15,14,0,0,0,9,16,false,false,true,0.718,0.282
321,370,-49,20.0625,24.666667,-49,1556,1513,43,0,0,0,0,-11,16,15,-2.818182,0,0,2,2,true,false,false,0,1
69,56,13,13.8,11.2,13,1045,948,97,0,0,0,0,63,5,5,0.539683,0,0,13,23,false,false,true,0.551,0.449
347,371,-24,19.277778,21.823529,-24,980,965,15,0,0,0,0,-15,18,17,-2.533333,0,0,1,4,false,false,false,0.026,0.974
214,261,-47,23.777778,29,-47,1331,1347,-16,1,0,0.111111,0,24,9,9,1.333333,0,0,13,9,false,false,false,0.079,0.921
177,182,-5,22.125,26,-5,576,602,-26,0,0,0,0,50,8,7,0.84,0,0,10,7,false,false,false,0.148,0.852
177,188,-11,19.666667,20.888889,-11,1439,1428,11,0,0,0,0,46,9,9,0.869565,0,0,14,12,false,false,false,0.271,0.729
274,270,4,21.076923,20.769231,4,1094,1041,53,1,0,0.076923,0,6,13,13,6.333333,0,0,17,7,false,false,true,0.546,0.454
116,140,-24,16.571429,23.333333,-24,1493,1453,40,0,0,0,0,55,7,6,0.636364,0,0,14,25,false,false,false,0.258,0.742
221,392,-171,13.8125,24.5,-171,913,1037,-124,0,3,0,0.1875,4,16,16,10.25,0,0,20,13,false,false,false,0,1
34,61,-27,17,30.5,-27,1699,1803,-104,0,0,0,0,86,2,2,0.406977,0,1,10,7,false,false,false,0.27,0.73
16,0,16,16,0,16,1633,1620,13,0,0,0,0,95,1,0,0.378947,0,0,10,0,false,false,true,0.562,0.438
333,345,-12,17.526316,19.166667,-12,944,1095,-151,0,1,0,0.055556,-12,19,18,-3.25,0,0,1,3,false,false,false,0.055,0.945
264,267,-3,22,22.25,-3,540,498,42,1,0,0.083333,0,13,12,12,3.538462,0,0,7,7,false,false,true,0.655,0.345
215,263,-48,16.538462,21.916667,-48,1257,1176,81,1,0,0.076923,0,22,13,12,1.545455,1,0,6,13,false,false,false,0.029,0.971
290,353,-63,18.125,22.0625,-63,566,742,-176,0,1,0,0.0625,-11,16,16,-2.909091,0,0,2,1,true,false,false,0,1
248,222,26,16.533333,15.857143,26,670,576,94,0,0,0,0,3,15,14,13.666667,1,0,13,16,false,false,true,0.872,0.128
221,218,3,22.1,24.222222,3,1063,1134,-71,1,0,0.1,0,43,10,9,1.023256,0,0,7,17,false,false,false,0.078,0.922
167,204,-37,16.7,22.666667,-37,1270,1424,-154,0,1,0,0.111111,43,10,9,0.813953,0,1,26,9,false,false,false,0.069,0.931
331,394,-63,17.421053,21.888889,-63,1047,1253,-206,1,1,0.052632,0.055556,-19,19,18,-1.947368,1,0,4,3,true,false,false,0,1
153,246,-93,15.3,24.6,-93,736,791,-55,0,0,0,0,26,10,10,1.461538,0,0,9,12,false,false,false,0.006,0.994
33,52,-19,16.5,26,-19,1094,1159,-65,0,0,0,0,82,2,2,0.463415,0,0,17,14,false,false,false,0.313,0.687
240,279,-39,21.818182,25.363636,-39,689,804,-115,0,0,0,0,18,11,11,1.944444,0,0,7,7,false,false,false,0.037,0.963
327,372,-45,20.4375,23.25,-45,1030,1014,16,0,1,0,0.0625,-11,16,16,-3,0,0,2,3,false,false,false,0.02,0.98
260,366,-106,16.25,22.875,-106,848,976,-128,0,1,0,0.0625,3,16,16,13.333333,0,0,13,7,false,false,false,0,1
346,394,-48,24.714286,28.142857,-48,1344,1208,136,1,1,0.071429,0.071429,-4,14,14,-7.5,1,0,3,2,false,false,false,0.046,0.954
30,17,13,15,17,13,999,1071,-72,0,0,0,0,87,2,1,0.45977,0,0,7,8,false,false,true,0.543,0.457
120,217,-97,10,18.083333,-97,651,996,-345,0,1,0,0.083333,18,12,12,2.5,0,2,26,5,false,false,false,0,1
27,29,-2,9,14.5,-2,1305,1307,-2,0,0,0,0,82,3,2,0.5,0,1,7,6,false,false,false,0.295,0.705
89,108,-19,17.8,27,-19,1182,1075,107,0,1,0,0.25,65,5,4,0.6,0,0,24,14,false,false,false,0.274,0.726
60,71,-11,15,23.666667,-11,1302,1351,-49,0,0,0,0,76,4,3,0.486842,1,0,7,10,false,false,false,0.308,0.692
62,172,-110,7.75,24.571429,-110,1037,913,124,0,1,0,0.142857,62,8,7,0.612903,1,0,8,14,false,false,false,0.028,0.972
164,252,-88,16.4,25.2,-88,944,1095,-151,0,1,0,0.1,38,10,10,1.026316,0,1,9,6,false,false,false,0.006,0.994
302,360,-58,20.133333,25.714286,-58,801,679,122,1,0,0.066667,0,-14,15,14,-2.071429,0,0,5,1,true,false,false,0,1
190,183,7,23.75,22.875,7,1633,1739,-106,1,0,0.125,0,47,8,8,0.723404,0,0,7,18,false,false,false,0.184,0.816
181,185,-4,25.857143,26.428571,-4,1237,1265,-28,1,0,0.142857,0,41,7,7,0.878049,0,0,19,11,false,false,true,0.561,0.439
100,243,-143,11.111111,30.375,-143,935,995,-60,0,1,0,0.125,47,9,8,0.829787,2,0,14,21,false,false,false,0.013,0.987
197,313,-116,13.133333,22.357143,-116,948,998,-50,0,0,0,0,1,15,14,37,0,0,10,12,false,false,false,0,1
100,78,22,20,19.5,22,1159,1131,28,0,0,0,0,69,5,4,0.536232,0,1,7,11,false,false,false,0.381,0.619
164,204,-40,18.222222,25.5,-40,1633,1620,13,0,0,0,0,35,9,8,1.028571,0,0,7,7,false,false,false,0.072,0.928
102,122,-20,17,24.4,-20,1422,1583,-161,0,1,0,0.2,60,6,5,0.683333,0,0,17,27,false,false,false,0.086,0.914
225,284,-59,14.0625,18.933333,-59,714,892,-178,0,2,0,0.133333,3,16,15,14,0,0,15,12,false,false,false,0,1
215,329,-114,15.357143,25.307692,-114,771,668,103,1,0,0.071429,0,0,14,13,0,0,0,7,19,false,false,false,0,1
236,278,-42,12.421053,14.631579,-42,668,363,305,0,0,0,0,-9,19,19,-5.222222,0,1,14,6,false,false,false,0,1
291,321,-30,22.384615,24.692308,-30,1167,1245,-78,1,0,0.076923,0,-2,13,13,-14,1,0,4,5,false,false,false,0.152,0.848
92,127,-35,30.666667,42.333333,-35,1431,1399,32,0,1,0,0.333333,72,3,3,0.347222,0,1,14,8,false,false,false,0.271,0.729
303,345,-42,17.823529,20.294118,-42,1439,1428,11,0,0,0,0,-3,17,17,-13.333333,1,0,6,8,false,false,false,0.031,0.969
258,350,-92,12.285714,17.5,-92,642,952,-310,0,0,0,0,-23,21,20,-1.913043,0,0,1,2,false,false,false,0,1
119,108,11,17,15.428571,11,1168,1216,-48,0,0,0,0,65,7,7,0.507692,0,0,15,14,false,false,false,0.232,0.768
163,143,20,14.818182,13,20,670,576,94,0,0,0,0,27,11,11,1.518519,1,1,13,8,false,false,true,0.79,0.21
197,164,33,32.833333,27.333333,33,1373,1334,39,1,1,0.166667,0.166667,54,6,6,0.592593,0,0,10,21,false,false,true,0.873,0.127
70,127,-57,11.666667,21.166667,-57,951,976,-25,0,0,0,0,62,6,6,0.709677,1,1,22,22,false,false,false,0.083,0.917
293,330,-37,20.928571,25.384615,-37,1164,1261,-97,0,1,0,0.076923,15,14,13,2.8,0,0,14,8,false,false,false,0.015,0.985
266,365,-99,16.625,24.333333,-99,1408,1539,-131,0,1,0,0.066667,-14,16,15,-2.428571,0,0,2,14,false,false,false,0,1
83,104,-21,13.833333,17.333333,-21,1045,1082,-37,0,0,0,0,62,6,6,0.725806,1,0,20,10,false,false,true,0.559,0.441
169,174,-5,33.8,34.8,-5,1354,1210,144,0,1,0,0.2,60,5,5,0.55,0,0,15,12,false,false,false,0.34,0.66
264,389,-125,11.478261,17.681818,-125,1248,1220,28,0,1,0,0.045455,-19,23,22,-2.736842,1,0,4,7,false,false,false,0,1
243,401,-158,14.294118,23.588235,-158,1422,1510,-88,0,2,0,0.117647,-3,17,17,-13,0,0,12,10,false,false,false,0,1
286,277,9,22,21.307692,9,921,1045,-124,0,0,0,0,15,13,13,2.333333,0,1,11,6,false,false,false,0.337,0.663
87,82,5,14.5,16.4,5,999,1071,-72,0,0,0,0,60,6,5,0.666667,1,0,11,9,false,false,true,0.542,0.458
122,85,37,24.4,21.25,37,967,856,111,0,0,0,0,65,5,4,0.507692,0,0,10,16,false,false,true,0.736,0.264
59,61,-2,14.75,20.333333,-2,1063,1134,-71,0,0,0,0,78,4,3,0.564103,0,0,10,27,false,false,false,0.073,0.927
239,325,-86,18.384615,25,-86,1633,1556,77,0,0,0,0,0,13,13,0,0,1,10,6,false,false,false,0,1
108,139,-31,15.428571,23.166667,-31,518,461,57,0,0,0,0,56,7,6,0.642857,0,1,16,11,false,false,false,0.248,0.752
149,182,-33,18.625,22.75,-33,1349,1203,146,0,1,0,0.125,41,8,8,0.780488,0,0,10,26,false,false,false,0.275,0.725
239,282,-43,11.95,14.1,-43,668,363,305,0,0,0,0,-14,20,20,-3.357143,0,0,12,4,false,false,false,0.015,0.985
119,118,1,23.8,23.6,1,1055,840,215,0,0,0,0,62,5,5,0.580645,0,0,7,9,false,false,true,0.535,0.465
113,128,-15,14.125,18.285714,-15,1000,960,40,0,0,0,0,53,8,7,0.849057,1,0,9,7,false,false,false,0.344,0.656
287,353,-66,13.666667,17.65,-66,1422,1583,-161,0,1,0,0.05,-10,21,20,-4.1,1,0,2,13,true,false,false,0,1
75,85,-10,18.75,28.333333,-10,1636,1796,-160,0,0,0,0,75,4,3,0.36,0,0,15,12,false,false,false,0.147,0.853
121,178,-57,20.166667,35.6,-57,1583,1403,180,0,0,0,0,52,6,5,0.615385,0,0,11,15,false,false,false,0.028,0.972
180,172,8,18,17.2,8,561,688,-127,0,0,0,0,40,10,10,1.15,0,0,17,9,false,false,true,0.541,0.459
54,82,-28,18,27.333333,-28,689,804,-115,0,0,0,0,74,3,3,0.472973,1,0,15,22,false,false,false,0.268,0.732
111,190,-79,11.1,19,-79,595,662,-67,0,1,0,0.1,34,10,10,1.294118,0,1,22,13,false,false,false,0.041,0.959
92,101,-9,15.333333,16.833333,-9,1310,1477,-167,0,0,0,0,54,6,6,0.666667,1,0,11,14,false,false,false,0.244,0.756
48,85,-37,12,28.333333,-37,341,416,-75,0,0,0,0,80,4,3,0.4875,0,0,16,10,false,false,false,0.072,0.928
105,96,9,13.125,12,9,1045,948,97,0,0,0,0,46,8,8,0.73913,0,0,9,22,false,false,true,0.558,0.442
147,225,-78,14.7,25,-78,952,826,126,0,1,0,0.111111,46,10,9,0.934783,0,0,13,7,false,false,false,0.03,0.97
198,301,-103,13.2,21.5,-103,542,605,-63,0,0,0,0,2,15,14,18,0,0,8,10,false,false,false,0,1
124,157,-33,20.666667,31.4,-33,1315,1334,-19,0,1,0,0.2,60,6,5,0.6,0,0,11,11,false,false,false,0.27,0.73
28,37,-9,14,18.5,-9,736,791,-55,0,0,0,0,87,2,2,0.436782,1,0,13,20,false,false,false,0.3,0.7
219,302,-83,18.25,25.166667,-83,1229,1220,9,0,1,0,0.083333,18,12,12,2.055556,0,0,9,25,false,false,false,0.004,0.996
172,158,14,14.333333,13.166667,14,1193,1220,-27,0,0,0,0,26,12,12,1.653846,1,1,6,16,false,false,false,0.294,0.706
198,328,-130,13.2,21.866667,-130,542,605,-63,0,0,0,0,-2,15,15,-18,0,0,8,10,false,false,false,0,1
24,110,-86,8,55,-86,760,976,-216,0,1,0,0.5,80,3,2,0.45,0,0,15,17,false,false,false,0.065,0.935
61,64,-3,30.5,64,-3,1164,1261,-97,0,1,0,1,85,2,1,0.494118,0,1,24,24,false,false,true,0.68,0.32
333,381,-48,15.136364,18.142857,-48,1064,1397,-333,0,2,0,0.095238,-18,22,21,-2.388889,1,0,5,2,true,false,false,0,1
237,319,-82,14.8125,19.9375,-82,603,721,-118,0,0,0,0,3,16,16,14.333333,0,0,11,9,false,false,false,0,1
112,149,-37,14,18.625,-37,450,427,23,0,1,0,0.125,42,8,8,0.880952,0,0,15,12,false,false,false,0.46,0.54
304,423,-119,12.16,16.92,-119,1037,1016,21,1,0,0.04,0,-21,25,25,-2.761905,1,0,2,5,false,false,false,0,1
158,263,-105,14.363636,26.3,-105,915,971,-56,0,0,0,0,22,11,10,1.5,0,0,11,28,false,false,false,0,1
127,245,-118,18.142857,35,-118,1093,1100,-7,0,1,0,0.142857,48,7,7,0.729167,0,0,7,9,false,false,false,0.027,0.973
78,23,55,78,23,55,714,820,-106,1,0,1,0,90,1,1,0.344444,0,1,11,16,false,false,false,0,1
174,234,-60,13.384615,18,-60,1071,1000,71,0,0,0,0,22,13,13,2.136364,0,1,7,12,false,false,false,0.03,0.97
258,348,-90,18.428571,24.857143,-90,1127,995,132,0,1,0,0.071429,2,14,14,16.5,0,0,20,11,false,false,false,0,1
113,145,-32,22.6,36.25,-32,964,1003,-39,0,1,0,0.25,66,5,4,0.590909,0,0,10,9,false,false,false,0.271,0.729
244,314,-70,12.2,16.526316,-70,595,662,-67,0,1,0,0.052632,-21,20,19,-2.095238,0,0,4,10,false,false,false,0,1
117,218,-101,10.636364,19.818182,-101,651,567,84,0,0,0,0,28,11,11,1.964286,0,0,10,9,false,false,false,0.07,0.93
39,54,-15,13,18,-15,568,570,-2,0,0,0,0,79,3,3,0.468354,0,0,10,26,false,false,false,0.202,0.798
16,13,3,16,13,3,732,868,-136,0,0,0,0,93,1,1,0.344086,0,1,9,15,false,false,false,0.212,0.788
166,194,-28,16.6,21.555556,-28,344,315,29,1,0,0.1,0,27,10,9,1.481481,0,0,21,8,false,false,false,0.222,0.778
255,308,-53,12.142857,14.666667,-53,615,542,73,0,0,0,0,-12,21,21,-3.5,0,0,11,8,true,false,false,0,1
42,94,-52,10.5,31.333333,-52,1397,1309,88,0,0,0,0,81,4,3,0.444444,1,1,6,22,false,false,false,0.028,0.972
258,198,60,18.428571,15.230769,60,1030,998,32,0,0,0,0,13,14,13,2.846154,0,1,14,10,false,false,true,0.931,0.069
344,371,-27,20.235294,23.1875,-27,1691,1551,140,1,0,0.058824,0,-10,17,16,-3.7,0,0,3,4,false,false,false,0.058,0.942
219,239,-20,24.333333,26.555556,-20,801,679,122,1,0,0.111111,0,24,9,9,1.208333,1,0,17,20,false,false,true,0.611,0.389
316,325,-9,18.588235,19.117647,-9,206,346,-140,1,0,0.058824,0,-16,17,17,-2.6875,0,1,18,7,false,false,false,0,1
215,288,-73,12.647059,18,-73,951,976,-25,0,0,0,0,0,17,16,0,0,0,12,9,false,false,false,0,1
18,0,18,18,0,18,1691,1551,140,0,0,0,0,97,1,0,0.381443,0,0,10,0,false,false,true,0.611,0.389
70,156,-86,14,31.2,-86,1101,1115,-14,0,0,0,0,65,5,5,0.461538,0,1,10,7,false,false,false,0.027,0.973
326,322,4,16.3,16.947368,4,540,498,42,1,0,0.05,0,-29,20,19,-1.586207,0,0,4,13,false,false,false,0.465,0.535
6,0,6,6,0,6,1606,1890,-284,0,0,0,0,97,1,0,0.28866,1,0,6,0,false,false,false,0.238,0.762
68,117,-49,13.6,23.4,-49,342,263,79,0,0,0,0,64,5,5,0.53125,0,1,8,10,false,false,false,0.087,0.913
309,411,-102,19.3125,25.6875,-102,1232,1448,-216,0,2,0,0.125,-14,16,16,-2.5,0,0,7,1,false,false,false,0,1
301,403,-102,16.722222,22.388889,-102,935,995,-60,1,1,0.055556,0.055556,-19,18,18,-2.052632,0,0,8,1,false,false,false,0,1
297,345,-48,15.631579,18.157895,-48,344,315,29,1,1,0.052632,0.052632,-34,19,19,-1.176471,0,0,1,3,false,false,false,0.008,0.992
144,158,-14,20.571429,26.333333,-14,804,766,38,0,1,0,0.166667,60,7,6,0.683333,0,1,7,19,false,false,false,0.276,0.724
259,194,65,21.583333,16.166667,65,1043,1003,40,0,0,0,0,20,12,12,1.9,0,1,13,10,false,false,true,0.953,0.047
281,326,-45,16.529412,20.375,-45,1281,1268,13,0,0,0,0,1,17,16,42,1,0,4,7,false,false,false,0.062,0.938
140,156,-16,12.727273,14.181818,-16,542,390,152,0,0,0,0,45,11,11,1.111111,0,0,7,22,false,false,true,0.511,0.489
256,348,-92,18.285714,24.857143,-92,1315,1331,-16,0,0,0,0,0,14,14,0,0,0,8,6,false,false,false,0,1
139,198,-59,19.857143,33,-59,561,633,-72,0,1,0,0.166667,58,7,6,0.603448,0,0,11,8,false,false,false,0.074,0.926
0,0,0,0,0,0,813,698,115,0,0,0,0,100,1,0,0.48,0,0,7,0,false,false,true,0.623,0.377
19,7,12,9.5,7,12,940,947,-7,0,0,0,0,90,2,1,0.388889,0,0,9,10,false,false,true,0.549,0.451
25,30,-5,12.5,15,-5,814,830,-16,0,0,0,0,85,2,2,0.482353,0,0,7,16,false,false,false,0.477,0.523
52,53,-1,8.666667,8.833333,-1,925,1000,-75,0,0,0,0,60,6,6,0.733333,0,1,7,11,false,false,false,0.187,0.813
87,107,-20,29,53.5,-20,1071,1065,6,0,0,0,0,70,3,2,0.442857,0,0,8,13,false,false,false,0.028,0.972
285,372,-87,28.5,41.333333,-87,1925,1885,40,1,2,0.1,0.222222,6,10,9,4.166667,0,0,9,19,false,false,false,0,1
288,340,-52,15.157895,17.894737,-52,500,509,-9,0,0,0,0,-20,19,19,-2.05,0,0,5,1,false,false,false,0,1
308,400,-92,25.666667,33.333333,-92,1689,1777,-88,1,1,0.083333,0.083333,1,12,12,30,0,0,14,17,false,false,false,0,1
109,101,8,21.8,20.2,8,1488,1428,60,1,0,0.2,0,62,5,5,0.596774,0,0,19,18,false,false,true,0.569,0.431
304,289,15,19,19.266667,15,804,766,38,0,1,0,0.066667,9,16,15,4.555556,0,0,8,13,false,false,true,0.833,0.167
100,113,-13,16.666667,18.833333,-13,1159,1131,28,0,1,0,0.166667,60,6,6,0.616667,0,1,10,7,false,false,false,0.302,0.698
138,189,-51,11.5,17.181818,-51,668,363,305,0,0,0,0,32,12,11,1.46875,1,0,16,14,false,false,false,0.088,0.912
65,86,-21,13,17.2,-21,361,413,-52,0,0,0,0,65,5,5,0.630769,0,0,30,8,false,false,false,0.286,0.714
215,242,-27,19.545455,24.2,-27,621,786,-165,0,0,0,0,14,11,10,2.142857,0,0,13,12,false,false,false,0.069,0.931
109,65,44,27.25,21.666667,44,1488,1428,60,1,0,0.25,0,72,4,3,0.513889,0,0,10,11,false,false,true,0.678,0.322
18,0,18,18,0,18,926,973,-47,0,0,0,0,95,1,0,0.368421,0,0,19,0,false,false,true,0.559,0.441
223,223,0,22.3,22.3,0,1227,1189,38,0,0,0,0,25,10,10,1.4,0,1,8,15,false,false,false,0.232,0.768
319,400,-81,24.538462,33.333333,-81,1689,1777,-88,1,1,0.076923,0.083333,-3,13,12,-10,0,0,8,17,false,false,false,0,1
86,141,-55,12.285714,20.142857,-55,907,1070,-163,0,0,0,0,49,7,7,0.714286,0,0,19,16,false,false,false,0.072,0.928
296,305,-9,18.5,20.333333,-9,1055,840,215,0,1,0,0.066667,-4,16,15,-9,0,0,8,24,false,false,false,0.1,0.9
215,298,-83,19.545455,27.090909,-83,653,1004,-351,0,0,0,0,13,11,11,2.230769,0,0,14,12,false,false,false,0,1
160,233,-73,20,29.125,-73,1583,1403,180,0,0,0,0,39,8,8,0.820513,0,1,12,6,false,false,false,0.028,0.972
14,14,0,7,14,0,288,359,-71,0,0,0,0,93,2,1,0.290323,0,0,9,10,false,false,false,0.213,0.787
73,72,1,12.166667,14.4,1,206,346,-140,0,0,0,0,65,6,5,0.661538,0,0,7,14,false,false,false,0.224,0.776
127,71,56,21.166667,14.2,56,742,594,148,0,0,0,0,60,6,5,0.65,0,0,30,16,false,false,true,0.967,0.033
293,321,-28,17.235294,20.0625,-28,1220,1185,35,0,1,0,0.0625,2,17,16,23.5,0,0,17,12,false,false,false,0,1
110,130,-20,22,32.5,-20,1554,1685,-131,0,1,0,0.25,69,5,4,0.463768,0,0,12,16,false,false,false,0.27,0.73
197,201,-4,16.416667,18.272727,-4,1176,1211,-35,0,0,0,0,13,12,11,2.538462,1,0,7,15,false,false,false,0.363,0.637
182,228,-46,13,16.285714,-46,1045,1082,-37,0,0,0,0,13,14,14,3.461538,1,0,13,19,false,false,false,0.127,0.873
194,315,-121,8.818182,14.318182,-121,818,826,-8,0,0,0,0,-20,22,22,-2.65,0,0,7,13,false,false,false,0,1
209,232,-23,20.9,25.777778,-23,503,527,-24,0,1,0,0.111111,25,10,9,1.32,0,0,10,14,false,false,false,0.266,0.734
90,133,-43,18,33.25,-43,1885,1842,43,0,1,0,0.25,64,5,4,0.421875,1,0,9,8,false,false,false,0.364,0.636
118,131,-13,16.857143,18.714286,-13,1037,1009,28,0,0,0,0,58,7,7,0.758621,0,1,17,6,false,false,false,0.282,0.718
12,0,12,12,0,12,999,1283,-284,0,0,0,0,97,1,0,0.340206,1,0,19,0,false,false,false,0.354,0.646
256,372,-116,13.473684,20.666667,-116,503,668,-165,0,1,0,0.055556,-18,19,18,-2.055556,1,0,6,2,true,false,false,0,1
95,125,-30,10.555556,15.625,-30,1045,1082,-37,0,0,0,0,49,9,8,0.918367,1,0,17,7,false,false,false,0.271,0.729
114,110,4,16.285714,15.714286,4,1344,1314,30,0,1,0,0.142857,54,7,7,0.62963,0,0,10,15,false,false,false,0.368,0.632
207,242,-35,15.923077,18.615385,-35,500,532,-32,0,0,0,0,8,13,13,5.125,0,2,18,8,false,false,false,0,1
35,27,8,11.666667,13.5,8,1047,1253,-206,0,0,0,0,87,3,2,0.425287,1,0,10,14,false,false,false,0.228,0.772
298,331,-33,16.555556,19.470588,-33,689,804,-115,0,1,0,0.058824,-21,18,17,-1.666667,0,1,2,4,true,false,false,0,1
293,387,-94,19.533333,27.642857,-94,1583,1403,180,0,0,0,0,-6,15,14,-5.333333,0,0,2,2,false,false,false,0,1
260,284,-24,17.333333,18.933333,-24,451,448,3,0,0,0,0,1,15,15,37,0,0,9,15,false,false,false,0.167,0.833
272,271,1,22.666667,24.636364,1,804,1074,-270,0,0,0,0,13,12,11,2.461538,0,1,11,9,false,false,false,0.032,0.968
12,43,-31,12,43,-31,1415,1361,54,0,0,0,0,94,1,1,0.329787,0,0,13,18,false,false,false,0.099,0.901
145,148,-3,20.714286,24.666667,-3,965,1078,-113,0,0,0,0,52,7,6,0.711538,0,0,11,14,false,false,false,0.079,0.921
257,356,-99,19.769231,27.384615,-99,835,786,49,0,0,0,0,-5,13,13,-6.8,0,0,14,7,false,false,false,0,1
216,243,-27,21.6,24.3,-27,786,885,-99,1,1,0.1,0.1,33,10,10,1.030303,0,0,10,23,false,false,false,0.246,0.754
54,68,-14,27,68,-14,1645,1636,9,0,1,0,1,83,2,1,0.39759,0,0,18,17,false,false,false,0.457,0.543
192,202,-10,19.2,20.2,-10,1417,1482,-65,0,0,0,0,39,10,10,0.846154,0,1,9,6,false,false,false,0.223,0.777
176,177,-1,22,22.125,-1,921,1045,-124,0,0,0,0,41,8,8,0.853659,0,0,17,9,false,false,false,0.21,0.79
47,37,10,23.5,18.5,10,1232,1448,-216,0,0,0,0,84,2,2,0.416667,0,0,8,13,false,false,false,0.212,0.788
277,309,-32,23.083333,25.75,-32,1388,1366,22,0,1,0,0.083333,11,12,12,2.909091,0,0,8,14,false,false,false,0.059,0.941
86,141,-55,17.2,28.2,-55,594,648,-54,1,1,0.2,0.2,62,5,5,0.645161,0,1,12,16,false,false,false,0,1
125,206,-81,15.625,25.75,-81,915,971,-56,0,0,0,0,43,8,8,0.767442,0,0,7,22,false,false,false,0.006,0.994
12,0,12,12,0,12,526,502,24,0,0,0,0,96,1,0,0.520833,0,0,25,0,false,false,true,0.634,0.366
253,357,-104,13.315789,19.833333,-104,632,603,29,0,1,0,0.055556,-30,19,18,-1.266667,0,0,1,1,false,false,false,0,1
150,204,-54,18.75,25.5,-54,1633,1620,13,0,0,0,0,38,8,8,0.947368,0,0,9,7,false,false,false,0.105,0.895
47,58,-11,11.75,19.333333,-11,503,668,-165,0,0,0,0,76,4,3,0.486842,0,0,9,11,false,false,false,0.144,0.856
52,80,-28,13,20,-28,727,820,-93,0,1,0,0.25,68,4,4,0.514706,0,0,11,21,false,false,false,0.222,0.778
307,325,-18,16.157895,18.055556,-18,1000,960,40,0,0,0,0,-20,19,18,-2.25,0,0,6,3,false,false,false,0.005,0.995
216,304,-88,19.636364,27.636364,-88,874,868,6,0,0,0,0,15,11,11,2.2,0,0,10,18,false,false,false,0.001,0.999
113,161,-48,22.6,32.2,-48,964,1003,-39,0,1,0,0.2,63,5,5,0.619048,0,0,10,9,false,false,false,0.27,0.73
22,0,22,22,0,22,704,523,181,0,0,0,0,95,1,0,0.368421,0,0,12,0,false,false,true,0.784,0.216
213,250,-37,19.363636,22.727273,-37,985,1062,-77,0,0,0,0,20,11,11,1.85,1,0,18,13,false,false,false,0.187,0.813
20,18,2,20,18,2,1493,1413,80,0,0,0,0,95,1,1,0.378947,0,0,26,8,false,false,true,0.68,0.32
85,85,0,21.25,21.25,0,1388,1366,22,0,0,0,0,70,4,4,0.457143,0,1,14,9,false,false,false,0.388,0.612
65,81,-16,16.25,27,-16,1094,1159,-65,0,0,0,0,72,4,3,0.527778,0,0,16,17,false,false,false,0.223,0.777
217,193,24,21.7,19.3,24,1341,1606,-265,1,0,0.1,0,23,10,10,1.434783,0,0,20,8,false,false,true,0.716,0.284
217,239,-22,18.083333,19.916667,-22,518,461,57,0,0,0,0,15,12,12,2.4,0,1,13,9,false,false,false,0.35,0.65
166,225,-59,13.833333,20.454545,-59,977,1100,-123,0,1,0,0.090909,34,12,11,1.205882,0,0,9,10,false,false,false,0.027,0.973
300,291,9,17.647059,18.1875,9,1270,1261,9,1,0,0.058824,0,5,17,16,7.4,0,0,6,12,false,false,false,0.423,0.577
22,45,-23,11,22.5,-23,720,437,283,0,0,0,0,90,2,2,0.466667,0,0,14,15,false,false,true,0.511,0.489
247,368,-121,15.4375,23,-121,1003,1018,-15,0,0,0,0,-24,16,16,-1.541667,0,0,8,3,false,false,false,0,1
250,237,13,13.888889,13.941176,13,306,302,4,0,0,0,0,-14,18,17,-2.928571,0,0,9,16,false,false,true,0.874,0.126
187,324,-137,12.466667,23.142857,-137,1075,1189,-114,0,0,0,0,7,15,14,5.714286,0,1,8,20,false,false,false,0,1
292,330,-38,16.222222,18.333333,-38,599,448,151,0,0,0,0,-15,18,18,-2.4,0,1,3,5,true,false,false,0,1
110,126,-16,22,25.2,-16,1176,1133,43,1,0,0.2,0,69,5,5,0.492754,0,0,12,18,false,false,true,0.525,0.475
258,282,-24,25.8,28.2,-24,1556,1513,43,0,0,0,0,20,10,10,1.55,0,0,11,8,false,false,false,0.167,0.833
145,392,-247,12.083333,32.666667,-247,1093,1100,-7,0,2,0,0.166667,23,12,12,1.521739,0,0,8,17,false,false,false,0,1
177,187,-10,17.7,18.7,-10,306,468,-162,0,0,0,0,41,10,10,0.902439,0,0,9,11,false,false,false,0.38,0.62
235,210,25,21.363636,21,25,1493,1413,80,0,0,0,0,29,11,10,1.241379,0,1,8,10,false,false,false,0.264,0.736
137,232,-95,17.125,33.142857,-95,473,683,-210,0,0,0,0,45,8,7,0.844444,0,0,8,10,false,false,false,0,1
42,42,0,10.5,14,0,1606,1890,-284,0,0,0,0,77,4,3,0.363636,1,0,6,21,false,false,false,0.199,0.801
234,312,-78,16.714286,22.285714,-78,594,648,-54,1,1,0.071429,0.071429,13,14,14,3.076923,0,0,15,15,false,false,false,0,1
329,385,-56,25.307692,32.083333,-56,1431,1399,32,0,2,0,0.166667,-9,13,12,-2.777778,0,0,10,3,true,false,false,0,1
180,182,-2,30,30.333333,-2,824,830,-6,1,0,0.166667,0,56,6,6,0.785714,0,0,12,16,false,false,false,0.253,0.747
89,113,-24,14.833333,22.6,-24,822,845,-23,0,0,0,0,67,6,5,0.522388,0,0,25,14,false,false,false,0.132,0.868
24,88,-64,12,88,-64,786,848,-62,0,1,0,1,91,2,1,0.340659,1,0,14,21,false,false,false,0.157,0.843
296,290,6,21.142857,22.307692,6,786,885,-99,1,1,0.071429,0.076923,12,14,13,2.833333,0,0,7,17,false,false,false,0.437,0.563
245,372,-127,18.846154,28.615385,-127,1101,1115,-14,0,1,0,0.076923,3,13,13,10,1,0,6,7,false,false,false,0,1
256,307,-51,17.066667,21.928571,-51,889,895,-6,0,1,0,0.071429,5,15,14,7.4,0,1,11,22,false,false,false,0,1
160,182,-22,16,20.222222,-22,727,820,-93,0,1,0,0.111111,32,10,9,1.09375,0,0,9,8,false,false,false,0.274,0.726
103,86,17,25.75,21.5,17,892,856,36,0,0,0,0,73,4,4,0.479452,1,0,10,9,false,false,true,0.863,0.137
97,200,-103,19.4,50,-103,786,848,-62,0,1,0,0.25,68,5,4,0.455882,1,0,13,11,false,false,false,0.035,0.965
18,15,3,18,15,3,1161,1030,131,0,0,0,0,92,1,1,0.413043,0,0,12,26,false,false,true,0.544,0.456
283,302,-19,17.6875,18.875,-19,822,845,-23,0,0,0,0,-9,16,16,-3.888889,0,0,17,2,false,false,false,0.12,0.88
195,252,-57,16.25,22.909091,-57,1161,1176,-15,1,1,0.083333,0.090909,15,12,11,2.533333,0,0,12,25,false,false,false,0.025,0.975
248,319,-71,16.533333,22.785714,-71,1071,1181,-110,0,0,0,0,7,15,14,4.857143,0,1,10,12,false,false,false,0,1
67,95,-28,13.4,23.75,-28,840,1055,-215,0,0,0,0,69,5,4,0.507246,0,0,15,13,false,false,false,0.074,0.926
185,349,-164,15.416667,31.727273,-164,1422,1510,-88,0,2,0,0.181818,32,12,11,1.21875,0,0,9,7,false,false,false,0,1
223,340,-117,18.583333,30.909091,-117,1334,1486,-152,2,1,0.166667,0.090909,20,12,11,1.45,0,0,8,14,false,false,false,0,1
194,268,-74,12.933333,17.866667,-74,1248,1220,28,0,1,0,0.066667,18,15,15,2.888889,1,0,9,16,false,false,false,0.029,0.971
329,354,-25,23.5,27.230769,-25,691,695,-4,1,0,0.071429,0,-4,14,13,-8,0,0,4,5,false,false,false,0.028,0.972
314,339,-25,19.625,21.1875,-25,1197,1156,41,0,1,0,0.0625,-10,16,16,-3.5,0,0,3,1,false,false,false,0.038,0.962
45,52,-7,11.25,17.333333,-7,1075,1189,-114,0,0,0,0,77,4,3,0.519481,0,0,7,23,false,false,false,0.073,0.927
61,120,-59,15.25,30,-59,837,844,-7,0,0,0,0,78,4,4,0.525641,0,1,13,12,false,false,false,0.03,0.97
258,282,-24,17.2,18.8,-24,1000,960,40,0,0,0,0,2,15,15,22.5,1,0,6,14,false,false,false,0.163,0.837
68,72,-4,13.6,18,-4,1439,1428,11,0,0,0,0,72,5,4,0.555556,1,0,9,20,false,false,false,0.305,0.695
232,308,-76,23.2,30.8,-76,1606,1890,-284,0,1,0,0.1,18,10,10,1.555556,1,0,10,19,false,false,false,0.025,0.975
239,293,-54,17.071429,22.538462,-54,805,918,-113,0,0,0,0,3,14,13,12,0,1,9,16,false,false,false,0,1
291,450,-159,17.117647,26.470588,-159,976,995,-19,1,2,0.058824,0.117647,-15,17,17,-2.533333,1,0,2,4,false,false,false,0,1
14,17,-3,7,8.5,-3,1278,1101,177,0,0,0,0,86,2,2,0.430233,1,0,16,8,false,false,true,0.828,0.172
203,305,-102,12.6875,20.333333,-102,1305,1307,-2,0,1,0,0.066667,-1,16,15,-41,0,1,13,9,false,false,false,0,1
338,349,-11,22.533333,24.928571,-11,1070,814,256,1,1,0.066667,0.071429,-7,15,14,-4.714286,0,0,3,3,false,false,false,0.031,0.969
172,253,-81,13.230769,19.461538,-81,278,1,277,0,0,0,0,10,13,13,3.7,0,0,16,7,false,false,false,0.073,0.927
257,333,-76,17.133333,22.2,-76,452,698,-246,0,1,0,0.066667,-2,15,15,-20.5,0,0,13,8,false,false,false,0,1
320,350,-30,21.333333,25,-30,1102,1245,-143,0,1,0,0.071429,-12,15,14,-2.416667,0,0,5,3,true,false,false,0,1
262,289,-27,21.833333,26.272727,-27,1454,1479,-25,1,0,0.083333,0,13,12,11,2.384615,0,0,21,23,false,false,false,0.006,0.994
207,375,-168,12.9375,23.4375,-168,948,998,-50,0,0,0,0,-13,16,16,-2.846154,0,0,8,5,false,false,false,0,1
62,126,-64,15.5,31.5,-64,944,1095,-151,0,1,0,0.25,74,4,4,0.527027,0,0,10,17,false,false,false,0.075,0.925
224,281,-57,16,20.071429,-57,889,855,34,0,1,0,0.071429,11,14,14,3.636364,0,0,16,13,false,false,false,0.037,0.963
177,179,-2,25.285714,25.571429,-2,1770,1745,25,1,0,0.142857,0,55,7,7,0.6,0,0,10,12,false,false,false,0.406,0.594
289,344,-55,18.0625,21.5,-55,694,658,36,0,1,0,0.0625,-4,16,16,-9.25,0,0,10,2,false,false,false,0.007,0.993
26,12,14,26,12,14,818,826,-8,0,0,0,0,93,1,1,0.569892,1,0,10,19,false,false,true,0.851,0.149
87,86,1,21.75,21.5,1,985,1062,-77,0,0,0,0,70,4,4,0.528571,0,0,12,23,false,false,false,0.134,0.866
156,126,30,26,21,30,786,885,-99,1,0,0.166667,0,60,6,6,0.566667,0,1,7,10,false,false,false,0.01,0.99
309,328,-19,28.090909,32.8,-19,1793,1957,-164,1,1,0.090909,0.1,17,11,10,1.705882,0,0,16,10,false,false,false,0.139,0.861
30,19,11,15,19,11,391,542,-151,0,0,0,0,89,2,1,0.516854,0,1,10,9,false,false,false,0.105,0.895
153,184,-31,17,20.444444,-31,1334,1439,-105,1,0,0.111111,0,54,9,9,0.666667,0,0,16,12,false,false,false,0.073,0.927
104,114,-10,14.857143,19,-10,344,315,29,1,0,0.142857,0,44,7,6,0.909091,0,0,28,20,false,false,false,0.318,0.682
100,127,-27,16.666667,21.166667,-27,725,668,57,0,0,0,0,58,6,6,0.603448,0,1,23,20,false,false,false,0.33,0.67
255,306,-51,15.9375,19.125,-51,952,826,126,0,1,0,0.0625,7,16,16,6.142857,0,0,14,17,false,false,false,0.047,0.953
121,150,-29,30.25,37.5,-29,820,718,102,0,2,0,0.5,64,4,4,0.4375,0,0,11,19,false,false,false,0.465,0.535
24,21,3,12,21,3,727,820,-93,0,0,0,0,87,2,1,0.402299,0,1,11,12,false,false,false,0.182,0.818
287,413,-126,15.105263,22.944444,-126,913,1037,-124,0,3,0,0.166667,-10,19,18,-4.1,0,0,10,11,false,false,false,0,1
269,205,64,20.692308,17.083333,64,742,594,148,0,0,0,0,19,13,12,2.052632,1,0,8,13,false,false,true,0.989,0.011
190,301,-111,13.571429,21.5,-111,542,605,-63,0,0,0,0,5,14,14,7.2,0,0,8,10,false,false,false,0,1
82,114,-32,11.714286,16.285714,-32,391,542,-151,1,0,0.142857,0,51,7,7,0.901961,0,0,10,8,false,false,false,0.222,0.778
234,390,-156,18,30,-156,1315,1334,-19,0,2,0,0.153846,3,13,13,12,0,0,11,16,false,false,false,0,1
112,50,62,28,16.666667,62,1047,1253,-206,1,0,0.25,0,76,4,3,0.486842,0,0,8,12,false,false,true,0.752,0.248
68,142,-74,11.333333,28.4,-74,1270,1424,-154,0,1,0,0.2,66,6,5,0.530303,0,0,12,8,false,false,false,0.168,0.832
98,189,-91,16.333333,31.5,-91,1101,1115,-14,0,0,0,0,56,6,6,0.535714,0,1,10,8,false,false,false,0.025,0.975
138,169,-31,13.8,18.777778,-31,951,976,-25,0,0,0,0,43,10,9,1.023256,0,0,16,16,false,false,false,0.091,0.909
36,115,-79,7.2,28.75,-79,1422,1510,-88,0,1,0,0.25,77,5,4,0.506494,0,0,11,29,false,false,false,0.121,0.879
16,6,10,8,3,10,1037,1016,21,0,0,0,0,93,2,2,0.623656,0,1,8,10,false,false,true,0.553,0.447
10,16,-6,10,16,-6,527,954,-427,0,0,0,0,92,1,1,0.380435,0,0,11,13,false,false,false,0.223,0.777
215,299,-84,15.357143,21.357143,-84,603,721,-118,0,0,0,0,15,14,14,2.866667,0,0,8,12,false,false,false,0,1
167,154,13,20.875,22,13,1270,1261,9,1,0,0.125,0,52,8,7,0.711538,0,0,8,26,false,false,false,0.134,0.866
46,3,43,23,3,43,1193,1220,-27,0,0,0,0,90,2,1,0.477778,1,1,8,25,false,false,false,0.298,0.702
166,225,-59,13.833333,18.75,-59,595,540,55,0,0,0,0,26,12,12,1.653846,0,0,10,12,false,false,false,0.089,0.911
235,324,-89,16.785714,24.923077,-89,935,995,-60,1,1,0.071429,0.076923,12,14,13,3.25,0,0,17,14,false,false,false,0,1
269,317,-48,16.8125,21.133333,-48,1422,1583,-161,0,1,0,0.066667,2,16,15,20.5,1,0,6,13,false,false,false,0.008,0.992
214,231,-17,19.454545,21,-17,921,1045,-124,0,0,0,0,26,11,11,1.346154,0,0,18,12,false,false,false,0.082,0.918
271,244,27,19.357143,18.769231,27,664,786,-122,0,0,0,0,6,14,13,5.5,0,0,10,14,false,false,false,0.484,0.516
236,306,-70,21.454545,27.818182,-70,1173,1256,-83,1,0,0.090909,0,23,11,11,1.347826,1,1,10,9,false,false,false,0,1
23,70,-47,11.5,35,-47,1397,1309,88,0,0,0,0,88,2,2,0.409091,1,1,15,25,false,false,false,0.079,0.921
256,365,-109,17.066667,24.333333,-109,1408,1539,-131,0,1,0,0.066667,-11,15,15,-3.090909,0,0,5,14,false,false,false,0,1
370,373,-3,21.764706,21.941176,-3,964,1003,-39,0,1,0,0.058824,-14,17,17,-2.785714,0,0,12,8,false,false,false,0.31,0.69
231,294,-63,16.5,22.615385,-63,1493,1453,40,0,0,0,0,7,14,13,5,0,2,12,9,false,false,false,0,1
111,148,-37,13.875,18.5,-37,830,787,43,0,0,0,0,45,8,8,0.844444,0,0,16,7,false,false,false,0.36,0.64
77,82,-5,15.4,20.5,-5,1003,1018,-15,0,0,0,0,68,5,4,0.544118,0,2,15,14,false,false,false,0.147,0.853
105,103,2,35,51.5,2,1354,1210,144,0,1,0,0.5,81,3,2,0.407407,0,0,19,18,false,false,false,0.489,0.511
360,427,-67,25.714286,32.846154,-67,1253,1324,-71,0,2,0,0.153846,-5,14,13,-5.8,0,0,1,1,false,false,false,0,1
88,98,-10,14.666667,19.6,-10,344,315,29,1,0,0.166667,0,52,6,5,0.769231,0,0,12,22,false,false,false,0.254,0.746
99,167,-68,16.5,27.833333,-68,694,658,36,0,1,0,0.166667,56,6,6,0.660714,0,0,37,10,false,false,false,0.398,0.602
34,24,10,17,24,10,897,996,-99,0,0,0,0,86,2,1,0.453488,0,0,14,8,false,false,false,0.475,0.525
195,239,-44,15,18.384615,-44,797,796,1,0,0,0,0,26,13,13,1.884615,1,0,12,12,false,false,false,0.158,0.842
269,292,-23,20.692308,24.333333,-23,1269,1477,-208,1,0,0.076923,0,15,13,12,2.333333,0,0,7,19,false,false,false,0.034,0.966
64,196,-132,7.111111,24.5,-132,1037,913,124,0,1,0,0.125,55,9,8,0.690909,1,0,11,9,false,false,false,0.027,0.973
49,69,-20,12.25,23,-20,595,540,55,0,0,0,0,76,4,3,0.565789,0,0,12,7,false,false,false,0.359,0.641
252,277,-25,19.384615,21.307692,-25,1302,1351,-49,0,0,0,0,14,13,13,2.642857,0,0,11,12,false,false,false,0.185,0.815
16,27,-11,16,27,-11,837,844,-7,0,0,0,0,93,1,1,0.44086,0,1,9,9,false,false,false,0.439,0.561
213,292,-79,16.384615,22.461538,-79,1159,1131,28,0,2,0,0.153846,12,13,13,3.083333,0,0,7,18,false,false,false,0.025,0.975
102,65,37,25.5,21.666667,37,967,856,111,0,0,0,0,72,4,3,0.458333,0,0,10,16,false,false,true,0.76,0.24
319,334,-15,15.190476,16.7,-15,613,525,88,0,0,0,0,-28,21,20,-1.5,0,0,4,2,false,false,false,0.009,0.991
322,399,-77,20.125,24.9375,-77,991,1063,-72,0,1,0,0.0625,-9,16,16,-4.222222,0,0,9,8,false,false,false,0,1
138,272,-134,12.545455,24.727273,-134,1305,1307,-2,0,1,0,0.090909,23,11,11,1.782609,0,0,9,23,false,false,false,0,1
194,196,-2,17.636364,17.818182,-2,907,1070,-163,0,0,0,0,29,11,11,1.206897,0,0,7,25,false,false,false,0.151,0.849
293,284,9,19.533333,18.933333,9,1168,1062,106,0,0,0,0,9,15,15,4.777778,1,0,6,23,false,false,true,0.563,0.437
137,121,16,19.571429,20.166667,16,1432,1452,-20,0,0,0,0,54,7,6,0.666667,1,0,6,9,false,false,false,0.459,0.541
147,177,-30,18.375,25.285714,-30,694,658,36,0,1,0,0.142857,48,8,7,0.770833,0,0,32,7,false,false,false,0.299,0.701
304,310,-6,17.882353,18.235294,-6,742,594,148,0,0,0,0,-11,17,17,-3.545455,1,0,6,6,false,false,false,0.265,0.735
232,265,-33,17.846154,20.384615,-33,1021,1094,-73,1,0,0.076923,0,13,13,13,2.846154,1,0,13,7,false,false,false,0.085,0.915
187,131,56,20.777778,16.375,56,1652,1473,179,1,0,0.111111,0,34,9,8,0.882353,0,0,17,11,false,false,true,0.854,0.146
28,77,-49,7,19.25,-49,1473,1500,-27,0,1,0,0.25,78,4,4,0.5,0,1,7,10,false,false,false,0.271,0.729
21,29,-8,10.5,14.5,-8,1101,1130,-29,0,0,0,0,88,2,2,0.511364,0,1,7,13,false,false,false,0.363,0.637
127,245,-118,15.875,35,-118,1093,1100,-7,0,1,0,0.142857,48,8,7,0.729167,0,0,10,9,false,false,false,0.024,0.976
300,362,-62,20,24.133333,-62,561,633,-72,0,1,0,0.066667,0,15,15,0,0,0,8,4,false,false,false,0,1
256,380,-124,13.473684,20,-124,1037,1016,21,1,0,0.052632,0,-3,19,19,-19.333333,1,0,18,13,false,false,false,0,1
284,322,-38,23.666667,26.833333,-38,1102,1245,-143,0,1,0,0.083333,3,12,12,9.666667,0,0,7,10,false,false,false,0.111,0.889
116,100,16,23.2,25,16,689,804,-115,0,0,0,0,62,5,4,0.564516,0,0,12,17,false,false,false,0.208,0.792
136,139,-3,17,17.375,-3,1037,1009,28,0,0,0,0,52,8,8,0.846154,0,1,21,9,false,false,false,0.314,0.686
206,297,-91,9.809524,14.142857,-91,542,390,152,0,0,0,0,-4,21,21,-12.5,1,0,6,7,false,false,false,0.004,0.996
314,437,-123,19.625,27.3125,-123,999,1283,-284,0,2,0,0.125,-15,16,16,-2.2,0,0,1,2,false,false,false,0,1
181,232,-51,20.111111,25.777778,-51,503,527,-24,0,1,0,0.111111,27,9,9,1.222222,0,0,10,14,false,false,false,0.184,0.816
227,238,-11,28.375,29.75,-11,1556,1513,43,0,0,0,0,35,8,8,0.885714,0,0,8,7,false,false,false,0.246,0.754
280,291,-11,17.5,18.1875,-11,1270,1261,9,1,0,0.0625,0,9,16,16,4.111111,0,0,10,12,false,false,false,0.283,0.717
166,222,-56,20.75,27.75,-56,1586,1633,-47,1,0,0.125,0,52,8,8,0.653846,0,1,21,10,false,false,false,0.033,0.967
55,52,3,27.5,26,3,1164,1149,15,0,0,0,0,85,2,2,0.552941,0,0,14,13,false,false,true,0.532,0.468
67,43,24,16.75,14.333333,24,450,427,23,0,0,0,0,76,4,3,0.486842,0,1,16,10,false,false,true,0.698,0.302
86,28,58,28.666667,14,58,1274,1394,-120,0,0,0,0,84,3,2,0.357143,0,0,13,10,false,false,true,0.526,0.474
187,246,-59,13.357143,18.923077,-59,775,786,-11,0,0,0,0,17,14,13,2.529412,1,0,13,26,false,false,false,0.019,0.981
285,316,-31,16.764706,19.75,-31,306,468,-162,1,0,0.058824,0,-5,17,16,-7.4,0,0,7,5,false,false,false,0,1
69,59,10,17.25,14.75,10,725,668,57,0,0,0,0,74,4,4,0.472973,0,0,11,29,false,false,true,0.565,0.435
200,268,-68,15.384615,20.615385,-68,1037,913,124,1,1,0.076923,0.076923,23,13,13,1.652174,1,0,11,10,false,false,false,0.03,0.97
216,272,-56,16.615385,22.666667,-56,804,1080,-276,0,0,0,0,17,13,12,2,1,0,9,12,false,false,false,0.04,0.96
159,281,-122,13.25,23.416667,-122,563,523,40,0,0,0,0,18,12,12,2.055556,0,0,17,23,false,false,false,0,1
244,328,-84,17.428571,23.428571,-84,452,698,-246,0,1,0,0.071429,7,14,14,5.857143,0,0,15,7,false,false,false,0,1
30,24,6,15,12,6,1037,913,124,0,0,0,0,90,2,2,0.422222,0,0,7,19,false,false,true,0.597,0.403
200,258,-58,13.333333,18.428571,-58,613,525,88,0,0,0,0,11,15,14,3.818182,0,1,26,8,false,false,false,0,1
76,188,-112,12.666667,31.333333,-112,595,412,183,0,1,0,0.166667,60,6,6,0.866667,0,1,15,6,false,false,false,0.028,0.972
281,364,-83,10.407407,14,-83,651,700,-49,0,0,0,0,-49,27,26,-1.142857,0,0,14,9,false,false,false,0,1
77,98,-21,15.4,24.5,-21,1777,1500,277,0,0,0,0,67,5,4,0.41791,1,1,9,12,false,false,false,0.205,0.795
270,294,-24,20.769231,22.615385,-24,1245,1148,97,0,0,0,0,4,13,13,8.75,0,0,19,7,false,false,false,0.37,0.63
297,372,-75,21.214286,26.571429,-75,1274,1394,-120,0,1,0,0.071429,-8,14,14,-3.75,0,0,8,3,false,false,false,0,1
208,226,-18,14.857143,16.142857,-18,1193,1220,-27,0,0,0,0,12,14,14,3.583333,1,0,6,14,false,false,true,0.599,0.401
18,0,18,18,0,18,450,427,23,0,0,0,0,96,1,0,0.385417,0,0,8,0,false,false,true,0.743,0.257
75,60,15,18.75,20,15,1633,1556,77,0,0,0,0,74,4,3,0.445946,0,0,23,7,false,false,false,0.43,0.57
110,101,9,13.75,14.428571,9,808,749,59,0,0,0,0,45,8,7,0.933333,0,0,8,13,false,false,true,0.523,0.477
55,117,-62,13.75,29.25,-62,1454,1479,-25,0,0,0,0,67,4,4,0.462687,1,0,6,15,false,false,false,0.135,0.865
111,67,44,22.2,16.75,44,995,965,30,0,0,0,0,64,5,4,0.625,0,0,18,7,false,false,true,0.653,0.347
16,35,-19,8,17.5,-19,530,683,-153,0,0,0,0,92,2,2,0.434783,0,0,9,10,false,false,false,0.185,0.815
187,246,-59,14.384615,18.923077,-59,775,786,-11,0,0,0,0,17,13,13,2.529412,1,0,6,26,false,false,false,0.018,0.982
220,271,-51,13.75,18.066667,-51,278,1,277,0,0,0,0,-5,16,15,-7.4,0,0,11,5,false,false,false,0.073,0.927
74,103,-29,12.333333,17.166667,-29,595,540,55,0,0,0,0,57,6,6,0.754386,0,1,12,16,false,false,false,0.393,0.607
14,33,-19,14,33,-19,1071,1000,71,0,0,0,0,93,1,1,0.505376,0,0,10,10,false,false,false,0.27,0.73
189,224,-35,18.9,22.4,-35,595,733,-138,1,1,0.1,0.1,26,10,10,1.5,0,1,22,13,false,false,false,0.032,0.968
273,303,-30,30.333333,37.875,-30,1431,1399,32,0,2,0,0.25,18,9,8,1.388889,0,0,10,9,false,false,false,0.128,0.872
354,370,-16,23.6,24.666667,-16,714,820,-106,1,0,0.066667,0,-7,15,15,-4.428571,0,0,2,2,false,false,true,0.578,0.422
211,204,7,19.181818,20.4,7,1495,1531,-36,0,0,0,0,34,11,10,1.088235,0,0,9,9,false,false,false,0.27,0.73
153,284,-131,15.3,28.4,-131,726,818,-92,0,1,0,0.1,28,10,10,1.25,0,0,15,17,false,false,false,0,1
255,308,-53,12.75,16.210526,-53,615,542,73,0,0,0,0,-12,20,19,-3.5,0,0,11,8,false,false,false,0,1
237,299,-62,19.75,24.916667,-62,1101,1237,-136,1,0,0.083333,0,18,12,12,1.888889,1,0,20,10,false,false,false,0.087,0.913
52,99,-47,13,24.75,-47,1123,1062,61,0,0,0,0,69,4,4,0.637681,0,0,7,16,false,false,false,0.216,0.784
249,306,-57,22.636364,27.818182,-57,1274,1394,-120,0,1,0,0.090909,12,11,11,2.5,0,0,17,20,false,false,false,0,1
92,102,-10,18.4,20.4,-10,1495,1597,-102,0,0,0,0,68,5,5,0.470588,0,1,12,18,false,false,false,0.085,0.915
35,58,-23,11.666667,19.333333,-23,503,668,-165,0,0,0,0,79,3,3,0.468354,0,0,7,11,false,false,false,0.182,0.818
92,137,-45,23,34.25,-45,503,527,-24,0,1,0,0.25,65,4,4,0.507692,0,0,7,10,false,false,false,0.278,0.722
41,77,-36,10.25,19.25,-36,1038,917,121,0,0,0,0,78,4,4,0.448718,0,1,7,17,false,false,false,0.239,0.761
142,183,-41,15.777778,20.333333,-41,1803,1658,145,0,0,0,0,35,9,9,0.942857,2,0,8,10,false,false,false,0.387,0.613
191,231,-40,21.222222,28.875,-40,1636,1702,-66,0,1,0,0.125,41,9,8,0.707317,0,0,14,11,false,false,false,0.254,0.746
370,366,4,21.764706,22.875,4,964,1003,-39,0,1,0,0.0625,-11,17,16,-3.545455,0,0,12,10,false,false,false,0.377,0.623
167,220,-53,12.846154,18.333333,-53,595,662,-67,0,1,0,0.083333,22,13,12,2,0,0,17,14,false,false,false,0.063,0.937
189,257,-68,17.181818,23.363636,-68,452,698,-246,0,1,0,0.090909,24,11,11,1.708333,0,0,15,10,false,false,false,0.066,0.934
199,289,-90,14.214286,20.642857,-90,952,826,126,0,1,0,0.071429,17,14,14,2.529412,0,0,22,17,false,false,false,0,1
338,333,5,28.166667,27.75,5,1885,1842,43,0,2,0,0.166667,1,12,12,27,0,1,12,5,false,false,true,0.516,0.484
170,181,-11,17,20.111111,-11,1161,1176,-15,1,1,0.1,0.111111,29,10,9,1.310345,0,0,10,19,false,false,false,0.444,0.556
65,93,-28,10.833333,15.5,-28,808,749,59,0,0,0,0,57,6,6,0.736842,0,0,9,10,false,false,false,0.446,0.554
232,327,-95,19.333333,27.25,-95,1131,1030,101,0,0,0,0,7,12,12,4.285714,0,0,10,8,false,false,false,0,1
298,359,-61,16.555556,19.944444,-61,694,658,36,0,1,0,0.055556,-17,18,18,-2.176471,0,0,5,1,false,false,false,0,1
228,268,-40,19,24.363636,-40,1055,1019,36,0,0,0,0,10,12,11,3.3,1,0,13,19,false,false,false,0.11,0.89
238,273,-35,26.444444,30.333333,-35,1167,1245,-78,1,0,0.111111,0,13,9,9,1.769231,1,1,8,17,false,false,false,0,1
308,359,-51,19.25,23.933333,-51,1305,1254,51,1,1,0.0625,0.066667,-16,16,15,-2,0,0,1,6,false,false,false,0.004,0.996
270,308,-38,20.769231,25.666667,-38,980,965,15,0,0,0,0,14,13,12,2.714286,0,0,7,16,false,false,false,0.021,0.979
133,247,-114,16.625,30.875,-114,710,758,-48,0,1,0,0.125,47,8,8,0.787234,0,0,8,7,false,false,false,0.016,0.984
46,21,25,15.333333,10.5,25,1552,1803,-251,0,0,0,0,86,3,2,0.383721,0,0,7,15,false,false,false,0.21,0.79
141,247,-106,15.666667,30.875,-106,710,758,-48,0,1,0,0.125,44,9,8,0.840909,0,0,9,7,false,false,false,0.013,0.987
288,341,-53,18,22.733333,-53,1047,1253,-206,1,1,0.0625,0.066667,-2,16,15,-18.5,1,0,8,16,false,false,false,0.004,0.996
188,205,-17,15.666667,17.083333,-17,402,448,-46,0,0,0,0,23,12,12,1.608696,0,2,11,14,false,false,false,0,1
112,82,30,28,20.5,30,1047,1253,-206,1,0,0.25,0,73,4,4,0.506849,0,0,8,10,false,false,false,0.398,0.602
240,261,-21,20,23.727273,-21,967,856,111,0,0,0,0,22,12,11,1.5,0,1,20,8,false,false,false,0.141,0.859
297,352,-55,21.214286,27.076923,-55,1274,1394,-120,0,1,0,0.076923,-5,14,13,-6,0,0,8,5,false,false,false,0,1
12,18,-6,12,18,-6,632,603,29,0,0,0,0,90,1,1,0.422222,0,0,9,14,false,false,true,0.637,0.363
51,51,0,12.75,12.75,0,163,346,-183,0,0,0,0,66,4,4,0.590909,0,1,16,9,false,false,false,0.072,0.928
146,227,-81,18.25,28.375,-81,1055,840,215,0,1,0,0.125,41,8,8,0.878049,1,0,6,7,false,false,false,0.051,0.949
20,18,2,20,18,2,694,658,36,0,0,0,0,91,1,1,0.406593,0,0,9,14,false,false,true,0.723,0.277
296,349,-53,14.8,17.45,-53,452,698,-246,0,1,0,0.05,-18,20,20,-2.277778,0,0,4,2,false,false,false,0,1
354,363,-9,23.6,25.928571,-9,714,820,-106,1,0,0.066667,0,-4,15,14,-7.75,0,0,2,2,false,false,false,0.084,0.916
12,18,-6,12,18,-6,775,786,-11,0,0,0,0,92,1,1,0.467391,0,0,8,21,false,false,false,0.367,0.633
325,345,-20,20.3125,21.5625,-20,786,885,-99,1,1,0.0625,0.0625,-4,16,16,-8.5,0,0,2,1,false,false,false,0.158,0.842
271,417,-146,22.583333,34.75,-146,1554,1685,-131,0,2,0,0.166667,10,12,12,3.2,0,0,9,16,false,false,false,0,1
78,73,5,11.142857,10.428571,5,670,576,94,0,0,0,0,52,7,7,0.788462,0,0,22,10,false,false,true,0.675,0.325
230,183,47,23,20.333333,47,1093,1173,-80,0,0,0,0,39,10,9,1.102564,0,0,17,19,false,false,false,0.429,0.571
331,364,-33,15.761905,17.333333,-33,1220,1185,35,0,1,0,0.047619,-22,21,21,-2.136364,0,0,9,4,false,false,false,0,1
107,198,-91,15.285714,28.285714,-91,595,412,183,0,1,0,0.142857,53,7,7,0.981132,0,1,8,15,false,false,false,0.039,0.961
98,153,-55,7.538462,12.75,-55,288,359,-71,0,0,0,0,38,13,12,0.710526,0,0,15,9,false,false,false,0.162,0.838
58,45,13,14.5,11.25,13,670,576,94,0,0,0,0,69,4,4,0.594203,0,0,19,12,false,false,true,0.785,0.215
285,312,-27,15.833333,18.352941,-27,360,371,-11,0,0,0,0,-27,18,17,-1.37037,0,0,1,1,false,false,false,0.057,0.943
256,257,-1,17.066667,17.133333,-1,796,800,-4,1,0,0.066667,0,13,15,15,3.692308,0,1,10,6,false,false,false,0.234,0.766
80,84,-4,11.428571,14,-4,530,683,-153,0,0,0,0,67,7,6,0.597015,0,1,9,7,false,false,false,0.112,0.888
184,191,-7,13.142857,14.692308,-7,163,346,-183,0,0,0,0,8,14,13,4.875,0,0,12,8,false,false,false,0.471,0.529
166,245,-79,18.444444,27.222222,-79,1305,1254,51,0,1,0,0.111111,30,9,9,1.066667,0,0,18,11,false,false,false,0.063,0.937
282,423,-141,12.818182,19.227273,-141,1037,1016,21,1,0,0.045455,0,-15,22,22,-3.866667,1,0,12,5,false,false,false,0,1
257,232,25,21.416667,19.333333,25,1227,1189,38,0,0,0,0,10,12,12,3.5,0,1,10,29,false,false,true,0.691,0.309
194,180,14,17.636364,18,14,907,1070,-163,0,0,0,0,32,11,10,1.09375,0,0,7,16,false,false,false,0.122,0.878
303,297,6,18.9375,19.8,6,907,910,-3,0,1,0,0.066667,10,16,15,4.3,0,0,8,7,false,false,true,0.655,0.345
215,208,7,23.888889,23.111111,7,1102,1245,-143,0,0,0,0,28,9,9,1.035714,0,0,8,16,false,false,false,0.154,0.846
55,96,-41,18.333333,48,-41,1422,1798,-376,0,1,0,0.5,77,3,2,0.415584,1,0,16,12,false,false,false,0.143,0.857
230,269,-39,17.692308,20.692308,-39,451,448,3,0,0,0,0,11,13,13,3.363636,0,0,11,7,false,false,false,0.163,0.837
97,113,-16,16.166667,22.6,-16,1037,1009,28,0,0,0,0,64,6,5,0.6875,0,1,18,8,false,false,false,0.271,0.729
212,249,-37,21.2,24.9,-37,1269,1477,-208,1,0,0.1,0,32,10,10,1.09375,0,0,15,7,false,false,false,0.092,0.908
323,289,34,19,18.0625,34,1488,1428,60,1,0,0.058824,0,-4,17,16,-9.25,0,1,29,6,false,false,false,0.006,0.994
18,0,18,18,0,18,967,856,111,0,0,0,0,95,1,0,0.347368,0,0,11,0,false,false,true,0.672,0.328
47,80,-33,9.4,16,-33,999,1165,-166,0,0,0,0,69,5,5,0.666667,0,0,17,12,false,false,false,0.074,0.926
159,323,-164,7.95,17,-164,651,567,84,0,0,0,0,-5,20,19,-11,0,0,8,11,false,false,false,0,1
306,326,-20,17,18.111111,-20,720,437,283,0,0,0,0,-5,18,18,-8.4,0,0,8,7,false,false,false,0.104,0.896
209,235,-26,34.833333,47,-26,1431,1399,32,0,1,0,0.2,44,6,5,0.568182,0,0,9,13,false,false,false,0.06,0.94
140,186,-46,15.555556,20.666667,-46,430,542,-112,0,1,0,0.111111,39,9,9,1.230769,0,0,17,13,false,false,false,0.128,0.872
48,98,-50,24,49,-50,1537,1539,-2,0,1,0,0.5,81,2,2,0.419753,0,0,10,16,false,false,false,0.273,0.727
26,47,-21,8.666667,15.666667,-21,632,603,29,0,0,0,0,78,3,3,0.487179,1,1,9,17,false,false,false,0.484,0.516
172,63,109,28.666667,12.6,109,1188,1334,-146,1,0,0.166667,0,58,6,5,0.517241,0,0,9,12,false,false,true,0.95,0.05
323,322,1,17,17.888889,1,1488,1428,60,1,0,0.052632,0,-13,19,18,-2.846154,0,1,29,4,true,false,false,0.001,0.999
358,394,-36,23.866667,26.266667,-36,1344,1208,136,1,1,0.066667,0.066667,-9,15,15,-3.333333,1,0,3,2,true,false,false,0.146,0.854
35,50,-15,11.666667,16.666667,-15,1047,1253,-206,0,0,0,0,83,3,3,0.445783,1,0,10,12,false,false,false,0.215,0.785
141,162,-21,15.666667,20.25,-21,306,361,-55,0,0,0,0,37,9,8,0.972973,0,2,8,7,false,false,false,0,1
14,72,-58,14,72,-58,594,648,-54,0,1,0,1,89,1,1,0.449438,0,0,15,11,false,false,false,0.27,0.73
34,52,-18,17,26,-18,1055,1019,36,0,0,0,0,83,2,2,0.39759,1,0,9,17,false,false,false,0.452,0.548
158,190,-32,17.555556,21.111111,-32,1021,1094,-73,1,0,0.111111,0,39,9,9,0.948718,1,0,9,12,false,false,false,0.171,0.829
311,335,-24,22.214286,25.769231,-24,1388,1366,22,0,1,0,0.076923,2,14,13,16,0,0,12,9,false,false,false,0.05,0.95
87,79,8,17.4,19.75,8,1161,1030,131,0,0,0,0,73,5,4,0.520548,0,1,7,13,false,false,false,0.283,0.717
154,175,-21,15.4,19.444444,-21,360,371,-11,0,0,0,0,29,10,9,1.275862,0,0,15,7,false,false,false,0.429,0.571
81,170,-89,13.5,34,-89,1220,1202,18,0,0,0,0,62,6,5,0.806452,0,0,20,7,false,false,false,0.031,0.969
148,197,-49,18.5,24.625,-49,653,820,-167,0,0,0,0,34,8,8,1.117647,0,0,8,13,false,false,false,0.064,0.936
119,133,-14,14.875,16.625,-14,613,525,88,0,0,0,0,48,8,8,0.875,0,1,10,16,false,false,true,0.509,0.491
155,151,4,19.375,18.875,4,965,1078,-113,0,0,0,0,46,8,8,0.804348,0,0,9,12,false,false,false,0.143,0.857
74,54,20,24.666667,27,20,1417,1482,-65,0,0,0,0,82,3,2,0.402439,0,0,25,12,false,false,true,0.667,0.333
159,207,-48,22.714286,29.571429,-48,1428,1361,67,0,0,0,0,41,7,7,0.804878,0,0,7,7,false,false,false,0.047,0.953
142,164,-22,14.2,18.222222,-22,568,570,-2,0,0,0,0,39,10,9,0.948718,0,0,10,19,false,false,false,0.175,0.825
65,61,4,13,15.25,4,361,413,-52,0,0,0,0,68,5,4,0.602941,0,0,30,11,false,false,false,0.359,0.641
282,406,-124,12.818182,19.333333,-124,1037,1016,21,1,0,0.045455,0,-13,22,21,-4.461538,1,0,12,6,false,false,false,0,1
220,268,-48,20,24.363636,-48,1055,1019,36,0,0,0,0,13,11,11,2.538462,1,0,6,19,false,false,false,0.066,0.934
189,235,-46,23.625,29.375,-46,1793,1957,-164,0,0,0,0,39,8,8,0.74359,0,1,14,7,false,false,false,0.064,0.936
245,254,-9,20.416667,21.166667,-9,939,969,-30,0,0,0,0,9,12,12,3.666667,0,0,20,7,false,false,false,0.319,0.681
321,361,-40,21.4,25.785714,-40,1556,1513,43,0,0,0,0,-8,15,14,-3.875,0,0,2,2,false,false,false,0.017,0.983
47,53,-6,15.666667,17.666667,-6,595,412,183,0,0,0,0,81,3,3,0.641975,0,0,7,16,false,false,true,0.545,0.455
292,317,-25,29.2,35.222222,-25,1431,1399,32,0,2,0,0.222222,10,10,9,2.5,0,0,13,7,false,false,false,0.195,0.805
127,164,-37,14.111111,18.222222,-37,568,570,-2,0,0,0,0,42,9,9,0.880952,0,0,12,19,false,false,false,0.185,0.815
198,275,-77,16.5,22.916667,-77,1159,1131,28,0,2,0,0.166667,18,12,12,2.055556,0,0,15,22,false,false,false,0.019,0.981
291,317,-26,13.227273,14.409091,-26,796,800,-4,1,0,0.045455,0,-16,22,22,-3,0,0,12,3,false,false,false,0,1
324,342,-18,21.6,22.8,-18,1645,1636,9,0,1,0,0.066667,-16,15,15,-2.0625,0,0,3,3,false,false,false,0.045,0.955
163,261,-98,18.111111,32.625,-98,653,1004,-351,0,0,0,0,34,9,8,0.852941,0,0,14,9,false,false,false,0,1
103,94,9,14.714286,15.666667,9,830,787,43,0,0,0,0,56,7,6,0.678571,0,0,18,10,false,false,true,0.503,0.497
234,263,-29,15.6,17.533333,-29,450,503,-53,0,0,0,0,3,15,15,13,1,0,6,10,false,false,false,0.11,0.89
366,380,-14,26.142857,27.142857,-14,1093,1100,-7,3,0,0.214286,0,6,14,14,5.166667,0,0,10,9,false,false,false,0.162,0.838
231,292,-61,16.5,22.461538,-61,1159,1131,28,0,2,0,0.153846,9,14,13,4.111111,0,0,10,18,false,false,false,0.023,0.977
56,44,12,14,14.666667,12,361,413,-52,0,0,0,0,74,4,3,0.554054,0,0,26,11,false,false,false,0.37,0.63
20,0,20,20,0,20,452,698,-246,0,0,0,0,96,1,1,0.427083,0,1,31,7,false,false,true,0.531,0.469
56,69,-13,28,34.5,-13,1126,1277,-151,0,0,0,0,79,2,2,0.443038,0,0,13,15,false,false,false,0.177,0.823
349,302,47,29.083333,27.454545,47,820,718,102,0,2,0,0.181818,5,12,11,5.6,0,0,13,9,false,false,true,0.913,0.087
83,95,-12,20.75,31.666667,-12,1334,1486,-152,0,0,0,0,78,4,3,0.371795,0,1,7,15,false,false,false,0.068,0.932
279,368,-89,18.6,24.533333,-89,771,668,103,2,0,0.133333,0,-12,15,15,-3.166667,1,0,16,13,false,false,false,0,1
162,162,0,16.2,16.2,0,889,855,34,0,0,0,0,39,10,10,1.025641,0,1,18,8,false,false,true,0.509,0.491
154,175,-21,17.111111,21.875,-21,1075,878,197,0,0,0,0,48,9,8,0.6875,0,0,10,12,false,false,false,0.304,0.696
253,277,-24,15.8125,17.3125,-24,840,1055,-215,0,0,0,0,-8,16,16,-4.375,0,0,18,2,false,false,false,0,1
230,181,49,19.166667,16.454545,49,1000,960,40,0,0,0,0,24,12,11,1.875,0,0,11,17,false,false,true,0.897,0.103
166,214,-48,20.75,30.571429,-48,1110,1399,-289,0,1,0,0.142857,44,8,7,0.772727,0,0,27,9,false,false,false,0.051,0.949
114,73,41,28.5,18.25,41,804,1074,-270,0,0,0,0,70,4,4,0.457143,0,0,13,26,false,false,true,0.586,0.414
105,165,-60,35,55,-60,1398,1431,-33,0,0,0,0,65,3,3,0.430769,0,0,10,10,false,false,false,0.043,0.957
161,145,16,17.888889,18.125,16,1043,1003,40,0,0,0,0,40,9,8,0.95,0,0,19,15,false,false,false,0.466,0.534
273,342,-69,18.2,22.8,-69,691,704,-13,0,1,0,0.066667,-2,15,15,-19,0,0,9,10,false,false,false,0,1
187,146,41,20.777778,16.222222,41,1432,1452,-20,0,0,0,0,40,9,9,0.9,1,1,9,10,false,false,true,0.569,0.431
217,249,-32,19.727273,22.636364,-32,971,635,336,0,0,0,0,19,11,11,1.684211,1,0,7,12,false,false,false,0.079,0.921
167,223,-56,20.875,27.875,-56,1645,1636,9,0,1,0,0.125,35,8,8,0.942857,0,0,12,7,false,false,false,0.219,0.781
156,132,24,19.5,18.857143,24,1432,1452,-20,0,0,0,0,45,8,7,0.8,1,0,18,7,false,false,true,0.714,0.286
14,0,14,14,0,14,1632,2020,-388,0,0,0,0,96,1,0,0.322917,0,0,16,0,false,false,false,0.211,0.789
319,334,-15,15.95,16.7,-15,430,542,-112,0,1,0,0.05,-20,20,20,-2.4,0,0,6,5,false,false,false,0.063,0.937
305,329,-24,20.333333,23.5,-24,1452,1388,64,0,1,0,0.071429,0,15,14,0,0,0,13,12,false,false,false,0.027,0.973
169,236,-67,16.9,23.6,-67,795,786,9,1,0,0.1,0,39,10,10,0.974359,0,0,9,13,false,false,false,0.007,0.993
34,65,-31,34,65,-31,1398,1431,-33,0,0,0,0,87,1,1,0.321839,0,0,22,9,false,false,false,0.06,0.94
83,124,-41,11.857143,20.666667,-41,95,453,-358,0,0,0,0,64,7,6,0.609375,0,1,9,9,false,false,false,0,1
197,298,-101,11.588235,17.529412,-101,651,700,-49,0,0,0,0,-6,17,17,-9.333333,1,1,9,12,false,false,false,0,1
268,346,-78,15.764706,21.625,-78,805,918,-113,0,0,0,0,-15,17,16,-2.4,0,0,1,5,false,false,false,0,1
295,340,-45,14.75,17.894737,-45,500,509,-9,0,0,0,0,-23,20,19,-1.782609,0,0,2,1,false,false,false,0,1
102,153,-51,25.5,38.25,-51,1071,1065,6,0,0,0,0,57,4,4,0.54386,0,0,17,9,false,false,false,0.154,0.846
37,20,17,18.5,10,17,1203,1270,-67,0,0,0,0,90,2,2,0.488889,0,0,11,16,false,false,false,0.465,0.535
245,211,34,20.416667,19.181818,34,664,786,-122,0,0,0,0,19,12,11,1.736842,1,0,11,7,false,false,true,0.525,0.475
82,97,-15,16.4,19.4,-15,1131,1030,101,0,0,0,0,66,5,5,0.454545,1,0,11,12,false,false,true,0.586,0.414
149,236,-87,18.625,33.714286,-87,1193,1177,16,0,1,0,0.142857,49,8,7,0.714286,0,0,7,11,false,false,false,0.028,0.972
146,103,43,36.5,25.75,43,691,695,-4,1,0,0.25,0,68,4,4,0.470588,0,0,15,18,false,false,true,0.532,0.468
181,196,-15,20.111111,21.777778,-15,758,904,-146,1,0,0.111111,0,29,9,9,1.172414,0,0,13,14,false,false,false,0.229,0.771
58,66,-8,29,33,-8,820,718,102,0,1,0,0.5,81,2,2,0.345679,0,1,18,8,false,false,false,0.486,0.514
164,182,-18,32.8,45.5,-18,2010,2219,-209,1,0,0.2,0,62,5,4,0.419355,0,0,12,8,false,false,false,0.064,0.936
215,286,-71,19.545455,26,-71,1110,1399,-289,0,1,0,0.090909,32,11,11,1.0625,0,0,18,13,false,false,false,0,1
129,118,11,21.5,23.6,11,999,1283,-284,0,0,0,0,62,6,5,0.532258,0,1,13,16,false,false,false,0.223,0.777
58,157,-99,9.666667,26.166667,-99,1037,913,124,0,1,0,0.166667,70,6,6,0.542857,1,0,8,7,false,false,false,0.048,0.952
34,0,34,34,0,34,1055,840,215,0,0,0,0,95,1,0,0.378947,0,0,13,0,false,false,true,0.809,0.191
302,316,-14,27.454545,28.727273,-14,1047,1127,-80,0,1,0,0.090909,7,11,11,3.857143,0,0,10,11,false,false,false,0.39,0.61
156,140,16,22.285714,20,16,786,885,-99,1,0,0.142857,0,57,7,7,0.596491,0,1,17,6,false,false,false,0.092,0.908
146,180,-34,18.25,22.5,-34,691,704,-13,0,1,0,0.125,49,8,8,0.77551,0,0,9,17,false,false,false,0.29,0.71
122,175,-53,13.555556,19.444444,-53,360,371,-11,0,0,0,0,34,9,9,1.088235,0,0,17,7,false,false,false,0.352,0.648
109,100,9,27.25,33.333333,9,1126,1277,-151,0,0,0,0,71,4,3,0.492958,0,0,13,8,false,false,false,0.228,0.772
90,123,-33,22.5,30.75,-33,1645,1636,9,0,1,0,0.25,65,4,4,0.507692,0,0,17,17,false,false,false,0.276,0.724
212,242,-30,15.142857,18.615385,-30,500,532,-32,0,0,0,0,6,14,13,6.833333,0,2,30,8,false,false,false,0,1
79,135,-56,15.8,27,-56,1636,1702,-66,0,1,0,0.2,68,5,5,0.426471,0,1,17,7,false,false,false,0.271,0.729
273,345,-72,19.5,26.538462,-72,1131,1030,101,0,0,0,0,-2,14,13,-15,0,0,2,4,false,false,false,0.009,0.991
155,158,-3,14.090909,14.363636,-3,1193,1220,-27,0,0,0,0,28,11,11,1.535714,1,1,6,16,false,false,false,0.265,0.735
218,203,15,21.8,22.555556,15,1168,1062,106,0,0,0,0,39,10,9,1.102564,0,0,13,9,false,false,false,0.491,0.509
160,201,-41,17.777778,22.333333,-41,804,766,38,0,1,0,0.111111,49,9,9,0.836735,0,1,7,10,false,false,false,0.13,0.87
283,283,0,18.866667,18.866667,0,356,498,-142,0,1,0,0.066667,1,15,15,35,0,0,7,16,false,false,true,0.584,0.416
161,153,8,23,21.857143,8,999,1283,-284,0,0,0,0,54,7,7,0.611111,0,1,8,10,false,false,false,0.392,0.608
104,124,-20,13,15.5,-20,361,413,-52,0,0,0,0,47,8,8,0.87234,1,0,18,7,false,false,false,0.459,0.541
37,97,-60,9.25,32.333333,-60,1305,1307,-2,0,1,0,0.333333,72,4,3,0.569444,0,0,8,21,false,false,false,0.27,0.73
38,81,-43,9.5,20.25,-43,1270,1261,9,0,0,0,0,79,4,4,0.468354,1,0,10,7,false,false,false,0.279,0.721
235,266,-31,19.583333,24.181818,-31,971,800,171,0,1,0,0.090909,3,12,11,9.666667,0,0,19,8,false,false,false,0.261,0.739
74,94,-20,10.571429,15.666667,-20,999,1165,-166,0,0,0,0,61,7,6,0.754098,0,0,23,10,false,false,false,0.073,0.927
165,253,-88,33,50.6,-88,1885,1908,-23,1,3,0.2,0.6,47,5,5,0.489362,0,0,11,25,false,false,false,0.062,0.938
211,304,-93,17.583333,25.333333,-93,700,820,-120,0,1,0,0.083333,13,12,12,2.923077,0,0,14,10,false,false,false,0,1
112,99,13,14,12.375,13,670,576,94,0,0,0,0,46,8,8,0.891304,1,0,12,9,false,false,true,0.873,0.127
294,331,-37,16.333333,19.470588,-37,1281,1268,13,0,0,0,0,-6,18,17,-7,0,0,4,5,false,false,false,0.001,0.999
164,160,4,20.5,22.857143,4,1055,1019,36,0,0,0,0,39,8,7,0.846154,1,0,14,11,false,false,true,0.616,0.384
147,228,-81,13.363636,20.727273,-81,1037,913,124,1,1,0.090909,0.090909,35,11,11,1.085714,0,0,16,13,false,false,false,0.031,0.969
75,76,-1,9.375,10.857143,-1,288,359,-71,0,0,0,0,61,8,7,0.442623,0,0,14,11,false,false,false,0.284,0.716
121,167,-46,12.1,18.555556,-46,668,363,305,0,0,0,0,43,10,9,1.093023,0,0,18,11,false,false,false,0.145,0.855
149,150,-1,13.545455,15,-1,306,302,4,0,0,0,0,33,11,10,1.242424,0,1,8,15,false,false,false,0.32,0.68
85,65,20,21.25,21.666667,20,480,518,-38,0,0,0,0,74,4,3,0.540541,0,1,7,11,false,false,false,0.238,0.762
130,196,-66,13,19.6,-66,1220,1202,18,0,0,0,0,33,10,10,1.515152,0,0,28,9,false,false,false,0.237,0.763
254,274,-20,15.875,18.266667,-20,595,538,57,0,0,0,0,-3,16,15,-12.666667,0,0,6,5,false,false,false,0.101,0.899
335,346,-11,22.333333,23.066667,-11,964,1003,-39,0,1,0,0.066667,-1,15,15,-39,0,0,12,11,false,false,false,0.418,0.582
222,234,-12,24.666667,26,-12,1237,1265,-28,1,0,0.111111,0,29,9,9,1.241379,0,0,9,7,false,false,true,0.51,0.49
316,401,-85,22.571429,28.642857,-85,1556,1616,-60,0,0,0,0,-8,14,14,-3.625,0,0,2,1,false,false,false,0,1
64,56,8,16,14,8,897,996,-99,0,0,0,0,74,4,4,0.527027,0,0,18,9,false,false,false,0.306,0.694
258,305,-47,14.333333,17.941176,-47,613,525,88,0,0,0,0,-5,18,17,-8.4,0,1,19,6,false,false,false,0,1
314,319,-5,16.526316,17.722222,-5,1270,1261,9,1,0,0.052632,0,-8,19,18,-4.625,0,0,3,3,true,false,false,0.159,0.841
297,379,-82,24.75,34.454545,-82,1537,1539,-2,0,1,0,0.090909,9,12,11,3.777778,0,1,7,17,false,false,false,0,1
44,42,2,11,10.5,2,1045,948,97,0,0,0,0,71,4,4,0.478873,0,0,11,15,false,false,true,0.549,0.451
119,124,-5,17,20.666667,-5,1229,1220,9,0,0,0,0,54,7,6,0.685185,0,1,20,10,false,false,false,0.272,0.728
258,316,-58,14.333333,17.555556,-58,613,525,88,0,0,0,0,-13,18,18,-3.230769,0,0,19,7,false,false,false,0,1
12,0,12,12,0,12,1205,1216,-11,0,0,0,0,97,1,0,0.340206,0,0,17,0,false,false,true,0.562,0.438
214,167,47,26.75,23.857143,47,1397,1405,-8,1,0,0.125,0,40,8,7,0.725,0,0,13,12,false,false,true,0.653,0.347
27,31,-4,13.5,15.5,-4,848,976,-128,0,0,0,0,86,2,2,0.465116,0,0,14,15,false,false,false,0.205,0.795
167,289,-122,12.846154,22.230769,-122,948,998,-50,0,0,0,0,9,13,13,4.111111,0,0,23,12,false,false,false,0,1
125,137,-12,15.625,19.571429,-12,306,468,-162,0,0,0,0,58,8,7,0.637931,1,0,7,12,false,false,false,0.165,0.835
182,212,-30,22.75,26.5,-30,1176,1133,43,1,0,0.125,0,51,8,8,0.666667,0,0,9,16,false,false,false,0.101,0.899
110,140,-30,18.333333,28,-30,954,939,15,0,0,0,0,57,6,5,0.631579,0,0,12,17,false,false,false,0.231,0.769
261,289,-28,18.642857,20.642857,-28,450,624,-174,0,0,0,0,-5,14,14,-6.6,1,0,6,17,false,false,false,0.087,0.913
26,0,26,26,0,26,758,791,-33,0,0,0,0,95,1,0,0.410526,0,0,16,0,false,false,true,0.556,0.444
215,247,-32,21.5,27.444444,-32,835,786,49,0,0,0,0,20,10,9,1.7,0,0,9,16,false,false,false,0.066,0.934
275,321,-46,17.1875,20.0625,-46,1220,1185,35,0,1,0,0.0625,4,16,16,11.75,0,0,17,12,false,false,false,0,1
191,267,-76,17.363636,26.7,-76,1408,1539,-131,0,1,0,0.1,17,11,10,2,0,0,11,19,false,false,false,0,1
234,346,-112,21.272727,31.454545,-112,1606,1890,-284,0,1,0,0.090909,14,11,11,2,1,0,10,14,false,false,false,0,1
158,173,-15,19.75,21.625,-15,206,346,-140,1,0,0.125,0,42,8,8,1.02381,0,1,15,6,false,false,false,0.001,0.999
64,61,3,16,20.333333,3,714,892,-178,0,0,0,0,76,4,3,0.552632,1,1,9,17,false,false,false,0.205,0.795
40,83,-43,13.333333,27.666667,-43,1315,1334,-19,0,1,0,0.333333,77,3,3,0.467532,0,1,21,11,false,false,false,0.271,0.729
209,490,-281,17.416667,44.545455,-281,1632,2020,-388,0,2,0,0.181818,10,12,11,3.1,0,0,24,9,false,false,false,0,1
97,102,-5,13.857143,14.571429,-5,999,1071,-72,0,0,0,0,50,7,7,0.8,1,0,9,12,false,false,true,0.576,0.424
90,102,-12,18,20.4,-12,1021,1094,-73,1,0,0.2,0,65,5,5,0.569231,0,0,14,14,false,false,false,0.229,0.771
197,340,-143,13.133333,24.285714,-143,530,683,-153,0,1,0,0.071429,14,15,14,2.857143,0,0,20,13,false,false,false,0,1
207,360,-153,15.923077,27.692308,-153,1484,1556,-72,0,2,0,0.153846,1,13,13,31,1,0,24,9,false,false,false,0,1
196,209,-13,16.333333,19,-13,796,800,-4,1,0,0.083333,0,29,12,11,1.655172,0,0,13,16,false,false,false,0.083,0.917
36,26,10,18,13,10,1040,1364,-324,0,0,0,0,85,2,2,0.423529,0,0,11,12,false,false,false,0.218,0.782
217,245,-28,12.055556,14.411765,-28,1220,1202,18,0,0,0,0,0,18,17,0,0,1,27,13,false,false,false,0,1
12,14,-2,12,14,-2,595,662,-67,0,0,0,0,92,1,1,0.478261,0,0,16,22,false,false,false,0.215,0.785
212,291,-79,17.666667,24.25,-79,721,757,-36,0,2,0,0.166667,16,12,12,2.375,1,0,10,19,false,false,false,0.031,0.969
34,69,-35,17,34.5,-35,1632,2020,-388,0,0,0,0,84,2,2,0.369048,1,0,12,21,false,false,false,0.164,0.836
138,252,-114,12.545455,25.2,-114,1305,1307,-2,0,1,0,0.1,25,11,10,1.64,0,0,9,24,false,false,false,0,1
96,116,-20,19.2,29,-20,1422,1583,-161,0,1,0,0.25,66,5,4,0.621212,0,0,14,11,false,false,false,0.27,0.73
14,0,14,14,0,14,874,868,6,0,0,0,0,96,1,0,0.34375,1,0,21,0,false,false,true,0.736,0.264
202,353,-151,10.1,18.578947,-151,651,996,-345,0,2,0,0.105263,-23,20,19,-1.956522,0,0,5,4,false,false,false,0,1
83,126,-43,16.6,31.5,-43,1349,1203,146,0,1,0,0.25,66,5,4,0.484848,0,0,7,13,false,false,false,0.251,0.749
283,314,-31,14.894737,17.444444,-31,518,414,104,0,1,0,0.055556,-15,19,18,-2.533333,0,0,12,4,false,false,false,0.051,0.949
33,34,-1,11,11.333333,-1,542,605,-63,0,0,0,0,76,3,3,0.473684,1,1,16,9,false,false,false,0.261,0.739
74,59,15,18.5,14.75,15,721,757,-36,0,0,0,0,74,4,4,0.513514,0,0,7,19,false,false,false,0.438,0.562
111,106,5,27.75,26.5,5,1636,1727,-91,0,1,0,0.25,69,4,4,0.434783,0,0,8,8,false,false,false,0.481,0.519
282,319,-37,18.8,21.266667,-37,689,804,-115,0,1,0,0.066667,-6,15,15,-5.833333,0,1,7,5,false,false,false,0.003,0.997
105,152,-47,21,30.4,-47,1021,897,124,0,1,0,0.2,60,5,5,0.616667,1,0,7,7,false,false,false,0.273,0.727
139,189,-50,23.166667,31.5,-50,595,733,-138,1,1,0.166667,0.166667,46,6,6,0.847826,0,1,19,13,false,false,false,0,1
83,133,-50,11.857143,19,-50,907,878,29,0,0,0,0,64,7,7,0.671875,0,0,13,12,false,false,false,0.275,0.725
70,0,70,70,0,70,169,306,-137,1,0,1,0,93,1,0,0.333333,0,0,19,0,false,false,false,0,1
232,234,-2,23.2,26,-2,1237,1265,-28,1,0,0.1,0,25,10,9,1.44,0,0,7,7,false,false,false,0.348,0.652
280,358,-78,25.454545,32.545455,-78,1086,926,160,0,2,0,0.181818,5,11,11,5.6,0,0,13,7,false,false,false,0.015,0.985
90,189,-99,18,37.8,-99,1232,1281,-49,0,2,0,0.4,51,5,5,0.607843,0,0,12,9,false,false,false,0.247,0.753
70,44,26,17.5,14.666667,26,874,868,6,0,0,0,0,74,4,3,0.445946,1,0,18,8,false,false,true,0.782,0.218
275,348,-73,18.333333,24.857143,-73,1315,1331,-16,0,0,0,0,-3,15,14,-11,0,0,4,6,false,false,false,0,1
79,107,-28,13.166667,21.4,-28,840,1055,-215,0,0,0,0,63,6,5,0.555556,0,1,13,9,false,false,false,0.074,0.926
14,0,14,14,0,14,742,594,148,0,0,0,0,94,1,0,0.414894,0,0,19,0,false,false,true,0.781,0.219
65,81,-16,21.666667,40.5,-16,954,939,15,0,0,0,0,80,3,2,0.45,0,0,10,9,false,false,false,0.173,0.827
191,266,-75,23.875,33.25,-75,1021,897,124,0,2,0,0.25,33,8,8,1.121212,0,0,22,10,false,false,false,0.156,0.844
293,355,-62,19.533333,25.357143,-62,1126,1277,-151,0,0,0,0,-14,15,14,-2.5,0,0,2,8,false,false,false,0,1
291,349,-58,14.55,18.368421,-58,620,698,-78,1,0,0.05,0,-23,20,19,-1.782609,1,0,3,1,false,false,false,0,1
223,235,-12,17.153846,18.076923,-12,1203,1270,-67,0,0,0,0,29,13,13,1.517241,1,0,6,15,false,false,false,0.094,0.906
141,162,-21,20.142857,23.142857,-21,1205,1216,-11,0,0,0,0,54,7,7,0.611111,0,0,9,18,false,false,false,0.259,0.741
85,155,-70,12.142857,22.142857,-70,714,892,-178,0,0,0,0,57,7,7,0.736842,1,1,8,6,false,false,false,0.034,0.966
33,29,4,16.5,14.5,4,1047,1127,-80,0,0,0,0,83,2,2,0.325301,1,1,13,16,false,false,false,0.313,0.687
8,16,-8,4,16,-8,1269,1477,-208,0,0,0,0,94,2,1,0.37234,0,0,10,10,false,false,false,0.086,0.914
48,65,-17,12,21.666667,-17,342,263,79,0,0,0,0,73,4,3,0.465753,0,1,8,18,false,false,false,0.431,0.569
140,121,19,23.333333,20.166667,19,1691,1551,140,0,0,0,0,59,6,6,0.627119,0,1,14,23,false,false,false,0.277,0.723
164,323,-159,7.809524,16.15,-159,651,567,84,0,0,0,0,-9,21,20,-6.111111,0,0,7,11,false,false,false,0,1
221,419,-198,20.090909,38.090909,-198,1556,1656,-100,0,2,0,0.181818,5,11,11,6,1,0,17,13,false,false,false,0,1
42,51,-9,14,25.5,-9,360,371,-11,0,0,0,0,80,3,2,0.4625,0,0,17,7,false,false,false,0.474,0.526
112,75,37,28,25,37,1281,1268,13,0,0,0,0,72,4,3,0.583333,0,0,9,7,false,false,true,0.558,0.442
69,40,29,23,13.333333,29,711,746,-35,0,0,0,0,82,3,3,0.463415,0,1,15,14,false,false,true,0.513,0.487
238,359,-121,18.307692,27.615385,-121,1038,917,121,1,2,0.076923,0.153846,2,13,13,17.5,0,0,11,9,false,false,false,0,1
240,214,26,26.666667,26.75,26,1354,1210,144,0,1,0,0.125,38,9,8,0.868421,0,0,19,8,false,false,false,0.413,0.587
154,139,15,22,23.166667,15,1586,1633,-47,1,0,0.142857,0,62,7,6,0.548387,0,0,24,18,false,false,false,0.302,0.698
200,215,-15,16.666667,19.545455,-15,1040,1364,-324,0,0,0,0,17,12,11,2.117647,0,0,14,11,false,false,false,0.075,0.925
282,303,-21,21.692308,23.307692,-21,1473,1500,-27,0,2,0,0.153846,9,13,13,4.333333,1,0,10,8,false,false,false,0.353,0.647
186,190,-4,20.666667,23.75,-4,1110,1123,-13,0,1,0,0.125,34,9,8,0.970588,0,0,8,19,false,false,false,0.278,0.722
191,244,-53,12.733333,17.428571,-53,1182,1075,107,0,1,0,0.071429,1,15,14,39,0,1,24,6,false,false,false,0,1
111,203,-92,10.090909,18.454545,-92,595,662,-67,0,1,0,0.090909,31,11,11,1.419355,0,1,20,15,false,false,false,0,1
16,0,16,16,0,16,1045,948,97,0,0,0,0,95,1,0,0.357895,0,0,16,0,false,false,true,0.582,0.418
238,357,-119,19.833333,32.454545,-119,1368,1452,-84,1,1,0.083333,0.090909,20,12,11,1.6,0,1,12,11,false,false,false,0,1
26,27,-1,13,27,-1,1331,1347,-16,0,0,0,0,88,2,1,0.363636,1,0,6,16,false,false,false,0.303,0.697
120,536,-416,6,28.210526,-416,1164,1149,15,0,3,0,0.157895,9,20,19,5.222222,0,1,12,18,false,false,false,0,1
59,42,17,19.666667,21,17,897,996,-99,0,0,0,0,80,3,2,0.4875,0,0,10,10,false,false,false,0.335,0.665
50,68,-18,10,17,-18,917,856,61,0,0,0,0,73,5,4,0.452055,0,1,17,9,false,false,false,0.272,0.728
10,21,-11,10,21,-11,1770,1745,25,0,0,0,0,95,1,1,0.347368,0,0,8,21,false,false,false,0.272,0.728
89,163,-74,12.714286,23.285714,-74,818,826,-8,0,0,0,0,65,7,7,0.815385,1,0,11,13,false,false,false,0.042,0.958
186,209,-23,20.666667,23.222222,-23,1269,1477,-208,1,0,0.111111,0,40,9,9,0.875,0,0,15,11,false,false,false,0.149,0.851
188,186,2,18.8,20.666667,2,615,542,73,0,0,0,0,42,10,9,1,0,1,19,8,false,false,true,0.559,0.441
136,112,24,19.428571,18.666667,24,995,965,30,0,0,0,0,53,7,6,0.754717,0,1,25,17,false,false,false,0.425,0.575
112,96,16,16,16,16,797,796,1,0,0,0,0,63,7,6,0.777778,0,0,11,14,false,false,false,0.449,0.551
300,305,-5,20,20.333333,-5,1094,1041,53,1,0,0.066667,0,-6,15,15,-6.333333,0,0,16,9,false,false,false,0.491,0.509
175,228,-53,17.5,22.8,-53,1561,1495,66,1,0,0.1,0,23,10,10,1.434783,1,0,6,17,false,false,false,0.033,0.967
168,195,-27,14,17.727273,-27,951,976,-25,0,0,0,0,33,12,11,1.333333,0,0,10,13,false,false,false,0.084,0.916
136,100,36,45.333333,33.333333,36,1436,1489,-53,1,0,0.333333,0,77,3,3,0.480519,0,1,11,11,false,false,true,0.541,0.459
158,164,-6,17.555556,20.5,-6,1176,1211,-35,0,0,0,0,32,9,8,1.03125,0,0,9,13,false,false,false,0.27,0.73
10,0,10,10,0,10,1257,1176,81,0,0,0,0,97,1,0,0.350515,0,0,17,0,false,false,true,0.561,0.439
259,333,-74,12.95,17.526316,-74,95,453,-358,0,0,0,0,-15,20,19,-2.6,0,0,2,4,true,false,false,0,1
116,107,9,23.2,26.75,9,1415,1361,54,0,0,0,0,72,5,4,0.430556,0,1,12,16,false,false,false,0.27,0.73
286,255,31,22,21.25,31,921,1045,-124,0,0,0,0,17,13,12,2.058824,0,0,11,10,false,false,false,0.32,0.68
337,349,-12,18.722222,20.529412,-12,1037,913,124,2,1,0.111111,0.058824,-12,18,17,-3.166667,0,0,4,11,false,false,true,0.57,0.43
296,406,-110,19.733333,27.066667,-110,1232,1448,-216,0,2,0,0.133333,-7,15,15,-5,0,0,9,5,false,false,false,0,1
10,15,-5,10,15,-5,805,918,-113,0,0,0,0,93,1,1,0.387097,0,0,23,7,false,false,false,0.251,0.749
47,18,29,15.666667,9,29,491,651,-160,0,0,0,0,84,3,2,0.357143,0,1,10,10,false,false,false,0.276,0.724
115,168,-53,12.777778,21,-53,500,509,-9,0,0,0,0,41,9,8,1,1,0,9,10,false,false,false,0.164,0.836
47,64,-17,11.75,16,-17,503,668,-165,0,0,0,0,72,4,4,0.513889,0,0,9,16,false,false,false,0.174,0.826
157,147,10,12.076923,12.25,10,1278,1101,177,0,0,0,0,30,13,12,1.233333,1,1,26,9,false,false,true,0.521,0.479
241,271,-30,16.066667,18.066667,-30,615,542,73,0,0,0,0,7,15,15,6,0,0,7,10,false,false,false,0.112,0.888
152,196,-44,12.666667,17.818182,-44,613,525,88,0,0,0,0,31,12,11,1.354839,0,1,10,12,false,false,false,0.072,0.928
70,23,47,35,23,47,1761,1770,-9,0,0,0,0,89,2,1,0.292135,0,0,11,8,false,false,true,0.698,0.302
278,348,-70,18.533333,23.2,-70,1397,1309,88,2,0,0.133333,0,4,15,15,9,0,0,9,11,false,false,false,0,1
264,328,-64,13.2,17.263158,-64,813,698,115,1,0,0.05,0,-16,20,19,-3,0,0,3,12,false,false,false,0,1
251,272,-21,14.764706,17,-21,1040,1091,-51,0,0,0,0,-1,17,16,-47,0,0,13,13,false,false,false,0.004,0.996
34,15,19,17,15,19,805,918,-113,0,0,0,0,88,2,1,0.409091,0,0,29,7,false,false,false,0.342,0.658
117,132,-15,16.714286,18.857143,-15,1439,1428,11,0,0,0,0,59,7,7,0.677966,1,0,9,17,false,false,false,0.338,0.662
279,279,0,16.411765,17.4375,0,1123,1062,61,0,0,0,0,-4,17,16,-11,0,0,6,17,false,false,false,0.148,0.852
369,362,7,20.5,21.294118,7,1156,1279,-123,2,0,0.111111,0,-14,18,17,-2.857143,0,0,2,3,false,false,true,0.916,0.084
125,168,-43,15.625,24,-43,915,971,-56,0,0,0,0,46,8,7,0.717391,0,0,7,29,false,false,false,0.015,0.985
291,304,-13,11.64,12.666667,-13,797,796,1,0,0,0,0,-24,25,24,-2.041667,0,0,5,4,true,false,false,0.434,0.566
286,307,-21,13.619048,15.35,-21,1123,1062,61,0,0,0,0,-19,21,20,-2.315789,0,0,3,10,false,false,false,0.001,0.999
164,196,-32,18.222222,24.5,-32,620,698,-78,1,0,0.111111,0,45,9,8,0.911111,0,0,22,10,false,false,false,0.08,0.92
79,119,-40,15.8,29.75,-40,1636,1702,-66,0,1,0,0.25,72,5,4,0.402778,0,1,17,11,false,false,false,0.271,0.729
40,100,-60,20,50,-60,1248,1220,28,0,1,0,0.5,83,2,2,0.626506,0,0,8,15,false,false,false,0.27,0.73
250,301,-51,13.888889,16.722222,-51,925,1000,-75,0,0,0,0,-12,18,18,-3.666667,0,1,14,5,false,false,false,0,1
76,54,22,19,18,22,664,786,-122,0,0,0,0,82,4,3,0.402439,0,0,19,11,false,false,false,0.279,0.721
299,325,-26,16.611111,18.055556,-26,1000,960,40,0,0,0,0,-17,18,18,-2.647059,0,0,12,3,false,false,false,0,1
154,163,-9,15.4,18.111111,-9,1312,1334,-22,0,0,0,0,31,10,9,1.258065,0,0,25,7,false,false,false,0.272,0.728
41,38,3,20.5,19,3,450,503,-53,0,0,0,0,85,2,2,0.458824,0,0,24,9,false,false,false,0.371,0.629
238,291,-53,15.866667,20.785714,-53,1439,1428,11,0,0,0,0,12,15,14,3.333333,1,0,19,7,false,false,false,0.122,0.878
310,353,-43,15.5,18.578947,-43,1064,1397,-333,0,2,0,0.105263,-9,20,19,-4.777778,1,1,7,11,false,false,false,0,1
173,244,-71,14.416667,22.181818,-71,1195,1397,-202,0,1,0,0.090909,30,12,11,1.333333,0,0,9,7,false,false,false,0.019,0.981
76,91,-15,19,30.333333,-15,954,939,15,0,0,0,0,74,4,3,0.486486,0,0,9,14,false,false,false,0.263,0.737
19,22,-3,9.5,11,-3,595,662,-67,0,0,0,0,85,2,2,0.517647,0,0,15,20,false,false,false,0.216,0.784
171,235,-64,17.1,26.111111,-64,1408,1539,-131,0,1,0,0.111111,25,10,9,1.36,0,0,8,10,false,false,false,0.077,0.923
200,252,-52,28.571429,42,-52,1537,1539,-2,0,1,0,0.166667,41,7,6,0.829268,0,0,16,10,false,false,false,0.071,0.929
105,182,-77,15,26,-77,837,844,-7,0,0,0,0,60,7,7,0.683333,0,1,10,7,false,false,false,0.007,0.993
114,190,-76,16.285714,27.142857,-76,1488,1403,85,0,1,0,0.142857,49,7,7,0.693878,0,0,17,12,false,false,false,0.179,0.821
243,320,-77,14.294118,18.823529,-77,1278,1101,177,0,1,0,0.058824,-7,17,17,-5.285714,0,0,20,1,false,false,false,0,1
255,339,-84,15.9375,21.1875,-84,725,668,57,0,0,0,0,-4,16,16,-8.75,1,0,5,3,false,false,false,0.066,0.934
104,71,33,20.8,17.75,33,1493,1413,80,0,0,0,0,71,5,4,0.507042,0,0,23,10,false,false,true,0.538,0.462
198,256,-58,16.5,23.272727,-58,1159,1131,28,0,2,0,0.181818,21,12,11,1.761905,0,0,15,19,false,false,false,0.056,0.944
234,252,-18,21.272727,22.909091,-18,1561,1495,66,1,0,0.090909,0,10,11,11,3.3,0,0,13,15,false,false,false,0.213,0.787
81,52,29,27,17.333333,29,991,1063,-72,0,0,0,0,82,3,3,0.463415,0,0,8,19,false,false,false,0.302,0.698
199,283,-84,15.307692,21.769231,-84,952,826,126,0,1,0,0.076923,20,13,13,2.15,0,0,8,16,false,false,false,0.056,0.944
272,333,-61,20.923077,27.75,-61,1126,1277,-151,0,0,0,0,-3,13,12,-11.666667,0,0,5,23,false,false,false,0,1
50,38,12,25,19,12,1777,1500,277,0,0,0,0,80,2,2,0.35,1,1,6,17,false,false,true,0.63,0.37
238,247,-9,15.866667,17.642857,-9,306,468,-162,0,0,0,0,11,15,14,3.363636,0,0,11,7,false,false,false,0.389,0.611
10,10,0,10,10,0,758,904,-146,0,0,0,0,92,1,1,0.369565,0,0,20,10,false,false,false,0.212,0.788
98,88,10,19.6,22,10,615,542,73,0,0,0,0,72,5,4,0.583333,0,0,9,15,false,false,true,0.555,0.445
38,41,-3,19,20.5,-3,785,892,-107,0,0,0,0,85,2,2,0.435294,1,0,10,10,false,false,false,0.289,0.711
270,272,-2,14.210526,15.111111,-2,999,1165,-166,0,0,0,0,-1,19,18,-46,1,1,6,8,false,false,true,0.999,0.001
248,327,-79,16.533333,21.8,-79,594,648,-54,1,1,0.066667,0.066667,9,15,15,4.444444,0,0,14,12,false,false,false,0,1
306,338,-32,15.3,17.789474,-32,1281,1268,13,0,0,0,0,-18,20,19,-2.333333,0,0,1,3,false,false,false,0,1
164,214,-50,18.222222,23.777778,-50,1633,1620,13,0,0,0,0,33,9,9,1.090909,0,0,7,9,false,false,false,0.08,0.92
97,109,-12,19.4,21.8,-12,500,532,-32,0,0,0,0,62,5,5,0.66129,0,0,10,10,false,false,false,0.462,0.538
75,199,-124,9.375,24.875,-124,1305,1307,-2,0,1,0,0.125,46,8,8,0.891304,0,0,11,17,false,false,false,0.027,0.973
267,303,-36,22.25,27.545455,-36,1021,897,124,0,2,0,0.181818,10,12,11,3.7,0,0,12,12,false,false,false,0.041,0.959
272,380,-108,24.727273,34.545455,-108,1388,1455,-67,0,0,0,0,7,11,11,4,1,0,17,10,false,false,false,0,1
357,439,-82,23.8,29.266667,-82,1415,1361,54,0,1,0,0.066667,-15,15,15,-2.066667,0,1,6,3,false,false,false,0,1
212,247,-35,21.2,24.7,-35,1645,1636,9,0,1,0,0.1,19,10,10,1.736842,0,0,16,11,false,false,false,0.262,0.738
189,297,-108,17.181818,27,-108,935,995,-60,1,1,0.090909,0.090909,24,11,11,1.625,0,0,7,16,false,false,false,0.001,0.999
126,90,36,42,30,36,1167,1245,-78,1,0,0.333333,0,71,3,3,0.394366,0,0,10,19,false,false,false,0.344,0.656
180,251,-71,20,27.888889,-71,1101,1115,-14,0,0,0,0,35,9,9,0.857143,0,1,12,13,false,false,false,0.012,0.988
213,272,-59,16.384615,22.666667,-59,1071,1181,-110,0,0,0,0,19,13,12,1.789474,0,0,23,16,false,false,false,0,1
211,257,-46,17.583333,21.416667,-46,450,624,-174,0,0,0,0,11,12,12,3,0,0,17,7,false,false,false,0.06,0.94
153,154,-1,21.857143,25.666667,-1,1176,1133,43,1,0,0.142857,0,60,7,6,0.566667,0,0,12,17,false,false,false,0.303,0.697
187,222,-35,14.384615,17.076923,-35,848,976,-128,0,0,0,0,22,13,13,1.818182,0,1,18,9,false,false,false,0.077,0.923
62,30,32,20.666667,15,32,356,498,-142,0,0,0,0,83,3,2,0.421687,0,0,10,13,false,false,false,0.355,0.645
141,140,1,20.142857,23.333333,1,1205,1216,-11,0,0,0,0,58,7,6,0.568966,0,0,9,21,false,false,false,0.248,0.752
171,239,-68,15.545455,21.727273,-68,1037,1016,21,1,0,0.090909,0,35,11,11,1.657143,1,0,23,13,false,false,false,0.114,0.886
83,171,-88,20.75,42.75,-88,1334,1486,-152,0,0,0,0,74,4,4,0.391892,0,0,7,14,false,false,false,0.006,0.994
97,171,-74,19.4,42.75,-74,1334,1486,-152,0,0,0,0,71,5,4,0.408451,0,0,7,14,false,false,false,0.006,0.994
76,52,24,19,17.333333,24,388,542,-154,0,0,0,0,70,4,3,0.528571,0,0,16,17,false,false,false,0.33,0.67
122,130,-8,20.333333,21.666667,-8,1305,1254,51,0,0,0,0,53,6,6,0.603774,0,0,12,12,false,false,false,0.28,0.72
148,196,-48,18.5,24.5,-48,620,698,-78,1,0,0.125,0,47,8,8,0.87234,0,0,23,10,false,false,false,0.11,0.89
178,188,-10,17.8,18.8,-10,500,532,-32,0,0,0,0,32,10,10,1.28125,0,0,8,14,false,false,false,0.238,0.762
204,271,-67,13.6,18.066667,-67,1071,1000,71,0,0,0,0,9,15,15,5.222222,0,0,7,12,false,false,false,0.054,0.946
121,107,14,20.166667,21.4,14,480,518,-38,0,0,0,0,58,6,5,0.689655,0,1,13,14,false,false,false,0.233,0.767
120,281,-161,13.333333,31.222222,-161,1164,1149,15,0,1,0,0.111111,49,9,9,0.959184,0,0,12,9,false,false,false,0,1
276,298,-22,17.25,18.625,-22,1310,1477,-167,0,0,0,0,-20,16,16,-1.8,0,0,5,6,false,false,false,0.005,0.995
220,419,-199,20,38.090909,-199,1219,1216,3,1,4,0.090909,0.363636,-1,11,11,-27,0,0,14,13,false,false,false,0,1
150,184,-34,13.636364,18.4,-34,840,1055,-215,0,0,0,0,32,11,10,1.09375,0,0,21,16,false,false,false,0.072,0.928
331,350,-19,20.6875,21.875,-19,804,1074,-270,0,0,0,0,-14,16,16,-2.285714,0,0,1,1,true,false,false,0.009,0.991
239,259,-20,19.916667,21.583333,-20,971,635,336,0,0,0,0,10,12,12,3.2,0,0,7,10,false,false,false,0.079,0.921
290,313,-23,19.333333,20.866667,-23,1227,1189,38,0,0,0,0,-7,15,15,-5,0,0,10,15,false,false,false,0.073,0.927
41,63,-22,10.25,15.75,-22,342,53,289,0,0,0,0,74,4,4,0.554054,0,0,11,22,false,false,true,0.51,0.49
104,110,-6,11.555556,12.222222,-6,542,390,152,0,0,0,0,59,9,9,0.847458,0,0,13,28,false,false,true,0.667,0.333
274,278,-4,30.444444,34.75,-4,1761,1770,-9,1,1,0.111111,0.125,24,9,8,1.083333,0,0,17,16,false,false,false,0.314,0.686
257,226,31,21.416667,20.545455,31,1227,1189,38,0,0,0,0,13,12,11,2.692308,0,1,10,22,false,false,false,0.349,0.651
159,302,-143,12.230769,23.230769,-143,1075,1189,-114,0,0,0,0,15,13,13,2.666667,0,1,9,21,false,false,false,0,1
236,257,-21,16.857143,18.357143,-21,796,800,-4,1,0,0.071429,0,15,14,14,3.2,0,1,13,8,false,false,false,0.12,0.88
324,285,39,23.142857,21.923077,39,1397,1405,-8,1,0,0.071429,0,-5,14,13,-5.8,0,1,2,7,false,false,true,0.998,0.002
16,57,-41,5.333333,28.5,-41,430,542,-112,0,0,0,0,86,3,2,0.55814,0,2,7,8,false,false,false,0,1
168,164,4,18.666667,20.5,4,527,954,-427,0,0,0,0,45,9,8,0.777778,0,2,25,12,false,false,false,0.001,0.999
191,234,-43,21.222222,29.25,-43,835,786,49,0,0,0,0,28,9,8,1.214286,0,0,16,17,false,false,false,0.066,0.934
134,136,-2,19.142857,19.428571,-2,796,800,-4,0,0,0,0,57,7,7,0.842105,0,0,10,13,false,false,false,0.433,0.567
249,211,38,20.75,19.181818,38,742,868,-126,0,0,0,0,24,12,11,1.375,0,1,12,6,false,false,true,0.559,0.441
148,145,3,21.142857,24.166667,3,921,1045,-124,0,0,0,0,52,7,6,0.673077,0,0,24,10,false,false,false,0.152,0.848
106,127,-21,15.142857,18.142857,-21,848,976,-128,0,0,0,0,57,7,7,0.701754,0,0,16,10,false,false,false,0.081,0.919
179,131,48,22.375,16.375,48,1652,1473,179,1,0,0.125,0,36,8,8,0.833333,0,0,17,11,false,false,true,0.85,0.15
26,79,-53,8.666667,26.333333,-53,1131,1030,101,0,0,0,0,78,3,3,0.384615,0,0,15,10,false,false,false,0.26,0.74
278,451,-173,14.631579,23.736842,-173,1422,1510,-88,0,2,0,0.105263,-19,19,19,-2.052632,0,0,5,2,false,false,false,0,1
70,120,-50,14,30,-50,837,844,-7,0,0,0,0,76,5,4,0.539474,0,1,13,12,false,false,false,0.017,0.983
169,261,-92,15.363636,26.1,-92,480,739,-259,0,0,0,0,34,11,10,1.147059,1,0,20,11,false,false,false,0.02,0.98
249,270,-21,19.153846,20.769231,-21,758,904,-146,1,0,0.076923,0,2,13,13,17,0,1,8,6,false,false,false,0.001,0.999
167,191,-24,20.875,27.285714,-24,1645,1636,9,0,1,0,0.142857,38,8,7,0.868421,0,0,12,16,false,false,false,0.266,0.734
133,211,-78,13.3,21.1,-78,977,1100,-123,0,1,0,0.1,43,10,10,0.953488,0,0,18,7,false,false,false,0.071,0.929
56,132,-76,9.333333,22,-76,795,786,9,0,0,0,0,70,6,6,0.542857,0,0,7,17,false,false,false,0.015,0.985
149,159,-10,21.285714,26.5,-10,356,498,-142,0,1,0,0.166667,53,7,6,0.660377,1,1,8,17,false,false,false,0.09,0.91
46,52,-6,15.333333,17.333333,-6,742,868,-126,0,0,0,0,78,3,3,0.423077,0,0,7,11,false,false,false,0.207,0.793
263,280,-17,17.533333,18.666667,-17,803,786,17,1,0,0.066667,0,-2,15,15,-16,0,0,18,16,false,false,false,0.2,0.8
116,137,-21,14.5,17.125,-21,913,1037,-124,0,1,0,0.125,62,8,8,0.66129,0,0,23,10,false,false,false,0.284,0.716
145,155,-10,12.083333,14.090909,-10,342,53,289,0,0,0,0,25,12,11,1.64,0,1,10,8,false,false,false,0.145,0.855
127,132,-5,25.4,33,-5,576,602,-26,0,0,0,0,68,5,4,0.617647,0,0,10,8,false,false,false,0.263,0.737
269,349,-80,15.823529,20.529412,-80,1064,1397,-333,0,2,0,0.117647,4,17,17,10.75,1,1,9,8,false,false,false,0,1
314,325,-11,19.625,21.666667,-11,1257,1176,81,2,0,0.125,0,1,16,15,34,0,0,9,7,false,false,false,0.071,0.929
63,132,-69,10.5,22,-69,651,996,-345,0,0,0,0,59,6,6,0.762712,0,0,12,15,false,false,false,0.072,0.928
95,53,42,19,13.25,42,1040,1091,-51,0,0,0,0,68,5,4,0.691176,0,0,15,19,false,false,true,0.567,0.433
73,119,-46,18.25,29.75,-46,1636,1702,-66,0,1,0,0.25,76,4,4,0.381579,0,1,16,11,false,false,false,0.271,0.729
343,351,-8,18.052632,19.5,-8,1094,1041,53,1,0,0.052632,0,-27,19,18,-1.407407,0,0,2,1,false,false,false,0.059,0.941
41,71,-30,13.666667,23.666667,-30,1302,1351,-49,0,0,0,0,78,3,3,0.474359,1,0,10,10,false,false,false,0.376,0.624
147,213,-66,13.363636,21.3,-66,683,859,-176,0,0,0,0,38,11,10,1.184211,1,0,10,15,false,false,false,0.03,0.97
222,272,-50,17.076923,20.923077,-50,568,570,-2,0,0,0,0,15,13,13,2.466667,0,1,12,10,false,false,false,0.006,0.994
270,370,-100,19.285714,26.428571,-100,967,856,111,0,1,0,0.071429,4,14,14,8.25,0,1,16,5,false,false,false,0,1
209,361,-152,20.9,36.1,-152,1636,1727,-91,0,2,0,0.2,17,10,10,1.764706,1,0,11,22,false,false,false,0,1
46,33,13,23,16.5,13,1168,1062,106,0,0,0,0,87,2,2,0.494253,0,1,7,16,false,false,true,0.516,0.484
133,170,-37,16.625,24.285714,-37,736,791,-55,0,0,0,0,49,8,7,0.77551,0,0,7,8,false,false,false,0.064,0.936
218,219,-1,21.8,21.9,-1,1168,1062,106,0,0,0,0,37,10,10,1.162162,0,0,13,10,false,false,true,0.503,0.497
285,383,-98,16.764706,23.9375,-98,965,1078,-113,1,1,0.058824,0.0625,-11,17,16,-3.363636,1,0,1,13,false,false,false,0,1
23,34,-11,7.666667,11.333333,-11,940,947,-7,0,0,0,0,80,3,3,0.4375,0,0,11,11,false,false,false,0.381,0.619
139,102,37,27.8,20.4,37,1093,1100,-7,1,0,0.2,0,65,5,5,0.476923,0,1,7,21,false,false,false,0.354,0.646
168,186,-18,21,23.25,-18,1168,1062,106,0,0,0,0,49,8,8,0.877551,0,0,11,11,false,false,false,0.423,0.577
84,99,-15,16.8,24.75,-15,620,698,-78,0,0,0,0,75,5,4,0.546667,0,0,22,10,false,false,false,0.081,0.919
314,333,-19,14.952381,16.65,-19,1000,960,40,0,0,0,0,-27,21,20,-1.666667,0,0,1,1,false,false,false,0.002,0.998
12,72,-60,4,24,-60,1473,1500,-27,0,1,0,0.333333,85,3,3,0.458824,0,1,10,8,false,false,false,0.271,0.729
178,192,-14,19.777778,21.333333,-14,1495,1531,-36,0,0,0,0,45,9,9,0.822222,0,0,8,7,false,false,false,0.27,0.73
141,155,-14,15.666667,17.222222,-14,889,855,34,0,0,0,0,44,9,9,0.909091,0,1,25,6,false,false,false,0.315,0.685
63,171,-108,15.75,42.75,-108,1576,1556,20,0,1,0,0.25,66,4,4,0.454545,0,0,18,16,false,false,false,0.037,0.963
201,366,-165,20.1,40.666667,-165,786,848,-62,0,2,0,0.222222,30,10,9,1.033333,1,0,16,7,false,false,false,0,1
36,108,-72,18,54,-72,1656,1649,7,0,0,0,0,79,2,2,0.405063,0,0,10,15,false,false,false,0.027,0.973
297,479,-182,19.8,31.933333,-182,1368,1452,-84,1,2,0.066667,0.133333,-8,15,15,-4,0,0,2,1,false,false,false,0,1
214,250,-36,12.588235,15.625,-36,668,363,305,0,0,0,0,8,17,16,5.875,0,1,8,7,false,false,false,0.075,0.925
329,314,15,23.5,24.153846,15,1436,1489,-53,1,1,0.071429,0.076923,10,14,13,3.7,0,1,14,19,false,false,false,0.357,0.643
272,399,-127,18.133333,28.5,-127,874,868,6,0,0,0,0,-12,15,14,-2.75,0,0,8,3,false,false,false,0,1
146,167,-21,20.857143,23.857143,-21,1636,1702,-66,0,1,0,0.142857,56,7,7,0.517857,0,1,7,12,false,false,false,0.272,0.728
336,361,-25,18.666667,21.235294,-25,721,757,-36,0,2,0,0.117647,-12,18,17,-3.166667,0,0,1,5,false,false,false,0.161,0.839
164,280,-116,20.5,40,-116,786,848,-62,0,1,0,0.142857,49,8,7,0.632653,1,0,13,12,false,false,false,0.008,0.992
307,341,-34,13.954545,16.238095,-34,1045,1082,-37,0,0,0,0,-32,22,21,-1.40625,0,0,1,1,false,false,false,0,1
162,149,13,27,29.8,13,1885,1842,43,0,1,0,0.2,51,6,5,0.529412,0,0,15,13,false,false,false,0.283,0.717
110,163,-53,13.75,20.375,-53,951,976,-25,0,0,0,0,50,8,8,0.88,1,0,15,16,false,false,false,0.179,0.821
294,337,-43,16.333333,19.823529,-43,480,518,-38,0,0,0,0,-15,18,17,-2.666667,0,0,4,2,false,false,false,0,1
269,344,-75,19.214286,24.571429,-75,1493,1413,80,0,1,0,0.071429,1,14,14,36,0,0,7,9,false,false,false,0,1
299,465,-166,18.6875,29.0625,-166,1003,1004,-1,0,2,0,0.125,-10,16,16,-3.5,0,0,2,2,false,false,false,0,1
178,220,-42,19.777778,27.5,-42,1473,1500,-27,0,2,0,0.25,39,9,8,1,0,0,14,22,false,false,false,0.264,0.736
41,67,-26,13.666667,22.333333,-26,480,739,-259,0,0,0,0,80,3,3,0.4875,0,0,9,7,false,false,false,0.206,0.794
76,188,-112,15.2,47,-112,2143,2219,-76,0,0,0,0,68,5,4,0.455882,0,0,10,8,false,false,false,0.028,0.972
145,177,-32,13.181818,17.7,-32,951,976,-25,0,0,0,0,38,11,10,1.157895,0,0,14,16,false,false,false,0.085,0.915
31,52,-21,15.5,26,-21,1302,1351,-49,0,0,0,0,85,2,2,0.435294,1,0,6,9,false,false,false,0.436,0.564
211,278,-67,19.181818,25.272727,-67,1495,1531,-36,0,1,0,0.090909,27,11,11,1.37037,0,0,9,13,false,false,false,0.035,0.965
99,66,33,19.8,16.5,33,785,892,-107,0,0,0,0,68,5,4,0.544118,0,0,28,14,false,false,true,0.514,0.486
118,160,-42,14.75,22.857143,-42,1176,1211,-35,0,0,0,0,40,8,7,0.825,1,0,16,13,false,false,false,0.357,0.643
234,228,6,21.272727,22.8,6,1561,1495,66,1,0,0.090909,0,15,11,10,2.2,0,0,13,17,false,false,false,0.264,0.736
55,70,-15,18.333333,23.333333,-15,1691,1551,140,0,0,0,0,78,3,3,0.474359,0,0,9,21,false,false,false,0.274,0.726
171,231,-60,19,25.666667,-60,1038,917,121,1,1,0.111111,0.111111,36,9,9,0.972222,0,0,11,7,false,false,false,0.045,0.955
250,134,116,19.230769,11.166667,116,1065,948,117,0,0,0,0,32,13,12,1.21875,0,0,8,8,false,false,true,0.996,0.004
128,214,-86,11.636364,19.454545,-86,830,787,43,0,0,0,0,28,11,11,1.357143,1,0,15,8,false,false,false,0.084,0.916
303,299,4,18.9375,18.6875,4,907,910,-3,0,1,0,0.0625,8,16,16,5.375,0,0,8,7,false,false,true,0.802,0.198
220,313,-93,12.222222,18.411765,-93,388,542,-154,0,0,0,0,-14,18,17,-2.642857,0,1,4,2,false,false,false,0,1
16,10,6,16,10,6,925,1000,-75,0,0,0,0,92,1,1,0.478261,0,0,9,8,false,false,true,0.502,0.498
39,61,-22,9.75,20.333333,-22,1257,1176,81,0,0,0,0,85,4,3,0.4,0,0,15,9,false,false,false,0.271,0.729
204,289,-85,15.692308,22.230769,-85,727,820,-93,0,1,0,0.076923,9,13,13,3.888889,0,0,7,15,false,false,false,0.001,0.999
107,120,-13,21.4,24,-13,1093,1173,-80,0,0,0,0,69,5,5,0.623188,0,0,10,14,false,false,false,0.102,0.898
183,168,15,20.333333,21,15,1422,1583,-161,0,1,0,0.125,43,9,8,0.953488,1,0,10,28,false,false,false,0.234,0.766
218,284,-66,16.769231,23.666667,-66,344,315,29,1,0,0.076923,0,3,13,12,13.333333,0,0,19,8,false,false,false,0,1
51,60,-9,12.75,15,-9,306,302,4,0,0,0,0,76,4,4,0.539474,0,0,16,10,false,false,true,0.639,0.361
103,155,-52,20.6,31,-52,356,498,-142,0,1,0,0.2,61,5,5,0.57377,1,1,8,17,false,false,false,0.001,0.999
93,86,7,23.25,28.666667,7,1164,1149,15,0,0,0,0,76,4,3,0.618421,0,1,9,9,false,false,false,0.299,0.701
169,216,-47,28.166667,36,-47,1761,1770,-9,0,1,0,0.166667,48,6,6,0.541667,0,0,8,12,false,false,false,0.188,0.812
116,233,-117,19.333333,46.6,-117,1632,2020,-388,0,1,0,0.2,52,6,5,0.596154,0,0,8,15,false,false,false,0,1
201,188,13,22.333333,20.888889,13,1691,1551,140,0,0,0,0,40,9,9,0.925,0,1,7,18,false,false,false,0.255,0.745
327,372,-45,19.235294,23.25,-45,1030,1014,16,0,1,0,0.0625,-11,17,16,-3,0,0,2,3,true,false,false,0.001,0.999
156,193,-37,13,16.083333,-37,999,1165,-166,0,0,0,0,28,12,12,1.642857,1,0,18,16,false,false,false,0.077,0.923
270,343,-73,15,20.176471,-73,725,668,57,0,0,0,0,-14,18,17,-2.5,0,0,1,3,true,false,false,0,1
253,305,-52,14.882353,19.0625,-52,642,952,-310,0,0,0,0,-4,17,16,-11,0,0,4,10,false,false,false,0,1
270,302,-32,16.875,18.875,-32,1045,948,97,0,0,0,0,-27,16,16,-1.259259,0,0,6,2,false,false,false,0.059,0.941
208,349,-141,11.555556,20.529412,-141,977,1100,-123,0,1,0,0.058824,-2,18,17,-20.5,0,0,9,19,false,false,false,0,1
39,0,39,19.5,0,39,1195,1397,-202,0,0,0,0,91,2,1,0.43956,0,1,7,10,false,false,false,0.213,0.787
67,57,10,16.75,19,10,595,538,57,0,0,0,0,76,4,3,0.5,0,0,9,14,false,false,true,0.641,0.359
165,259,-94,9.705882,15.235294,-94,818,826,-8,0,0,0,0,7,17,17,7.571429,0,0,7,26,false,false,false,0,1
141,194,-53,15.666667,21.555556,-53,344,315,29,1,0,0.111111,0,30,9,9,1.333333,0,0,22,8,false,false,false,0.224,0.776
292,322,-30,24.333333,26.833333,-30,1556,1513,43,0,0,0,0,7,12,12,4.428571,0,0,9,9,false,false,false,0.056,0.944
193,262,-69,13.785714,18.714286,-69,1045,948,97,0,0,0,0,-5,14,14,-6.8,1,0,13,11,false,false,false,0.077,0.923
243,281,-38,16.2,20.071429,-38,889,855,34,0,1,0,0.071429,8,15,14,5,0,0,10,13,false,false,false,0.044,0.956
75,74,1,18.75,24.666667,1,1110,1399,-289,0,0,0,0,73,4,3,0.465753,0,1,14,9,false,false,false,0.199,0.801
246,280,-34,18.923077,21.538462,-34,450,624,-174,0,0,0,0,3,13,13,11,0,0,10,11,false,false,false,0.065,0.935
158,226,-68,17.555556,25.111111,-68,1493,1453,40,0,0,0,0,37,9,9,0.945946,0,0,12,8,false,false,false,0.043,0.957
37,58,-21,18.5,29,-21,1281,1268,13,0,0,0,0,82,2,2,0.512195,1,0,17,11,false,false,true,0.579,0.421
183,203,-20,12.2,13.533333,-20,391,542,-151,1,0,0.066667,0,8,15,15,5.75,0,0,7,22,false,false,true,0.784,0.216
128,156,-28,11.636364,14.181818,-28,999,1071,-72,0,0,0,0,29,11,11,1.37931,1,0,15,24,false,false,false,0.143,0.857
261,288,-27,17.4,20.571429,-27,568,570,-2,0,0,0,0,5,15,14,7.4,0,0,9,11,false,false,false,0.031,0.969
333,342,-9,15.136364,16.285714,-9,430,542,-112,0,1,0,0.047619,-28,22,21,-1.714286,0,0,1,2,false,false,false,0.076,0.924
68,41,27,17,13.666667,27,1065,948,117,0,0,0,0,75,4,3,0.52,1,0,17,20,false,false,true,0.874,0.126
65,61,4,16.25,15.25,4,1043,1003,40,0,0,0,0,70,4,4,0.542857,1,0,18,12,false,false,true,0.811,0.189
144,128,16,36,42.666667,16,1086,926,160,0,1,0,0.333333,68,4,3,0.411765,1,0,16,19,false,false,true,0.724,0.276
18,16,2,18,16,2,926,973,-47,0,0,0,0,91,1,1,0.384615,0,1,19,7,false,false,true,0.547,0.453
14,12,2,14,12,2,1344,1208,136,0,0,0,0,92,1,1,0.326087,0,0,11,19,false,false,false,0.415,0.585
178,142,36,25.428571,23.666667,36,1245,1148,97,0,0,0,0,52,7,6,0.673077,0,0,22,23,false,false,true,0.695,0.305
131,204,-73,14.555556,25.5,-73,952,826,126,0,1,0,0.125,52,9,8,0.826923,0,0,13,9,false,false,false,0.037,0.963
177,163,14,19.666667,20.375,14,1257,1176,81,1,0,0.111111,0,47,9,8,0.723404,1,0,16,21,false,false,false,0.495,0.505
39,71,-32,19.5,71,-32,1925,1885,40,0,0,0,0,85,2,1,0.294118,0,0,13,20,false,false,false,0.036,0.964
72,109,-37,14.4,21.8,-37,1270,1261,9,0,0,0,0,72,5,5,0.513889,1,0,9,15,false,false,false,0.306,0.694
234,292,-58,23.4,29.2,-58,1436,1489,-53,1,1,0.1,0.1,30,10,10,1.233333,0,0,14,7,false,false,false,0.106,0.894
113,189,-76,18.833333,37.8,-76,1399,1210,189,0,1,0,0.2,58,6,5,0.603448,0,0,17,23,false,false,false,0.029,0.971
75,70,5,18.75,17.5,5,1633,1556,77,0,0,0,0,69,4,4,0.478261,0,0,23,7,false,false,true,0.509,0.491
185,197,-12,16.818182,17.909091,-12,430,542,-112,0,1,0,0.090909,29,11,11,1.655172,0,0,21,11,false,false,false,0.393,0.607
65,105,-40,16.25,26.25,-40,1094,1159,-65,0,0,0,0,68,4,4,0.558824,0,0,16,20,false,false,false,0.15,0.85
257,301,-44,16.0625,20.066667,-44,1161,1176,-15,1,1,0.0625,0.066667,-13,16,15,-2.923077,0,0,5,23,false,false,false,0.002,0.998
37,60,-23,12.333333,20,-23,1075,878,197,0,0,0,0,81,3,3,0.407407,0,0,18,12,false,false,true,0.508,0.492
5,30,-25,2.5,30,-25,1078,983,95,0,0,0,0,92,2,1,0.521739,1,0,8,12,false,false,false,0.264,0.736
140,193,-53,14,21.444444,-53,683,859,-176,0,0,0,0,46,10,9,0.978261,1,0,6,13,false,false,false,0.051,0.949
198,221,-23,16.5,20.090909,-23,360,371,-11,0,0,0,0,11,12,11,3.363636,1,0,6,11,false,false,false,0.333,0.667
147,165,-18,16.333333,18.333333,-18,526,502,24,0,0,0,0,47,9,9,1.06383,0,0,12,7,false,false,false,0.5,0.5
174,229,-55,13.384615,19.083333,-55,1071,1000,71,0,0,0,0,26,13,12,1.807692,0,1,7,13,false,false,false,0.028,0.972
301,411,-110,15.842105,22.833333,-110,965,1078,-113,1,1,0.052632,0.055556,-23,19,18,-1.608696,1,0,0,1,true,false,false,0,1
62,77,-15,15.5,19.25,-15,1229,1220,9,0,0,0,0,69,4,4,0.536232,0,1,13,19,false,false,false,0.274,0.726
238,219,19,21.636364,21.9,19,1168,1062,106,0,0,0,0,33,11,10,1.30303,1,0,7,10,false,false,true,0.535,0.465
118,135,-17,19.666667,22.5,-17,1636,1702,-66,0,1,0,0.166667,64,6,6,0.453125,0,1,10,7,false,false,false,0.277,0.723
51,73,-22,17,24.333333,-22,952,870,82,0,0,0,0,75,3,3,0.493333,0,0,7,18,false,false,false,0.371,0.629
96,128,-32,16,21.333333,-32,620,698,-78,0,0,0,0,65,6,6,0.630769,0,0,29,17,false,false,false,0.09,0.91
57,55,2,19,18.333333,2,306,468,-162,0,0,0,0,84,3,3,0.440476,0,0,11,14,false,false,false,0.316,0.684
59,101,-42,14.75,25.25,-42,1063,1134,-71,0,0,0,0,75,4,4,0.586667,0,0,10,20,false,false,false,0.075,0.925
193,176,17,19.3,19.555556,17,785,892,-107,0,0,0,0,36,10,9,1.027778,0,0,11,17,false,false,false,0.134,0.866
264,314,-50,20.307692,26.166667,-50,653,1004,-351,0,0,0,0,3,13,12,9.666667,0,0,20,16,false,false,false,0,1
337,368,-31,18.722222,20.444444,-31,1037,913,124,2,1,0.111111,0.055556,-14,18,18,-2.714286,0,0,4,6,false,false,false,0.381,0.619
148,126,22,21.142857,21,22,1131,1030,101,0,0,0,0,55,7,6,0.545455,1,0,9,18,false,false,true,0.664,0.336
276,282,-6,17.25,18.8,-6,1310,1477,-167,0,0,0,0,-15,16,15,-2.4,0,0,5,7,false,false,false,0.07,0.93
307,391,-84,18.058824,24.4375,-84,835,786,49,0,0,0,0,-28,17,16,-1.214286,0,0,1,1,false,false,false,0,1
232,273,-41,19.333333,22.75,-41,1078,1095,-17,1,1,0.083333,0.083333,18,12,12,2.055556,0,0,7,10,false,false,false,0.086,0.914
157,205,-48,14.272727,18.636364,-48,651,700,-49,0,0,0,0,30,11,11,1.866667,1,0,6,12,false,false,false,0.097,0.903
124,185,-61,13.777778,23.125,-61,1220,1202,18,0,0,0,0,43,9,8,1.162791,0,0,25,7,false,false,false,0.256,0.744
331,329,2,18.388889,19.352941,2,944,1095,-151,0,1,0,0.058824,-6,18,17,-6.5,0,1,2,4,false,false,true,0.944,0.056
76,70,6,12.666667,14,6,805,918,-113,0,0,0,0,62,6,5,0.580645,0,1,26,6,false,false,false,0.216,0.784
234,280,-46,16.714286,21.538462,-46,725,668,57,0,0,0,0,13,14,13,2.692308,1,0,6,8,false,false,false,0.077,0.923
95,59,36,19,11.8,36,1040,1091,-51,0,0,0,0,66,5,5,0.712121,0,0,15,19,false,false,true,0.755,0.245
60,50,10,20,25,10,1021,1094,-73,0,0,0,0,84,3,2,0.440476,0,0,8,16,false,false,false,0.178,0.822
195,212,-17,15,17.666667,-17,797,796,1,0,0,0,0,29,13,12,1.689655,1,0,12,18,false,false,false,0.181,0.819
291,295,-4,13.857143,14.75,-4,796,800,-4,1,0,0.047619,0,-10,21,20,-4.8,0,1,12,9,false,false,false,0,1
276,263,13,21.230769,20.230769,13,1305,1194,111,1,0,0.076923,0,9,13,13,3.666667,0,0,16,7,false,false,false,0.497,0.503
351,388,-37,18.473684,21.555556,-37,1043,1003,40,0,1,0,0.055556,-21,19,18,-1.809524,0,0,2,2,false,false,false,0,1
24,51,-27,12,25.5,-27,595,540,55,0,0,0,0,84,2,2,0.511905,0,0,13,8,false,false,false,0.362,0.638
224,250,-26,17.230769,19.230769,-26,1040,1364,-324,0,0,0,0,7,13,13,5.142857,0,1,10,19,false,false,false,0.002,0.998
263,315,-52,14.611111,17.5,-52,1040,1091,-51,0,0,0,0,-13,18,18,-3.615385,0,0,13,10,false,false,false,0,1
36,45,-9,12,22.5,-9,720,437,283,0,0,0,0,87,3,2,0.482759,0,0,11,15,false,false,true,0.508,0.492
83,78,5,13.833333,15.6,5,1344,1208,136,0,0,0,0,66,6,5,0.454545,0,0,27,13,false,false,false,0.451,0.549
36,30,6,12,10,6,1045,948,97,0,0,0,0,76,3,3,0.447368,0,0,13,14,false,false,true,0.677,0.323
281,208,73,28.1,23.111111,73,1552,1803,-251,2,0,0.2,0,29,10,9,1.137931,0,1,13,11,false,false,false,0.305,0.695
285,316,-31,21.923077,26.333333,-31,1021,897,124,0,2,0,0.166667,4,13,12,9.25,1,0,8,12,false,false,false,0.036,0.964
46,0,46,46,0,46,1274,1394,-120,0,0,0,0,95,1,0,0.315789,0,0,10,0,false,false,true,0.575,0.425
16,17,-1,5.333333,8.5,-1,95,453,-358,0,0,0,0,93,3,2,0.419355,0,0,10,15,false,false,false,0.224,0.776
100,122,-22,12.5,15.25,-22,163,346,-183,0,0,0,0,44,8,8,0.886364,1,1,6,18,false,false,false,0.003,0.997
197,340,-143,14.071429,24.285714,-143,530,683,-153,0,1,0,0.071429,14,14,14,2.857143,0,0,17,13,false,false,false,0,1
229,361,-132,20.818182,36.1,-132,1636,1727,-91,0,2,0,0.2,15,11,10,2,1,0,11,22,false,false,false,0,1
256,370,-114,19.692308,28.461538,-114,1576,1556,20,0,1,0,0.076923,2,13,13,15,1,0,8,16,false,false,false,0,1
254,315,-61,19.538462,26.25,-61,1127,995,132,0,1,0,0.083333,12,13,12,2.75,0,0,7,10,false,false,false,0.028,0.972
185,187,-2,26.428571,31.166667,-2,801,679,122,1,0,0.142857,0,44,7,6,0.659091,0,0,12,12,false,false,false,0.386,0.614
30,33,-3,15,33,-3,1770,1751,19,0,0,0,0,85,2,1,0.341176,0,1,12,9,false,false,false,0.267,0.733
305,302,3,17.941176,17.764706,3,540,498,42,1,0,0.058824,0,-14,17,17,-3.285714,0,0,7,16,false,false,true,0.735,0.265
67,35,32,22.333333,11.666667,32,1305,1254,51,0,0,0,0,82,3,3,0.390244,0,2,11,6,false,false,true,0.583,0.417
148,223,-75,18.5,27.875,-75,1408,1539,-131,0,1,0,0.125,37,8,8,0.918919,0,0,11,9,false,false,false,0.195,0.805
165,248,-83,15,24.8,-83,1094,1159,-65,0,0,0,0,24,11,10,1.583333,1,0,18,11,false,false,false,0.025,0.975
26,0,26,26,0,26,1232,1281,-49,0,0,0,0,95,1,0,0.326316,0,0,7,0,false,false,true,0.562,0.438
369,374,-5,18.45,19.684211,-5,1156,1279,-123,2,0,0.1,0,-17,20,19,-2.352941,0,0,2,1,false,false,false,0.001,0.999
263,301,-38,18.785714,23.153846,-38,1047,1253,-206,1,1,0.071429,0.076923,11,14,13,3.363636,1,0,7,15,false,false,false,0.052,0.948
191,263,-72,17.363636,26.3,-72,1349,1203,146,0,1,0,0.1,29,11,10,1.103448,0,1,8,7,false,false,false,0.027,0.973
34,27,7,17,27,7,1055,1019,36,0,0,0,0,87,2,1,0.37931,1,0,9,8,false,false,true,0.568,0.432
311,317,-6,19.4375,21.133333,-6,1344,1314,30,0,2,0,0.133333,-5,16,15,-6.8,0,0,7,11,false,false,false,0.348,0.652
234,290,-56,23.4,29,-56,1164,1261,-97,0,1,0,0.1,35,10,10,1.2,0,0,10,10,false,false,false,0.05,0.95
273,446,-173,19.5,31.857143,-173,1003,1004,-1,0,2,0,0.142857,0,14,14,0,0,0,9,7,false,false,false,0,1
29,0,29,14.5,0,29,452,698,-246,0,0,0,0,92,2,1,0.445652,0,1,31,7,false,false,false,0.454,0.546
8,0,8,8,0,8,1278,1101,177,0,0,0,0,97,1,0,0.381443,0,0,17,0,false,false,true,0.581,0.419
74,202,-128,12.333333,33.666667,-128,653,1004,-351,0,0,0,0,52,6,6,0.557692,1,0,12,9,false,false,false,0.002,0.998
156,203,-47,19.5,29,-47,1045,1100,-55,0,0,0,0,48,8,7,0.708333,0,1,8,13,false,false,false,0.007,0.993
186,288,-102,14.307692,22.153846,-102,542,605,-63,0,0,0,0,11,13,13,3.272727,0,0,8,9,false,false,false,0,1
92,160,-68,11.5,20,-68,503,668,-165,0,0,0,0,50,8,8,0.74,0,0,7,9,false,false,false,0.061,0.939
70,93,-23,23.333333,46.5,-23,1554,1685,-131,0,1,0,0.5,79,3,2,0.405063,0,0,19,9,false,false,false,0.36,0.64
276,356,-80,19.714286,27.384615,-80,835,786,49,0,0,0,0,-9,14,13,-3.777778,0,0,7,7,false,false,false,0,1
4,8,-4,4,8,-4,710,758,-48,0,0,0,0,94,1,1,0.393617,0,0,16,11,false,false,false,0.409,0.591
181,78,103,36.2,19.5,103,1373,1334,39,1,0,0.2,0,68,5,4,0.470588,0,0,7,10,false,false,true,0.981,0.019
159,209,-50,15.9,20.9,-50,889,895,-6,0,1,0,0.1,32,10,10,1.15625,0,1,17,21,false,false,false,0.178,0.822
92,133,-41,15.333333,22.166667,-41,726,818,-92,0,0,0,0,59,6,6,0.59322,0,0,9,11,false,false,false,0.073,0.927
261,391,-130,18.642857,27.928571,-130,1101,1115,-14,0,1,0,0.071429,-5,14,14,-6,1,0,8,5,false,false,false,0,1
212,261,-49,19.272727,23.727273,-49,561,633,-72,0,1,0,0.090909,24,11,11,1.458333,0,0,14,23,false,false,false,0.059,0.941
46,9,37,23,4.5,37,1193,1220,-27,0,0,0,0,88,2,2,0.488636,1,1,8,25,false,false,false,0.373,0.627
140,127,13,20,21.166667,13,939,969,-30,0,0,0,0,50,7,6,0.66,0,1,11,6,false,false,false,0.466,0.534
279,313,-34,13.95,15.65,-34,670,576,94,0,0,0,0,-19,20,20,-2.157895,0,0,2,1,false,false,false,0.086,0.914
110,138,-28,13.75,19.714286,-28,951,976,-25,0,0,0,0,53,8,7,0.830189,1,1,15,21,false,false,false,0.072,0.928
142,122,20,17.75,15.25,20,897,996,-99,0,0,0,0,47,8,8,0.829787,0,0,10,9,false,false,true,0.522,0.478
210,207,3,23.333333,25.875,3,1439,1314,125,0,0,0,0,39,9,8,0.717949,0,0,10,8,false,false,false,0.269,0.731
163,216,-53,20.375,30.857143,-53,980,965,15,0,0,0,0,45,8,7,0.844444,0,0,8,9,false,false,false,0.031,0.969
74,218,-144,7.4,21.8,-144,1037,913,124,0,1,0,0.1,46,10,10,0.826087,1,0,10,11,false,false,false,0.028,0.972
66,44,22,22,22,22,599,448,151,0,0,0,0,82,3,2,0.439024,0,0,8,10,false,false,true,0.758,0.242
127,94,33,25.4,18.8,33,1495,1531,-36,0,0,0,0,70,5,5,0.528571,0,0,13,17,false,false,true,0.569,0.431
286,289,-3,22,24.083333,-3,1354,1210,144,0,1,0,0.083333,9,13,12,3.666667,0,1,18,6,false,false,false,0.181,0.819
14,12,2,7,12,2,1344,1208,136,0,0,0,0,92,2,1,0.326087,0,0,14,19,false,false,false,0.304,0.696
54,65,-11,27,65,-11,1398,1431,-33,0,0,0,0,83,2,1,0.337349,0,0,12,9,false,false,false,0.028,0.972
223,257,-34,17.153846,19.769231,-34,803,786,17,1,0,0.076923,0,10,13,13,3.2,0,0,8,16,false,false,false,0.021,0.979
112,141,-29,14,20.142857,-29,907,1070,-163,0,0,0,0,46,8,7,0.76087,0,0,17,16,false,false,false,0.072,0.928
41,16,25,20.5,16,25,1341,1606,-265,0,0,0,0,86,2,1,0.383721,2,0,8,17,false,false,true,0.638,0.362
160,202,-42,14.545455,18.363636,-42,603,721,-118,0,0,0,0,31,11,11,1.387097,0,0,18,19,false,false,false,0.083,0.917
112,135,-23,18.666667,22.5,-23,926,973,-47,0,0,0,0,52,6,6,0.673077,0,1,9,11,false,false,false,0.228,0.772
137,182,-45,13.7,20.222222,-45,1182,1075,107,0,1,0,0.111111,32,10,9,1.21875,0,1,24,6,false,false,false,0.254,0.746
140,172,-32,17.5,21.5,-32,1071,1181,-110,0,0,0,0,53,8,8,0.641509,0,1,7,6,false,false,false,0.068,0.932
135,122,13,13.5,13.555556,13,306,302,4,0,0,0,0,39,10,9,1.051282,0,1,9,10,false,false,true,0.538,0.462
0,0,0,0,0,0,1636,1702,-66,0,0,0,0,100,1,0,0.29,0,0,17,0,false,false,true,0.533,0.467
240,310,-70,18.461538,23.846154,-70,1633,1739,-106,1,0,0.076923,0,8,13,13,4.25,1,0,6,16,false,false,false,0.006,0.994
190,266,-76,19,26.6,-76,1030,1014,16,0,1,0,0.1,32,10,10,1.03125,0,0,23,16,false,false,false,0.052,0.948
352,364,-12,23.466667,24.266667,-12,169,306,-137,2,1,0.133333,0.066667,-21,15,15,-1.47619,0,0,1,3,false,false,false,0.003,0.997
190,195,-5,27.142857,27.857143,-5,1885,1842,43,0,2,0,0.285714,37,7,7,0.72973,0,0,11,23,false,false,false,0.301,0.699
205,324,-119,20.5,32.4,-119,1334,1486,-152,2,1,0.2,0.1,28,10,10,1.035714,0,0,8,7,false,false,false,0,1
184,154,30,18.4,15.4,30,1168,1216,-48,0,0,0,0,46,10,10,0.717391,0,0,17,17,false,false,true,0.515,0.485
175,166,9,14.583333,13.833333,9,808,749,59,0,0,0,0,14,12,12,3,0,0,7,17,false,false,true,0.825,0.175
331,395,-64,25.461538,30.384615,-64,1770,1745,25,2,1,0.153846,0.076923,6,13,13,5.5,0,0,14,9,false,false,false,0,1
228,213,15,15.2,14.2,15,671,638,33,0,0,0,0,6,15,15,8.166667,0,0,15,21,false,false,true,0.908,0.092
55,30,25,27.5,30,25,954,939,15,0,0,0,0,86,2,1,0.418605,0,0,10,19,false,false,true,0.501,0.499
197,246,-49,24.625,30.75,-49,1274,1394,-120,0,1,0,0.125,32,8,8,0.9375,0,0,12,10,false,false,false,0.257,0.743
167,168,-1,16.7,18.666667,-1,1094,1041,53,0,0,0,0,32,10,9,1.1875,1,0,6,17,false,false,true,0.524,0.476
253,273,-20,21.083333,24.818182,-20,1245,1148,97,0,0,0,0,15,12,11,2.333333,0,0,16,7,false,false,false,0.19,0.81
251,284,-33,16.733333,20.285714,-33,1220,1185,35,0,1,0,0.071429,13,15,14,3.615385,0,1,19,21,false,false,false,0,1
373,442,-69,20.722222,26,-69,724,398,326,1,1,0.055556,0.058824,-14,18,17,-2.785714,0,0,7,8,false,false,false,0,1
98,72,26,16.333333,14.4,26,671,638,33,0,0,0,0,59,6,5,0.830508,0,0,18,16,false,false,true,0.767,0.233
96,189,-93,16,37.8,-93,1232,1281,-49,0,2,0,0.4,49,6,5,0.632653,0,0,12,9,false,false,false,0.217,0.783
108,135,-27,18,27,-27,915,971,-56,0,0,0,0,60,6,5,0.55,0,0,7,26,false,false,false,0.053,0.947
277,324,-47,13.85,17.052632,-47,1040,1091,-51,0,0,0,0,-21,20,19,-2.238095,0,0,7,6,false,false,false,0,1
26,21,5,8.666667,10.5,5,917,856,61,0,0,0,0,82,3,2,0.402439,0,1,13,18,false,false,false,0.304,0.696
349,325,24,18.368421,18.055556,24,907,910,-3,0,1,0,0.055556,-7,19,18,-6.142857,0,0,7,9,false,false,true,0.952,0.048
288,371,-83,22.153846,28.538462,-83,1699,1803,-104,1,1,0.076923,0.076923,20,13,13,1.75,0,0,15,10,false,false,false,0,1
55,100,-45,18.333333,50,-45,1248,1220,28,0,1,0,0.5,79,3,2,0.658228,0,0,8,15,false,false,false,0.27,0.73
127,121,6,31.75,40.333333,6,1173,1256,-83,1,0,0.25,0,73,4,3,0.424658,0,1,8,9,false,false,false,0.002,0.998
196,190,6,28,31.666667,6,1354,1210,144,0,1,0,0.166667,52,7,6,0.634615,0,0,13,11,false,false,false,0.276,0.724
54,76,-22,7.714286,10.857143,-22,288,359,-71,0,0,0,0,63,7,7,0.428571,0,0,23,11,false,false,false,0.278,0.722
219,250,-31,18.25,22.727273,-31,1488,1403,85,0,1,0,0.090909,13,12,11,2.615385,0,0,10,18,false,false,false,0.052,0.948
0,0,0,0,0,0,530,683,-153,0,0,0,0,100,1,0,0.4,0,0,10,0,false,false,false,0.211,0.789
299,366,-67,14.95,19.263158,-67,594,648,-54,1,1,0.05,0.052632,-19,20,19,-2.105263,0,0,1,1,false,false,false,0,1
60,36,24,20,18,24,402,448,-46,0,0,0,0,82,3,2,0.45122,0,1,7,10,false,false,false,0.233,0.767
174,240,-66,11.6,17.142857,-66,226,361,-135,0,0,0,0,-2,15,14,-22,1,0,9,11,false,false,false,0.014,0.986
189,246,-57,15.75,22.363636,-57,341,416,-75,0,0,0,0,27,12,11,1.444444,0,1,7,10,false,false,false,0,1
112,197,-85,22.4,49.25,-85,1556,1656,-100,0,1,0,0.25,56,5,4,0.535714,0,1,7,8,false,false,false,0.025,0.975
163,389,-226,18.111111,43.222222,-226,1219,1216,3,1,3,0.111111,0.333333,14,9,9,1.928571,0,0,26,9,false,false,false,0,1
37,49,-12,9.25,16.333333,-12,206,346,-140,0,0,0,0,78,4,3,0.551282,0,0,13,16,false,false,false,0.141,0.859
103,129,-26,14.714286,21.5,-26,561,688,-127,0,0,0,0,59,7,6,0.779661,0,0,13,7,false,false,false,0.074,0.926
383,393,-10,21.277778,21.833333,-10,964,1003,-39,0,1,0,0.055556,-20,18,18,-1.95,0,0,8,2,false,false,false,0.031,0.969
98,156,-58,16.333333,31.2,-58,1101,1115,-14,0,0,0,0,60,6,5,0.5,0,1,10,7,false,false,false,0.03,0.97
288,348,-60,20.571429,26.769231,-60,732,868,-136,0,1,0,0.076923,-2,14,13,-16,0,0,5,18,false,false,false,0,1
53,52,1,17.666667,26,1,1094,1159,-65,0,0,0,0,79,3,2,0.481013,0,0,16,14,false,false,false,0.305,0.695
214,282,-68,30.571429,47,-68,1689,1777,-88,1,1,0.142857,0.166667,37,7,6,0.810811,0,0,20,15,false,false,false,0,1
37,39,-2,18.5,19.5,-2,595,538,57,0,0,0,0,86,2,2,0.44186,1,0,9,13,false,false,true,0.793,0.207
250,267,-17,19.230769,20.538462,-17,1063,1134,-71,1,0,0.076923,0,25,13,13,1.76,0,1,10,19,false,false,false,0.049,0.951
56,85,-29,18.666667,28.333333,-29,1636,1796,-160,0,0,0,0,78,3,3,0.346154,0,0,16,12,false,false,false,0.17,0.83
341,371,-30,21.3125,24.733333,-30,691,695,-4,1,0,0.0625,0,-15,16,15,-2.133333,0,0,2,2,false,false,false,0.031,0.969
31,11,20,15.5,11,20,758,791,-33,0,0,0,0,89,2,1,0.438202,0,0,16,10,false,false,true,0.538,0.462
292,301,-9,24.333333,27.363636,-9,1556,1513,43,0,0,0,0,10,12,11,3.1,0,0,9,11,false,false,false,0.098,0.902
285,326,-41,16.764706,19.176471,-41,995,965,30,0,1,0,0.058824,-9,17,17,-4.444444,0,0,5,5,false,false,false,0.037,0.963
63,91,-28,12.6,22.75,-28,683,859,-176,0,0,0,0,71,5,4,0.633803,1,0,10,12,false,false,false,0.102,0.898
32,17,15,32,17,15,1495,1531,-36,0,0,0,0,92,1,1,0.402174,0,0,11,14,false,false,true,0.621,0.379
247,392,-145,19,30.153846,-145,1606,1890,-284,0,1,0,0.076923,2,13,13,14,1,0,10,9,false,false,false,0,1
124,228,-104,8.266667,16.285714,-104,651,996,-345,0,1,0,0.071429,12,15,14,3.75,0,2,33,5,false,false,false,0,1
189,224,-35,17.181818,22.4,-35,620,698,-78,1,0,0.090909,0,35,11,10,1.171429,0,0,21,16,false,false,false,0.07,0.93
8,0,8,8,0,8,1030,1014,16,0,0,0,0,97,1,0,0.340206,1,0,9,0,false,false,true,0.566,0.434
141,323,-182,7.833333,19,-182,651,567,84,0,0,0,0,0,18,17,0,0,0,12,11,false,false,false,0,1
140,139,1,17.5,19.857143,1,1047,1253,-206,1,0,0.125,0,54,8,7,0.685185,0,0,7,15,false,false,false,0.223,0.777
247,313,-66,10.73913,14.227273,-66,1220,1202,18,0,0,0,0,-23,23,22,-2.173913,0,1,26,12,false,false,false,0,1
30,60,-30,15,60,-30,1439,1314,125,0,0,0,0,91,2,1,0.307692,0,0,19,9,false,false,false,0.03,0.97
347,346,1,21.6875,23.066667,1,964,1003,-39,0,1,0,0.066667,-4,16,15,-9.75,0,0,14,11,false,false,true,0.52,0.48
143,122,21,23.833333,20.333333,21,967,856,111,0,0,0,0,53,6,6,0.622642,0,0,9,21,false,false,true,0.647,0.353
242,225,17,18.615385,18.75,17,1000,960,40,0,0,0,0,18,13,12,2.5,0,0,9,8,false,false,true,0.549,0.451
43,16,27,21.5,16,27,1408,1539,-131,0,0,0,0,89,2,1,0.382022,0,0,10,11,false,false,false,0.449,0.551
46,26,20,23,13,20,1110,1123,-13,0,0,0,0,82,2,2,0.402439,0,0,15,10,false,false,true,0.566,0.434
72,43,29,24,14.333333,29,1070,814,256,0,0,0,0,82,3,3,0.402439,0,0,9,10,false,false,true,0.771,0.229
320,340,-20,14.545455,16.190476,-20,561,688,-127,0,0,0,0,-19,22,21,-2.421053,0,0,1,4,false,false,false,0,1
256,331,-75,14.222222,18.388889,-75,642,952,-310,0,0,0,0,-13,18,18,-3.384615,0,0,2,4,false,false,false,0,1
156,113,43,26,18.833333,43,1552,1803,-251,1,0,0.166667,0,59,6,6,0.559322,1,1,6,10,false,false,false,0.215,0.785
115,113,2,16.428571,16.142857,2,1248,1220,28,0,1,0,0.142857,58,7,7,0.896552,0,0,10,23,false,false,false,0.427,0.573
14,32,-18,14,32,-18,595,538,57,0,0,0,0,93,1,1,0.408602,1,0,10,12,false,false,true,0.652,0.348
228,241,-13,25.333333,30.125,-13,1885,1842,43,0,2,0,0.25,28,9,8,0.964286,0,0,16,14,false,false,false,0.278,0.722
321,396,-75,21.4,26.4,-75,1422,1798,-376,0,2,0,0.133333,-6,15,15,-5.333333,0,0,2,2,false,false,false,0,1
108,113,-5,15.428571,16.142857,-5,613,525,88,0,0,0,0,55,7,7,0.763636,0,1,10,16,false,false,true,0.535,0.465
216,297,-81,16.615385,22.846154,-81,804,1080,-276,0,0,0,0,14,13,13,2.428571,1,0,9,9,false,false,false,0.012,0.988
258,347,-89,16.125,21.6875,-89,341,416,-75,0,0,0,0,-6,16,16,-6.5,0,1,9,6,false,false,false,0,1
220,339,-119,12.941176,21.1875,-119,542,605,-63,0,0,0,0,-11,17,16,-3.272727,0,0,5,11,false,false,false,0,1
142,275,-133,23.666667,45.833333,-133,1556,1616,-60,0,0,0,0,54,6,6,0.537037,0,0,10,10,false,false,false,0,1
297,371,-74,18.5625,23.1875,-74,710,758,-48,1,1,0.0625,0.0625,-4,16,16,-9.25,0,0,13,10,false,false,false,0,1
297,334,-37,14.85,16.7,-37,613,525,88,0,0,0,0,-26,20,20,-1.615385,0,0,4,2,false,false,false,0,1
203,245,-42,11.941176,15.3125,-42,808,749,59,0,0,0,0,-7,17,16,-6,0,0,15,9,false,false,false,0.002,0.998
46,59,-13,15.333333,19.666667,-13,758,904,-146,0,0,0,0,77,3,3,0.441558,1,0,9,23,false,false,false,0.207,0.793
209,307,-98,20.9,34.111111,-98,1636,1727,-91,0,2,0,0.222222,23,10,9,1.304348,1,0,11,17,false,false,false,0.023,0.977
56,102,-46,11.2,20.4,-46,613,525,88,0,0,0,0,65,5,5,0.646154,0,1,18,6,false,false,false,0.28,0.72
158,192,-34,14.363636,19.2,-34,306,361,-55,0,0,0,0,22,11,10,1.636364,0,1,11,6,false,false,false,0.026,0.974
221,268,-47,22.1,26.8,-47,1473,1500,-27,0,2,0,0.2,29,10,10,1.344828,0,0,14,10,false,false,false,0.266,0.734
173,109,64,11.533333,7.785714,64,491,651,-160,0,0,0,0,22,15,14,1.363636,0,1,29,6,false,false,true,0.761,0.239
289,334,-45,18.0625,22.266667,-45,694,658,36,0,1,0,0.066667,-2,16,15,-18.5,0,0,10,4,false,false,false,0.017,0.983
216,360,-144,9.818182,17.142857,-144,651,996,-345,0,2,0,0.095238,-33,22,21,-1.363636,0,0,4,2,false,false,false,0,1
189,318,-129,14.538462,26.5,-129,473,683,-210,0,0,0,0,18,13,12,2.111111,0,0,11,10,false,false,false,0,1
270,312,-42,15,18.352941,-42,518,414,104,0,1,0,0.058824,-10,18,17,-3.8,0,0,12,5,false,false,false,0.032,0.968
316,315,1,19.75,19.6875,1,664,786,-122,0,0,0,0,-11,16,16,-3,0,0,4,2,false,false,false,0.311,0.689
30,66,-36,6,16.5,-36,1078,983,95,0,0,0,0,76,5,4,0.631579,1,0,7,9,false,false,false,0.305,0.695
47,17,30,11.75,5.666667,30,1278,1101,177,0,0,0,0,79,4,3,0.468354,1,0,15,12,false,false,true,0.857,0.143
228,186,42,25.333333,23.25,42,1397,1405,-8,1,0,0.111111,0,31,9,8,0.935484,1,0,13,19,false,false,true,0.907,0.093
156,208,-52,17.333333,26,-52,1488,1403,85,0,1,0,0.125,37,9,8,0.918919,0,0,7,11,false,false,false,0.045,0.955
310,231,79,34.444444,28.875,79,1777,1689,88,1,1,0.111111,0.125,24,9,8,1.125,0,1,10,15,false,false,true,0.929,0.071
10,0,10,10,0,10,1086,926,160,0,0,0,0,97,1,0,0.28866,0,0,11,0,false,false,true,0.675,0.325
278,334,-56,18.533333,22.266667,-56,694,658,36,0,1,0,0.066667,1,15,15,37,0,0,14,4,false,false,false,0.009,0.991
241,296,-55,24.1,29.6,-55,1274,1394,-120,0,1,0,0.1,18,10,10,1.666667,0,0,7,23,false,false,false,0.015,0.985
362,359,3,17.238095,17.095238,3,907,910,-3,0,1,0,0.047619,-20,21,21,-2.15,0,0,6,4,false,false,true,0.83,0.17
60,92,-32,15,23,-32,1302,1351,-49,0,0,0,0,72,4,4,0.513889,1,0,7,10,false,false,false,0.303,0.697
267,331,-64,29.666667,41.375,-64,1925,1885,40,1,2,0.111111,0.25,16,9,8,1.5625,0,0,9,27,false,false,false,0.007,0.993
194,111,83,27.714286,15.857143,83,1188,1334,-146,1,0,0.142857,0,44,7,7,0.681818,0,1,10,10,false,false,true,0.6,0.4
64,50,14,21.333333,16.666667,14,1030,998,32,0,0,0,0,74,3,3,0.5,0,0,7,7,false,false,true,0.571,0.429
265,396,-131,17.666667,26.4,-131,1229,1220,9,0,1,0,0.066667,0,15,15,0,0,0,9,5,false,false,false,0,1
120,536,-416,6.315789,28.210526,-416,1164,1149,15,0,3,0,0.157895,9,19,19,5.222222,0,1,12,18,false,false,false,0,1
14,0,14,14,0,14,595,538,57,0,0,0,0,96,1,0,0.395833,1,0,10,0,false,false,true,0.772,0.228
33,39,-6,16.5,19.5,-6,1331,1374,-43,0,0,0,0,85,2,2,0.388235,0,0,8,7,false,false,false,0.468,0.532
138,104,34,19.714286,17.333333,34,615,542,73,0,0,0,0,60,7,6,0.7,0,0,7,12,false,false,true,0.788,0.212
122,93,29,20.333333,18.6,29,742,868,-126,0,0,0,0,62,6,5,0.532258,0,0,11,14,false,false,false,0.291,0.709
117,156,-39,14.625,19.5,-39,278,1,277,0,0,0,0,37,8,8,1,0,1,18,18,false,false,false,0.177,0.823
24,32,-8,6,10.666667,-8,288,359,-71,0,0,0,0,84,4,3,0.321429,0,1,19,7,false,false,false,0.169,0.831
317,476,-159,21.133333,34,-159,786,848,-62,1,2,0.066667,0.142857,-9,15,14,-3.444444,0,0,2,2,false,false,false,0,1
300,380,-80,15.789474,21.111111,-80,795,786,9,1,0,0.052632,0,-16,19,18,-2.375,0,0,5,2,false,false,false,0,1
52,47,5,13,15.666667,5,1195,1397,-202,0,0,0,0,79,4,3,0.506329,0,1,7,6,false,false,false,0.177,0.823
145,166,-21,16.111111,20.75,-21,402,448,-46,0,0,0,0,45,9,8,0.822222,0,1,9,12,false,false,false,0.023,0.977
184,143,41,16.727273,14.3,41,671,638,33,0,0,0,0,28,11,10,1.75,0,0,16,22,false,false,true,0.887,0.113
268,340,-72,15.764706,21.25,-72,402,448,-46,0,0,0,0,-14,17,16,-2.642857,0,0,7,2,false,false,false,0,1
244,283,-39,24.4,28.3,-39,1331,1347,-16,1,1,0.1,0.1,13,10,10,2.461538,0,0,11,7,false,false,false,0.205,0.795
173,129,44,24.714286,21.5,44,804,1074,-270,0,0,0,0,55,7,6,0.581818,0,0,8,12,false,false,true,0.567,0.433
26,17,9,26,17,9,595,412,183,0,0,0,0,94,1,1,0.553191,0,0,8,10,false,false,true,0.783,0.217
133,149,-16,19,21.285714,-16,727,820,-93,0,1,0,0.142857,48,7,7,0.729167,0,0,7,9,false,false,true,0.542,0.458
249,144,105,31.125,20.571429,105,1156,1279,-123,2,0,0.25,0,44,8,7,0.909091,0,0,13,10,false,false,true,0.947,0.053
401,539,-138,28.642857,41.461538,-138,1398,1431,-33,0,0,0,0,-21,14,13,-1.333333,0,0,1,10,false,false,false,0.001,0.999
139,175,-36,23.166667,29.166667,-36,1305,1194,111,0,0,0,0,54,6,6,0.611111,0,0,14,7,false,false,false,0.232,0.768
96,29,67,48,14.5,67,1156,1279,-123,1,0,0.5,0,81,2,2,0.493827,0,0,9,13,false,false,true,0.627,0.373
324,399,-75,21.6,28.5,-75,724,398,326,1,1,0.066667,0.071429,8,15,14,4.875,0,0,9,10,false,false,false,0.037,0.963
36,60,-24,12,20,-24,830,787,43,0,0,0,0,76,3,3,0.5,0,0,22,12,false,false,false,0.312,0.688
155,168,-13,25.833333,33.6,-13,1173,1256,-83,1,0,0.166667,0,61,6,5,0.508197,0,1,11,8,false,false,false,0.003,0.997
80,89,-9,16,22.25,-9,803,786,17,0,0,0,0,70,5,4,0.457143,0,0,9,7,false,false,false,0.287,0.713
89,146,-57,14.833333,24.333333,-57,822,845,-23,0,0,0,0,63,6,6,0.555556,0,0,25,11,false,false,false,0.155,0.845
129,131,-2,18.428571,18.714286,-2,1334,1439,-105,1,0,0.142857,0,68,7,7,0.529412,0,0,16,9,false,false,false,0.212,0.788
130,249,-119,10.833333,20.75,-119,632,603,29,0,1,0,0.083333,13,12,12,2.923077,0,0,17,7,false,false,false,0,1
30,29,1,15,14.5,1,999,1071,-72,0,0,0,0,84,2,2,0.47619,0,0,7,8,false,false,true,0.549,0.451
87,91,-4,17.4,22.75,-4,1691,1510,181,0,0,0,0,66,5,4,0.454545,0,0,16,16,false,false,false,0.298,0.702
120,130,-10,30,32.5,-10,724,398,326,1,0,0.25,0,71,4,4,0.549296,0,0,23,14,false,false,true,0.667,0.333
120,615,-495,5.217391,26.73913,-495,1164,1149,15,0,3,0,0.130435,-4,23,23,-11.75,0,1,12,13,false,false,false,0,1
186,196,-10,20.666667,24.5,-10,1055,1019,36,0,0,0,0,29,9,8,1.137931,1,0,13,15,false,false,false,0.47,0.53
132,208,-76,14.666667,23.111111,-76,1159,1131,28,0,2,0,0.222222,39,9,9,0.948718,0,0,7,18,false,false,false,0.061,0.939
12,0,12,12,0,12,1193,1177,16,0,0,0,0,96,1,0,0.364583,0,0,14,0,false,false,true,0.562,0.438
231,219,12,28.875,27.375,12,1167,1245,-78,1,0,0.125,0,30,8,8,0.933333,1,0,7,17,false,false,false,0.469,0.531
283,236,47,35.375,29.5,47,169,306,-137,2,1,0.25,0.125,24,8,8,1.291667,0,0,10,8,false,false,false,0.01,0.99
262,305,-43,13.1,15.25,-43,526,502,24,0,0,0,0,-16,20,20,-3.125,1,0,19,17,false,false,false,0,1
120,151,-31,20,30.2,-31,1164,1149,15,0,0,0,0,64,6,5,0.734375,0,1,12,6,false,false,false,0.129,0.871
16,13,3,16,13,3,977,1100,-123,0,0,0,0,92,1,1,0.445652,0,0,8,9,false,false,false,0.245,0.755
190,288,-98,15.833333,24,-98,1094,1159,-65,0,0,0,0,12,12,12,3.166667,1,0,15,21,false,false,false,0.001,0.999
347,496,-149,24.785714,35.428571,-149,1586,1633,-47,1,1,0.071429,0.071429,-1,14,14,-34,0,0,9,7,false,false,false,0,1
215,295,-80,16.538462,22.692308,-80,944,1095,-151,0,1,0,0.076923,22,13,13,1.772727,0,2,16,14,false,false,false,0,1
322,394,-72,20.125,26.266667,-72,1176,1133,43,1,0,0.0625,0,0,16,15,0,0,0,2,6,false,false,false,0,1
114,209,-95,16.285714,34.833333,-95,710,758,-48,0,1,0,0.166667,55,7,6,0.672727,0,0,9,14,false,false,false,0.014,0.986
130,161,-31,21.666667,32.2,-31,964,1003,-39,0,1,0,0.2,60,6,5,0.65,0,0,8,9,false,false,false,0.269,0.731
281,453,-172,20.071429,34.846154,-172,1368,1452,-84,1,2,0.071429,0.153846,3,14,13,10.666667,0,0,8,9,false,false,false,0,1
252,261,-9,21,23.727273,-9,561,633,-72,0,1,0,0.090909,19,12,11,1.842105,0,0,12,23,false,false,false,0.249,0.751
246,305,-59,15.375,19.0625,-59,642,952,-310,0,0,0,0,0,16,16,0,0,0,8,10,false,false,false,0,1
169,186,-17,15.363636,16.909091,-17,995,965,30,0,0,0,0,25,11,11,1.6,0,0,17,11,false,false,false,0.464,0.536
354,333,21,23.6,23.785714,21,1407,1473,-66,1,2,0.066667,0.142857,-11,15,14,-2.818182,0,0,4,6,false,false,true,0.982,0.018
317,348,-31,18.647059,20.470588,-31,1055,840,215,0,1,0,0.058824,-14,17,17,-2.571429,0,0,3,1,false,false,false,0.079,0.921
265,363,-98,18.928571,27.923077,-98,874,868,6,0,0,0,0,-3,14,13,-11,0,0,11,12,false,false,false,0,1
76,81,-5,19,20.25,-5,1021,1094,-73,1,0,0.25,0,70,4,4,0.528571,0,0,9,15,false,false,false,0.289,0.711
158,248,-90,15.8,24.8,-90,1094,1159,-65,0,0,0,0,27,10,10,1.407407,1,0,15,11,false,false,false,0.027,0.973
159,223,-64,15.9,22.3,-64,1484,1556,-72,0,1,0,0.1,23,10,10,1.347826,1,0,16,11,false,false,false,0.266,0.734
20,0,20,20,0,20,344,315,29,0,0,0,0,96,1,0,0.416667,0,0,9,0,false,false,true,0.776,0.224
304,314,-10,20.266667,20.933333,-10,1473,1500,-27,0,2,0,0.133333,-1,15,15,-39,1,0,7,10,false,false,true,0.884,0.116
282,373,-91,15.666667,20.722222,-91,1580,1629,-49,0,1,0,0.055556,-21,18,18,-1.761905,0,0,1,1,false,false,false,0,1
190,194,-4,19,21.555556,-4,1030,1014,16,0,0,0,0,39,10,9,0.846154,0,1,23,7,false,false,false,0.275,0.725
20,0,20,20,0,20,1070,814,256,0,0,0,0,95,1,1,0.347368,0,0,21,0,false,false,true,0.812,0.188
81,84,-3,20.25,21,-3,926,973,-47,0,0,0,0,69,4,4,0.507246,0,0,7,12,false,false,false,0.488,0.512
367,415,-48,30.583333,37.727273,-48,1699,1580,119,3,2,0.25,0.181818,9,12,11,3.333333,0,0,17,16,false,false,false,0,1
174,173,1,13.384615,14.416667,1,306,302,4,0,0,0,0,17,13,12,2.411765,0,0,13,28,false,false,false,0.485,0.515
155,148,7,19.375,21.142857,7,965,1078,-113,0,0,0,0,49,8,7,0.755102,0,0,9,12,false,false,false,0.085,0.915
118,65,53,29.5,16.25,53,1101,1237,-136,1,0,0.25,0,68,4,4,0.5,0,1,19,7,false,false,false,0.438,0.562
185,187,-2,26.428571,26.714286,-2,1305,1211,94,1,0,0.142857,0,54,7,7,0.611111,1,0,6,11,false,false,true,0.556,0.444
20,83,-63,20,83,-63,907,910,-3,0,1,0,1,90,1,1,0.477778,0,0,14,12,false,false,false,0.014,0.986
116,102,14,19.333333,20.4,14,1021,1094,-73,1,0,0.166667,0,63,6,5,0.587302,0,0,11,14,false,false,false,0.243,0.757
243,306,-63,20.25,27.818182,-63,1173,1256,-83,1,0,0.083333,0,20,12,11,1.55,1,1,9,9,false,false,false,0,1
80,54,26,26.666667,27,26,450,624,-174,0,0,0,0,79,3,2,0.417722,1,0,10,14,false,false,false,0.272,0.728
279,289,-10,18.6,19.266667,-10,985,1062,-77,0,0,0,0,-4,15,15,-9.25,1,0,12,7,false,false,false,0.212,0.788
137,161,-24,15.222222,17.888889,-24,714,892,-178,0,0,0,0,48,9,9,0.875,0,1,11,9,false,false,false,0.091,0.909
65,69,-4,10.833333,13.8,-4,771,668,103,0,0,0,0,58,6,5,0.655172,0,0,8,10,false,false,true,0.515,0.485
214,285,-71,11.263158,15,-71,595,540,55,0,0,0,0,-8,19,19,-5.375,0,0,9,15,false,false,false,0,1
266,250,16,24.181818,22.727273,16,1102,1245,-143,0,0,0,0,14,11,11,2.071429,0,1,9,7,false,false,false,0.348,0.652
326,417,-91,19.176471,24.529412,-91,1232,1448,-216,0,2,0,0.117647,-20,17,17,-1.75,0,0,2,1,false,false,false,0,1
53,109,-56,10.6,21.8,-56,1064,1397,-333,0,1,0,0.2,81,5,5,0.530864,1,0,10,19,false,false,false,0.074,0.926
212,214,-2,16.307692,17.833333,-2,480,518,-38,0,0,0,0,15,13,12,2.666667,0,0,19,10,false,false,false,0.384,0.616
65,83,-18,10.833333,13.833333,-18,771,668,103,0,0,0,0,54,6,6,0.703704,0,0,8,7,false,false,true,0.523,0.477
279,325,-46,12.130435,14.130435,-46,1071,1000,71,0,0,0,0,-29,23,23,-1.62069,0,0,1,1,false,false,false,0,1
170,201,-31,24.285714,28.714286,-31,1793,1869,-76,0,1,0,0.142857,46,7,7,0.652174,0,0,21,12,false,false,false,0.312,0.688
14,0,14,14,0,14,402,448,-46,0,0,0,0,96,1,0,0.385417,0,0,10,0,false,false,false,0.3,0.7
30,0,30,30,0,30,1761,1770,-9,0,0,0,0,96,1,0,0.270833,0,0,16,0,false,false,true,0.723,0.277
211,271,-60,19.181818,27.1,-60,1127,995,132,0,1,0,0.1,26,11,10,1.269231,0,0,11,12,false,false,false,0.028,0.972
221,237,-16,20.090909,21.545455,-16,1633,1739,-106,1,0,0.090909,0,25,11,11,1.36,1,1,8,6,false,false,false,0.176,0.824
132,244,-112,18.857143,40.666667,-112,1539,1891,-352,0,1,0,0.166667,45,7,6,0.555556,1,0,10,7,false,false,false,0.007,0.993
164,256,-92,20.5,32,-92,1606,1593,13,0,1,0,0.125,38,8,8,0.763158,0,0,7,15,false,false,false,0.028,0.972
205,221,-16,18.636364,22.1,-16,518,461,57,0,0,0,0,26,11,10,1.384615,0,1,10,6,false,false,false,0.194,0.806
340,387,-47,22.666667,25.8,-47,1373,1334,39,1,2,0.066667,0.133333,-5,15,15,-6.4,1,0,3,4,false,false,false,0.043,0.957
85,44,41,21.25,14.666667,41,356,498,-142,0,0,0,0,75,4,3,0.466667,1,0,11,11,false,false,false,0.305,0.695
86,232,-146,8.6,23.2,-146,1101,1130,-29,0,1,0,0.1,45,10,10,1,0,1,8,7,false,false,false,0,1
177,171,6,19.666667,21.375,6,1439,1428,11,0,0,0,0,50,9,8,0.8,0,0,14,12,false,false,false,0.271,0.729
313,463,-150,20.866667,33.071429,-150,1556,1656,-100,0,2,0,0.142857,-15,15,14,-2,0,0,2,1,false,false,false,0,1
61,37,24,20.333333,18.5,24,1232,1448,-216,0,0,0,0,80,3,2,0.4375,0,0,18,13,false,false,false,0.215,0.785
29,15,14,9.666667,7.5,14,925,1000,-75,0,0,0,0,81,3,2,0.54321,0,0,11,7,false,false,true,0.528,0.472
142,130,12,23.666667,21.666667,12,1636,1727,-91,0,1,0,0.166667,56,6,6,0.535714,0,0,7,8,false,false,true,0.533,0.467
189,249,-60,17.181818,22.636364,-60,653,820,-167,0,0,0,0,15,11,11,2.533333,0,0,8,15,false,false,false,0.019,0.981
256,326,-70,36.571429,54.333333,-70,2147,2219,-72,1,2,0.142857,0.333333,31,7,6,0.774194,0,0,13,17,false,false,false,0,1
172,158,14,14.333333,14.363636,14,1193,1220,-27,0,0,0,0,26,12,11,1.653846,1,1,6,16,false,false,false,0.257,0.743
284,347,-63,16.705882,20.411765,-63,452,698,-246,0,1,0,0.058824,-12,17,17,-3.416667,0,0,7,3,false,false,false,0,1
145,186,-41,18.125,23.25,-41,518,461,57,0,0,0,0,47,8,8,0.765957,0,1,17,11,false,false,false,0.237,0.763
46,89,-43,11.5,22.25,-43,948,998,-50,0,0,0,0,69,4,4,0.536232,1,1,11,12,false,false,false,0.226,0.774
67,105,-38,13.4,21,-38,726,818,-92,0,0,0,0,64,5,5,0.546875,0,0,11,13,false,false,false,0.075,0.925
18,6,12,18,6,12,450,427,23,0,0,0,0,93,1,1,0.397849,0,1,8,7,false,false,true,0.604,0.396
53,108,-55,13.25,27,-55,518,414,104,0,1,0,0.25,71,4,4,0.535211,0,0,16,7,false,false,false,0.362,0.638
135,188,-53,15,20.888889,-53,721,757,-36,0,1,0,0.111111,43,9,9,0.883721,0,0,14,9,false,false,false,0.268,0.732
115,109,6,16.428571,18.166667,6,1248,1220,28,0,1,0,0.166667,61,7,6,0.852459,0,0,10,23,false,false,false,0.299,0.701
65,75,-10,13,15,-10,306,302,4,0,0,0,0,69,5,5,0.594203,0,0,15,10,false,false,true,0.616,0.384
116,170,-54,19.333333,28.333333,-54,452,698,-246,0,1,0,0.166667,58,6,6,0.706897,0,1,16,6,false,false,false,0.002,0.998
126,47,79,42,23.5,79,1167,1245,-78,1,0,0.333333,0,76,3,2,0.368421,0,0,10,26,false,false,true,0.555,0.445
289,365,-76,18.0625,24.333333,-76,1315,1331,-16,0,0,0,0,-9,16,15,-3.666667,0,0,2,2,false,false,false,0,1
141,256,-115,15.666667,28.444444,-115,726,818,-92,0,1,0,0.111111,36,9,9,0.972222,0,0,17,11,false,false,false,0,1
240,338,-98,15,21.125,-98,837,844,-7,0,0,0,0,5,16,16,8.2,1,0,10,9,false,false,false,0,1
142,153,-11,20.285714,21.857143,-11,450,624,-174,0,0,0,0,46,7,7,0.717391,0,0,19,11,false,false,false,0.278,0.722
135,212,-77,13.5,21.2,-77,917,856,61,0,1,0,0.1,34,10,10,0.970588,0,1,19,14,false,false,false,0.041,0.959
45,50,-5,11.25,12.5,-5,226,361,-135,0,0,0,0,70,4,4,0.628571,0,1,22,8,false,false,false,0.283,0.717
120,91,29,20,18.2,29,991,1063,-72,0,0,0,0,67,6,5,0.567164,0,0,16,16,false,false,false,0.228,0.772
276,486,-210,16.235294,28.588235,-210,1093,1100,-7,0,2,0,0.117647,-13,17,17,-2.692308,0,0,20,8,false,false,false,0,1
232,306,-74,21.090909,27.818182,-74,1126,1277,-151,0,0,0,0,6,11,11,5.833333,0,0,10,31,false,false,false,0,1
123,140,-17,20.5,23.333333,-17,1205,1216,-11,0,0,0,0,60,6,6,0.55,0,0,11,21,false,false,false,0.259,0.741
263,308,-45,16.4375,19.25,-45,1000,960,40,0,0,0,0,-3,16,16,-15,1,0,8,8,false,false,false,0.083,0.917
50,48,2,16.666667,24,2,1633,1620,13,0,0,0,0,82,3,2,0.439024,0,0,10,24,false,false,false,0.271,0.729
195,188,7,17.727273,18.8,7,1037,1009,28,0,0,0,0,36,11,10,1.222222,1,1,8,7,false,false,false,0.285,0.715
206,339,-133,12.875,21.1875,-133,542,605,-63,0,0,0,0,-7,16,16,-5.142857,0,0,8,11,false,false,false,0,1
99,128,-29,19.8,25.6,-29,804,766,38,0,1,0,0.2,68,5,5,0.602941,0,1,11,13,false,false,false,0.286,0.714
66,45,21,16.5,15,21,1495,1597,-102,0,0,0,0,80,4,3,0.4,0,0,10,14,false,false,false,0.326,0.674
224,269,-45,12.444444,14.944444,-45,668,363,305,0,0,0,0,0,18,18,0,0,1,8,6,false,false,false,0.075,0.925
97,171,-74,12.125,24.428571,-74,795,786,9,0,0,0,0,60,8,7,0.633333,0,0,8,8,false,false,false,0.012,0.988
92,145,-53,23,36.25,-53,964,1003,-39,0,1,0,0.25,69,4,4,0.565217,0,0,11,9,false,false,false,0.27,0.73
115,153,-38,16.428571,21.857143,-38,803,786,17,0,0,0,0,56,7,7,0.571429,0,0,12,7,false,false,false,0.281,0.719
211,266,-55,19.181818,24.181818,-55,971,800,171,0,1,0,0.090909,6,11,11,4.833333,0,0,25,8,false,false,false,0.252,0.748
56,79,-23,14,26.333333,-23,1071,1000,71,0,0,0,0,78,4,3,0.602564,1,0,6,10,false,false,false,0.271,0.729
160,210,-50,16,21,-50,804,766,38,0,1,0,0.1,47,10,10,0.87234,0,1,17,13,false,false,false,0.229,0.771
39,79,-40,9.75,19.75,-40,1257,1176,81,0,0,0,0,81,4,4,0.419753,0,0,15,7,false,false,false,0.271,0.729
275,427,-152,17.1875,26.6875,-152,1045,1100,-55,0,1,0,0.0625,-11,16,16,-3.090909,0,0,2,4,false,false,false,0,1
117,168,-51,14.625,21,-51,1302,1351,-49,0,0,0,0,45,8,8,0.822222,0,0,13,12,false,false,false,0.254,0.746
307,449,-142,21.928571,32.071429,-142,1606,1593,13,1,1,0.071429,0.071429,-9,14,14,-3.222222,0,0,2,1,false,false,false,0,1
232,249,-17,21.090909,24.9,-17,1269,1477,-208,1,0,0.090909,0,29,11,10,1.206897,0,0,10,7,false,false,false,0.079,0.921
218,284,-66,12.111111,16.705882,-66,1248,1220,28,0,1,0,0.058824,10,18,17,5.2,1,0,9,13,false,false,false,0.03,0.97
198,311,-113,16.5,25.916667,-113,771,668,103,0,0,0,0,13,12,12,2.923077,0,0,7,21,false,false,false,0,1
75,91,-16,18.75,30.333333,-16,1167,1245,-78,0,0,0,0,70,4,3,0.328571,0,0,10,16,false,false,false,0.237,0.763
312,301,11,18.352941,17.705882,11,675,570,105,0,0,0,0,-23,17,17,-1.521739,0,0,14,2,false,false,true,0.856,0.144
190,218,-28,17.272727,19.818182,-28,803,786,17,0,0,0,0,30,11,11,1.066667,0,0,11,10,false,false,false,0.438,0.562
267,331,-64,17.8,22.066667,-64,387,683,-296,0,0,0,0,-12,15,15,-2.833333,1,0,6,5,false,false,false,0.007,0.993
278,285,-7,19.857143,20.357143,-7,540,498,42,1,0,0.071429,0,6,14,14,7.666667,0,0,13,11,false,false,true,0.534,0.466
225,342,-117,18.75,28.5,-117,1656,1649,7,0,0,0,0,12,12,12,2.666667,0,0,10,12,false,false,false,0,1
14,0,14,14,0,14,503,668,-165,0,0,0,0,96,1,0,0.385417,0,0,10,0,false,false,false,0.211,0.789
121,140,-19,17.285714,23.333333,-19,1422,1583,-161,0,1,0,0.166667,55,7,6,0.745455,0,0,17,20,false,false,false,0.122,0.878
108,91,17,21.6,18.2,17,991,1063,-72,0,0,0,0,70,5,5,0.542857,0,0,16,16,false,false,false,0.313,0.687
329,387,-58,29.909091,35.181818,-58,1761,1770,-9,1,1,0.090909,0.090909,1,11,11,26,0,0,9,5,false,false,false,0.001,0.999
149,254,-105,18.625,31.75,-105,1193,1177,16,0,1,0,0.125,46,8,8,0.76087,0,0,7,11,false,false,false,0.027,0.973
289,369,-80,24.083333,30.75,-80,1556,1616,-60,0,0,0,0,2,12,12,14.5,0,0,7,6,false,false,false,0,1
91,77,14,15.166667,15.4,14,1312,1334,-22,0,0,0,0,61,6,5,0.639344,0,0,17,19,false,false,false,0.278,0.722
72,139,-67,14.4,34.75,-67,1422,1798,-376,0,1,0,0.25,63,5,4,0.507937,1,0,17,9,false,false,false,0.106,0.894
72,103,-31,36,51.5,-31,1354,1210,144,0,1,0,0.5,85,2,2,0.388235,0,0,23,18,false,false,false,0.455,0.545
93,167,-74,11.625,20.875,-74,818,826,-8,0,0,0,0,59,8,8,0.898305,1,0,10,13,false,false,false,0.04,0.96
314,329,-15,18.470588,19.352941,-15,944,1095,-151,0,1,0,0.058824,-4,17,17,-9.75,0,1,4,4,false,false,false,0.057,0.943
94,148,-54,11.75,18.5,-54,1580,1629,-49,0,0,0,0,45,8,8,0.822222,0,0,24,9,false,false,false,0.273,0.727
52,35,17,17.333333,17.5,17,561,633,-72,0,0,0,0,81,3,2,0.432099,1,1,6,16,false,false,false,0.211,0.789
194,283,-89,17.636364,25.727273,-89,1229,1220,9,0,1,0,0.090909,24,11,11,1.541667,0,0,16,11,false,false,false,0.003,0.997
108,182,-74,10.8,20.222222,-74,651,567,84,0,0,0,0,35,10,9,1.571429,0,0,8,9,false,false,false,0.07,0.93
145,148,-3,20.714286,21.142857,-3,965,1078,-113,0,0,0,0,52,7,7,0.711538,0,0,11,12,false,false,false,0.133,0.867
92,90,2,23,30,2,1227,1189,38,0,0,0,0,72,4,3,0.486111,0,0,12,19,false,false,false,0.272,0.728
369,395,-26,28.384615,30.384615,-26,1761,1770,-9,1,1,0.076923,0.076923,-11,13,13,-2.363636,0,0,2,2,true,false,false,0.121,0.879
78,59,19,15.6,14.75,19,542,390,152,0,0,0,0,79,5,4,0.632911,0,0,10,18,false,false,true,0.54,0.46
0,0,0,0,0,0,664,786,-122,0,0,0,0,100,1,0,0.33,0,0,0,0,false,false,false,0.215,0.785
147,147,0,18.375,18.375,0,526,502,24,0,0,0,0,51,8,8,0.980392,0,0,16,7,false,false,true,0.766,0.234
113,133,-20,22.6,26.6,-20,1227,1189,38,0,0,0,0,60,5,5,0.583333,0,0,14,17,false,false,false,0.273,0.727
51,72,-21,12.75,18,-21,530,683,-153,0,0,0,0,77,4,4,0.519481,0,1,7,7,false,false,false,0.138,0.862
71,76,-5,17.75,19,-5,999,1283,-284,0,0,0,0,71,4,4,0.464789,0,1,18,19,false,false,false,0.228,0.772
115,134,-19,16.428571,22.333333,-19,1123,1062,61,0,0,0,0,53,7,6,0.830189,0,0,12,16,false,false,false,0.28,0.72
224,332,-108,18.666667,27.666667,-108,874,868,6,0,0,0,0,8,12,12,4.125,0,0,13,9,false,false,false,0,1
57,54,3,14.25,18,3,568,570,-2,0,0,0,0,77,4,3,0.480519,0,0,8,26,false,false,false,0.19,0.81
194,224,-30,16.166667,20.363636,-30,595,538,57,0,0,0,0,20,12,11,1.9,0,1,16,7,false,false,false,0.173,0.827
45,50,-5,22.5,25,-5,985,1062,-77,0,0,0,0,87,2,2,0.425287,0,0,8,16,false,false,false,0.23,0.77
61,34,27,15.25,11.333333,27,542,390,152,0,0,0,0,85,4,3,0.588235,0,0,8,18,false,false,true,0.653,0.347
191,309,-118,21.222222,34.333333,-118,1636,1702,-66,0,1,0,0.111111,33,9,9,0.878788,0,0,14,10,false,false,false,0,1
258,324,-66,19.846154,24.923077,-66,1493,1413,80,0,1,0,0.076923,12,13,13,3,0,0,9,9,false,false,false,0.021,0.979
184,201,-17,16.727273,20.1,-17,1176,1211,-35,0,0,0,0,17,11,10,1.941176,1,0,8,10,false,false,false,0.27,0.73
191,273,-82,15.916667,22.75,-82,450,427,23,0,1,0,0.083333,16,12,12,2.3125,0,0,13,12,false,false,false,0.035,0.965
24,89,-65,6,22.25,-65,1064,1397,-333,0,1,0,0.25,87,4,4,0.494253,1,0,20,20,false,false,false,0.083,0.917
53,102,-49,10.6,25.5,-49,341,416,-75,0,0,0,0,75,5,4,0.52,0,0,16,12,false,false,false,0.071,0.929
167,159,8,16.7,17.666667,8,704,523,181,0,0,0,0,32,10,9,1.09375,0,0,11,10,false,false,true,0.512,0.488
181,244,-63,18.1,24.4,-63,1055,840,215,0,1,0,0.1,31,10,10,1.16129,1,0,8,16,false,false,false,0.077,0.923
18,21,-3,9,10.5,-3,917,856,61,0,0,0,0,85,2,2,0.388235,0,1,13,18,false,false,false,0.407,0.593
141,150,-9,12.818182,15,-9,814,830,-16,0,0,0,0,31,11,10,1.322581,0,0,19,28,false,false,false,0.198,0.802
65,90,-25,16.25,30,-25,1093,1173,-80,0,0,0,0,78,4,3,0.551282,0,0,19,8,false,false,false,0.221,0.779
35,77,-42,7,19.25,-42,1473,1500,-27,0,1,0,0.25,73,5,4,0.534247,0,1,17,10,false,false,false,0.271,0.729
51,46,5,12.75,15.333333,5,306,302,4,0,0,0,0,80,4,3,0.5125,0,0,16,16,false,false,false,0.364,0.636
105,132,-27,26.25,33,-27,576,602,-26,0,0,0,0,71,4,4,0.591549,0,0,8,8,false,false,false,0.264,0.736
85,78,7,21.25,26,7,1245,1148,97,0,0,0,0,73,4,3,0.479452,0,0,21,17,false,false,false,0.363,0.637
46,64,-18,15.333333,21.333333,-18,1040,1364,-324,0,0,0,0,77,3,3,0.467532,0,0,13,16,false,false,false,0.189,0.811
190,288,-98,13.571429,22.153846,-98,542,605,-63,0,0,0,0,8,14,13,4.5,0,0,8,9,false,false,false,0,1
330,308,22,17.368421,17.111111,22,1065,948,117,0,1,0,0.055556,-8,19,18,-4.875,0,0,8,6,false,false,true,0.912,0.088
284,315,-31,17.75,19.6875,-31,1302,1351,-49,0,0,0,0,-7,16,16,-5.285714,0,0,5,2,false,false,false,0.032,0.968
64,92,-28,12.8,23,-28,1302,1351,-49,0,0,0,0,70,5,4,0.528571,1,0,7,10,false,false,false,0.272,0.728
264,292,-28,20.307692,22.461538,-28,689,804,-115,0,0,0,0,9,13,13,3.888889,0,1,7,11,false,false,false,0.006,0.994
12,10,2,12,10,2,306,302,4,0,0,0,0,95,1,1,0.431579,1,0,8,17,false,false,true,0.514,0.486
327,379,-52,19.235294,23.6875,-52,1495,1531,-36,0,1,0,0.0625,-6,17,16,-6.166667,0,0,2,4,false,false,false,0,1
205,200,5,18.636364,20,5,1257,1176,81,1,0,0.090909,0,35,11,10,0.971429,1,0,9,20,false,false,false,0.443,0.557
244,296,-52,15.25,18.5,-52,518,414,104,0,1,0,0.0625,-1,16,16,-38,0,0,20,7,false,false,false,0.015,0.985
129,91,38,14.333333,10.111111,38,491,651,-160,0,0,0,0,48,9,9,0.625,0,1,10,6,false,false,true,0.589,0.411
234,373,-139,16.714286,28.692308,-139,926,973,-47,0,0,0,0,4,14,13,8.75,0,0,10,8,false,false,false,0,1
299,431,-132,14.238095,21.55,-132,913,1037,-124,0,3,0,0.15,-20,21,20,-2.05,0,0,9,6,true,false,false,0,1
164,234,-70,16.4,26,-70,944,1095,-151,0,1,0,0.111111,41,10,9,0.95122,0,1,9,6,false,false,false,0.008,0.992
240,370,-130,16,24.666667,-130,563,523,40,0,0,0,0,-2,15,15,-18.5,0,0,10,7,false,false,false,0,1
168,214,-46,18.666667,26.75,-46,561,633,-72,0,1,0,0.125,42,9,8,0.833333,0,0,16,10,false,false,false,0.097,0.903
122,65,57,30.5,21.666667,57,786,885,-99,1,0,0.25,0,75,4,3,0.453333,0,1,7,16,false,false,false,0.01,0.99
234,245,-11,18,20.416667,-11,527,954,-427,0,0,0,0,21,13,12,1.666667,0,2,23,5,false,false,false,0,1
73,85,-12,24.333333,28.333333,-12,820,718,102,0,1,0,0.333333,75,3,3,0.373333,0,1,17,7,false,false,false,0.417,0.583
247,299,-52,11.227273,14.238095,-52,1220,1202,18,0,0,0,0,-20,22,21,-2.5,0,1,26,15,false,false,false,0,1
33,22,11,11,11,11,808,749,59,0,0,0,0,82,3,2,0.512195,0,1,9,17,false,false,false,0.403,0.597
25,4,21,8.333333,2,21,913,1037,-124,0,0,0,0,92,3,2,0.445652,0,0,28,12,false,false,false,0.217,0.783
167,248,-81,18.555556,27.555556,-81,1583,1403,180,0,0,0,0,33,9,9,0.969697,0,1,12,9,false,false,false,0.027,0.973
177,129,48,25.285714,21.5,48,1770,1745,25,1,0,0.142857,0,59,7,6,0.559322,0,0,10,20,false,false,true,0.671,0.329
301,391,-90,18.8125,24.4375,-90,835,786,49,0,0,0,0,-26,16,16,-1.307692,0,0,1,1,false,false,false,0,1
396,435,-39,26.4,31.071429,-39,1770,1745,25,2,1,0.133333,0.071429,-4,15,14,-8.25,0,0,5,4,false,false,false,0,1
83,140,-57,16.6,28,-57,1349,1203,146,0,1,0,0.2,63,5,5,0.507937,0,0,7,9,false,false,false,0.241,0.759
83,81,2,16.6,20.25,2,952,870,82,0,0,0,0,67,5,4,0.552239,0,0,9,25,false,false,true,0.504,0.496
120,161,-41,17.142857,26.833333,-41,1164,1149,15,0,0,0,0,62,7,6,0.758065,0,1,12,7,false,false,false,0.09,0.91
158,162,-4,12.153846,13.5,-4,542,390,152,0,0,0,0,39,13,12,1.282051,0,0,7,19,false,false,true,0.541,0.459
159,173,-14,13.25,14.416667,-14,1045,1082,-37,0,0,0,0,24,12,12,1.875,1,0,18,24,false,false,false,0.369,0.631
90,104,-14,11.25,14.857143,-14,970,1030,-60,0,0,0,0,50,8,7,0.8,0,0,22,10,false,false,false,0.232,0.768
120,196,-76,13.333333,21.777778,-76,542,605,-63,0,0,0,0,37,9,9,0.972973,0,0,12,19,false,false,false,0.014,0.986
250,383,-133,13.157895,21.277778,-133,450,427,23,1,1,0.052632,0.055556,-25,19,18,-1.48,0,0,1,5,true,false,false,0,1
135,177,-42,13.5,17.7,-42,907,878,29,0,0,0,0,50,10,10,0.86,1,0,11,9,false,false,false,0.455,0.545
98,182,-84,10.888889,20.222222,-84,651,567,84,0,0,0,0,38,9,9,1.447368,0,0,7,9,false,false,false,0.071,0.929
152,153,-1,15.2,17,-1,1220,1185,35,0,0,0,0,45,10,9,1.044444,0,1,27,6,false,false,false,0.281,0.719
195,276,-81,19.5,27.6,-81,1315,1331,-16,0,0,0,0,25,10,10,1.32,0,0,10,20,false,false,false,0.016,0.984
308,327,-19,25.666667,27.25,-19,169,306,-137,2,1,0.166667,0.083333,-2,12,12,-15.5,0,0,10,12,false,false,false,0.001,0.999
249,318,-69,24.9,35.333333,-69,1556,1616,-60,0,0,0,0,23,10,9,1.26087,0,0,11,8,false,false,false,0.001,0.999
190,207,-17,19,23,-17,1131,1030,101,0,0,0,0,33,10,9,0.909091,1,0,9,11,false,false,false,0.422,0.578
165,178,-13,16.5,19.777778,-13,402,448,-46,0,0,0,0,38,10,9,0.973684,0,1,9,14,false,false,false,0.05,0.95
135,164,-29,16.875,20.5,-29,1094,1041,53,0,0,0,0,41,8,8,0.926829,1,0,16,14,false,false,true,0.558,0.442
47,26,21,23.5,26,21,1232,1448,-216,0,0,0,0,87,2,1,0.402299,0,0,8,12,false,false,false,0.209,0.791
259,255,4,13.631579,14.166667,4,306,302,4,0,0,0,0,-21,19,18,-1.952381,0,0,4,5,false,false,true,0.882,0.118
260,316,-56,21.666667,28.727273,-56,991,1063,-72,0,1,0,0.090909,18,12,11,2.111111,0,0,9,11,false,false,false,0.017,0.983
43,50,-7,14.333333,16.666667,-7,805,918,-113,0,0,0,0,77,3,3,0.467532,0,1,35,7,false,false,false,0.244,0.756
197,247,-50,16.416667,22.454545,-50,594,648,-54,1,1,0.083333,0.090909,28,12,11,1.428571,0,0,17,17,false,false,false,0.063,0.937
173,145,28,21.625,18.125,28,786,885,-99,1,0,0.125,0,51,8,8,0.666667,0,1,15,6,false,false,false,0.406,0.594
234,304,-70,15.6,21.714286,-70,595,412,183,0,1,0,0.071429,12,15,14,4.333333,0,0,12,9,false,false,false,0.065,0.935
274,356,-82,24.909091,32.363636,-82,1556,1616,-60,0,0,0,0,11,11,11,2.636364,0,0,7,10,false,false,false,0,1
20,13,7,20,13,7,387,683,-296,0,0,0,0,91,1,1,0.373626,0,0,19,8,false,false,false,0.33,0.67
209,298,-89,19,27.090909,-89,1315,1331,-16,0,0,0,0,19,11,11,1.736842,0,0,7,11,false,false,false,0.009,0.991
31,20,11,10.333333,10,11,1495,1597,-102,0,0,0,0,87,3,2,0.367816,0,0,17,12,false,false,false,0.356,0.644
351,393,-42,21.9375,26.2,-42,1173,1256,-83,2,0,0.125,0,-10,16,15,-3.1,0,1,1,3,true,false,false,0,1
90,88,2,45,44,2,714,820,-106,1,0,0.5,0,84,2,2,0.369048,0,0,14,8,false,false,false,0.022,0.978
120,552,-432,5.714286,26.285714,-432,1164,1149,15,0,3,0,0.142857,3,21,21,15.666667,0,1,12,18,false,false,false,0,1
26,68,-42,6.5,17,-42,917,856,61,0,0,0,0,76,4,4,0.434211,0,1,15,9,false,false,false,0.27,0.73
63,111,-48,12.6,22.2,-48,668,771,-103,0,0,0,0,65,5,5,0.615385,0,0,22,18,false,false,false,0.072,0.928
12,0,12,12,0,12,999,1071,-72,0,0,0,0,95,1,0,0.421053,0,0,8,0,false,false,true,0.55,0.45
294,315,-21,17.294118,18.529412,-21,343,570,-227,0,0,0,0,-20,17,17,-1.8,0,0,1,1,false,false,false,0.137,0.863
302,448,-146,25.166667,40.727273,-146,1925,1885,40,1,2,0.083333,0.181818,-11,12,11,-2.272727,0,0,1,1,false,false,false,0,1
288,423,-135,12,18.391304,-135,1037,1016,21,1,0,0.041667,0,-18,24,23,-3.222222,1,0,7,5,false,false,false,0,1
174,265,-91,12.428571,18.928571,-91,951,976,-25,0,0,0,0,17,14,14,2.588235,0,0,9,12,false,false,false,0,1
205,164,41,41,32.8,41,169,306,-137,2,1,0.4,0.2,47,5,5,0.659574,0,0,12,12,false,false,false,0.009,0.991
67,110,-43,22.333333,36.666667,-43,1399,1210,189,0,1,0,0.333333,74,3,3,0.472973,0,1,16,11,false,false,false,0.27,0.73
239,278,-39,11.95,14.631579,-39,668,363,305,0,0,0,0,-11,20,19,-4.272727,0,1,12,6,false,false,false,0,1
261,210,51,37.285714,30,51,169,306,-137,2,1,0.285714,0.142857,33,7,7,0.939394,1,0,11,16,false,false,false,0.012,0.988
77,131,-54,15.4,32.75,-54,1305,1194,111,0,0,0,0,68,5,4,0.485294,0,0,9,16,false,false,false,0.029,0.971
248,323,-75,14.588235,20.1875,-75,653,820,-167,0,0,0,0,-17,17,16,-2.235294,0,0,2,5,false,false,false,0,1
299,328,-29,17.588235,19.294118,-29,1302,1351,-49,0,0,0,0,-14,17,17,-2.642857,0,0,3,1,false,false,false,0.011,0.989
153,170,-17,17,21.25,-17,1334,1439,-105,1,0,0.111111,0,58,9,8,0.62069,0,0,16,7,false,false,false,0.073,0.927
108,102,6,15.428571,17,6,613,525,88,0,0,0,0,58,7,6,0.724138,0,1,10,6,false,false,true,0.513,0.487
244,284,-40,17.428571,21.846154,-40,1691,1551,140,0,0,0,0,13,14,13,2.846154,1,0,7,12,false,false,false,0.045,0.955
308,327,-19,14.666667,16.35,-19,1203,1270,-67,1,0,0.047619,0,-23,21,20,-1.913043,0,0,1,3,false,false,false,0,1
223,289,-66,17.153846,22.230769,-66,691,704,-13,0,1,0,0.076923,15,13,13,2.533333,0,0,7,15,false,false,false,0.021,0.979
120,521,-401,6.666667,30.647059,-401,1164,1149,15,0,3,0,0.176471,17,18,17,2.764706,0,1,12,6,false,false,false,0,1
277,310,-33,16.294118,19.375,-33,450,624,-174,0,0,0,0,-17,17,16,-1.941176,1,0,3,6,true,false,false,0.027,0.973
82,41,41,16.4,10.25,41,797,796,1,0,0,0,0,76,5,4,0.644737,0,0,10,19,false,false,true,0.769,0.231
118,96,22,16.857143,13.714286,22,739,480,259,1,0,0.142857,0,52,7,7,0.692308,0,0,31,8,false,true,true,0.882,0.118
20,12,8,20,12,8,1091,1078,13,0,0,0,0,94,1,1,0.457447,0,0,16,8,false,true,true,0.564,0.436
211,154,57,16.230769,11.846154,57,872,818,54,0,1,0,0.076923,28,13,13,1.464286,1,0,11,14,false,true,true,0.995,0.005
296,159,137,26.909091,15.9,137,742,696,46,0,0,0,0,23,11,10,1.391304,0,0,14,16,false,true,true,0.999,0.001
338,276,62,15.363636,13.142857,62,892,768,124,0,0,0,0,-17,22,21,-2.529412,0,0,5,4,true,true,true,1,0
49,24,25,24.5,24,25,540,518,22,0,0,0,0,89,2,1,0.449438,0,1,14,7,false,true,true,0.605,0.395
336,317,19,18.666667,17.611111,19,594,605,-11,0,0,0,0,-21,18,18,-1.761905,0,0,1,1,false,true,true,0.993,0.007
109,43,66,36.333333,21.5,66,1245,1241,4,1,1,0.333333,0.5,75,3,2,0.386667,0,0,20,23,false,true,true,0.958,0.042
174,106,68,21.75,15.142857,68,576,532,44,0,0,0,0,50,8,7,0.92,1,0,11,16,false,true,true,0.984,0.016
250,243,7,15.625,15.1875,7,361,493,-132,1,0,0.0625,0,-17,16,16,-2.411765,0,0,7,18,false,true,true,0.868,0.132
56,67,-11,18.666667,22.333333,-11,2219,2029,190,0,0,0,0,77,3,3,0.337662,1,0,9,7,false,true,true,1,0
281,253,28,28.1,25.3,28,1428,1606,-178,1,0,0.1,0,23,10,10,1.391304,1,0,16,9,false,true,true,0.571,0.429
176,133,43,25.142857,19,43,1210,1253,-43,0,1,0,0.142857,46,7,7,0.76087,0,1,12,12,false,true,true,0.872,0.128
62,46,16,15.5,11.5,16,1253,1166,87,0,0,0,0,74,4,4,0.581081,0,0,13,21,false,true,true,0.535,0.465
36,20,16,18,20,16,361,493,-132,0,0,0,0,88,2,1,0.465909,0,0,16,8,false,true,false,0.23,0.77
224,158,66,28,22.571429,66,1023,1070,-47,1,0,0.125,0,43,8,7,0.744186,1,0,13,7,false,true,true,0.947,0.053
272,240,32,17,16,32,801,807,-6,0,0,0,0,-8,16,15,-4.375,0,0,4,8,false,true,true,0.977,0.023
236,207,29,19.666667,18.818182,29,1266,1247,19,0,0,0,0,23,12,11,1.391304,1,0,10,8,false,true,true,0.593,0.407
404,308,96,25.25,20.533333,96,1331,1399,-68,1,0,0.0625,0,-16,16,15,-2.1875,0,0,3,4,false,true,true,1,0
292,201,91,22.461538,16.75,91,1004,653,351,0,0,0,0,3,13,12,11.666667,0,0,13,25,false,true,true,1,0
311,142,169,31.1,15.777778,169,918,619,299,2,0,0.2,0,31,10,9,1.129032,2,0,8,10,false,true,true,1,0
94,71,23,18.8,17.75,23,786,976,-190,0,0,0,0,75,5,4,0.426667,0,0,8,7,false,true,false,0.242,0.758
198,108,90,39.6,21.6,90,1396,1454,-58,1,0,0.2,0,59,5,5,0.559322,1,0,9,11,false,true,true,0.982,0.018
321,234,87,22.928571,18,87,960,1070,-110,1,0,0.071429,0,10,14,13,3.5,0,1,13,9,false,true,true,1,0
337,291,46,15.318182,13.857143,46,826,771,55,0,0,0,0,-23,22,21,-1.956522,0,0,2,1,false,true,true,1,0
32,31,1,32,31,1,1793,1897,-104,0,0,0,0,93,1,1,0.322581,1,0,6,12,false,true,true,0.725,0.275
419,326,93,26.1875,21.733333,93,1093,1100,-7,3,3,0.1875,0.2,-15,16,15,-2.133333,0,0,1,1,false,true,true,0.988,0.012
287,133,154,23.916667,12.090909,154,554,342,212,0,0,0,0,16,12,11,2.25,1,0,7,28,false,true,true,1,0
220,147,73,18.333333,13.363636,73,566,542,24,0,0,0,0,26,12,11,1.576923,0,1,24,10,false,true,true,0.95,0.05
265,263,2,18.928571,20.230769,2,901,889,12,0,1,0,0.076923,15,14,13,2.866667,0,0,23,8,false,true,true,0.677,0.323
158,136,22,17.555556,17,22,620,513,107,0,0,0,0,42,9,8,1.071429,0,0,10,7,false,true,true,0.614,0.386
97,93,4,16.166667,18.6,4,758,750,8,0,0,0,0,54,6,5,0.685185,1,0,18,8,false,true,true,0.747,0.253
339,238,101,24.214286,18.307692,101,769,527,242,1,0,0.071429,0,-3,14,13,-12,0,0,18,15,false,true,true,1,0
248,200,48,20.666667,16.666667,48,691,473,218,0,0,0,0,15,12,12,2.4,1,0,12,17,false,true,true,0.978,0.022
257,202,55,23.363636,18.363636,55,1406,1454,-48,0,1,0,0.090909,18,11,11,1.888889,1,1,10,9,false,true,true,0.87,0.13
409,280,129,14.607143,10.37037,129,1413,1422,-9,0,0,0,0,-30,28,27,-1.9,0,0,3,1,false,true,true,1,0
103,107,-4,14.714286,15.285714,-4,1047,1094,-47,0,0,0,0,55,7,7,0.654545,0,1,8,7,false,true,false,0.302,0.698
65,79,-14,16.25,19.75,-14,596,595,1,0,0,0,0,74,4,4,0.540541,1,0,12,14,false,true,true,0.742,0.258
109,59,50,27.25,14.75,50,1156,1114,42,1,0,0.25,0,61,4,4,0.52459,0,0,23,10,false,true,true,0.694,0.306
363,298,65,25.928571,22.923077,65,1093,1090,3,1,2,0.071429,0.153846,9,14,13,3.777778,0,0,9,9,false,true,true,0.988,0.012
141,189,-48,47,63,-48,1370,1431,-61,1,1,0.333333,0.333333,65,3,3,0.353846,0,0,17,8,false,true,false,0.115,0.885
319,179,140,21.266667,12.785714,140,786,757,29,1,0,0.066667,0,6,15,14,6.5,0,0,25,15,false,true,true,1,0
326,271,55,20.375,16.9375,55,1045,1009,36,1,0,0.0625,0,-5,16,16,-7.6,0,0,6,10,false,true,true,0.996,0.004
267,216,51,17.8,14.4,51,758,750,8,0,0,0,0,-1,15,15,-37,0,1,10,7,false,true,true,1,0
135,69,66,33.75,23,66,1256,1232,24,1,0,0.25,0,71,4,3,0.422535,0,1,10,12,false,true,true,0.578,0.422
214,203,11,16.461538,15.615385,11,725,771,-46,0,1,0,0.076923,19,13,13,2.421053,1,0,6,15,false,true,true,0.988,0.012
6,0,6,6,0,6,825,907,-82,0,0,0,0,97,1,0,0.412371,1,0,10,0,false,true,false,0.476,0.524
172,151,21,24.571429,21.571429,21,1548,1493,55,1,0,0.142857,0,47,7,7,0.87234,0,0,14,10,false,true,true,0.577,0.423
72,50,22,18,16.666667,22,1735,1770,-35,0,0,0,0,67,4,3,0.41791,0,0,9,10,false,true,false,0.412,0.588
84,106,-22,16.8,21.2,-22,725,771,-46,0,1,0,0.2,60,5,5,0.766667,0,1,19,16,false,true,false,0.447,0.553
348,344,4,23.2,24.571429,4,1539,1537,2,0,1,0,0.071429,-4,15,14,-8,0,0,6,7,false,true,false,0.13,0.87
264,260,4,18.857143,20,4,518,448,70,0,0,0,0,6,14,13,5.666667,0,0,8,9,false,true,false,0.462,0.538
236,184,52,21.454545,18.4,52,1170,1156,14,1,0,0.090909,0,25,11,10,1.52,1,0,8,13,false,true,true,0.948,0.052
171,148,23,24.428571,24.666667,23,1227,1060,167,0,1,0,0.166667,55,7,6,0.727273,0,0,16,9,false,true,false,0.473,0.527
364,378,-14,20.222222,22.235294,-14,834,844,-10,1,2,0.055556,0.117647,-20,18,17,-1.8,0,0,1,9,false,true,true,0.524,0.476
195,139,56,27.857143,23.166667,56,1550,1466,84,1,0,0.142857,0,50,7,6,0.74,0,0,18,17,false,true,true,0.624,0.376
363,318,45,22.6875,21.2,45,1014,1303,-289,1,0,0.0625,0,-12,16,15,-3.166667,0,0,5,13,false,true,true,1,0
207,106,101,34.5,21.2,101,1935,2020,-85,0,0,0,0,57,6,5,0.54386,1,0,6,11,false,true,true,0.956,0.044
196,135,61,24.5,19.285714,61,844,821,23,0,0,0,0,58,8,7,0.724138,1,0,18,7,false,true,true,0.944,0.056
45,16,29,22.5,16,29,1125,1227,-102,0,0,0,0,87,2,1,0.344828,0,0,12,19,false,true,false,0.247,0.753
212,183,29,17.666667,16.636364,29,448,598,-150,0,0,0,0,19,12,11,1.894737,0,0,19,11,false,true,true,0.668,0.332
245,244,1,17.5,17.428571,1,892,788,104,2,0,0.142857,0,11,14,14,3.909091,0,0,11,19,false,true,true,0.921,0.079
110,80,30,36.666667,26.666667,30,1684,1320,364,1,0,0.333333,0,74,3,3,0.405405,0,0,8,13,false,true,true,1,0
298,252,46,18.625,15.75,46,450,412,38,0,0,0,0,-11,16,16,-3.454545,0,0,6,9,false,true,true,0.994,0.006
292,176,116,36.5,25.142857,116,1735,1770,-35,2,1,0.25,0.142857,30,8,7,0.933333,0,1,15,9,false,true,true,0.915,0.085
167,118,49,20.875,16.857143,49,1127,1176,-49,0,0,0,0,45,8,7,0.933333,0,0,12,14,false,true,true,0.743,0.257
68,90,-22,13.6,22.5,-22,691,675,16,0,0,0,0,66,5,4,0.575758,0,0,20,7,false,true,false,0.283,0.717
140,142,-2,20,20.285714,-2,1277,1166,111,0,1,0,0.142857,51,7,7,0.705882,0,0,7,12,false,true,false,0.293,0.707
181,169,12,22.625,21.125,12,1156,1184,-28,1,0,0.125,0,37,8,8,0.756757,0,0,15,9,false,true,true,0.598,0.402
175,137,38,21.875,19.571429,38,941,926,15,1,0,0.125,0,48,8,7,0.791667,1,0,10,9,false,true,true,0.91,0.09
112,106,6,18.666667,17.666667,6,468,542,-74,0,0,0,0,63,6,6,0.619048,0,0,20,20,false,true,true,0.666,0.334
340,256,84,22.666667,18.285714,84,1036,1181,-145,0,0,0,0,8,15,14,4.25,1,0,9,12,false,true,true,1,0
185,94,91,30.833333,18.8,91,820,783,37,0,0,0,0,58,6,5,0.568966,1,0,10,10,false,true,true,0.984,0.016
306,287,19,19.125,17.9375,19,1547,1439,108,1,0,0.0625,0,-5,16,16,-7.4,0,0,14,5,false,true,true,0.862,0.138
317,178,139,26.416667,14.833333,139,1482,1554,-72,1,0,0.083333,0,16,12,12,2.25,0,0,7,10,false,true,true,1,0
117,115,2,23.4,23,2,1539,1537,2,0,0,0,0,69,5,5,0.463768,1,0,7,8,false,true,true,0.662,0.338
127,92,35,21.166667,18.4,35,1803,1552,251,0,0,0,0,63,6,5,0.444444,0,1,10,9,false,true,true,0.996,0.004
339,220,119,24.214286,15.714286,119,1482,1394,88,2,0,0.142857,0,4,14,14,9,0,0,10,11,false,true,true,1,0
179,112,67,16.272727,11.2,67,498,43,455,0,0,0,0,26,11,10,1.423077,0,0,13,19,false,true,true,0.952,0.048
445,176,269,29.666667,11.733333,269,1054,917,137,2,0,0.133333,0,-15,15,15,-2.333333,0,0,23,8,false,true,true,1,0
134,60,74,33.5,20,74,1331,1399,-68,0,0,0,0,67,4,3,0.522388,0,0,8,13,false,true,true,0.756,0.244
116,54,62,23.2,10.8,62,1413,1422,-9,0,0,0,0,65,5,5,0.876923,1,0,15,16,false,true,true,0.934,0.066
113,114,-1,18.833333,19,-1,847,952,-105,0,0,0,0,66,6,6,0.545455,0,0,10,18,false,true,false,0.106,0.894
350,300,50,17.5,15.789474,50,1572,1550,22,1,0,0.05,0,-24,20,19,-1.625,0,0,3,1,true,true,true,1,0
320,252,68,22.857143,18,68,1516,1397,119,0,1,0,0.071429,-2,14,14,-16.5,0,1,13,8,false,true,true,1,0
260,234,26,26,26,26,908,1070,-162,1,0,0.1,0,28,10,9,1.071429,0,0,13,14,false,true,false,0.486,0.514
187,111,76,26.714286,18.5,76,901,889,12,0,1,0,0.166667,61,7,6,0.704918,0,0,15,12,false,true,true,0.948,0.052
258,162,96,23.454545,16.2,96,1439,1413,26,0,0,0,0,35,11,10,1.028571,1,0,14,12,false,true,true,0.998,0.002
318,236,82,19.875,14.75,82,1181,1069,112,0,0,0,0,-6,16,16,-6.166667,1,0,6,12,false,true,true,1,0
321,289,32,24.692308,24.083333,32,1023,1110,-87,1,1,0.076923,0.083333,-3,13,12,-10,1,0,9,9,false,true,true,0.98,0.02
203,176,27,33.833333,35.2,27,1454,1531,-77,1,1,0.166667,0.2,53,6,5,0.566038,0,0,11,10,false,true,true,0.641,0.359
323,337,-14,17.944444,19.823529,-14,1439,1294,145,1,0,0.055556,0,-23,18,17,-1.565217,1,0,2,5,false,true,true,0.664,0.336
315,305,10,19.6875,19.0625,10,786,847,-61,0,0,0,0,-8,16,16,-4.25,0,0,2,4,false,true,true,0.677,0.323
152,144,8,19,18,8,468,542,-74,0,0,0,0,50,8,8,0.78,0,1,16,15,false,true,true,0.534,0.466
351,266,85,23.4,19,85,902,866,36,0,0,0,0,-18,15,14,-1.777778,0,0,1,5,false,true,true,1,0
288,254,34,26.181818,25.4,34,1670,1770,-100,1,1,0.090909,0.1,23,11,10,1.391304,0,0,9,11,false,true,true,0.935,0.065
356,304,52,19.777778,17.882353,52,1090,1244,-154,0,0,0,0,-19,18,17,-1.947368,0,0,2,1,false,true,true,1,0
300,267,33,21.428571,19.071429,33,1270,1348,-78,0,0,0,0,8,14,14,4.75,0,0,7,7,false,true,true,0.756,0.244
235,209,26,16.785714,16.076923,26,916,876,40,0,0,0,0,1,14,13,34,2,0,15,18,false,true,true,0.968,0.032
136,193,-57,13.6,19.3,-57,1075,989,86,0,0,0,0,44,10,10,0.886364,0,0,23,15,false,true,false,0.429,0.571
320,206,114,29.090909,20.6,114,1093,1197,-104,2,0,0.181818,0,23,11,10,1.347826,1,0,7,9,false,true,true,1,0
60,48,12,20,16,12,859,811,48,0,0,0,0,76,3,3,0.473684,0,0,14,8,false,true,true,0.687,0.313
12,7,5,12,7,5,719,614,105,0,0,0,0,92,1,1,0.467391,0,1,13,11,false,true,true,0.69,0.31
311,204,107,28.272727,18.545455,107,986,856,130,1,0,0.090909,0,8,11,11,3.875,0,0,18,9,false,true,true,1,0
58,33,25,19.333333,16.5,25,786,788,-2,0,0,0,0,77,3,2,0.441558,0,0,16,22,false,true,true,0.68,0.32
194,147,47,19.4,14.7,47,303,342,-39,0,0,0,0,37,10,10,1.027027,1,0,22,10,false,true,true,0.957,0.043
102,111,-9,17,18.5,-9,620,513,107,0,0,0,0,59,6,6,0.762712,0,0,10,7,false,true,true,0.586,0.414
218,186,32,18.166667,16.909091,32,719,785,-66,0,1,0,0.090909,22,12,11,1.636364,0,0,19,18,false,true,true,0.839,0.161
40,56,-16,13.333333,28,-16,1211,1173,38,0,0,0,0,83,3,2,0.421687,0,0,20,11,false,true,false,0.272,0.728
336,333,3,19.764706,19.588235,3,1277,1166,111,0,1,0,0.058824,-18,17,17,-2,0,0,2,1,false,true,false,0.388,0.612
41,37,4,20.5,18.5,4,2219,2029,190,0,0,0,0,85,2,2,0.305882,1,0,8,9,false,true,true,1,0
61,64,-3,15.25,21.333333,-3,95,360,-265,0,1,0,0.333333,68,4,3,0.588235,0,0,12,7,false,true,true,0.554,0.446
108,53,55,21.6,10.6,55,1067,95,972,0,0,0,0,71,5,5,0.478873,0,0,21,7,false,true,true,1,0
249,148,101,24.9,14.8,101,1014,1303,-289,1,0,0.1,0,26,10,10,1.461538,0,1,8,13,false,true,true,0.999,0.001
347,299,48,20.411765,17.588235,48,1214,1176,38,0,0,0,0,-6,17,17,-6,0,0,2,5,false,true,true,1,0
236,244,-8,14.75,16.266667,-8,699,448,251,0,0,0,0,7,16,15,5.714286,0,0,13,12,false,true,false,0.13,0.87
313,184,129,26.083333,16.727273,129,1216,1230,-14,1,0,0.083333,0,23,12,11,1.391304,1,0,6,17,false,true,true,1,0
56,60,-4,11.2,15,-4,826,771,55,0,0,0,0,75,5,4,0.6,0,0,8,15,false,true,false,0.465,0.535
279,227,52,17.4375,15.133333,52,804,683,121,0,0,0,0,5,16,15,9,1,1,12,11,false,true,true,0.856,0.144
85,78,7,14.166667,15.6,7,954,1078,-124,0,1,0,0.2,59,6,5,0.644068,2,0,21,10,false,true,true,0.948,0.052
235,196,39,15.666667,13.066667,39,871,999,-128,0,0,0,0,14,15,15,3.428571,0,0,7,12,false,true,true,0.928,0.072
398,233,165,39.8,23.3,165,1571,1554,17,2,1,0.2,0.1,14,10,10,2.357143,1,0,12,12,false,true,true,1,0
367,309,58,21.588235,19.3125,58,1210,1253,-43,0,1,0,0.0625,-25,17,16,-1.36,0,0,1,10,false,true,true,1,0
535,365,170,38.214286,26.071429,170,1824,1793,31,2,0,0.142857,0,-16,14,14,-1.75,0,0,7,3,true,true,true,1,0
315,272,43,21,18.133333,43,825,907,-82,1,0,0.066667,0,4,15,15,10,0,0,18,15,false,true,true,0.884,0.116
207,123,84,29.571429,20.5,84,820,783,37,0,0,0,0,50,7,6,0.66,1,0,18,10,false,true,true,0.973,0.027
47,48,-1,11.75,16,-1,448,598,-150,0,0,0,0,78,4,3,0.461538,0,0,7,7,false,true,false,0.203,0.797
358,264,94,19.888889,14.666667,94,711,876,-165,0,0,0,0,-12,18,18,-3.583333,0,0,3,3,false,true,true,1,0
65,49,16,21.666667,16.333333,16,1691,1692,-1,0,0,0,0,72,3,3,0.416667,0,0,15,14,false,true,true,0.531,0.469
309,275,34,20.6,19.642857,34,901,889,12,0,1,0,0.071429,8,15,14,5.375,0,0,14,8,false,true,true,0.839,0.161
148,103,45,21.142857,17.166667,45,1295,1281,14,0,0,0,0,64,7,6,0.59375,0,0,17,13,false,true,true,0.55,0.45
149,94,55,18.625,13.428571,55,1050,1144,-94,0,0,0,0,53,8,7,0.716981,0,0,16,8,false,true,true,0.845,0.155
267,253,14,16.6875,16.866667,14,725,771,-46,0,1,0,0.066667,4,16,15,11.5,1,0,10,11,false,true,true,0.98,0.02
27,41,-14,9,20.5,-14,1214,1176,38,0,0,0,0,82,3,2,0.439024,0,0,20,7,false,true,false,0.273,0.727
36,32,4,12,16,4,539,632,-93,0,0,0,0,85,3,2,0.541176,0,0,11,14,false,true,false,0.185,0.815
196,266,-70,21.777778,29.555556,-70,1897,1793,104,1,2,0.111111,0.222222,46,9,9,0.695652,0,1,10,9,false,true,true,0.764,0.236
322,307,15,23,21.928571,15,1096,1009,87,2,0,0.142857,0,20,14,14,2.2,0,0,10,8,false,true,true,0.781,0.219
365,281,84,24.333333,18.733333,84,769,527,242,1,0,0.066667,0,-11,15,15,-3.272727,0,0,9,4,false,true,true,1,0
16,0,16,16,0,16,954,1078,-124,0,0,0,0,96,1,0,0.395833,0,0,14,0,false,true,false,0.244,0.756
264,181,83,29.333333,22.625,83,1762,1582,180,2,2,0.222222,0.25,35,9,8,0.914286,0,0,10,10,false,true,true,0.995,0.005
392,284,108,20.631579,14.947368,108,1030,998,32,1,0,0.052632,0,-24,19,19,-1.583333,0,0,1,1,true,true,true,1,0
279,226,53,19.928571,16.142857,53,711,876,-165,0,0,0,0,5,14,14,8.6,0,1,12,9,false,true,true,0.996,0.004
400,290,110,25,19.333333,110,1550,1466,84,1,0,0.0625,0,-9,16,15,-4.111111,0,0,6,14,false,true,true,1,0
40,51,-11,13.333333,17,-11,971,761,210,0,0,0,0,78,3,3,0.384615,0,1,10,6,false,true,false,0.489,0.511
108,153,-45,18,25.5,-45,1530,1550,-20,0,1,0,0.166667,51,6,6,0.666667,0,1,19,10,false,true,false,0.271,0.729
201,132,69,22.333333,16.5,69,691,675,16,0,0,0,0,41,9,8,0.902439,0,1,17,14,false,true,true,0.948,0.052
111,98,13,18.5,19.6,13,518,533,-15,1,0,0.166667,0,57,6,5,0.614035,0,0,21,10,false,true,false,0.364,0.636
80,12,68,80,12,68,908,1070,-162,1,0,1,0,90,1,1,0.333333,1,0,13,9,false,true,true,0.8,0.2
253,164,89,19.461538,12.615385,89,415,518,-103,0,0,0,0,18,13,13,2.111111,0,0,10,18,false,true,true,0.981,0.019
219,154,65,24.333333,17.111111,65,746,796,-50,0,1,0,0.111111,31,9,9,1.548387,0,0,16,8,false,true,true,0.979,0.021
112,48,64,28,16,64,859,811,48,0,0,0,0,74,4,3,0.486486,0,0,10,8,false,true,true,0.898,0.102
185,329,-144,18.5,32.9,-144,834,844,-10,0,2,0,0.2,21,10,10,1.714286,0,0,7,7,false,true,false,0,1
346,193,153,31.454545,17.545455,153,1431,825,606,1,1,0.090909,0.090909,19,11,11,1.789474,0,0,8,16,false,true,true,1,0
220,242,-22,14.666667,16.133333,-22,540,518,22,0,0,0,0,2,15,15,20,0,0,9,14,false,true,false,0.444,0.556
238,136,102,15.866667,9.714286,102,1428,1302,126,0,0,0,0,13,15,14,4.076923,0,1,13,19,false,true,true,1,0
322,269,53,17.888889,14.944444,53,671,725,-54,0,0,0,0,-20,18,18,-1.85,0,0,4,1,false,true,true,1,0
81,98,-17,20.25,24.5,-17,758,952,-194,0,0,0,0,64,4,4,0.625,0,1,10,6,false,true,false,0.199,0.801
24,6,18,12,6,18,721,689,32,0,0,0,0,84,2,1,0.404762,0,0,16,13,false,true,true,0.711,0.289
84,78,6,21,19.5,6,1110,1039,71,0,0,0,0,74,4,4,0.486486,0,0,16,11,false,true,true,0.505,0.495
260,256,4,23.636364,23.272727,4,1434,1493,-59,1,0,0.090909,0,14,11,11,2.642857,0,1,13,6,false,true,true,0.551,0.449
354,304,50,27.230769,23.384615,50,1394,1424,-30,1,1,0.076923,0.076923,8,13,13,4,1,0,10,17,false,true,true,0.998,0.002
249,144,105,24.9,14.4,105,1397,1422,-25,2,0,0.2,0,38,10,10,0.947368,0,2,7,19,false,true,true,0.95,0.05
159,112,47,15.9,12.444444,47,1128,889,239,0,1,0,0.111111,43,10,9,1.093023,0,0,27,7,false,true,true,0.887,0.113
329,310,19,16.45,15.5,19,942,976,-34,0,0,0,0,-26,20,20,-1.538462,0,0,1,5,true,true,true,1,0
77,18,59,38.5,18,59,974,995,-21,0,0,0,0,85,2,1,0.388235,0,0,15,10,false,true,true,0.844,0.156
79,53,26,26.333333,17.666667,26,1550,1624,-74,0,0,0,0,80,3,3,0.375,0,0,26,17,false,true,true,0.746,0.254
18,13,5,18,13,5,1439,1397,42,0,0,0,0,93,1,1,0.365591,0,0,24,12,false,true,true,0.704,0.296
222,156,66,22.2,17.333333,66,691,675,16,0,0,0,0,32,10,9,1.15625,0,1,14,13,false,true,true,0.948,0.052
271,91,180,19.357143,6.5,180,896,818,78,0,0,0,0,27,14,14,1.62963,1,1,13,6,false,true,true,1,0
311,167,144,19.4375,11.133333,144,595,543,52,0,0,0,0,6,16,15,7.833333,0,1,8,11,false,true,true,1,0
232,131,101,33.142857,21.833333,101,1237,1277,-40,0,0,0,0,47,7,6,0.617021,1,1,8,13,false,true,true,0.875,0.125
230,239,-9,16.428571,18.384615,-9,658,817,-159,0,0,0,0,16,14,13,2.375,0,0,10,20,false,true,false,0.156,0.844
263,213,50,16.4375,14.2,50,346,231,115,0,0,0,0,-19,16,15,-2.157895,0,1,31,7,false,true,true,0.962,0.038
198,206,-8,15.230769,17.166667,-8,262,306,-44,0,0,0,0,23,13,12,2,0,0,7,17,false,true,false,0.319,0.681
434,301,133,31,21.5,133,1439,1353,86,1,0,0.071429,0,-5,14,14,-6,0,0,4,5,false,true,true,1,0
293,235,58,20.928571,18.076923,58,904,783,121,0,0,0,0,17,14,13,2.470588,0,0,13,10,false,true,true,0.879,0.121
54,38,16,18,19,16,1051,1030,21,0,0,0,0,81,3,2,0.37037,0,0,8,8,false,true,true,0.504,0.496
535,365,170,38.214286,28.076923,170,1824,1793,31,2,0,0.142857,0,-16,14,13,-1.75,0,0,7,3,false,true,true,1,0
28,6,22,28,6,22,1101,1078,23,0,0,0,0,92,1,1,0.358696,0,0,23,19,false,true,true,0.798,0.202
335,293,42,22.333333,20.928571,42,1022,1095,-73,0,1,0,0.071429,-8,15,14,-4.125,0,0,7,9,false,true,true,0.965,0.035
48,24,24,24,24,24,1482,1394,88,0,0,0,0,89,2,1,0.404494,0,0,9,23,false,true,false,0.284,0.716
239,202,37,17.071429,14.428571,37,1048,1000,48,0,0,0,0,20,14,14,2,0,1,18,13,false,true,true,0.85,0.15
101,92,9,25.25,30.666667,9,1636,1576,60,0,1,0,0.333333,65,4,3,0.523077,0,1,10,15,false,true,false,0.272,0.728
224,164,60,18.666667,14.909091,60,1181,1069,112,0,0,0,0,24,12,11,1.541667,1,0,9,8,false,true,true,0.973,0.027
313,224,89,17.388889,13.176471,89,576,532,44,0,0,0,0,-8,18,17,-5.75,0,0,11,20,false,true,true,1,0
349,283,66,14.541667,11.791667,66,272,288,-16,0,0,0,0,-28,24,24,-1.857143,0,0,1,1,false,true,true,1,0
159,157,2,19.875,19.625,2,1452,1469,-17,0,1,0,0.125,42,8,8,0.904762,1,1,15,12,false,true,false,0.47,0.53
83,94,-11,16.6,18.8,-11,630,786,-156,0,0,0,0,64,5,5,0.546875,1,0,13,14,false,true,false,0.22,0.78
251,199,52,20.916667,18.090909,52,1439,1294,145,1,0,0.083333,0,23,12,11,1.565217,0,0,9,28,false,true,true,0.943,0.057
195,91,104,32.5,18.2,104,1054,917,137,0,0,0,0,53,6,5,0.660377,0,0,7,9,false,true,true,0.962,0.038
52,35,17,17.333333,17.5,17,1482,1554,-72,0,0,0,0,85,3,2,0.423529,1,0,15,11,false,true,true,0.727,0.273
56,30,26,18.666667,15,26,620,513,107,0,0,0,0,82,3,2,0.54878,0,0,10,20,false,true,true,0.752,0.248
24,0,24,24,0,24,695,671,24,0,0,0,0,94,1,0,0.351064,0,0,23,0,false,true,true,0.665,0.335
28,32,-4,28,32,-4,758,952,-194,0,0,0,0,88,1,1,0.454545,0,1,13,10,false,true,false,0.226,0.774
297,122,175,33,15.25,175,918,619,299,2,0,0.222222,0,39,9,8,0.897436,1,0,6,13,false,true,true,1,0
364,378,-14,20.222222,21,-14,834,844,-10,1,2,0.055556,0.111111,-20,18,18,-1.8,0,0,1,9,true,true,true,0.8,0.2
101,89,12,14.428571,14.833333,12,921,1072,-151,0,0,0,0,61,7,6,0.622951,1,0,6,10,false,true,false,0.302,0.698
220,191,29,24.444444,23.875,29,1344,1325,19,1,0,0.111111,0,35,9,8,0.885714,0,0,10,11,false,true,true,0.57,0.43
135,170,-35,13.5,17,-35,699,448,251,0,0,0,0,39,10,10,1.025641,0,0,12,7,false,true,false,0.352,0.648
318,306,12,18.705882,18,12,1161,1166,-5,1,0,0.058824,0,-20,17,17,-1.75,0,1,1,9,false,true,true,0.994,0.006
332,259,73,22.133333,17.266667,73,1216,1217,-1,1,0,0.066667,0,-6,15,15,-5.666667,0,0,6,5,false,true,true,1,0
293,239,54,22.538462,18.384615,54,1439,1413,26,0,0,0,0,16,13,13,2.25,1,0,13,7,false,true,true,0.989,0.011
154,188,-34,15.4,20.888889,-34,1100,1008,92,0,0,0,0,41,10,9,0.878049,2,0,10,17,false,true,true,0.598,0.402
153,108,45,21.857143,18,45,1127,1176,-49,0,0,0,0,53,7,6,0.792453,0,0,12,16,false,true,true,0.641,0.359
119,107,12,19.833333,17.833333,12,349,315,34,0,0,0,0,52,6,6,0.653846,0,0,21,9,false,true,true,0.895,0.105
187,117,70,23.375,16.714286,70,939,907,32,0,0,0,0,53,8,7,0.754717,1,0,16,16,false,true,true,0.975,0.025
109,32,77,27.25,10.666667,77,1144,1014,130,0,0,0,0,74,4,3,0.486486,1,0,16,13,false,true,true,0.902,0.098
168,89,79,33.6,22.25,79,695,671,24,0,0,0,0,65,5,4,0.507692,0,0,10,13,false,true,true,0.95,0.05
14,0,14,14,0,14,416,282,134,0,0,0,0,96,1,0,0.354167,0,0,11,0,false,true,true,0.784,0.216
204,93,111,22.666667,10.333333,111,993,897,96,1,0,0.111111,0,34,9,9,1.382353,0,0,11,16,false,true,true,0.996,0.004
108,39,69,18,7.8,69,1176,1076,100,0,0,0,0,73,6,5,0.808219,0,0,11,7,false,true,true,0.935,0.065
235,289,-54,19.583333,24.083333,-54,1265,1045,220,0,1,0,0.083333,12,12,12,3.5,0,0,20,8,false,true,false,0.079,0.921
266,190,76,29.555556,21.111111,76,1245,1232,13,1,0,0.111111,0,23,9,9,1.26087,0,0,19,7,false,true,true,0.968,0.032
156,142,14,19.5,17.75,14,613,461,152,0,0,0,0,39,8,8,0.948718,0,0,10,9,false,true,true,0.725,0.275
42,0,42,42,0,42,834,844,-10,0,0,0,0,95,1,0,0.378947,0,0,9,0,false,true,true,0.618,0.382
36,40,-4,18,20,-4,361,493,-132,0,0,0,0,84,2,2,0.488095,0,0,16,9,false,true,false,0.225,0.775
337,336,1,16.85,16.8,1,1782,1512,270,1,1,0.05,0.05,-23,20,20,-1.826087,0,0,1,1,false,true,true,1,0
189,133,56,23.625,19,56,1210,1253,-43,0,1,0,0.142857,44,8,7,0.795455,0,1,9,12,false,true,true,0.871,0.129
30,0,30,30,0,30,1824,1793,31,0,0,0,0,95,1,0,0.294737,0,0,16,0,false,true,true,0.728,0.272
12,0,12,12,0,12,595,543,52,0,0,0,0,97,1,0,0.484536,0,0,10,0,false,true,true,0.692,0.308
257,173,84,16.0625,10.8125,84,1428,1302,126,0,0,0,0,1,16,16,53,0,1,7,17,false,true,true,1,0
276,261,15,25.090909,23.727273,15,795,830,-35,1,1,0.090909,0.090909,14,11,11,3,0,0,17,11,false,true,true,0.889,0.111
276,232,44,25.090909,21.090909,44,834,758,76,0,1,0,0.090909,17,11,11,2.117647,0,0,7,12,false,true,true,0.972,0.028
353,334,19,17.65,16.7,19,825,907,-82,1,0,0.05,0,-24,20,20,-1.666667,0,0,1,9,true,true,true,0.995,0.005
317,200,117,26.416667,16.666667,117,1651,1691,-40,1,0,0.083333,0,23,12,12,1.478261,1,0,6,10,false,true,true,1,0
239,226,13,19.916667,20.545455,13,971,906,65,0,0,0,0,14,12,11,2.285714,1,0,7,11,false,true,true,0.565,0.435
332,267,65,19.529412,16.6875,65,1551,1550,1,0,0,0,0,-11,17,16,-3.818182,0,1,12,9,false,true,true,1,0
436,222,214,29.066667,15.857143,214,820,783,37,1,0,0.066667,0,-4,15,14,-8.25,0,0,8,7,false,true,true,1,0
243,194,49,22.090909,17.636364,49,1022,1095,-73,0,0,0,0,17,11,11,1.941176,0,1,16,9,false,true,true,0.87,0.13
365,309,56,22.8125,19.3125,56,1210,1253,-43,0,1,0,0.0625,-23,16,16,-1.478261,0,0,1,10,false,true,true,1,0
235,190,45,19.583333,17.272727,45,885,719,166,0,0,0,0,25,12,11,1.52,1,0,7,10,false,true,true,0.887,0.113
300,267,33,20,19.071429,33,1161,1166,-5,1,0,0.066667,0,-5,15,14,-7,0,1,6,16,false,true,true,0.745,0.255
137,67,70,27.4,13.4,70,1586,1782,-196,0,0,0,0,62,5,5,0.645161,1,0,8,7,false,true,true,0.959,0.041
80,0,80,80,0,80,908,1070,-162,1,0,1,0,93,1,0,0.322581,1,0,13,0,false,true,true,0.633,0.367
352,302,50,19.555556,16.777778,50,580,620,-40,1,0,0.055556,0,-17,18,18,-2.529412,0,0,9,9,false,true,true,0.999,0.001
358,270,88,17.9,13.5,88,711,876,-165,0,0,0,0,-16,20,20,-2.6875,0,0,3,1,false,true,true,1,0
224,190,34,20.363636,19,34,468,542,-74,0,0,0,0,32,11,10,1.21875,0,0,9,16,false,true,true,0.696,0.304
214,150,64,26.75,18.75,64,758,796,-38,0,0,0,0,42,8,8,0.904762,0,0,11,14,false,true,true,0.952,0.048
159,77,82,26.5,15.4,82,904,668,236,0,0,0,0,58,6,5,0.586207,0,0,11,15,false,true,true,0.94,0.06
152,108,44,19,15.428571,44,786,976,-190,0,0,0,0,58,8,7,0.551724,0,0,9,7,false,true,true,0.61,0.39
297,202,95,21.214286,15.538462,95,1055,1050,5,0,0,0,0,9,14,13,3.777778,0,0,16,9,false,true,true,0.998,0.002
250,202,48,22.727273,18.363636,48,1036,1181,-145,0,0,0,0,28,11,11,1.214286,0,0,16,11,false,true,true,0.623,0.377
350,261,89,21.875,17.4,89,1305,1218,87,1,0,0.0625,0,-13,16,15,-2.923077,0,0,9,10,false,true,true,1,0
333,168,165,25.615385,12.923077,165,1413,1422,-9,0,0,0,0,18,13,13,3.166667,0,0,7,13,false,true,true,1,0
272,268,4,15.111111,15.764706,4,628,658,-30,0,0,0,0,1,18,17,46,0,0,11,7,false,true,true,0.638,0.362
161,137,24,23,19.571429,24,941,926,15,1,0,0.142857,0,53,7,7,0.716981,0,0,13,9,false,true,true,0.72,0.28
106,164,-58,15.142857,23.428571,-58,971,761,210,0,0,0,0,48,7,7,0.625,1,0,9,19,false,true,false,0.1,0.9
100,138,-38,14.285714,19.714286,-38,725,771,-46,0,1,0,0.142857,51,7,7,0.901961,0,0,17,12,false,true,false,0.288,0.712
66,92,-26,22,30.666667,-26,1636,1576,60,0,1,0,0.333333,67,3,3,0.507463,0,1,17,15,false,true,false,0.271,0.729
371,329,42,26.5,23.5,42,1875,1793,82,2,1,0.142857,0.071429,-7,14,14,-4.285714,0,0,5,2,false,true,true,0.999,0.001
292,291,1,20.857143,20.785714,1,771,754,17,0,0,0,0,-1,14,14,-32,0,0,16,9,false,true,true,0.721,0.279
289,263,26,26.272727,26.3,26,1439,1397,42,1,2,0.090909,0.2,12,11,10,2.833333,0,0,16,13,false,true,true,0.945,0.055
72,109,-37,10.285714,15.571429,-37,580,620,-40,0,0,0,0,61,7,7,0.704918,1,0,16,13,false,true,false,0.156,0.844
189,139,50,31.5,27.8,50,416,282,134,1,0,0.166667,0,59,6,5,0.576271,0,0,9,21,false,true,true,0.92,0.08
355,259,96,25.357143,19.923077,96,1050,1144,-94,0,1,0,0.076923,4,14,13,9.5,0,1,15,14,false,true,true,1,0
231,206,25,25.666667,22.888889,25,1089,1063,26,1,0,0.111111,0,41,9,9,0.926829,0,0,11,8,false,true,true,0.781,0.219
282,186,96,28.2,18.6,96,986,856,130,1,0,0.1,0,18,10,10,1.722222,0,0,13,13,false,true,true,1,0
296,228,68,22.769231,19,68,306,169,137,0,0,0,0,0,13,12,0,0,0,13,11,false,true,true,0.986,0.014
272,256,16,16,16,16,628,658,-30,0,0,0,0,4,17,16,11.5,0,0,12,8,false,true,true,0.603,0.397
337,202,135,28.083333,18.363636,135,1408,1454,-46,1,0,0.083333,0,19,12,11,1.684211,0,0,15,9,false,true,true,1,0
298,249,49,21.285714,19.153846,49,1069,917,152,0,1,0,0.076923,7,14,13,4.857143,1,0,8,10,false,true,true,0.986,0.014
234,184,50,19.5,15.333333,50,1227,1060,167,0,1,0,0.083333,22,12,12,1.818182,0,0,10,16,false,true,true,0.984,0.016
214,137,77,23.777778,15.222222,77,1004,653,351,0,0,0,0,29,9,9,1.206897,0,0,15,22,false,true,true,0.964,0.036
12,18,-6,6,18,-6,844,821,23,0,0,0,0,93,2,1,0.451613,0,0,25,9,false,true,false,0.307,0.693
66,96,-30,22,32,-30,1305,1218,87,0,0,0,0,74,3,3,0.513514,0,0,11,7,false,true,false,0.257,0.743
265,271,-6,24.090909,27.1,-6,1102,1245,-143,2,0,0.181818,0,-1,11,10,-28,0,0,15,9,false,true,false,0.163,0.837
215,181,34,21.5,20.111111,34,1305,1242,63,1,0,0.1,0,39,10,9,0.871795,0,1,9,7,false,true,true,0.624,0.376
84,33,51,28,11,51,1093,1100,-7,1,0,0.333333,0,85,3,3,0.376471,0,1,19,15,false,true,false,0.422,0.578
224,255,-31,24.888889,31.875,-31,1636,1576,60,0,2,0,0.25,28,9,8,1.214286,0,0,10,18,false,true,false,0.184,0.816
319,189,130,21.266667,12.6,130,786,757,29,1,0,0.066667,0,4,15,15,9.75,0,0,25,14,false,true,true,1,0
365,329,36,22.8125,20.5625,36,965,1013,-48,1,0,0.0625,0,-18,16,16,-1.833333,0,1,3,3,false,true,true,1,0
200,138,62,18.181818,12.545455,62,1011,921,90,0,0,0,0,32,11,11,1.53125,1,0,6,18,false,true,true,0.994,0.006
47,19,28,15.666667,9.5,28,468,542,-74,0,0,0,0,85,3,2,0.458824,0,0,17,14,false,true,false,0.321,0.679
409,230,179,24.058824,14.375,179,954,1078,-124,1,1,0.058824,0.0625,-12,17,16,-3.166667,0,0,4,12,false,true,true,1,0
401,158,243,30.846154,13.166667,243,1054,917,137,2,0,0.153846,0,3,13,12,11.666667,0,0,13,12,false,true,true,1,0
387,280,107,21.5,15.555556,107,1394,1230,164,0,1,0,0.055556,-24,18,18,-1.583333,0,1,7,11,false,true,true,1,0
133,34,99,44.333333,17,99,1489,1405,84,1,0,0.333333,0,80,3,2,0.35,1,0,10,17,false,true,true,0.968,0.032
220,208,12,24.444444,23.111111,12,1344,1325,19,1,0,0.111111,0,30,9,9,1.033333,0,0,10,10,false,true,true,0.568,0.432
338,261,77,16.095238,13.05,77,892,768,124,0,0,0,0,-14,21,20,-3.071429,0,0,5,4,false,true,true,1,0
165,121,44,16.5,12.1,44,415,518,-103,0,0,0,0,41,10,10,0.926829,1,0,13,22,false,true,true,0.979,0.021
32,12,20,16,6,20,576,494,82,0,0,0,0,89,2,2,0.494382,0,0,7,31,false,true,true,0.739,0.261
222,197,25,18.5,17.909091,25,1452,1469,-17,0,1,0,0.090909,22,12,11,1.727273,1,0,11,23,false,true,true,0.805,0.195
312,161,151,17.333333,9.470588,151,993,897,96,1,0,0.055556,0,-11,18,17,-4.272727,0,1,25,25,false,true,true,1,0
229,160,69,32.714286,22.857143,69,1030,998,32,1,0,0.142857,0,44,7,7,0.863636,0,0,17,12,false,true,true,0.9,0.1
255,206,49,23.181818,20.6,49,902,866,36,0,0,0,0,14,11,10,2.285714,0,0,15,7,false,true,true,0.914,0.086
391,290,101,26.066667,19.333333,101,996,1063,-67,1,1,0.066667,0.066667,-10,15,15,-3.2,1,0,2,6,false,true,true,1,0
272,229,43,20.923077,19.083333,43,784,758,26,0,0,0,0,9,13,12,3.888889,0,0,10,18,false,true,true,0.869,0.131
116,102,14,19.333333,20.4,14,1027,856,171,1,0,0.166667,0,53,6,5,0.622642,0,1,12,6,false,true,true,0.557,0.443
187,173,14,15.583333,14.416667,14,871,999,-128,0,0,0,0,26,12,12,1.846154,0,0,7,19,false,true,true,0.594,0.406
62,41,21,20.666667,20.5,21,349,315,34,0,0,0,0,80,3,2,0.425,1,0,6,8,false,true,true,0.786,0.214
186,70,116,26.571429,11.666667,116,942,1003,-61,0,0,0,0,51,7,6,0.882353,0,0,19,16,false,true,true,0.991,0.009
16,0,16,16,0,16,1482,1394,88,0,0,0,0,97,1,0,0.371134,0,0,16,0,false,true,true,0.563,0.437
202,97,105,28.857143,16.166667,105,801,925,-124,1,0,0.142857,0,47,7,6,0.744681,1,0,25,16,false,true,true,0.974,0.026
188,138,50,23.5,17.25,50,1110,1039,71,0,0,0,0,43,8,8,0.837209,0,0,21,10,false,true,true,0.947,0.053
29,33,-4,14.5,16.5,-4,1539,1537,2,0,0,0,0,90,2,2,0.355556,0,0,12,10,false,true,false,0.319,0.681
347,295,52,20.411765,17.352941,52,1547,1439,108,1,0,0.058824,0,-11,17,17,-3.363636,0,0,5,3,false,true,true,1,0
62,48,14,20.666667,24,14,1304,1040,264,0,0,0,0,80,3,2,0.4125,1,0,6,16,false,true,true,0.639,0.361
341,264,77,17.947368,13.894737,77,830,907,-77,1,0,0.052632,0,-15,19,19,-2.6,0,1,14,1,false,true,true,1,0
98,139,-41,16.333333,23.166667,-41,1519,1782,-263,0,0,0,0,58,6,6,0.568966,0,0,16,11,false,true,false,0.072,0.928
289,240,49,17,14.117647,49,299,315,-16,0,0,0,0,-18,17,17,-2.333333,0,0,10,18,false,true,true,0.987,0.013
206,180,26,15.846154,15,26,658,817,-159,0,0,0,0,23,13,12,1.652174,0,0,12,19,false,true,true,0.542,0.458
98,56,42,19.6,14,42,527,503,24,0,0,0,0,74,5,4,0.554054,0,0,17,11,false,true,true,0.92,0.08
248,214,34,20.666667,19.454545,34,1078,1130,-52,0,1,0,0.090909,22,12,11,1.772727,0,0,8,27,false,true,true,0.844,0.156
194,150,44,16.166667,13.636364,44,416,306,110,0,0,0,0,33,12,11,1.272727,0,0,14,13,false,true,true,0.894,0.106
84,60,24,14,12,24,1159,1051,108,0,0,0,0,70,6,5,0.571429,0,0,21,17,false,true,true,0.518,0.482
322,197,125,20.125,13.133333,125,1281,1339,-58,0,0,0,0,12,16,15,3.416667,0,0,13,9,false,true,true,1,0
97,46,51,19.4,9.2,51,939,913,26,0,0,0,0,75,5,5,0.533333,0,0,18,13,false,true,true,0.949,0.051
436,378,58,21.8,18.9,58,1220,1261,-41,2,0,0.1,0,-21,20,20,-2.142857,0,0,3,2,false,true,true,1,0
338,264,74,24.142857,20.307692,74,1127,1075,52,1,1,0.071429,0.076923,0,14,13,0,0,1,10,6,false,true,true,0.954,0.046
37,32,5,18.5,32,5,1093,1197,-104,0,0,0,0,90,2,1,0.344444,0,0,17,10,false,true,false,0.311,0.689
200,195,5,14.285714,15,5,480,518,-38,0,0,0,0,23,14,13,2,1,1,9,10,false,true,false,0.235,0.765
286,145,141,19.066667,9.666667,141,1176,1076,100,0,0,0,0,33,15,15,1.787879,0,0,10,8,false,true,true,1,0
173,127,46,19.222222,15.875,46,786,788,-2,0,0,0,0,34,9,8,1,1,0,11,7,false,true,true,0.945,0.055
214,229,-15,21.4,22.9,-15,1154,1062,92,1,0,0.1,0,32,10,10,1.09375,1,0,9,15,false,true,false,0.291,0.709
364,268,96,19.157895,14.888889,96,527,503,24,0,0,0,0,-14,19,18,-2.928571,0,0,3,4,false,true,true,1,0
414,284,130,18,12.909091,130,942,1003,-61,0,0,0,0,-37,23,22,-1.216216,1,0,0,1,true,true,true,1,0
365,282,83,36.5,31.333333,83,1890,2020,-130,1,2,0.1,0.222222,13,10,9,2.230769,0,0,7,16,false,true,true,0.99,0.01
54,77,-23,18,25.666667,-23,334,446,-112,0,0,0,0,79,3,3,0.506329,0,0,14,16,false,true,false,0.166,0.834
223,144,79,22.3,16,79,580,620,-40,1,0,0.1,0,41,10,9,1.04878,0,1,15,7,false,true,true,0.545,0.455
358,268,90,27.538462,22.333333,90,1397,1361,36,1,0,0.076923,0,0,13,12,0,0,0,3,6,false,true,true,1,0
221,174,47,31.571429,24.857143,47,1142,1095,47,1,0,0.142857,0,43,7,7,0.813953,0,1,16,15,false,true,true,0.849,0.151
385,367,18,24.0625,24.466667,18,1397,1195,202,1,0,0.0625,0,-8,16,15,-4.375,0,0,5,5,false,true,true,0.99,0.01
234,252,-18,16.714286,18,-18,1090,1244,-154,0,0,0,0,6,14,14,6.166667,1,1,6,11,false,true,false,0.057,0.943
68,35,33,68,35,33,1256,1232,24,1,0,1,0,89,1,1,0.337079,0,1,16,8,false,true,false,0.082,0.918
238,147,91,29.75,21,91,820,783,37,0,0,0,0,43,8,7,0.767442,2,0,11,9,false,true,true,0.994,0.006
143,120,23,28.6,30,23,974,995,-21,0,1,0,0.25,61,5,4,0.540984,0,0,18,10,false,true,true,0.803,0.197
51,52,-1,12.75,13,-1,523,480,43,0,0,0,0,72,4,4,0.458333,0,0,18,10,false,true,true,0.772,0.228
198,177,21,28.285714,25.285714,21,1004,840,164,1,0,0.142857,0,42,7,7,0.714286,1,0,12,11,false,true,true,0.668,0.332
101,79,22,25.25,26.333333,22,518,448,70,0,0,0,0,77,4,3,0.441558,0,0,7,11,false,true,true,0.77,0.23
316,258,58,22.571429,18.428571,58,1004,653,351,0,0,0,0,-9,14,14,-3.888889,0,0,10,6,false,true,true,1,0
351,334,17,18.473684,17.578947,17,825,907,-82,1,0,0.052632,0,-22,19,19,-1.818182,0,0,1,9,false,true,true,0.98,0.02
354,296,58,23.6,19.733333,58,1034,1040,-6,1,0,0.066667,0,-4,15,15,-8.75,1,0,11,6,false,true,true,1,0
248,242,6,17.714286,17.285714,6,1214,1176,38,0,0,0,0,16,14,14,2.25,0,0,12,11,false,true,true,0.702,0.298
215,102,113,35.833333,17,113,1550,1624,-74,0,0,0,0,59,6,6,0.508475,0,1,11,26,false,true,true,0.834,0.166
170,151,19,18.888889,16.777778,19,831,830,1,0,0,0,0,40,9,9,0.925,0,0,20,9,false,true,true,0.904,0.096
321,276,45,22.928571,19.714286,45,995,912,83,2,0,0.142857,0,14,14,14,3.142857,0,0,14,8,false,true,true,0.989,0.011
18,14,4,18,14,4,847,952,-105,0,0,0,0,94,1,1,0.382979,0,0,18,15,false,true,false,0.215,0.785
341,262,79,14.826087,11.391304,79,1128,889,239,0,1,0,0.043478,-33,23,23,-1.424242,0,0,3,1,false,true,true,1,0
409,334,75,22.722222,19.647059,75,1331,1399,-68,1,0,0.055556,0,-24,18,17,-1.458333,0,0,2,2,true,true,true,1,0
22,13,9,22,13,9,303,342,-39,0,0,0,0,95,1,1,0.4,0,0,13,15,false,true,false,0.452,0.548
253,186,67,16.866667,13.285714,67,913,871,42,0,0,0,0,10,15,14,4.3,0,0,14,27,false,true,true,0.985,0.015
255,186,69,17,13.285714,69,1037,950,87,1,0,0.066667,0,11,15,14,2.818182,0,0,8,18,false,true,true,0.986,0.014
262,289,-27,20.153846,24.083333,-27,1265,1045,220,0,1,0,0.083333,9,13,12,4.666667,0,0,23,8,false,true,false,0.269,0.731
216,198,18,19.636364,18,18,786,847,-61,0,0,0,0,27,11,11,1.259259,0,0,9,11,false,true,true,0.657,0.343
159,69,90,31.8,13.8,90,1216,1217,-1,1,0,0.2,0,61,5,5,0.557377,0,0,12,28,false,true,true,0.987,0.013
392,310,82,21.777778,18.235294,82,1075,1152,-77,0,1,0,0.058824,-13,18,17,-3.076923,0,0,11,8,false,true,true,1,0
309,265,44,14.045455,12.619048,44,371,435,-64,0,0,0,0,-31,22,21,-1.419355,0,0,1,2,false,true,true,1,0
47,64,-17,11.75,16,-17,448,598,-150,0,0,0,0,75,4,4,0.48,0,0,7,7,false,true,false,0.203,0.797
102,68,34,25.5,17,34,609,620,-11,0,0,0,0,72,4,4,0.513889,0,0,12,10,false,true,true,0.917,0.083
306,234,72,20.4,15.6,72,505,95,410,0,1,0,0.066667,11,15,15,4,0,0,12,16,false,true,true,0.985,0.015
160,210,-50,26.666667,42,-50,1554,1716,-162,1,1,0.166667,0.2,50,6,5,0.7,0,0,18,7,false,true,false,0.283,0.717
30,0,30,30,0,30,942,1003,-61,0,0,0,0,95,1,0,0.473684,0,0,11,0,false,true,true,0.543,0.457
146,142,4,18.25,20.285714,4,1277,1166,111,0,1,0,0.142857,48,8,7,0.75,0,0,7,12,false,true,false,0.282,0.718
436,283,153,33.538462,21.769231,153,1571,1554,17,2,1,0.153846,0.076923,-3,13,13,-11,1,0,8,9,false,true,true,1,0
340,278,62,20,17.375,62,719,785,-66,0,1,0,0.0625,-9,17,16,-4,0,0,4,5,false,true,true,0.999,0.001
318,220,98,19.875,14.666667,98,1181,1069,112,0,0,0,0,-2,16,15,-18.5,1,0,6,12,false,true,true,1,0
22,48,-26,11,24,-26,1161,1166,-5,0,0,0,0,85,2,2,0.411765,0,0,9,14,false,true,false,0.272,0.728
122,95,27,20.333333,19,27,1452,1469,-17,0,1,0,0.2,57,6,5,0.666667,0,0,9,16,false,true,false,0.393,0.607
336,317,19,17.684211,17.611111,19,594,605,-11,0,0,0,0,-21,19,18,-1.761905,0,0,1,1,true,true,true,0.911,0.089
248,198,50,27.555556,22,50,1556,1591,-35,1,0,0.111111,0,33,9,9,1.090909,0,0,9,9,false,true,true,0.925,0.075
12,22,-10,12,22,-10,948,933,15,0,0,0,0,92,1,1,0.413043,1,1,16,10,false,true,true,0.556,0.444
296,264,32,17.411765,16.5,32,908,859,49,0,0,0,0,-4,17,16,-9.75,0,0,9,10,false,true,true,0.944,0.056
300,330,-30,25,27.5,-30,1030,1144,-114,0,2,0,0.166667,17,12,12,2.058824,0,0,17,10,false,true,true,0.649,0.351
262,237,25,21.833333,21.545455,25,290,416,-126,0,0,0,0,18,12,11,1.888889,0,0,8,11,false,true,true,0.748,0.252
291,256,35,26.454545,23.272727,35,1355,1210,145,1,0,0.090909,0,20,11,11,1.5,1,0,6,15,false,true,true,0.999,0.001
74,0,74,74,0,74,1216,1230,-14,1,0,1,0,93,1,0,0.344086,0,0,22,0,false,true,true,0.576,0.424
34,26,8,17,26,8,1355,1210,145,0,0,0,0,88,2,1,0.340909,0,0,19,12,false,true,false,0.291,0.709
244,160,84,30.5,22.857143,84,1030,998,32,1,0,0.125,0,40,8,7,0.95,0,0,15,12,false,true,true,0.946,0.054
319,216,103,19.9375,13.5,103,925,801,124,1,0,0.0625,0,0,16,16,0,0,0,16,9,false,true,true,0.999,0.001
378,310,68,18,15.5,68,880,952,-72,0,0,0,0,-28,21,20,-1.464286,0,0,1,1,true,true,true,1,0
238,229,9,21.636364,22.9,9,1154,1062,92,1,0,0.090909,0,29,11,10,1.206897,1,0,6,15,false,true,false,0.372,0.628
300,186,114,33.333333,20.666667,114,1093,1197,-104,2,0,0.222222,0,32,9,9,0.96875,1,0,9,9,false,true,true,1,0
323,282,41,21.533333,20.142857,41,892,819,73,0,1,0,0.071429,-3,15,14,-11.333333,0,0,5,6,false,true,true,0.973,0.027
307,302,5,20.466667,20.133333,5,771,754,17,0,0,0,0,-9,15,15,-3.555556,0,0,6,5,false,true,true,0.667,0.333
167,149,18,27.833333,29.8,18,1428,1452,-24,0,0,0,0,60,6,5,0.516667,0,0,15,10,false,true,false,0.37,0.63
57,72,-15,19,24,-15,1244,1361,-117,0,0,0,0,82,3,3,0.463415,0,0,14,10,false,true,false,0.18,0.82
66,45,21,16.5,15,21,540,518,22,0,0,0,0,79,4,3,0.506329,0,1,13,17,false,true,false,0.445,0.555
426,249,177,23.666667,14.647059,177,954,1078,-124,1,1,0.055556,0.058824,-18,18,17,-2.111111,0,0,1,4,false,true,true,1,0
226,212,14,17.384615,16.307692,14,704,691,13,0,0,0,0,17,13,13,2.235294,1,0,6,7,false,true,true,0.921,0.079
252,183,69,15.75,11.4375,69,1069,1040,29,0,0,0,0,-6,16,16,-7.333333,0,2,17,8,false,true,true,1,0
270,172,98,20.769231,13.230769,98,1253,1166,87,1,0,0.076923,0,21,13,13,2.047619,0,0,10,19,false,true,true,0.996,0.004
113,128,-15,16.142857,18.285714,-15,1583,1422,161,0,0,0,0,61,7,7,0.836066,1,0,16,7,false,true,true,0.602,0.398
229,232,-3,17.615385,19.333333,-3,491,398,93,0,0,0,0,18,13,12,2,0,0,7,21,false,true,false,0.252,0.748
265,226,39,18.928571,17.384615,39,1159,1051,108,0,0,0,0,14,14,13,2.857143,0,0,9,10,false,true,true,0.799,0.201
366,345,21,17.428571,17.25,21,901,889,12,0,1,0,0.05,-30,21,20,-1.433333,0,0,2,1,false,true,true,1,0
307,220,87,19.1875,13.75,87,1091,1078,13,0,0,0,0,6,16,16,7.166667,0,0,10,11,false,true,true,1,0
140,89,51,23.333333,17.8,51,1388,1477,-89,1,0,0.166667,0,60,6,5,0.8,0,0,8,8,false,true,true,0.891,0.109
334,291,43,25.692308,24.25,43,1554,1716,-162,1,1,0.076923,0.083333,3,13,12,11.666667,0,0,12,12,false,true,true,0.973,0.027
36,33,3,18,16.5,3,1037,950,87,0,0,0,0,85,2,2,0.364706,1,0,8,10,false,true,true,0.765,0.235
180,171,9,18,17.1,9,1221,1258,-37,1,0,0.1,0,36,10,10,1.083333,0,0,26,12,false,true,true,0.743,0.257
123,103,20,24.6,20.6,20,1148,1164,-16,0,0,0,0,60,5,5,0.416667,1,1,9,10,false,true,true,0.564,0.436
196,171,25,21.777778,21.375,25,1304,1040,264,1,0,0.111111,0,41,9,8,0.804878,0,0,18,23,false,true,false,0.489,0.511
378,281,97,22.235294,16.529412,97,801,925,-124,1,0,0.058824,0,-20,17,17,-1.75,0,0,4,1,false,true,true,1,0
324,304,20,17.052632,16.888889,20,942,976,-34,0,0,0,0,-21,19,18,-1.904762,0,0,1,6,false,true,true,1,0
331,309,22,17.421053,16.263158,22,758,952,-194,0,0,0,0,-24,19,19,-1.666667,0,0,1,1,false,true,true,1,0
202,141,61,20.2,14.1,61,1037,950,87,1,0,0.1,0,36,10,10,0.861111,0,0,11,10,false,true,true,0.989,0.011
363,296,67,21.352941,17.411765,67,1047,1094,-47,1,1,0.058824,0.058824,-10,17,17,-3.6,1,0,3,3,false,true,true,0.992,0.008
22,0,22,22,0,22,1826,1803,23,0,0,0,0,95,1,0,0.315789,0,0,21,0,false,true,true,0.729,0.271
328,296,32,20.5,19.733333,32,758,796,-38,0,0,0,0,-7,16,15,-5.428571,0,0,3,9,false,true,true,0.869,0.131
274,226,48,17.125,15.066667,48,613,461,152,0,1,0,0.066667,-15,16,15,-2.466667,0,0,19,10,false,true,true,0.987,0.013
383,383,0,25.533333,25.533333,0,1256,1232,24,1,0,0.066667,0,-12,15,15,-2.5,1,0,2,2,true,true,true,0.999,0.001
54,29,25,18,14.5,25,303,342,-39,0,0,0,0,86,3,2,0.44186,0,0,20,16,false,true,true,0.566,0.434
400,309,91,22.222222,18.176471,91,1227,1060,167,0,2,0,0.117647,-20,18,17,-2,0,0,4,6,false,true,true,1,0
263,204,59,29.222222,25.5,59,1320,1339,-19,2,1,0.222222,0.125,31,9,8,1.258065,0,0,19,15,false,true,true,0.987,0.013
54,56,-2,18,18.666667,-2,1277,1166,111,0,0,0,0,78,3,3,0.461538,0,2,14,9,false,true,false,0.348,0.652
348,323,25,21.75,21.533333,25,1096,1009,87,2,0,0.125,0,6,16,15,7.333333,0,0,10,16,false,true,true,0.932,0.068
138,111,27,19.714286,15.857143,27,363,668,-305,0,0,0,0,62,7,7,0.693548,0,0,7,12,false,true,true,0.613,0.387
338,288,50,16.095238,13.714286,50,1091,1078,13,0,0,0,0,-20,21,21,-2.15,1,0,4,2,false,true,true,1,0
303,223,80,16.833333,13.117647,80,415,518,-103,0,0,0,0,-15,18,17,-2.533333,0,0,1,15,false,true,true,1,0
354,275,79,18.631579,14.473684,79,1606,1544,62,0,0,0,0,-10,19,19,-4.5,0,0,6,2,false,true,true,1,0
211,182,29,16.230769,15.166667,29,908,859,49,0,0,0,0,20,13,12,1.95,0,1,17,12,false,true,true,0.831,0.169
355,271,84,22.1875,18.066667,84,902,866,36,0,0,0,0,-22,16,15,-1.454545,0,0,1,4,false,true,true,1,0
432,276,156,25.411765,17.25,156,1167,1216,-49,1,0,0.058824,0,-2,17,16,-20.5,0,0,4,7,false,true,true,1,0
182,212,-30,22.75,26.5,-30,1439,1397,42,0,2,0,0.25,36,8,8,0.944444,0,0,7,8,false,true,false,0.277,0.723
251,172,79,19.307692,14.333333,79,1037,950,87,1,0,0.076923,0,16,13,12,1.9375,0,0,8,27,false,true,true,0.992,0.008
35,45,-10,11.666667,22.5,-10,926,854,72,0,0,0,0,82,3,2,0.414634,0,0,17,16,false,true,false,0.301,0.699
226,248,-22,15.066667,17.714286,-22,576,494,82,0,0,0,0,12,15,14,3.666667,0,1,9,8,false,true,false,0.087,0.913
300,215,85,23.076923,17.916667,85,596,595,1,1,0,0.076923,0,15,13,12,2.666667,0,0,7,15,false,true,true,0.986,0.014
157,67,90,26.166667,13.4,90,871,867,4,0,0,0,0,62,6,5,0.693548,0,0,8,9,false,true,true,0.972,0.028
142,100,42,17.75,12.5,42,415,518,-103,0,0,0,0,51,8,8,0.745098,1,0,7,28,false,true,true,0.974,0.026
332,243,89,27.666667,22.090909,89,630,786,-156,1,0,0.083333,0,17,12,11,2.058824,0,0,7,12,false,true,true,0.999,0.001
14,27,-13,14,27,-13,1434,1493,-59,0,0,0,0,91,1,1,0.406593,0,0,11,11,false,true,false,0.29,0.71
227,190,37,25.222222,21.111111,37,695,671,24,0,0,0,0,28,9,9,1.178571,0,0,7,9,false,true,true,0.931,0.069
70,63,7,23.333333,21,7,971,906,65,0,0,0,0,78,3,3,0.410256,0,1,16,9,false,true,true,0.554,0.446
275,221,54,22.916667,20.090909,54,976,965,11,1,0,0.083333,0,11,12,11,2.909091,1,0,11,14,false,true,true,0.973,0.027
165,167,-2,16.5,16.7,-2,1583,1422,161,0,0,0,0,46,10,10,1.108696,1,0,16,7,false,true,true,0.837,0.163
141,68,73,35.25,22.666667,73,1093,1197,-104,1,0,0.25,0,74,4,3,0.418919,0,0,16,8,false,true,true,0.605,0.395
60,38,22,20,12.666667,22,1014,1303,-289,0,0,0,0,78,3,3,0.487179,1,1,7,6,false,true,false,0.212,0.788
28,14,14,28,14,14,1513,1482,31,0,0,0,0,90,1,1,0.366667,0,0,12,28,false,true,true,0.564,0.436
107,45,62,21.4,11.25,62,804,683,121,0,0,0,0,67,5,4,0.671642,0,1,20,6,false,true,true,0.936,0.064
163,84,79,16.3,8.4,79,859,719,140,0,1,0,0.1,31,10,10,1.709677,0,2,19,13,false,true,true,0.952,0.048
104,85,19,20.8,17,19,1029,1075,-46,0,0,0,0,66,5,5,0.727273,0,0,8,13,false,true,true,0.558,0.442
296,165,131,26.909091,15,131,742,696,46,0,0,0,0,20,11,11,1.6,0,0,14,16,false,true,true,1,0
284,263,21,20.285714,18.785714,21,838,786,52,0,1,0,0.071429,4,14,14,8,0,0,8,16,false,true,true,0.934,0.066
238,264,-26,14.875,17.6,-26,576,494,82,0,0,0,0,5,16,15,8.8,0,1,12,6,false,true,false,0.083,0.917
188,167,21,18.8,16.7,21,527,503,24,0,0,0,0,42,10,10,0.97619,0,0,20,11,false,true,true,0.9,0.1
24,39,-15,24,39,-15,1684,1320,364,0,0,0,0,92,1,1,0.326087,1,0,7,15,false,true,true,1,0
379,307,72,21.055556,17.055556,72,1089,1063,26,1,0,0.055556,0,-17,18,18,-2.235294,0,0,1,6,false,true,true,1,0
192,125,67,21.333333,15.625,67,1055,1050,5,0,0,0,0,44,9,8,0.772727,0,0,9,18,false,true,true,0.972,0.028
222,170,52,17.076923,13.076923,52,913,871,42,0,0,0,0,21,13,13,2.047619,0,0,11,27,false,true,true,0.983,0.017
52,22,30,26,22,30,1094,1030,64,0,0,0,0,87,2,1,0.413793,0,0,9,10,false,true,true,0.574,0.426
91,78,13,22.75,26,13,820,822,-2,0,0,0,0,75,4,3,0.52,1,0,19,8,false,true,true,0.747,0.253
364,296,68,21.411765,18.5,68,1452,1469,-17,1,1,0.058824,0.0625,-14,17,16,-2.714286,0,0,3,8,false,true,true,1,0
38,0,38,38,0,38,1075,989,86,0,0,0,0,95,1,0,0.410526,0,0,8,0,false,true,true,0.711,0.289
14,0,14,14,0,14,801,925,-124,0,0,0,0,95,1,1,0.368421,0,0,10,9,false,true,false,0.212,0.788
67,70,-3,13.4,17.5,-3,892,768,124,0,0,0,0,71,5,4,0.605634,0,0,8,16,false,true,true,0.511,0.489
118,81,37,23.6,16.2,37,1065,1030,35,0,0,0,0,68,5,5,0.5,0,1,18,6,false,true,true,0.802,0.198
375,280,95,22.058824,16.470588,95,1030,998,32,1,0,0.058824,0,-16,17,17,-2.375,1,0,1,2,false,true,true,1,0
361,209,152,22.5625,13.0625,152,1033,1037,-4,0,1,0,0.0625,-2,16,16,-22.5,0,1,18,14,false,true,true,1,0
71,64,7,17.75,16,7,1394,1118,276,0,0,0,0,69,4,4,0.536232,1,0,9,7,false,true,true,0.773,0.227
279,205,74,17.4375,13.666667,74,1583,1422,161,1,0,0.0625,0,24,16,15,2.125,0,0,9,21,false,true,true,1,0
183,154,29,15.25,12.833333,29,218,86,132,0,0,0,0,15,12,12,2.666667,0,0,19,9,false,true,true,0.951,0.049
257,205,52,25.7,22.777778,52,1394,1424,-30,0,1,0,0.111111,34,10,9,0.941176,1,0,6,20,false,true,true,0.943,0.057
165,43,122,33,10.75,122,1507,1554,-47,1,0,0.2,0,64,5,4,0.453125,1,0,8,8,false,true,true,0.97,0.03
263,169,94,32.875,24.142857,94,1397,1361,36,1,0,0.125,0,37,8,7,0.783784,0,0,8,7,false,true,true,0.989,0.011
8,18,-10,8,18,-10,95,378,-283,0,0,0,0,95,1,1,0.368421,1,0,6,14,false,true,false,0.202,0.798
189,155,34,31.5,25.833333,34,1101,1078,23,0,0,0,0,54,6,6,0.611111,0,1,7,10,false,true,true,0.678,0.322
81,115,-34,13.5,23,-34,892,788,104,0,0,0,0,69,6,5,0.623188,1,0,15,13,false,true,true,0.577,0.423
195,155,40,15,12.916667,40,584,565,19,0,0,0,0,22,13,12,2.090909,0,0,7,14,false,true,true,0.975,0.025
156,198,-42,17.333333,22,-42,1177,1214,-37,0,0,0,0,39,9,9,0.897436,0,0,19,15,false,true,false,0.227,0.773
228,143,85,28.5,17.875,85,1826,1803,23,1,0,0.125,0,41,8,8,0.731707,1,0,7,10,false,true,true,0.962,0.038
262,297,-35,20.153846,22.846154,-35,1265,1045,220,0,1,0,0.076923,7,13,13,6,0,0,23,8,false,true,false,0.305,0.695
79,40,39,26.333333,20,39,939,907,32,0,0,0,0,83,3,2,0.481928,0,0,18,18,false,true,true,0.769,0.231
353,232,121,25.214286,17.846154,121,1029,1227,-198,1,0,0.071429,0,-13,14,13,-2.461538,0,0,5,7,false,true,true,1,0
90,67,23,22.5,22.333333,23,711,876,-165,0,0,0,0,73,4,3,0.589041,0,0,8,12,false,true,false,0.227,0.773
187,131,56,12.466667,9.357143,56,310,359,-49,0,0,0,0,5,15,14,9.8,0,0,10,18,false,true,true,0.951,0.049
59,48,11,19.666667,24,11,671,725,-54,0,0,0,0,80,3,2,0.4625,1,0,6,11,false,true,true,0.507,0.493
231,218,13,23.1,24.222222,13,1142,1176,-34,1,0,0.1,0,30,10,9,1.2,1,0,19,11,false,true,true,0.682,0.318
62,31,31,20.666667,15.5,31,904,783,121,0,0,0,0,79,3,2,0.531646,1,0,14,22,false,true,true,0.883,0.117
152,113,39,19,16.142857,39,1094,1030,64,0,0,0,0,51,8,7,0.705882,1,0,10,10,false,true,true,0.853,0.147
45,101,-56,15,50.5,-56,1782,1512,270,0,1,0,0.5,81,3,2,0.518519,1,0,7,7,false,true,true,1,0
330,306,24,25.384615,23.538462,24,1439,1397,42,1,2,0.076923,0.153846,-3,13,13,-11.333333,0,0,11,19,false,true,true,0.985,0.015
249,266,-17,17.785714,19,-17,491,398,93,0,0,0,0,10,14,14,3.6,0,0,7,13,false,true,false,0.225,0.775
359,261,98,23.933333,17.4,98,1030,998,32,1,0,0.066667,0,-5,15,15,-7.6,1,0,6,14,false,true,true,1,0
325,290,35,20.3125,19.333333,35,1027,856,171,1,1,0.0625,0.066667,-20,16,15,-1.65,0,0,2,3,false,true,true,0.947,0.053
205,186,19,18.636364,18.6,19,1090,1244,-154,0,0,0,0,28,11,10,1.321429,0,1,10,13,false,true,false,0.142,0.858
385,318,67,25.666667,22.714286,67,1355,1210,145,2,0,0.133333,0,-2,15,14,-15,1,0,6,8,false,true,true,1,0
310,99,211,19.375,6.6,211,896,818,78,0,0,0,0,18,16,15,2.444444,1,1,11,6,false,true,true,1,0
162,144,18,16.2,16,18,540,518,22,0,0,0,0,40,10,9,1,0,0,8,12,false,true,true,0.652,0.348
181,170,11,25.857143,24.285714,11,965,1013,-48,1,0,0.142857,0,42,7,7,0.785714,0,1,20,11,false,true,false,0.316,0.684
304,298,6,20.266667,19.866667,6,1277,1166,111,0,1,0,0.066667,-5,15,15,-7.2,0,0,10,9,false,true,true,0.72,0.28
135,89,46,33.75,22.25,46,695,671,24,0,0,0,0,68,4,4,0.485294,0,0,16,13,false,true,true,0.952,0.048
329,309,20,14.954545,14.045455,20,500,567,-67,0,0,0,0,-20,22,22,-2.2,0,0,2,11,true,true,true,1,0
90,76,14,15,15.2,14,566,542,24,0,0,0,0,63,6,5,0.650794,0,1,7,10,false,true,true,0.522,0.478
94,45,49,23.5,11.25,49,1067,95,972,0,0,0,0,77,4,4,0.441558,0,0,21,7,false,true,true,1,0
336,304,32,16,15.2,32,363,668,-305,0,0,0,0,-17,21,20,-2.529412,0,0,7,1,false,true,true,1,0
201,211,-10,13.4,14.066667,-10,826,771,55,0,0,0,0,16,15,15,2.8125,0,0,19,10,false,true,true,0.836,0.164
191,200,-9,19.1,20,-9,1077,1094,-17,0,0,0,0,34,10,10,1.235294,0,0,7,8,false,true,false,0.276,0.724
171,196,-25,14.25,17.818182,-25,628,658,-30,0,0,0,0,31,12,11,1.483871,0,0,16,11,false,true,false,0.158,0.842
198,139,59,22,17.375,59,1216,1228,-12,0,0,0,0,47,9,8,0.702128,1,0,6,11,false,true,true,0.937,0.063
368,357,11,21.647059,21,11,1554,1716,-162,1,1,0.058824,0.058824,-21,17,17,-1.666667,0,0,2,2,false,true,true,0.977,0.023
297,220,77,21.214286,15.714286,77,527,503,24,0,0,0,0,14,14,14,2.928571,0,0,7,7,false,true,true,0.996,0.004
245,189,56,40.833333,31.5,56,1983,2020,-37,1,0,0.166667,0,46,6,6,0.565217,0,1,12,8,false,true,true,0.875,0.125
119,110,9,14.875,15.714286,9,523,480,43,1,0,0.125,0,46,8,7,0.717391,0,0,13,9,false,true,true,0.633,0.367
310,240,70,23.846154,20,70,1073,1177,-104,1,0,0.076923,0,7,13,12,4.571429,0,0,18,17,false,true,true,0.941,0.059
279,221,58,16.411765,13.8125,58,346,231,115,0,0,0,0,-25,17,16,-1.64,0,1,20,9,false,true,true,1,0
20,24,-4,20,24,-4,1090,1244,-154,0,0,0,0,91,1,1,0.406593,0,0,9,9,false,true,false,0.236,0.764
49,82,-33,8.166667,16.4,-33,480,518,-38,0,0,0,0,74,6,5,0.621622,0,0,9,12,false,true,false,0.085,0.915
12,0,12,12,0,12,620,658,-38,0,0,0,0,96,1,0,0.375,1,0,11,0,false,true,true,0.549,0.451
175,87,88,25,12.428571,88,786,757,29,1,0,0.142857,0,56,7,7,0.696429,0,0,7,20,false,true,true,0.992,0.008
250,238,12,16.666667,15.866667,12,904,857,47,0,0,0,0,3,15,15,13.666667,1,0,15,10,false,true,true,0.837,0.163
264,238,26,14.666667,13.222222,26,871,999,-128,0,0,0,0,-7,18,18,-6.857143,0,0,10,10,false,true,true,0.987,0.013
116,43,73,29,14.333333,73,1127,1075,52,1,0,0.25,0,75,4,3,0.413333,0,0,21,14,false,true,true,0.757,0.243
368,229,139,26.285714,17.615385,139,695,671,24,0,0,0,0,4,14,13,8.25,0,0,7,16,false,true,true,1,0
83,47,36,16.6,9.4,36,1394,1230,164,0,0,0,0,65,5,5,0.584615,0,0,7,11,false,true,true,0.757,0.243
77,57,20,19.25,19,20,1023,1070,-47,0,0,0,0,75,4,3,0.426667,1,0,15,13,false,true,true,0.723,0.277
276,163,113,27.6,18.111111,113,795,830,-35,1,1,0.1,0.111111,25,10,9,1.68,0,0,14,14,false,true,true,0.988,0.012
252,194,58,25.2,19.4,58,1216,1217,-1,1,0,0.1,0,27,10,10,1.259259,1,0,14,19,false,true,true,0.986,0.014
391,267,124,24.4375,17.8,124,1510,1583,-73,1,0,0.0625,0,-13,16,15,-2.461538,0,0,7,5,false,true,true,1,0
94,70,24,23.5,17.5,24,1181,1149,32,0,0,0,0,76,4,4,0.592105,0,0,10,14,false,true,true,0.584,0.416
346,319,27,15.043478,14.5,27,1221,1438,-217,0,0,0,0,-21,23,22,-2.142857,0,0,2,1,true,true,true,0.982,0.018
16,0,16,16,0,16,505,95,410,0,0,0,0,97,1,0,0.453608,0,0,7,0,false,true,true,0.783,0.217
40,23,17,40,23,17,866,949,-83,0,0,0,0,92,1,1,0.434783,0,0,13,10,false,true,true,0.523,0.477
199,220,-21,28.428571,31.428571,-21,1256,1232,24,1,0,0.142857,0,43,7,7,0.697674,0,0,16,20,false,true,false,0.33,0.67
312,243,69,13.565217,11.045455,69,310,359,-49,0,0,0,0,-45,23,22,-1.088889,0,0,4,12,false,true,true,1,0
240,141,99,30,17.625,99,1408,1454,-46,1,0,0.125,0,43,8,8,0.744186,0,0,12,19,false,true,true,0.988,0.012
89,51,38,22.25,17,38,1048,1000,48,0,0,0,0,76,4,3,0.526316,0,1,10,12,false,true,true,0.567,0.433
405,296,109,27,21.142857,109,1507,1554,-47,1,2,0.066667,0.142857,-12,15,14,-2.416667,0,0,3,4,true,true,true,1,0
14,0,14,14,0,14,1428,1606,-178,0,0,0,0,96,1,0,0.333333,1,0,6,0,false,true,false,0.307,0.693
126,105,21,15.75,13.125,21,1253,1166,87,0,0,0,0,56,8,8,0.767857,2,0,6,26,false,true,true,0.974,0.026
247,230,17,17.642857,16.428571,17,801,807,-6,0,0,0,0,4,14,14,8.75,1,0,10,11,false,true,true,0.929,0.071
94,57,37,23.5,19,37,1181,1149,32,0,0,0,0,79,4,3,0.56962,0,0,10,17,false,true,true,0.526,0.474
94,95,-1,18.8,19,-1,363,668,-305,0,0,0,0,75,5,5,0.573333,1,0,8,13,false,true,false,0.224,0.776
315,304,11,17.5,16.888889,11,527,514,13,0,0,0,0,-18,18,18,-2.166667,0,0,3,1,false,true,true,0.927,0.073
125,52,73,25,13,73,1022,1095,-73,0,0,0,0,72,5,4,0.458333,0,0,17,8,false,true,true,0.865,0.135
87,106,-19,14.5,17.666667,-19,825,907,-82,0,0,0,0,62,6,6,0.645161,2,0,5,11,false,true,true,0.571,0.429
42,56,-14,14,18.666667,-14,1320,1339,-19,0,0,0,0,77,3,3,0.506494,1,0,7,7,false,true,true,0.524,0.476
46,7,39,23,7,39,554,342,212,0,0,0,0,89,2,1,0.404494,0,0,13,17,false,true,true,0.786,0.214
111,54,57,22.2,13.5,57,771,754,17,0,0,0,0,67,5,4,0.477612,0,0,12,7,false,true,true,0.9,0.1
119,114,5,13.222222,14.25,5,416,374,42,0,0,0,0,56,9,8,0.821429,1,0,9,8,false,true,true,0.595,0.405
233,231,2,25.888889,25.666667,2,1554,1622,-68,2,0,0.222222,0,29,9,9,1.068966,0,0,22,7,false,true,true,0.547,0.453
83,184,-101,13.833333,30.666667,-101,1265,1045,220,0,1,0,0.166667,51,6,6,0.823529,0,0,20,10,false,true,false,0.034,0.966
61,19,42,20.333333,9.5,42,872,818,54,0,0,0,0,80,3,2,0.5125,0,1,10,12,false,true,true,0.605,0.395
279,293,-14,17.4375,18.3125,-14,1078,1130,-52,0,1,0,0.0625,-6,16,16,-6.5,0,0,11,11,false,true,true,0.638,0.362
355,271,84,25.357143,19.357143,84,1050,1144,-94,0,1,0,0.071429,1,14,14,38,0,1,15,18,false,true,true,1,0
118,52,66,29.5,17.333333,66,1216,1230,-14,1,0,0.25,0,69,4,3,0.463768,0,0,18,7,false,true,true,0.738,0.262
186,174,12,18.6,19.333333,12,1073,1177,-104,0,0,0,0,32,10,9,1,0,0,7,24,false,true,false,0.077,0.923
175,138,37,17.5,13.8,37,872,818,54,0,1,0,0.1,42,10,10,0.97619,0,0,9,8,false,true,true,0.99,0.01
309,267,42,20.6,19.071429,42,1270,1348,-78,0,0,0,0,6,15,14,6.333333,0,0,9,7,false,true,true,0.715,0.285
152,110,42,25.333333,22,42,1659,1782,-123,1,0,0.166667,0,56,6,5,0.517857,1,0,11,8,false,true,true,0.927,0.073
213,199,14,26.625,24.875,14,1670,1770,-100,1,1,0.125,0.125,44,8,8,0.727273,0,0,12,8,false,true,true,0.823,0.177
243,118,125,24.3,11.8,125,925,801,124,1,0,0.1,0,39,10,10,1.025641,1,0,6,28,false,true,true,0.996,0.004
279,266,13,23.25,24.181818,13,1344,1325,19,1,0,0.083333,0,12,12,11,2.583333,0,1,18,13,false,true,false,0.316,0.684
88,48,40,22,16,40,739,480,259,1,0,0.25,0,71,4,3,0.507042,0,0,10,9,false,true,true,0.845,0.155
39,86,-47,19.5,43,-47,1076,1176,-100,0,1,0,0.5,80,2,2,0.4,0,0,13,17,false,true,false,0.271,0.729
409,280,129,15.730769,10.769231,129,1413,1422,-9,0,0,0,0,-30,26,26,-1.9,0,0,3,1,false,true,true,1,0
300,258,42,25,23.454545,42,1305,1242,63,2,1,0.166667,0.090909,18,12,11,1.888889,0,0,17,10,false,true,true,0.984,0.016
211,205,6,21.1,22.777778,6,771,754,17,0,0,0,0,32,10,9,1,0,0,11,19,false,true,false,0.463,0.537
313,281,32,19.5625,17.5625,32,1572,1550,22,1,0,0.0625,0,-5,16,16,-7.8,0,0,16,5,false,true,true,0.946,0.054
151,71,80,21.571429,11.833333,80,1482,1554,-72,0,0,0,0,58,7,6,0.62069,0,0,13,19,false,true,true,0.957,0.043
85,79,6,21.25,19.75,6,784,758,26,0,0,0,0,69,4,4,0.507246,0,0,11,19,false,true,true,0.711,0.289
119,69,50,23.8,13.8,50,859,811,48,0,0,0,0,64,5,5,0.5625,0,0,12,17,false,true,true,0.939,0.061
362,261,101,32.909091,26.1,101,1684,1320,364,1,0,0.090909,0,9,11,10,3.333333,0,0,8,14,false,true,true,1,0
304,304,0,20.266667,20.266667,0,869,820,49,0,1,0,0.066667,-8,15,15,-4.625,0,0,13,6,false,true,true,0.79,0.21
320,161,159,16.842105,8.473684,159,993,897,96,1,0,0.052632,0,-14,19,19,-3.357143,0,1,23,25,false,true,true,1,0
299,264,35,19.933333,17.6,35,1210,1253,-43,0,1,0,0.066667,-6,15,15,-5.833333,1,0,8,11,false,true,true,0.987,0.013
157,116,41,39.25,29,41,1197,1127,70,0,0,0,0,63,4,4,0.47619,0,0,24,11,false,true,true,0.902,0.098
254,207,47,23.090909,18.818182,47,825,907,-82,1,0,0.090909,0,23,11,11,1.73913,0,0,23,14,false,true,true,0.74,0.26
40,24,16,20,24,16,864,808,56,0,0,0,0,87,2,1,0.390805,0,0,9,20,false,true,true,0.515,0.485
232,163,69,33.142857,23.285714,69,1148,1164,-16,1,1,0.142857,0.142857,37,7,7,0.675676,0,0,16,13,false,true,true,0.982,0.018
156,198,-42,17.333333,24.75,-42,947,810,137,0,1,0,0.125,43,9,8,0.976744,0,0,31,13,false,true,false,0.334,0.666
76,0,76,76,0,76,1762,1616,146,1,0,1,0,93,1,0,0.322581,0,0,17,0,false,true,true,0.591,0.409
195,165,30,11.470588,10.3125,30,416,222,194,0,0,0,0,4,17,16,13.75,0,0,15,25,false,true,true,0.981,0.019
44,0,44,44,0,44,991,996,-5,0,0,0,0,95,1,0,0.315789,0,0,12,0,false,true,true,0.707,0.293
32,20,12,32,20,12,576,532,44,0,0,0,0,90,1,1,0.511111,1,0,8,13,false,true,true,0.882,0.118
322,176,146,26.833333,16,146,1482,1394,88,2,0,0.166667,0,20,12,11,1.8,0,0,12,11,false,true,true,1,0
55,47,8,18.333333,23.5,8,907,752,155,0,0,0,0,85,3,2,0.388235,0,0,17,13,false,true,true,0.525,0.475
197,169,28,19.7,16.9,28,505,95,410,0,1,0,0.1,44,10,10,1,0,1,18,10,false,true,true,0.853,0.147
299,255,44,27.181818,23.181818,44,791,885,-94,1,1,0.090909,0.090909,23,11,11,1.652174,0,0,12,10,false,true,true,0.907,0.093
389,330,59,24.3125,22,59,1093,1090,3,1,2,0.0625,0.133333,-3,16,15,-11.333333,0,0,3,8,false,true,true,0.988,0.012
292,272,20,19.466667,19.428571,20,1181,1149,32,0,1,0,0.071429,13,15,14,3.461538,1,0,9,14,false,true,true,0.885,0.115
272,129,143,22.666667,11.727273,143,942,1003,-61,0,0,0,0,22,12,11,2.045455,1,1,22,15,false,true,true,1,0
345,236,109,28.75,21.454545,109,1245,1232,13,1,0,0.083333,0,0,12,11,0,0,1,5,9,false,true,true,1,0
242,92,150,30.25,13.142857,150,1295,1477,-182,2,0,0.25,0,48,8,7,0.958333,0,0,25,8,false,true,true,0.947,0.053
83,84,-1,13.833333,16.8,-1,892,768,124,0,0,0,0,64,6,5,0.671875,0,0,11,16,false,true,true,0.512,0.488
262,92,170,43.666667,15.333333,170,1513,1482,31,1,0,0.166667,0,48,6,6,0.6875,0,0,14,16,false,true,true,1,0
0,0,0,0,0,0,421,306,115,0,0,0,0,100,1,0,0.44,0,0,15,0,false,true,true,0.78,0.22
186,150,36,23.25,21.428571,36,902,866,36,0,0,0,0,38,8,7,0.842105,0,0,9,9,false,true,true,0.745,0.255
0,10,-10,0,10,-10,1270,1348,-78,0,0,0,0,97,1,1,0.391753,0,0,13,12,false,true,false,0.338,0.662
262,251,11,21.833333,20.916667,11,290,416,-126,0,0,0,0,14,12,12,2.428571,0,0,8,11,false,true,true,0.771,0.229
116,99,17,19.333333,19.8,17,901,889,12,0,1,0,0.2,67,6,5,0.641791,1,0,21,13,false,true,true,0.737,0.263
263,177,86,16.4375,11.0625,86,1128,889,239,0,1,0,0.0625,6,16,16,7.833333,0,0,19,18,false,true,true,0.988,0.012
68,0,68,68,0,68,371,336,35,1,0,1,0,93,1,0,0.408602,0,0,14,0,false,true,true,0.58,0.42
20,17,3,20,17,3,691,675,16,0,0,0,0,94,1,1,0.393617,0,1,19,6,false,true,true,0.565,0.435
440,313,127,29.333333,22.357143,127,1216,1230,-14,1,0,0.066667,0,-2,15,14,-16,0,0,3,15,false,true,true,1,0
193,221,-28,14.846154,17,-28,699,448,251,0,0,0,0,18,13,13,2.222222,0,0,13,11,false,true,false,0.161,0.839
222,199,23,22.2,19.9,23,1210,1253,-43,0,1,0,0.1,26,10,10,1.346154,0,0,7,13,false,true,true,0.875,0.125
36,40,-4,18,20,-4,1583,1422,161,0,0,0,0,87,2,2,0.586207,0,0,20,9,false,true,false,0.395,0.605
26,9,17,26,9,17,1170,1156,14,0,0,0,0,95,1,1,0.4,1,0,13,22,false,true,true,0.813,0.187
234,182,52,19.5,16.545455,52,1227,1060,167,0,1,0,0.090909,24,12,11,1.666667,0,0,10,16,false,true,true,0.973,0.027
56,26,30,28,13,30,262,306,-44,0,0,0,0,89,2,2,0.516854,0,0,23,14,false,true,true,0.82,0.18
225,211,14,17.307692,16.230769,14,801,807,-6,0,0,0,0,10,13,13,3.5,1,0,6,18,false,true,true,0.915,0.085
345,290,55,26.538462,24.166667,55,1075,1009,66,2,0,0.153846,0,7,13,12,4.571429,0,0,9,11,false,true,true,1,0
281,162,119,25.545455,16.2,119,1651,1691,-40,1,0,0.090909,0,32,11,10,1.0625,0,0,16,11,false,true,true,0.989,0.011
89,53,36,22.25,13.25,36,1305,1390,-85,0,0,0,0,75,4,4,0.48,0,0,23,16,false,true,true,0.796,0.204
67,43,24,16.75,10.75,24,1651,1691,-40,0,0,0,0,80,4,4,0.425,0,0,17,22,false,true,false,0.363,0.637
284,204,80,28.4,22.666667,80,1355,1210,145,1,0,0.1,0,30,10,9,1,1,0,6,13,false,true,true,1,0
29,24,5,9.666667,12,5,904,857,47,0,0,0,0,83,3,2,0.493976,0,0,27,8,false,true,false,0.491,0.509
301,171,130,17.705882,10.058824,130,1176,1076,100,0,0,0,0,26,17,17,2.269231,0,0,12,14,false,true,true,1,0
214,189,25,23.777778,21,25,1156,1184,-28,1,0,0.111111,0,30,9,9,0.933333,0,0,14,8,false,true,true,0.771,0.229
95,89,6,15.833333,17.8,6,921,1072,-151,0,0,0,0,64,6,5,0.59375,1,0,6,7,false,true,false,0.227,0.773
283,214,69,20.214286,15.285714,69,1606,1544,62,0,0,0,0,22,14,14,2.045455,0,1,16,8,false,true,true,0.994,0.006
357,262,95,23.8,18.714286,95,1510,1583,-73,1,0,0.066667,0,-5,15,14,-6.4,0,0,7,7,false,true,true,1,0
90,64,26,18,16,26,1089,1063,26,0,0,0,0,74,5,4,0.513514,1,0,9,19,false,true,true,0.732,0.268
140,110,30,17.5,13.75,30,913,871,42,0,0,0,0,47,8,8,0.914894,0,1,9,16,false,true,true,0.87,0.13
371,310,61,26.5,23.846154,61,1875,1793,82,2,1,0.142857,0.076923,-1,14,13,-30,0,0,5,11,false,true,true,1,0
141,87,54,23.5,17.4,54,1051,1030,21,0,0,0,0,57,6,5,0.526316,0,0,15,10,false,true,true,0.766,0.234
324,328,-4,20.25,20.5,-4,1277,1166,111,0,1,0,0.0625,-10,16,16,-3.6,0,0,5,4,false,true,false,0.172,0.828
108,92,16,18,18.4,16,786,976,-190,0,0,0,0,69,6,5,0.463768,1,0,17,7,false,true,false,0.319,0.681
165,75,90,23.571429,12.5,90,1159,1031,128,1,0,0.142857,0,47,7,6,0.829787,0,0,28,14,false,true,true,0.98,0.02
394,287,107,30.307692,22.076923,107,1507,1554,-47,1,2,0.076923,0.153846,-5,13,13,-5.8,0,0,6,4,false,true,true,0.999,0.001
55,12,43,18.333333,4,43,896,818,78,0,0,0,0,86,3,3,0.511628,0,0,14,10,false,true,true,0.841,0.159
256,139,117,19.692308,10.692308,117,1176,1076,100,0,0,0,0,44,13,13,1.340909,0,0,8,11,false,true,true,0.997,0.003
204,155,49,18.545455,15.5,49,904,783,121,0,0,0,0,35,11,10,1.2,0,0,16,21,false,true,true,0.857,0.143
12,9,3,12,9,3,1069,1040,29,0,0,0,0,91,1,1,0.483516,0,1,14,6,false,true,true,0.561,0.439
323,300,23,29.363636,27.272727,23,1826,1656,170,2,0,0.181818,0,9,11,11,3,1,0,13,11,false,true,true,1,0
218,178,40,24.222222,19.777778,40,986,856,130,1,0,0.111111,0,30,9,9,1.033333,1,0,6,10,false,true,true,0.953,0.047
176,162,14,22,20.25,14,1556,1591,-35,0,0,0,0,45,8,8,0.8,1,0,6,11,false,true,true,0.58,0.42
338,370,-32,24.142857,28.461538,-32,834,844,-10,1,2,0.071429,0.153846,-8,14,13,-4.5,0,0,6,14,false,true,false,0.094,0.906
284,206,78,20.285714,15.846154,78,830,907,-77,1,0,0.071429,0,12,14,13,3.25,0,0,18,13,false,true,true,0.947,0.053
129,64,65,21.5,10.666667,65,415,518,-103,0,0,0,0,63,6,6,0.603175,1,0,7,26,false,true,true,0.978,0.022
378,246,132,18,11.714286,132,620,513,107,0,0,0,0,-20,21,21,-2.25,0,0,1,3,false,true,true,1,0
40,45,-5,20,22.5,-5,1189,1266,-77,0,0,0,0,85,2,2,0.4,1,0,10,12,false,true,true,0.709,0.291
416,318,98,37.818182,31.8,98,1983,2020,-37,2,1,0.181818,0.1,12,11,10,2.166667,0,0,8,13,false,true,true,1,0
307,181,126,19.1875,12.066667,126,872,818,54,0,1,0,0.066667,12,16,15,3.416667,0,0,20,16,false,true,true,1,0
300,213,87,21.428571,15.214286,87,939,913,26,0,1,0,0.071429,8,14,14,5,0,0,10,15,false,true,true,0.996,0.004
158,126,32,22.571429,18,32,691,473,218,0,0,0,0,48,7,7,0.75,0,0,17,7,false,true,true,0.866,0.134
110,100,10,22,25,10,902,866,36,0,0,0,0,62,5,4,0.516129,0,0,13,10,false,true,false,0.429,0.571
276,253,23,25.090909,23,23,1142,1095,47,1,0,0.090909,0,15,11,11,2.333333,0,0,14,14,false,true,true,0.785,0.215
208,143,65,23.111111,17.875,65,1270,1315,-45,0,0,0,0,40,9,8,0.9,0,0,10,25,false,true,true,0.881,0.119
403,284,119,23.705882,16.705882,119,1069,917,152,1,1,0.058824,0.058824,-16,17,17,-2.125,0,0,2,1,true,true,true,1,0
40,73,-33,13.333333,24.333333,-33,1211,1173,38,0,0,0,0,81,3,3,0.432099,0,0,20,7,false,true,false,0.274,0.726
167,180,-13,16.7,18,-13,334,446,-112,0,0,0,0,26,10,10,1.538462,0,1,11,6,false,true,false,0.253,0.747
281,249,32,17.5625,15.5625,32,609,620,-11,0,0,0,0,-8,16,16,-4.625,0,1,7,6,false,true,true,0.999,0.001
248,173,75,19.076923,13.307692,75,1281,1339,-58,0,0,0,0,27,13,13,1.518519,0,0,16,10,false,true,true,0.992,0.008
6,13,-7,6,13,-7,1034,1040,-6,0,0,0,0,93,1,1,0.376344,0,0,25,9,false,true,true,0.529,0.471
413,335,78,25.8125,22.333333,78,1394,1424,-30,1,1,0.0625,0.066667,-8,16,15,-4,0,0,1,6,false,true,true,1,0
85,40,45,21.25,13.333333,45,1439,1397,42,0,0,0,0,75,4,3,0.453333,0,0,8,9,false,true,true,0.56,0.44
269,202,67,20.692308,15.538462,67,1055,1050,5,0,0,0,0,13,13,13,2.615385,1,0,16,9,false,true,true,0.997,0.003
185,146,39,18.5,16.222222,39,527,581,-54,0,0,0,0,34,10,9,1.235294,1,0,19,16,false,true,true,0.782,0.218
97,47,50,24.25,15.666667,50,1216,1228,-12,0,0,0,0,73,4,3,0.452055,0,0,7,17,false,true,true,0.579,0.421
277,153,124,18.466667,10.928571,124,595,543,52,0,0,0,0,13,15,14,3.615385,0,0,14,12,false,true,true,1,0
160,241,-81,17.777778,26.777778,-81,1265,1045,220,0,1,0,0.111111,28,9,9,1.5,0,0,16,17,false,true,false,0.036,0.964
184,157,27,16.727273,14.272727,27,691,675,16,0,0,0,0,25,11,11,1.52,0,0,13,21,false,true,true,0.906,0.094
75,81,-6,25,27,-6,594,605,-11,0,0,0,0,80,3,3,0.4625,0,0,7,11,false,true,true,0.55,0.45
157,111,46,17.444444,13.875,46,363,668,-305,0,0,0,0,54,9,8,0.796296,0,0,8,21,false,true,true,0.807,0.193
285,258,27,16.764706,15.176471,27,613,461,152,0,1,0,0.058824,-21,17,17,-1.761905,0,0,9,1,false,true,true,0.986,0.014
387,235,152,32.25,19.583333,152,1501,1622,-121,2,0,0.166667,0,10,12,12,3.1,0,0,16,8,false,true,true,1,0
24,0,24,24,0,24,1302,1234,68,0,0,0,0,95,1,0,0.326316,0,0,8,0,false,true,true,0.563,0.437
176,191,-15,25.142857,27.285714,-15,1659,1782,-123,1,0,0.142857,0,40,7,7,0.725,1,0,7,11,false,true,true,0.566,0.434
161,189,-28,20.125,23.625,-28,1554,1573,-19,0,0,0,0,48,8,8,0.708333,0,0,8,14,false,true,false,0.254,0.746
333,291,42,22.2,19.4,42,1075,1152,-77,0,1,0,0.066667,0,15,15,0,0,0,14,11,false,true,true,0.96,0.04
396,308,88,23.294118,19.25,88,1220,1261,-41,2,0,0.117647,0,-5,17,16,-9,0,0,15,12,false,true,true,1,0
134,68,66,22.333333,13.6,66,1394,1118,276,0,0,0,0,60,6,5,0.616667,1,0,19,9,false,true,true,0.902,0.098
89,159,-70,14.833333,26.5,-70,1154,1062,92,0,0,0,0,61,6,6,0.57377,0,0,11,16,false,true,false,0.039,0.961
306,200,106,30.6,22.222222,106,1167,1216,-49,1,0,0.1,0,27,10,9,1.518519,0,0,9,11,false,true,true,1,0
310,289,21,23.846154,22.230769,21,791,885,-94,1,1,0.076923,0.076923,9,13,13,4.222222,0,0,9,8,false,true,true,0.894,0.106
338,301,37,14.695652,13.086957,37,480,518,-38,0,0,0,0,-36,23,23,-1.277778,0,0,1,2,true,true,true,1,0
192,107,85,27.428571,17.833333,85,778,758,20,0,0,0,0,51,7,6,0.764706,0,0,19,7,false,true,true,0.952,0.048
171,108,63,28.5,18,63,1270,1315,-45,0,0,0,0,55,6,6,0.654545,0,0,7,11,false,true,true,0.866,0.134
321,257,64,20.0625,16.0625,64,505,95,410,0,1,0,0.0625,6,16,16,7.333333,0,0,9,13,false,true,true,0.983,0.017
438,288,150,15.642857,10.285714,150,1176,1076,100,0,0,0,0,-32,28,28,-1.84375,0,0,1,3,false,true,true,1,0
36,22,14,18,22,14,942,976,-34,0,0,0,0,88,2,1,0.454545,0,0,12,15,false,true,false,0.482,0.518
233,205,28,17.923077,17.083333,28,859,786,73,0,0,0,0,15,13,12,2.533333,0,0,18,10,false,true,true,0.793,0.207
224,150,74,22.4,16.666667,74,1055,1050,5,0,0,0,0,37,10,9,0.918919,0,0,19,9,false,true,true,0.955,0.045
183,123,60,20.333333,13.666667,60,1033,1037,-4,0,1,0,0.111111,40,9,9,1.125,0,0,26,10,false,true,true,0.965,0.035
252,182,70,21,16.545455,70,1516,1397,119,0,1,0,0.090909,13,12,11,2.538462,0,0,30,13,false,true,true,0.957,0.043
96,157,-61,16,26.166667,-61,613,611,2,0,0,0,0,54,6,6,0.703704,0,0,7,17,false,true,false,0.036,0.964
247,182,65,24.7,20.222222,65,596,595,1,1,0,0.1,0,33,10,9,1.212121,0,0,10,12,false,true,true,0.938,0.062
12,0,12,12,0,12,363,668,-305,0,0,0,0,97,1,0,0.443299,0,0,15,0,false,true,false,0.212,0.788
16,0,16,16,0,16,1023,1110,-87,0,0,0,0,95,1,0,0.315789,0,0,10,0,false,true,true,0.523,0.477
30,36,-6,15,36,-6,1023,1110,-87,0,0,0,0,86,2,1,0.348837,0,1,10,15,false,true,false,0.141,0.859
352,194,158,16,9.238095,158,993,897,96,1,0,0.045455,0,-25,22,21,-1.88,0,0,3,25,false,true,true,1,0
176,171,5,19.555556,21.375,5,518,448,70,0,0,0,0,42,9,8,0.809524,0,0,12,9,false,true,true,0.54,0.46
182,114,68,30.333333,22.8,68,1093,1197,-104,1,0,0.166667,0,58,6,5,0.534483,0,0,11,11,false,true,true,0.778,0.222
365,209,156,21.470588,13.0625,156,1033,1037,-4,0,1,0,0.0625,-5,17,16,-9,1,1,17,14,false,true,true,1,0
158,105,53,22.571429,15,53,960,1070,-110,1,0,0.142857,0,51,7,7,0.686275,0,0,20,23,false,true,true,0.904,0.096
239,160,79,29.875,22.857143,79,1550,1466,84,1,0,0.125,0,45,8,7,0.822222,0,0,9,14,false,true,true,0.941,0.059
434,260,174,31,20,174,1439,1353,86,1,0,0.071429,0,-1,14,13,-30,0,0,4,15,false,true,true,1,0
30,0,30,30,0,30,921,1072,-151,0,0,0,0,95,1,0,0.4,0,0,10,0,false,true,false,0.213,0.787
18,11,7,18,11,7,1030,1045,-15,0,0,0,0,95,1,1,0.484211,0,0,16,10,false,true,true,0.562,0.438
344,254,90,21.5,15.875,90,1394,1230,164,0,1,0,0.0625,-9,16,16,-4.222222,0,1,21,17,false,true,true,1,0
283,318,-35,21.769231,24.461538,-35,1539,1537,2,0,1,0,0.076923,8,13,13,4,0,0,18,12,false,true,false,0.065,0.935
98,30,68,24.5,10,68,1055,1050,5,0,0,0,0,77,4,3,0.441558,0,0,12,7,false,true,true,0.798,0.202
307,269,38,23.615385,22.416667,38,976,965,11,1,0,0.076923,0,2,13,12,16,1,0,9,12,false,true,true,0.997,0.003
222,163,59,17.076923,13.583333,59,913,871,42,0,0,0,0,23,13,12,1.869565,0,0,11,25,false,true,true,0.98,0.02
0,22,-22,0,22,-22,1547,1439,108,0,0,0,0,94,1,1,0.393617,1,0,15,7,false,true,false,0.357,0.643
76,142,-66,9.5,17.75,-66,1221,1258,-37,0,0,0,0,52,8,8,0.75,1,0,9,8,false,true,false,0.25,0.75
85,78,7,21.25,19.5,7,1069,917,152,0,0,0,0,71,4,4,0.478873,0,1,16,7,false,true,true,0.542,0.458
10,7,3,10,7,3,468,542,-74,0,0,0,0,93,1,1,0.419355,0,0,21,10,false,true,false,0.223,0.777
212,141,71,19.272727,14.1,71,1037,950,87,1,0,0.090909,0,32,11,10,0.96875,0,0,8,10,false,true,true,0.989,0.011
365,320,45,22.8125,21.333333,45,965,1013,-48,1,0,0.0625,0,-14,16,15,-2.357143,0,1,3,3,false,true,true,1,0
58,47,11,14.5,15.666667,11,1043,1055,-12,0,0,0,0,73,4,3,0.506849,0,0,16,12,false,true,false,0.426,0.574
115,64,51,23,12.8,51,1439,1413,26,0,0,0,0,67,5,5,0.537313,0,0,18,7,false,true,true,0.73,0.27
463,438,25,35.615385,33.692308,25,1885,1793,92,0,0,0,0,-9,13,13,-3,0,0,3,2,false,true,true,0.998,0.002
383,243,140,18.238095,12.15,140,872,818,54,0,1,0,0.05,-21,21,20,-1.952381,0,0,3,1,true,true,true,1,0
52,34,18,13,8.5,18,1016,1037,-21,0,0,0,0,78,4,4,0.615385,0,1,11,13,false,true,true,0.532,0.468
375,287,88,28.846154,22.076923,88,1051,1030,21,0,0,0,0,0,13,13,0,0,0,11,6,false,true,true,1,0
238,147,91,29.75,18.375,91,820,783,37,0,0,0,0,43,8,8,0.767442,2,0,11,9,false,true,true,0.997,0.003
176,123,53,25.142857,17.571429,53,691,675,16,0,0,0,0,52,7,7,0.711538,0,1,13,15,false,true,true,0.945,0.055
313,297,16,18.411765,18.5625,16,527,514,13,0,0,0,0,-13,17,16,-3,0,0,4,3,false,true,true,0.771,0.229
203,174,29,25.375,21.75,29,1093,1090,3,1,1,0.125,0.125,48,8,8,0.708333,0,1,9,7,false,true,true,0.872,0.128
100,51,49,25,17,49,1029,1227,-198,0,0,0,0,71,4,3,0.450704,0,0,9,17,false,true,false,0.336,0.664
114,68,46,22.8,17,46,609,620,-11,0,0,0,0,69,5,4,0.536232,0,0,11,10,false,true,true,0.895,0.105
281,230,51,23.416667,20.909091,51,1089,1063,26,1,0,0.083333,0,19,12,11,2,1,0,16,11,false,true,true,0.959,0.041
161,174,-13,12.384615,14.5,-13,480,518,-38,0,0,0,0,30,13,12,1.533333,0,1,22,13,false,true,false,0.443,0.557
267,147,120,24.272727,14.7,120,303,342,-39,0,0,0,0,32,11,10,1.1875,0,0,18,10,false,true,true,0.986,0.014
309,228,81,17.166667,12.666667,81,913,871,42,0,0,0,0,-11,18,18,-3.909091,0,0,4,7,false,true,true,1,0
210,236,-26,19.090909,21.454545,-26,1304,1040,264,1,0,0.090909,0,28,11,11,1.178571,0,0,18,9,false,true,false,0.167,0.833
319,259,60,24.538462,19.923077,60,1050,1144,-94,0,1,0,0.076923,8,13,13,4.75,0,1,15,14,false,true,true,0.941,0.059
331,245,86,30.090909,22.272727,86,1803,1552,251,1,2,0.090909,0.181818,12,11,11,2.333333,0,0,9,26,false,true,true,0.998,0.002
248,206,42,20.666667,17.166667,42,808,639,169,0,0,0,0,20,12,12,2.05,0,1,16,9,false,true,true,0.903,0.097
47,12,35,23.5,12,35,1216,1228,-12,0,0,0,0,89,2,1,0.370787,0,0,12,18,false,true,true,0.561,0.439
216,143,73,24,17.875,73,977,976,1,0,0,0,0,45,9,8,0.755556,1,0,8,10,false,true,true,0.981,0.019
15,48,-33,7.5,24,-33,941,926,15,0,0,0,0,84,2,2,0.452381,1,0,7,8,false,true,false,0.321,0.679
12,0,12,12,0,12,1148,1164,-16,0,0,0,0,97,1,0,0.257732,0,0,17,0,false,true,true,0.562,0.438
22,9,13,22,9,13,1826,1803,23,0,0,0,0,93,1,1,0.322581,0,0,21,10,false,true,true,0.728,0.272
157,204,-47,19.625,25.5,-47,1554,1622,-68,1,0,0.125,0,40,8,8,0.775,0,0,14,9,false,true,false,0.226,0.774
209,172,37,26.125,24.571429,37,1344,1325,19,1,0,0.125,0,41,8,7,0.756098,0,0,10,14,false,true,true,0.595,0.405
352,291,61,16,13.857143,61,1253,1166,87,1,0,0.045455,0,-27,22,21,-1.592593,0,0,1,2,true,true,true,1,0
160,213,-53,26.666667,35.5,-53,1554,1716,-162,1,1,0.166667,0.166667,47,6,6,0.744681,0,0,18,7,false,true,true,0.502,0.498
206,204,2,12.875,13.6,2,1030,1045,-15,0,0,0,0,12,16,15,3.833333,1,0,6,8,false,true,true,0.903,0.097
43,42,1,14.333333,14,1,825,907,-82,0,0,0,0,81,3,3,0.493827,2,0,12,10,false,true,true,0.713,0.287
99,81,18,19.8,16.2,18,1489,1445,44,0,0,0,0,62,5,5,0.516129,0,0,23,9,false,true,true,0.604,0.396
322,253,69,11.925926,9.730769,69,416,222,194,0,0,0,0,-40,27,26,-1.375,0,0,7,2,false,true,true,1,0
265,255,10,18.928571,18.214286,10,1159,1051,108,0,0,0,0,9,14,14,4.444444,0,0,9,7,false,true,true,0.589,0.411
24,0,24,24,0,24,916,876,40,0,0,0,0,94,1,0,0.361702,0,0,11,0,false,true,true,0.577,0.423
208,160,48,20.8,17.777778,48,916,837,79,0,0,0,0,41,10,9,0.97561,0,0,14,10,false,true,true,0.888,0.112
283,270,13,20.214286,20.769231,13,869,820,49,0,1,0,0.076923,3,14,13,12.333333,0,0,12,18,false,true,true,0.828,0.172
142,191,-49,15.777778,21.222222,-49,95,360,-265,0,1,0,0.111111,31,9,9,1.290323,0,0,13,10,false,true,false,0.369,0.631
322,238,84,13.416667,10.347826,84,416,222,194,0,0,0,0,-33,24,23,-1.666667,0,0,7,10,false,true,true,1,0
191,127,64,27.285714,18.142857,64,986,856,130,1,0,0.142857,0,43,7,7,0.72093,1,0,6,16,false,true,true,0.975,0.025
63,93,-30,12.6,18.6,-30,825,907,-82,0,0,0,0,68,5,5,0.588235,2,0,12,11,false,true,false,0.476,0.524
273,270,3,21,20.769231,3,315,294,21,0,1,0,0.076923,0,13,13,0,0,0,21,10,false,true,true,0.94,0.06
101,116,-15,20.2,23.2,-15,613,549,64,0,0,0,0,58,5,5,0.758621,0,0,11,13,false,true,true,0.596,0.404
236,172,64,15.733333,11.466667,64,947,909,38,0,0,0,0,0,15,15,0,0,0,10,32,false,true,true,0.987,0.013
76,127,-51,9.5,18.142857,-51,1221,1258,-37,0,0,0,0,55,8,7,0.709091,1,0,9,10,false,true,false,0.253,0.747
159,112,47,17.666667,12.444444,47,1128,889,239,0,1,0,0.111111,43,9,9,1.093023,0,0,32,7,false,true,true,0.947,0.053
331,307,24,19.470588,18.058824,24,758,796,-38,0,0,0,0,-15,17,17,-2.533333,0,0,2,5,false,true,true,0.989,0.011
100,70,30,25,17.5,30,1029,1227,-198,0,0,0,0,69,4,4,0.463768,0,0,9,19,false,true,false,0.348,0.652
357,255,102,19.833333,15,102,746,796,-50,0,1,0,0.058824,-7,18,17,-6.857143,0,0,5,8,false,true,true,1,0
139,76,63,23.166667,15.2,63,576,532,44,0,0,0,0,61,6,5,0.754098,1,0,16,7,false,true,true,0.922,0.078
330,225,105,23.571429,17.307692,105,1397,1422,-25,3,0,0.214286,0,23,14,13,1.565217,0,2,13,10,false,true,true,0.945,0.055
448,333,115,32,23.785714,115,1489,1405,84,3,0,0.214286,0,-8,14,14,-3.5,0,0,5,2,true,true,true,1,0
180,155,25,22.5,22.142857,25,926,854,72,0,0,0,0,50,8,7,0.68,0,0,16,9,false,true,true,0.611,0.389
171,140,31,15.545455,14,31,758,750,8,0,0,0,0,26,11,10,1.423077,0,1,7,11,false,true,true,0.764,0.236
370,346,24,23.125,21.625,24,1305,1242,63,2,1,0.125,0.0625,-14,16,16,-2.428571,0,0,2,2,false,true,true,0.987,0.013
46,127,-81,15.333333,42.333333,-81,1554,1716,-162,0,1,0,0.333333,75,3,3,0.466667,1,1,8,9,false,true,false,0.258,0.742
6,6,0,6,6,0,904,783,121,0,0,0,0,92,1,1,0.456522,0,0,19,12,false,true,true,0.75,0.25
173,219,-46,15.727273,21.9,-46,316,306,10,0,2,0,0.2,26,11,10,1.461538,0,0,20,18,false,true,true,0.639,0.361
160,123,37,22.857143,20.5,37,1334,1270,64,1,0,0.142857,0,56,7,6,0.660714,0,0,20,10,false,true,true,0.587,0.413
277,272,5,16.294118,16,5,613,549,64,0,0,0,0,-12,17,17,-3.666667,0,0,5,5,false,true,true,0.868,0.132
103,104,-1,25.75,26,-1,1394,1424,-30,0,1,0,0.25,70,4,4,0.457143,0,0,20,14,false,true,false,0.432,0.568
103,57,46,25.75,14.25,46,1075,1027,48,1,0,0.25,0,68,4,4,0.544118,0,0,17,14,false,true,true,0.774,0.226
258,157,101,36.857143,26.166667,101,1203,1221,-18,2,0,0.285714,0,50,7,6,0.7,0,0,9,9,false,true,true,0.993,0.007
68,53,15,17,13.25,15,303,342,-39,0,0,0,0,76,4,4,0.5,0,0,18,17,false,true,true,0.717,0.283
56,72,-16,14,18,-16,1027,856,171,1,0,0.25,0,62,4,4,0.532258,0,1,20,7,false,true,true,0.561,0.439
385,330,55,21.388889,18.333333,55,834,758,76,0,1,0,0.055556,-26,18,18,-1.384615,0,0,2,3,true,true,true,1,0
30,9,21,15,9,21,1069,1040,29,0,0,0,0,88,2,1,0.5,0,1,12,6,false,true,true,0.56,0.44
332,203,129,27.666667,18.454545,129,1030,998,32,1,0,0.083333,0,13,12,11,2.923077,0,0,10,11,false,true,true,1,0
32,18,14,32,18,14,974,995,-21,0,0,0,0,88,1,1,0.375,0,0,21,10,false,true,true,0.733,0.267
39,14,25,19.5,14,25,725,771,-46,0,0,0,0,87,2,1,0.528736,0,1,11,16,false,true,false,0.233,0.767
322,250,72,12.384615,10,72,416,222,194,0,0,0,0,-38,26,25,-1.447368,0,0,7,4,false,true,true,1,0
205,181,24,22.777778,20.111111,24,1210,1253,-43,0,1,0,0.111111,33,9,9,1.060606,0,0,9,11,false,true,true,0.874,0.126
78,95,-17,19.5,23.75,-17,1244,1361,-117,0,0,0,0,75,4,4,0.506667,0,0,11,10,false,true,false,0.13,0.87
8,15,-7,8,15,-7,613,461,152,0,0,0,0,92,1,1,0.402174,1,0,6,20,false,true,true,0.74,0.26
273,223,50,24.818182,22.3,50,1153,1065,88,0,1,0,0.1,8,11,10,3.5,1,0,6,17,false,true,true,0.974,0.026
8,0,8,8,0,8,415,518,-103,0,0,0,0,97,1,0,0.391753,1,0,19,0,false,true,false,0.231,0.769
310,252,58,20.666667,16.8,58,971,658,313,0,0,0,0,-5,15,15,-7.2,1,0,8,6,false,true,true,1,0
174,122,52,24.857143,20.333333,52,971,906,65,0,0,0,0,49,7,6,0.653061,0,0,9,11,false,true,true,0.833,0.167
383,241,142,19.15,12.684211,142,872,818,54,0,1,0,0.052632,-19,20,19,-2.157895,0,0,3,1,false,true,true,1,0
74,43,31,18.5,14.333333,31,1489,1445,44,0,0,0,0,74,4,3,0.432432,0,0,19,9,false,true,true,0.518,0.482
341,250,91,15.5,11.904762,91,1128,889,239,0,1,0,0.047619,-26,22,21,-1.807692,0,0,3,2,false,true,true,1,0
310,187,123,28.181818,18.7,123,1408,1454,-46,1,0,0.090909,0,29,11,10,1.103448,0,0,13,16,false,true,true,0.998,0.002
124,115,9,31,38.333333,9,1782,1512,270,1,1,0.25,0.333333,71,4,3,0.591549,0,0,17,7,false,true,true,1,0
68,49,19,22.666667,16.333333,19,1014,948,66,0,0,0,0,77,3,3,0.428571,1,1,12,11,false,true,true,0.596,0.404
103,120,-17,20.6,30,-17,1530,1550,-20,0,1,0,0.25,62,5,4,0.548387,0,1,14,10,false,true,false,0.271,0.729
385,258,127,25.666667,17.2,127,1211,1173,38,0,0,0,0,0,15,15,0,0,0,7,8,false,true,true,1,0
282,256,26,14.842105,13.473684,26,871,999,-128,0,0,0,0,-14,19,19,-3.428571,0,0,8,17,false,true,true,1,0
322,218,104,21.466667,15.571429,104,580,620,-40,1,0,0.066667,0,7,15,14,6.142857,0,0,11,14,false,true,true,0.989,0.011
189,137,52,23.625,17.125,52,1388,1477,-89,1,0,0.125,0,42,8,8,1.142857,0,0,8,14,false,true,true,0.98,0.02
409,381,28,25.5625,23.8125,28,1030,1144,-114,0,2,0,0.125,-12,16,16,-2.916667,1,0,5,1,false,true,true,0.988,0.012
217,212,5,18.083333,17.666667,5,1090,1244,-154,0,0,0,0,19,12,12,1.947368,1,1,8,9,false,true,false,0.155,0.845
316,293,23,18.588235,18.3125,23,1078,1130,-52,0,1,0,0.0625,-11,17,16,-3.545455,0,0,5,11,false,true,true,0.941,0.059
260,106,154,37.142857,15.142857,154,918,619,299,2,0,0.285714,0,49,7,7,0.714286,1,0,12,14,false,true,true,1,0
239,246,-7,17.071429,17.571429,-7,95,360,-265,0,1,0,0.071429,1,14,14,40,1,0,6,9,false,true,true,0.934,0.066
49,32,17,12.25,10.666667,17,721,689,32,0,0,0,0,71,4,3,0.478873,0,0,15,14,false,true,true,0.734,0.266
113,156,-43,16.142857,22.285714,-43,1075,989,86,0,0,0,0,60,7,7,0.65,0,0,30,14,false,true,true,0.509,0.491
48,41,7,16,13.666667,7,1164,1201,-37,0,0,0,0,78,3,3,0.538462,0,1,15,13,false,true,true,0.538,0.462
58,29,29,19.333333,9.666667,29,346,231,115,0,0,0,0,77,3,3,0.532468,0,1,14,9,false,true,true,0.888,0.112
39,39,0,13,19.5,0,758,750,8,0,0,0,0,78,3,2,0.474359,1,0,6,9,false,true,true,0.577,0.423
204,154,50,17,14,50,859,822,37,0,0,0,0,20,12,11,1.9,0,0,12,21,false,true,true,0.965,0.035
342,318,24,20.117647,18.705882,24,1244,1361,-117,2,1,0.117647,0.058824,-1,17,17,-38,0,0,7,14,false,true,true,0.911,0.089
313,235,78,17.388889,13.055556,78,576,532,44,0,0,0,0,-13,18,18,-3.538462,0,0,11,20,false,true,true,1,0
241,191,50,24.1,21.222222,50,902,866,36,0,0,0,0,22,10,9,1.454545,0,0,21,8,false,true,true,0.927,0.073
121,139,-18,17.285714,19.857143,-18,613,549,64,0,0,0,0,47,7,7,0.93617,0,0,12,20,false,true,true,0.513,0.487
281,257,24,17.5625,16.0625,24,671,725,-54,0,0,0,0,-10,16,16,-3.7,0,0,13,3,false,true,true,0.962,0.038
64,53,11,21.333333,17.666667,11,1305,1390,-85,0,0,0,0,78,3,3,0.461538,0,0,26,16,false,true,true,0.705,0.295
170,73,97,42.5,24.333333,97,971,621,350,1,0,0.25,0,69,4,3,0.463768,0,0,9,10,false,true,true,0.868,0.132
137,148,-11,22.833333,24.666667,-11,1670,1770,-100,1,1,0.166667,0.166667,57,6,6,0.561404,0,0,19,9,false,true,true,0.573,0.427
211,201,10,23.444444,25.125,10,1142,1176,-34,1,0,0.111111,0,34,9,8,1.058824,1,0,20,10,false,true,true,0.718,0.282
163,154,9,23.285714,22,9,1302,1082,220,0,0,0,0,38,7,7,0.789474,0,0,17,7,false,true,true,0.572,0.428
348,237,111,21.75,14.8125,111,1011,921,90,1,0,0.0625,0,3,16,16,16.333333,0,0,12,16,false,true,true,1,0
40,37,3,13.333333,18.5,3,971,761,210,0,0,0,0,82,3,2,0.365854,0,1,10,7,false,true,false,0.45,0.55
93,111,-18,11.625,13.875,-18,539,632,-93,0,0,0,0,54,8,8,0.851852,0,1,18,13,false,true,false,0.137,0.863
328,281,47,27.333333,25.545455,47,1885,1846,39,1,1,0.083333,0.090909,7,12,11,4.142857,1,0,12,8,false,true,true,0.953,0.047
79,100,-21,19.75,25,-21,1355,1210,145,0,0,0,0,70,4,4,0.428571,1,0,11,20,false,true,true,0.643,0.357
113,89,24,12.555556,9.888889,24,892,768,124,0,0,0,0,54,9,9,0.796296,0,0,7,20,false,true,true,0.889,0.111
79,76,3,19.75,25.333333,3,262,306,-44,0,0,0,0,81,4,3,0.567901,0,0,23,8,false,true,false,0.352,0.648
341,329,12,28.416667,27.416667,12,1265,1237,28,1,0,0.083333,0,5,12,12,6,0,1,7,19,false,true,true,0.994,0.006
332,203,129,27.666667,16.916667,129,1550,1546,4,0,0,0,0,21,12,12,1.428571,1,1,13,8,false,true,true,1,0
83,59,24,20.75,19.666667,24,630,786,-156,0,0,0,0,73,4,3,0.479452,0,1,9,6,false,true,false,0.257,0.743
340,290,50,20,17.058824,50,719,785,-66,0,1,0,0.058824,-12,17,17,-3,0,0,4,2,false,true,true,0.999,0.001
269,200,69,17.933333,13.333333,69,1164,1201,-37,0,0,0,0,8,15,15,5.25,0,2,23,9,false,true,true,1,0
118,85,33,19.666667,17,33,1094,1030,64,0,0,0,0,63,6,5,0.571429,1,0,6,9,false,true,true,0.794,0.206
160,102,58,22.857143,17,58,885,719,166,0,0,0,0,59,7,6,0.644068,0,1,14,9,false,true,true,0.933,0.067
253,169,84,19.461538,14.083333,84,1181,1069,112,0,0,0,0,18,13,12,2.055556,1,0,9,11,false,true,true,0.994,0.006
212,115,97,30.285714,16.428571,97,1826,1803,23,1,0,0.142857,0,48,7,7,0.625,1,0,9,16,false,true,true,0.983,0.017
324,300,24,19.058824,18.75,24,1295,1281,14,0,0,0,0,3,17,16,12.666667,0,0,16,7,false,true,true,0.8,0.2
431,261,170,26.9375,17.4,170,971,621,350,2,0,0.125,0,-21,16,15,-1.52381,0,0,1,6,false,true,true,1,0
138,112,26,23,18.666667,26,1220,1261,-41,1,0,0.166667,0,61,6,6,0.737705,0,0,12,14,false,true,true,0.618,0.382
136,31,105,45.333333,15.5,105,1510,1583,-73,1,0,0.333333,0,75,3,2,0.426667,0,0,17,17,false,true,true,0.904,0.096
278,264,14,21.384615,20.307692,14,1115,1078,37,0,1,0,0.076923,11,13,13,3.090909,1,0,11,19,false,true,true,0.88,0.12
91,113,-22,22.75,28.25,-22,1554,1573,-19,0,0,0,0,71,4,4,0.478873,0,0,12,9,false,true,false,0.275,0.725
193,175,18,19.3,19.444444,18,349,315,34,0,0,0,0,21,10,9,1.619048,0,0,10,10,false,true,true,0.779,0.221
295,232,63,22.692308,17.846154,63,825,907,-82,1,0,0.076923,0,17,13,13,2.352941,0,0,16,15,false,true,true,0.938,0.062
212,179,33,21.2,17.9,33,804,988,-184,1,0,0.1,0,30,10,10,1.1,0,0,8,8,false,true,true,0.921,0.079
62,27,35,20.666667,9,35,1439,1294,145,0,0,0,0,80,3,3,0.45,0,1,14,7,false,true,true,0.569,0.431
165,143,22,18.333333,15.888889,22,371,435,-64,0,0,0,0,31,9,9,1.419355,0,0,9,11,false,true,true,0.857,0.143
42,35,7,14,17.5,7,1320,1339,-19,0,0,0,0,80,3,2,0.4875,1,0,7,12,false,true,true,0.52,0.48
152,192,-40,19,24,-40,869,820,49,0,1,0,0.125,50,8,8,0.74,0,1,10,8,false,true,false,0.222,0.778
370,284,86,23.125,18.933333,86,804,988,-184,2,0,0.125,0,-14,16,15,-2.357143,0,0,1,3,false,true,true,1,0
172,152,20,21.5,21.714286,20,948,933,15,1,0,0.125,0,52,8,7,0.730769,0,0,15,11,false,true,true,0.568,0.432
322,222,100,26.833333,18.5,100,769,527,242,1,0,0.083333,0,7,12,12,5.142857,0,0,10,8,false,true,true,1,0
97,120,-23,19.4,24,-23,869,820,49,0,1,0,0.2,67,5,5,0.552239,0,0,19,14,false,true,false,0.299,0.701
341,236,105,28.416667,21.454545,105,1156,1114,42,1,0,0.083333,0,8,12,11,4,0,0,10,16,false,true,true,1,0
341,291,50,22.733333,19.4,50,976,965,11,1,0,0.066667,0,-12,15,15,-2.666667,1,0,2,4,false,true,true,1,0
328,301,27,20.5,18.8125,27,758,796,-38,0,0,0,0,-10,16,16,-3.8,0,0,3,7,false,true,true,0.973,0.027
0,10,-10,0,10,-10,1220,1261,-41,0,0,0,0,96,1,1,0.46875,1,0,14,19,false,true,false,0.493,0.507
24,13,11,24,13,11,1633,1580,53,0,0,0,0,94,1,1,0.297872,1,0,13,19,false,true,true,0.732,0.268
408,342,66,29.142857,24.428571,66,1237,1277,-40,0,0,0,0,-15,14,14,-1.933333,0,0,6,1,false,true,true,1,0
314,297,17,17.444444,16.5,17,947,810,137,0,1,0,0.055556,-14,18,18,-3,0,0,10,10,false,true,true,0.962,0.038
28,34,-6,14,17,-6,613,502,111,0,0,0,0,82,2,2,0.597561,0,0,10,11,false,true,true,0.743,0.257
342,336,6,24.428571,24,6,908,1070,-162,2,0,0.142857,0,-8,14,14,-3.75,0,0,2,3,false,true,true,0.708,0.292
324,280,44,23.142857,21.538462,44,1406,1454,-48,0,2,0,0.153846,-3,14,13,-11.333333,0,0,8,11,false,true,true,0.982,0.018
142,21,121,23.666667,4.2,121,1033,1037,-4,0,0,0,0,66,6,5,0.681818,0,0,11,8,false,true,true,0.995,0.005
191,161,30,19.1,17.888889,30,1305,1390,-85,0,0,0,0,36,10,9,1,0,0,7,18,false,true,false,0.193,0.807
39,33,6,9.75,11,6,299,315,-16,0,0,0,0,79,4,3,0.531646,0,0,10,24,false,true,false,0.252,0.748
291,223,68,29.1,22.3,68,1793,1897,-104,2,0,0.2,0,24,10,10,1.25,0,1,10,6,false,true,true,0.871,0.129
313,226,87,20.866667,16.142857,87,719,651,68,0,1,0,0.071429,14,15,14,3.214286,0,0,7,10,false,true,true,0.995,0.005
273,234,39,18.2,16.714286,39,739,480,259,1,0,0.066667,0,7,15,14,5.142857,0,1,13,6,false,true,true,0.828,0.172
256,244,12,21.333333,20.333333,12,1027,856,171,1,1,0.083333,0.083333,4,12,12,8.25,0,0,27,10,false,true,true,0.851,0.149
96,122,-26,16,24.4,-26,1304,1040,264,0,0,0,0,64,6,5,0.515625,1,0,7,14,false,true,false,0.264,0.736
368,359,9,23,23.933333,9,1539,1537,2,0,1,0,0.066667,-11,16,15,-2.909091,0,0,6,2,false,true,false,0.173,0.827
249,165,84,20.75,13.75,84,1253,1166,87,1,0,0.083333,0,27,12,12,1.592593,0,0,13,19,false,true,true,0.994,0.006
66,12,54,66,12,54,1075,1027,48,1,0,1,0,90,1,1,0.411111,0,0,8,12,false,true,true,0.899,0.101
319,185,134,24.538462,15.416667,134,778,758,20,0,1,0,0.083333,8,13,12,4.875,0,0,22,20,false,true,true,0.998,0.002
230,89,141,32.857143,14.833333,141,996,1063,-67,1,1,0.142857,0.166667,47,7,6,0.680851,0,1,9,11,false,true,true,0.965,0.035
125,63,62,25,12.6,62,1144,1014,130,0,0,0,0,64,5,5,0.5625,1,1,16,11,false,true,true,0.865,0.135
16,23,-7,16,23,-7,947,810,137,0,0,0,0,93,1,1,0.451613,0,0,8,12,false,true,true,0.519,0.481
53,44,9,26.5,22,9,691,473,218,0,0,0,0,83,2,2,0.433735,0,0,16,11,false,true,true,0.778,0.222
17,27,-10,8.5,13.5,-10,1880,1777,103,0,0,0,0,90,2,2,0.311111,0,1,10,16,false,true,false,0.291,0.709
218,180,38,15.571429,12.857143,38,539,632,-93,0,0,0,0,21,14,14,2.190476,0,0,11,8,false,true,true,0.946,0.054
334,378,-44,30.363636,34.363636,-44,2219,2029,190,0,0,0,0,-2,11,11,-13,0,0,10,15,false,true,true,0.978,0.022
349,283,66,13.96,11.32,66,272,288,-16,0,0,0,0,-28,25,25,-1.857143,0,0,1,1,false,true,true,1,0
422,336,86,30.142857,25.846154,86,1684,1320,364,1,0,0.071429,0,-9,14,13,-3.333333,0,0,4,11,false,true,true,1,0
60,22,38,20,11,38,699,448,251,0,0,0,0,85,3,2,0.470588,0,0,9,16,false,true,true,0.765,0.235
116,139,-23,29,46.333333,-23,1265,1237,28,0,0,0,0,65,4,3,0.461538,0,0,13,9,false,true,false,0.043,0.957
281,232,49,21.615385,19.333333,49,1270,1348,-78,0,0,0,0,20,13,12,1.9,0,0,11,8,false,true,true,0.71,0.29
256,136,120,28.444444,17,120,1014,948,66,1,0,0.111111,0,44,9,8,0.75,0,0,8,15,false,true,true,0.992,0.008
8,0,8,8,0,8,904,857,47,0,0,0,0,96,1,0,0.427083,0,0,26,0,false,true,true,0.566,0.434
46,15,31,15.333333,7.5,31,1069,1040,29,0,0,0,0,82,3,2,0.536585,0,1,22,10,false,true,true,0.564,0.436
133,122,11,16.625,15.25,11,1159,1051,108,0,0,0,0,52,8,8,0.769231,0,1,17,10,false,true,false,0.404,0.596
356,244,112,29.666667,22.181818,112,1245,1241,4,2,1,0.166667,0.090909,3,12,11,9.666667,0,0,7,8,false,true,true,0.999,0.001
37,32,5,18.5,16,5,1090,1244,-154,0,0,0,0,84,2,2,0.440476,0,0,15,12,false,true,false,0.217,0.783
158,81,77,26.333333,16.2,77,554,342,212,0,0,0,0,60,6,5,0.6,0,0,12,7,false,true,true,0.949,0.051
246,250,-4,17.571429,17.857143,-4,1043,1055,-12,0,0,0,0,7,14,14,5.285714,1,0,17,11,false,true,true,0.596,0.404
191,105,86,15.916667,8.75,86,1428,1302,126,0,0,0,0,28,12,12,1.892857,0,1,15,18,false,true,true,0.915,0.085
390,316,74,27.857143,22.571429,74,1156,1184,-28,2,1,0.142857,0.071429,-5,14,14,-5.6,0,0,3,9,true,true,true,1,0
106,92,14,17.666667,15.333333,14,1176,1127,49,0,0,0,0,56,6,6,0.660714,0,0,8,16,false,true,false,0.467,0.533
367,285,82,24.466667,19,82,1050,1144,-94,0,1,0,0.066667,-8,15,15,-4.75,0,0,14,15,false,true,true,1,0
149,132,17,18.625,18.857143,17,518,533,-15,1,0,0.125,0,45,8,7,0.777778,0,0,21,7,false,true,true,0.571,0.429
285,245,40,16.764706,15.3125,40,613,461,152,0,1,0,0.0625,-19,17,16,-1.947368,0,0,9,5,false,true,true,0.985,0.015
339,319,20,16.95,15.95,20,1159,1051,108,0,0,0,0,-25,20,20,-1.6,0,0,3,1,true,true,true,1,0
239,170,69,23.9,18.888889,69,306,169,137,0,0,0,0,23,10,9,1.478261,0,0,13,12,false,true,true,0.956,0.044
348,294,54,18.315789,15.473684,54,1548,1493,55,1,0,0.052632,0,-21,19,19,-1.952381,0,0,2,3,false,true,true,1,0
303,289,14,17.823529,17,14,942,976,-34,0,0,0,0,-13,17,17,-3.076923,0,0,8,8,false,true,true,0.936,0.064
103,66,37,25.75,16.5,37,1295,1281,14,0,0,0,0,73,4,4,0.520548,0,0,23,10,false,true,true,0.8,0.2
159,124,35,22.714286,20.666667,35,1556,1591,-35,0,0,0,0,56,7,6,0.642857,1,1,9,17,false,true,false,0.491,0.509
290,264,26,17.058824,15.529412,26,95,360,-265,0,1,0,0.058824,-15,17,17,-2.666667,0,0,9,7,false,true,true,0.954,0.046
65,45,20,16.25,15,20,620,658,-38,0,0,0,0,76,4,3,0.473684,2,0,5,11,false,true,true,0.952,0.048
230,119,111,32.857143,17,111,996,1063,-67,1,1,0.142857,0.142857,41,7,7,0.780488,0,0,9,18,false,true,true,0.988,0.012
340,279,61,22.666667,18.6,61,1036,1181,-145,0,0,0,0,6,15,15,5.666667,1,0,9,11,false,true,true,0.999,0.001
46,17,29,23,17,29,691,675,16,0,0,0,0,91,2,1,0.406593,0,1,24,6,false,true,true,0.619,0.381
66,63,3,16.5,15.75,3,916,876,40,0,0,0,0,70,4,4,0.485714,0,0,15,10,false,true,true,0.598,0.402
298,298,0,12.956522,12.956522,0,1029,1075,-46,0,0,0,0,-23,23,23,-2.086957,0,0,1,1,false,true,true,0.999,0.001
151,111,40,18.875,15.857143,40,1027,856,171,1,0,0.125,0,41,8,7,0.804878,1,1,17,10,false,true,true,0.565,0.435
222,209,13,20.181818,19,13,1572,1550,22,1,0,0.090909,0,26,11,11,1.5,0,1,14,9,false,true,false,0.45,0.55
153,118,35,15.3,13.111111,35,719,614,105,0,0,0,0,40,10,9,1.075,0,1,18,8,false,true,true,0.865,0.135
248,180,68,20.666667,16.363636,68,691,473,218,0,0,0,0,20,12,11,1.8,1,0,12,19,false,true,true,0.987,0.013
44,8,36,22,8,36,346,231,115,0,0,0,0,88,2,1,0.465909,0,1,14,12,false,true,true,0.805,0.195
174,130,44,24.857143,21.666667,44,907,752,155,0,0,0,0,56,7,6,0.589286,0,0,9,12,false,true,true,0.737,0.263
239,208,31,14.9375,13,31,871,999,-128,0,0,0,0,7,16,16,6.857143,0,0,10,9,false,true,true,0.921,0.079
363,224,139,21.352941,14,139,554,342,212,0,0,0,0,-17,17,16,-2.117647,0,0,1,4,false,true,true,1,0
345,289,56,18.157895,16.055556,56,691,675,16,0,0,0,0,-17,19,18,-2.176471,0,0,1,1,true,true,true,1,0
120,134,-14,30,33.5,-14,1890,2020,-130,0,1,0,0.25,65,4,4,0.446154,0,0,13,12,false,true,false,0.305,0.695
293,193,100,24.416667,17.545455,100,371,336,35,2,0,0.166667,0,1,12,11,38,0,0,8,21,false,true,true,0.998,0.002
161,140,21,17.888889,15.555556,21,791,774,17,1,0,0.111111,0,51,9,9,0.803922,1,0,10,20,false,true,true,0.823,0.177
363,291,72,21.352941,18.1875,72,1047,1094,-47,1,1,0.058824,0.0625,-6,17,16,-6,1,0,3,5,false,true,true,0.991,0.009
237,185,52,13.941176,11.5625,52,1016,1037,-21,0,0,0,0,12,17,16,4,1,0,8,23,false,true,true,0.947,0.053
235,240,-5,16.785714,17.142857,-5,613,549,64,0,0,0,0,8,14,14,5.5,1,0,7,8,false,true,true,0.62,0.38
368,305,63,20.444444,16.944444,63,948,933,15,1,0,0.055556,0,-5,18,18,-7.6,0,0,2,3,false,true,true,1,0
384,238,146,21.333333,13.222222,146,303,342,-39,0,0,0,0,-19,18,18,-2,0,0,1,1,false,true,true,1,0
438,288,150,14.6,9.931034,150,1176,1076,100,0,0,0,0,-32,30,29,-1.84375,0,0,1,3,true,true,true,1,0
156,142,14,17.333333,17.75,14,1221,1258,-37,1,0,0.111111,0,45,9,8,0.866667,0,0,22,8,false,true,true,0.533,0.467
250,180,70,22.727273,18,70,719,651,68,0,1,0,0.1,39,11,10,1.153846,0,0,10,9,false,true,true,0.988,0.012
316,298,18,22.571429,21.285714,18,791,885,-94,1,1,0.071429,0.071429,2,14,14,19,0,0,9,13,false,true,true,0.903,0.097
251,181,70,22.818182,18.1,70,939,907,32,0,0,0,0,38,11,10,1.052632,2,0,5,8,false,true,true,0.99,0.01
320,270,50,22.857143,19.285714,50,416,282,134,1,0,0.071429,0,-1,14,14,-34,1,0,9,8,false,true,true,1,0
127,92,35,25.4,18.4,35,1803,1552,251,0,0,0,0,63,5,5,0.444444,0,1,10,9,false,true,true,0.972,0.028
276,272,4,25.090909,27.2,4,908,1070,-162,1,0,0.090909,0,21,11,10,1.428571,0,0,10,8,false,true,false,0.222,0.778
290,246,44,26.363636,22.363636,44,965,1013,-48,1,0,0.090909,0,13,11,11,2.538462,0,1,11,10,false,true,true,0.767,0.233
87,90,-3,21.75,22.5,-3,1148,1164,-16,0,0,0,0,67,4,4,0.373134,1,0,13,12,false,true,true,0.725,0.275
252,133,119,36,19,119,1684,1320,364,1,0,0.142857,0,36,7,7,0.833333,0,1,18,13,false,true,true,1,0
354,283,71,19.666667,16.647059,71,791,774,17,1,0,0.055556,0,-7,18,17,-5.857143,0,0,4,5,false,true,true,1,0
171,168,3,15.545455,15.272727,3,658,817,-159,0,0,0,0,35,11,11,1.085714,0,0,19,15,false,true,false,0.33,0.67
0,0,0,0,0,0,907,752,155,0,0,0,0,100,1,0,0.33,0,0,16,0,false,true,true,0.672,0.328
99,49,50,24.75,12.25,50,1572,1550,22,1,0,0.25,0,75,4,4,0.52,0,0,18,12,false,true,true,0.826,0.174
255,294,-39,25.5,29.4,-39,1762,1538,224,1,2,0.1,0.2,26,10,10,1.307692,0,0,8,20,false,true,false,0.204,0.796
416,294,122,26,19.6,122,1189,1266,-77,1,0,0.0625,0,-15,16,15,-2.266667,0,0,1,1,false,true,true,1,0
149,82,67,29.8,20.5,67,1334,1477,-143,0,0,0,0,65,5,4,0.461538,0,2,14,11,false,true,true,0.582,0.418
375,249,126,28.846154,20.75,126,1051,1030,21,0,0,0,0,3,13,12,10,0,0,11,18,false,true,true,1,0
280,251,29,25.454545,22.818182,29,1266,1144,122,0,0,0,0,19,11,11,1.789474,1,0,7,14,false,true,true,0.978,0.022
308,302,6,20.533333,21.571429,6,971,906,65,0,0,0,0,-5,15,14,-6.4,1,0,3,13,false,true,true,0.726,0.274
146,137,9,18.25,17.125,9,831,830,1,0,0,0,0,48,8,8,0.770833,0,0,20,11,false,true,true,0.741,0.259
74,68,6,14.8,17,6,1100,1008,92,0,0,0,0,75,5,4,0.48,2,0,6,13,false,true,true,0.896,0.104
30,0,30,30,0,30,864,808,56,0,0,0,0,95,1,0,0.357895,0,0,7,0,false,true,true,0.683,0.317
197,101,96,39.4,25.25,96,1983,2020,-37,1,0,0.2,0,62,5,4,0.419355,0,1,15,12,false,true,true,0.795,0.205
49,53,-4,12.25,13.25,-4,721,689,32,0,0,0,0,67,4,4,0.507463,0,0,15,21,false,true,true,0.611,0.389
346,307,39,38.444444,34.111111,39,1885,1793,92,0,0,0,0,21,9,9,1.285714,1,0,15,9,false,true,true,1,0
116,136,-20,11.6,15.111111,-20,480,518,-38,0,0,0,0,49,10,9,0.938776,0,1,19,7,false,true,false,0.093,0.907
348,306,42,20.470588,18,42,795,830,-35,1,1,0.058824,0.058824,-12,17,17,-3.5,0,0,3,7,false,true,true,0.987,0.013
151,128,23,21.571429,18.285714,23,977,976,1,0,0,0,0,56,7,7,0.607143,0,0,13,9,false,true,true,0.737,0.263
260,204,56,21.666667,18.545455,56,784,758,26,0,0,0,0,15,12,11,2.333333,0,0,11,9,false,true,true,0.958,0.042
29,38,-9,14.5,19,-9,1297,1606,-309,0,0,0,0,85,2,2,0.352941,1,0,6,20,false,true,false,0.233,0.767
224,257,-33,22.4,25.7,-33,1539,1537,2,0,1,0,0.1,29,10,10,1.103448,0,0,13,8,false,true,false,0.257,0.743
181,78,103,36.2,15.6,103,996,1063,-67,1,1,0.2,0.2,56,5,5,0.571429,0,1,21,12,false,true,true,0.873,0.127
249,154,95,20.75,14,95,1253,1166,87,1,0,0.083333,0,32,12,11,1.34375,0,0,13,18,false,true,true,0.992,0.008
10,30,-20,5,15,-20,1651,1691,-40,0,0,0,0,91,2,2,0.373626,0,0,24,14,false,true,false,0.285,0.715
130,110,20,18.571429,15.714286,20,527,503,24,0,0,0,0,61,7,7,0.672131,0,0,21,16,false,true,true,0.899,0.101
43,82,-39,10.75,27.333333,-39,416,306,110,0,0,0,0,80,4,3,0.525,0,0,25,7,false,true,true,0.502,0.498
49,33,16,12.25,11,16,658,817,-159,0,0,0,0,84,4,3,0.452381,0,0,22,10,false,true,false,0.244,0.756
204,133,71,34,22.166667,71,1148,1164,-16,1,1,0.166667,0.166667,46,6,6,0.543478,0,0,15,16,false,true,true,0.985,0.015
73,22,51,24.333333,11,51,1875,1793,82,0,0,0,0,89,3,2,0.337079,0,0,8,16,false,true,true,0.636,0.364
79,92,-13,13.166667,15.333333,-13,448,598,-150,0,0,0,0,59,6,6,0.610169,1,0,13,9,false,true,false,0.22,0.78
208,145,63,26,18.125,63,976,965,11,1,0,0.125,0,36,8,8,0.888889,0,1,7,21,false,true,true,0.862,0.138
340,255,85,20,15.9375,85,580,620,-40,1,0,0.058824,0,-5,17,16,-8.6,0,0,12,11,false,true,true,0.999,0.001
375,288,87,31.25,26.181818,87,1197,1127,70,0,0,0,0,8,12,11,3.75,1,0,17,9,false,true,true,1,0
60,41,19,15,13.666667,19,1091,1078,13,0,0,0,0,75,4,3,0.573333,0,0,17,8,false,true,true,0.522,0.478
291,137,154,26.454545,13.7,154,801,925,-124,1,0,0.090909,0,23,11,10,1.521739,1,0,16,16,false,true,true,0.987,0.013
213,127,86,26.625,18.142857,86,971,1180,-209,1,0,0.125,0,48,8,7,0.666667,0,0,10,12,false,true,true,0.944,0.056
326,294,32,27.166667,24.5,32,1156,1184,-28,2,1,0.166667,0.083333,5,12,12,5.6,0,0,13,20,false,true,true,0.987,0.013
59,54,5,19.666667,18,5,1334,1477,-143,0,0,0,0,77,3,3,0.38961,0,2,19,9,false,true,false,0.219,0.781
312,306,6,22.285714,21.857143,6,1493,1513,-20,1,0,0.071429,0,5,14,14,6.6,0,1,11,6,false,true,false,0.463,0.537
263,217,46,26.3,21.7,46,1034,1040,-6,1,0,0.1,0,24,10,10,1.458333,1,0,13,15,false,true,true,0.969,0.031
279,200,79,16.411765,12.5,79,566,542,24,0,0,0,0,1,17,16,41,0,1,21,6,false,true,true,0.999,0.001
165,127,38,23.571429,21.166667,38,1305,1242,63,1,0,0.142857,0,55,7,6,0.618182,0,1,7,22,false,true,true,0.559,0.441
341,311,30,18.944444,18.294118,30,613,611,2,0,0,0,0,-24,18,17,-1.583333,0,0,2,2,false,true,true,0.999,0.001
41,53,-12,13.666667,17.666667,-12,1128,889,239,0,1,0,0.333333,78,3,3,0.602564,1,0,7,7,false,true,true,0.569,0.431
80,47,33,26.666667,15.666667,33,1078,1130,-52,0,0,0,0,81,3,3,0.481481,0,1,8,9,false,true,true,0.621,0.379
107,14,93,53.5,14,93,1270,1322,-52,1,0,0.5,0,86,2,1,0.44186,0,0,7,13,false,true,true,0.852,0.148
311,215,96,22.214286,16.538462,96,1022,1095,-73,0,0,0,0,2,14,13,16.5,0,1,12,8,false,true,true,1,0
95,75,20,19,18.75,20,1189,1266,-77,0,0,0,0,70,5,4,0.485714,1,0,17,19,false,true,true,0.582,0.418
267,308,-41,20.538462,25.666667,-41,1501,1473,28,0,0,0,0,12,13,12,3,0,1,10,6,false,true,false,0.005,0.995
151,117,34,18.875,16.714286,34,704,691,13,0,0,0,0,50,8,7,0.76,1,0,10,11,false,true,true,0.839,0.161
223,102,121,22.3,10.2,121,993,897,96,1,0,0.1,0,29,10,10,1.62069,0,0,12,16,false,true,true,0.996,0.004
182,134,48,26,22.333333,48,1089,1063,26,1,0,0.142857,0,57,7,6,0.666667,0,0,19,13,false,true,true,0.784,0.216
439,375,64,33.769231,28.846154,64,1880,1777,103,1,1,0.076923,0.076923,-10,13,13,-2.8,0,0,3,1,false,true,true,1,0
191,186,5,19.1,18.6,5,1090,1244,-154,0,0,0,0,31,10,10,1.193548,0,1,9,13,false,true,false,0.155,0.845
308,173,135,25.666667,14.416667,135,742,696,46,0,0,0,0,12,12,12,2.666667,0,0,15,16,false,true,true,1,0
398,271,127,19.9,14.263158,127,942,1003,-61,0,0,0,0,-25,20,19,-1.8,1,0,6,5,false,true,true,1,0
290,280,10,18.125,18.666667,10,1782,1512,270,1,1,0.0625,0.066667,-3,16,15,-14,0,0,10,19,false,true,true,0.999,0.001
333,226,107,27.75,20.545455,107,977,976,1,1,0,0.083333,0,19,12,11,1.789474,1,0,9,7,false,true,true,1,0
292,220,72,32.444444,24.444444,72,1762,1616,146,2,0,0.222222,0,23,9,9,1.304348,0,0,7,17,false,true,true,1,0
307,282,25,21.928571,20.142857,25,1304,1040,264,1,0,0.071429,0,5,14,14,6.6,0,1,9,14,false,true,true,0.629,0.371
283,200,83,21.769231,16.666667,83,691,473,218,0,0,0,0,11,13,12,3.272727,1,0,9,17,false,true,true,0.999,0.001
441,301,140,29.4,21.5,140,1439,1353,86,1,0,0.066667,0,-9,15,14,-3.333333,0,0,4,5,false,true,true,1,0
129,89,40,25.8,22.25,40,809,868,-59,1,0,0.2,0,62,5,4,0.516129,0,0,19,13,false,true,false,0.352,0.648
324,266,58,17.052632,14.777778,58,699,448,251,0,0,0,0,-12,19,18,-3.333333,0,0,2,10,false,true,true,0.996,0.004
183,152,31,18.3,15.2,31,1029,1075,-46,0,0,0,0,39,10,10,1.230769,2,0,5,10,false,true,true,0.988,0.012
242,68,174,24.2,7.555556,174,896,818,78,0,0,0,0,48,10,9,0.916667,0,0,10,9,false,true,true,0.997,0.003
101,48,53,20.2,12,53,791,774,17,1,0,0.2,0,77,5,4,0.532468,0,0,12,14,false,true,true,0.87,0.13
251,210,41,20.916667,17.5,41,1394,1230,164,0,1,0,0.083333,16,12,12,2.375,0,1,9,18,false,true,true,0.819,0.181
94,84,10,15.666667,16.8,10,95,378,-283,0,0,0,0,59,6,5,0.59322,0,0,16,11,false,true,true,0.511,0.489
136,77,59,27.2,15.4,59,904,668,236,0,0,0,0,61,5,5,0.557377,0,0,18,15,false,true,true,0.936,0.064
30,14,16,30,14,16,1691,1692,-1,0,0,0,0,92,1,1,0.326087,0,0,9,9,false,true,true,0.579,0.421
20,8,12,10,4,12,1394,1230,164,0,0,0,0,86,2,2,0.44186,0,0,11,8,false,true,true,0.64,0.36
313,243,70,16.473684,12.789474,70,892,768,124,0,0,0,0,-5,19,19,-8.6,0,0,10,11,false,true,true,1,0
208,243,-35,14.857143,17.357143,-35,500,567,-67,0,0,0,0,21,14,14,2.095238,0,1,9,8,false,true,false,0.049,0.951
293,225,68,20.928571,17.307692,68,859,811,48,0,0,0,0,8,14,13,4.5,1,1,11,12,false,true,true,0.961,0.039
362,292,70,22.625,19.466667,70,1220,1261,-41,2,0,0.125,0,4,16,15,11.25,1,0,15,7,false,true,true,1,0
128,152,-24,16,21.714286,-24,719,785,-66,0,1,0,0.142857,47,8,7,0.765957,0,0,10,17,false,true,false,0.218,0.782
428,403,25,28.533333,28.785714,25,1935,2020,-85,0,1,0,0.071429,-14,15,14,-2.214286,0,0,1,2,false,true,true,1,0
343,220,123,20.176471,12.941176,123,1586,1782,-196,0,0,0,0,-9,17,17,-4.444444,1,0,14,4,false,true,true,1,0
71,24,47,35.5,12,47,1075,1027,48,1,0,0.5,0,82,2,2,0.45122,0,0,8,13,false,true,true,0.913,0.087
359,291,68,19.944444,16.166667,68,527,581,-54,0,0,0,0,-24,18,18,-1.75,0,0,4,6,false,true,true,1,0
342,346,-4,24.428571,24.714286,-4,1297,1606,-309,1,1,0.071429,0.071429,-7,14,14,-4.285714,0,0,3,4,false,true,true,0.797,0.203
269,155,114,24.454545,15.5,114,539,500,39,0,0,0,0,19,11,10,2.105263,0,0,10,10,false,true,true,0.996,0.004
84,73,11,16.8,18.25,11,620,513,107,0,0,0,0,70,5,4,0.642857,0,0,9,11,false,true,true,0.595,0.405
227,124,103,37.833333,24.8,103,1762,1616,146,2,0,0.333333,0,49,6,5,0.612245,0,0,14,11,false,true,true,0.977,0.023
182,113,69,22.75,16.142857,69,1551,1550,1,0,0,0,0,49,8,7,0.857143,0,1,8,15,false,true,true,0.785,0.215
22,18,4,22,18,4,1394,1118,276,0,0,0,0,89,1,1,0.41573,0,0,10,12,false,true,true,0.57,0.43
319,188,131,26.583333,17.090909,131,1075,1027,48,2,0,0.166667,0,16,12,11,2.3125,0,1,26,10,false,true,true,0.993,0.007
278,280,-2,18.533333,18.666667,-2,1782,1512,270,1,1,0.066667,0.066667,0,15,15,0,0,0,19,19,false,true,true,0.999,0.001
127,55,72,21.166667,11,72,1482,1554,-72,0,0,0,0,68,6,5,0.529412,1,0,6,18,false,true,true,0.942,0.058
204,125,79,22.666667,15.625,79,1115,1078,37,0,0,0,0,41,9,8,0.829268,1,0,13,11,false,true,true,0.991,0.009
108,56,52,27,18.666667,52,1320,1339,-19,1,0,0.25,0,70,4,3,0.557143,0,0,9,7,false,true,true,0.836,0.164
298,286,12,19.866667,19.066667,12,448,598,-150,0,0,0,0,-7,15,15,-5.142857,0,0,8,9,false,true,true,0.691,0.309
84,41,43,21,13.666667,43,834,758,76,0,0,0,0,75,4,3,0.48,0,1,11,12,false,true,true,0.732,0.268
327,272,55,20.4375,18.133333,55,825,907,-82,1,0,0.0625,0,0,16,15,0,0,0,10,15,false,true,true,0.921,0.079
299,228,71,23,19,71,1075,1152,-77,0,1,0,0.083333,13,13,12,3.076923,0,0,7,15,false,true,true,0.987,0.013
267,266,1,19.071429,19,1,1127,1176,-49,0,0,0,0,9,14,14,4.666667,0,0,19,8,false,true,true,0.505,0.495
236,166,70,15.733333,11.857143,70,947,909,38,0,0,0,0,4,15,14,11.5,0,0,10,34,false,true,true,0.986,0.014
56,54,2,28,27,2,695,671,24,0,0,0,0,81,2,2,0.407407,0,0,17,15,false,true,true,0.715,0.285
415,250,165,29.642857,17.857143,165,971,621,350,2,0,0.142857,0,-11,14,14,-2.909091,1,0,8,16,false,true,true,1,0
126,77,49,42,25.666667,49,1793,1897,-104,1,0,0.333333,0,77,3,3,0.38961,0,0,7,21,false,true,true,0.602,0.398
254,181,73,21.166667,15.083333,73,954,1078,-124,0,1,0,0.083333,18,12,12,2.111111,1,0,11,14,false,true,true,0.989,0.011
76,28,48,25.333333,9.333333,48,1413,1422,-9,0,0,0,0,77,3,3,0.74026,1,0,16,17,false,true,true,0.761,0.239
66,62,4,22,20.666667,4,1069,917,152,0,0,0,0,77,3,3,0.441558,0,1,12,9,false,true,true,0.501,0.499
267,175,92,24.272727,15.909091,92,518,533,-15,1,0,0.090909,0,18,11,11,1.944444,0,0,17,11,false,true,true,0.993,0.007
169,227,-58,18.777778,28.375,-58,1501,1473,28,0,0,0,0,36,9,8,1,0,0,18,20,false,true,false,0.041,0.959
253,209,44,18.071429,14.928571,44,346,231,115,0,0,0,0,-10,14,14,-4.1,0,0,19,7,false,true,true,0.985,0.015
381,310,71,19.05,16.315789,71,1551,1550,1,0,0,0,0,-32,20,19,-1.3125,0,1,1,2,false,true,true,1,0
191,125,66,21.222222,15.625,66,609,620,-11,0,0,0,0,42,9,8,0.880952,0,1,10,9,false,true,true,0.935,0.065
151,125,26,18.875,15.625,26,1027,856,171,1,0,0.125,0,38,8,8,0.868421,1,1,17,8,false,true,true,0.566,0.434
33,17,16,16.5,17,16,658,817,-159,0,0,0,0,93,2,1,0.408602,0,0,19,7,false,true,false,0.219,0.781
228,124,104,25.333333,15.5,104,1691,1692,-1,0,0,0,0,35,9,8,0.857143,0,0,19,12,false,true,true,0.976,0.024
99,87,12,24.75,21.75,12,907,752,155,0,0,0,0,75,4,4,0.44,1,0,12,12,false,true,true,0.883,0.117
326,213,113,29.636364,21.3,113,1245,1232,13,1,0,0.090909,0,8,11,10,3.625,0,0,9,10,false,true,true,1,0
233,129,104,21.181818,12.9,104,1586,1782,-196,0,0,0,0,27,11,10,1.481481,1,0,9,7,false,true,true,0.989,0.011
384,270,114,27.428571,19.285714,114,1489,1445,44,1,0,0.071429,0,1,14,14,32,0,0,7,5,false,true,true,1,0
332,246,86,30.181818,24.6,86,1349,1302,47,0,0,0,0,19,11,10,1.526316,0,0,15,8,false,true,true,1,0
412,323,89,21.684211,17.944444,89,1075,1027,48,2,1,0.105263,0.055556,-20,19,18,-1.85,0,0,4,4,true,true,true,1,0
155,136,19,17.222222,17,19,872,818,54,0,1,0,0.125,46,9,8,0.891304,0,0,12,8,false,true,true,0.74,0.26
190,172,18,17.272727,15.636364,18,527,581,-54,0,0,0,0,25,11,11,1.68,1,0,18,17,false,true,true,0.792,0.208
144,68,76,36,22.666667,76,1408,1454,-46,1,0,0.25,0,73,4,3,0.438356,0,0,8,17,false,true,true,0.851,0.149
87,98,-11,12.428571,16.333333,-11,523,480,43,0,0,0,0,56,7,6,0.589286,1,0,18,7,false,true,true,0.671,0.329
142,147,-5,20.285714,24.5,-5,942,976,-34,0,0,0,0,53,7,6,0.754717,1,0,12,17,false,true,false,0.353,0.647
369,283,86,20.5,15.722222,86,613,569,44,0,0,0,0,-19,18,18,-2.052632,0,0,1,1,false,true,true,1,0
69,71,-2,17.25,17.75,-2,468,542,-74,0,0,0,0,77,4,4,0.506494,0,0,19,10,false,true,false,0.272,0.728
108,51,57,18,8.5,57,1176,1076,100,0,0,0,0,70,6,6,0.842857,0,0,11,16,false,true,true,0.962,0.038
371,251,120,24.733333,17.928571,120,1305,1390,-85,0,1,0,0.071429,-6,15,14,-6,0,2,10,14,false,true,true,1,0
80,64,16,16,16,16,1090,1244,-154,0,0,0,0,68,5,4,0.544118,0,0,12,21,false,true,false,0.12,0.88
110,86,24,15.714286,12.285714,24,346,231,115,0,0,0,0,46,7,7,0.891304,0,0,9,12,false,true,true,0.902,0.098
253,150,103,19.461538,12.5,103,415,518,-103,0,0,0,0,22,13,12,1.727273,0,0,10,21,false,true,true,0.982,0.018
81,54,27,27,27,27,695,671,24,0,0,0,0,77,3,2,0.428571,0,0,18,15,false,true,true,0.752,0.248
300,253,47,21.428571,19.461538,47,847,952,-105,0,0,0,0,14,14,13,2.571429,0,0,12,11,false,true,true,0.539,0.461
14,23,-9,14,23,-9,871,867,4,0,0,0,0,90,1,1,0.477778,0,0,21,14,false,true,false,0.462,0.538
235,174,61,26.111111,19.333333,61,1029,1227,-198,1,0,0.111111,0,29,9,9,1.103448,1,0,9,12,false,true,true,0.939,0.061
279,183,96,16.411765,11.4375,96,1069,1040,29,0,0,0,0,-8,17,16,-5.5,0,2,22,8,false,true,true,1,0
189,99,90,37.8,19.8,90,1489,1405,84,1,0,0.2,0,66,5,5,0.424242,1,0,9,13,false,true,true,0.974,0.026
332,254,78,25.538462,21.166667,78,630,786,-156,1,0,0.076923,0,14,13,12,2.5,0,0,10,12,false,true,true,0.984,0.016
44,9,35,22,9,35,1067,95,972,0,0,0,0,88,2,1,0.386364,0,0,14,14,false,true,true,1,0
373,313,60,26.642857,22.357143,60,1762,1582,180,2,3,0.142857,0.214286,-5,14,14,-6.4,0,0,2,24,false,true,true,0.989,0.011
91,115,-24,13,16.428571,-24,699,448,251,0,0,0,0,57,7,7,0.701754,0,1,19,12,false,true,true,0.506,0.494
213,88,125,30.428571,14.666667,125,1216,1217,-1,1,0,0.142857,0,49,7,6,0.693878,0,0,10,26,false,true,true,0.988,0.012
9,6,3,4.5,6,3,1014,1303,-289,0,0,0,0,91,2,1,0.417582,1,1,14,9,false,true,false,0.211,0.789
262,202,60,21.833333,18.363636,60,1036,1181,-145,0,0,0,0,25,12,11,1.36,1,0,22,11,false,true,true,0.89,0.11
83,31,52,16.6,7.75,52,595,543,52,0,0,0,0,74,5,4,0.635135,0,0,12,15,false,true,true,0.921,0.079
42,53,-11,14,17.666667,-11,1547,1439,108,0,0,0,0,82,3,3,0.45122,1,0,6,9,false,true,false,0.331,0.669
191,94,97,23.875,13.428571,97,719,651,68,0,0,0,0,60,8,7,0.75,0,0,17,8,false,true,true,0.968,0.032
121,101,20,20.166667,20.2,20,1167,1216,-49,0,0,0,0,64,6,5,0.640625,1,0,6,22,false,true,false,0.328,0.672
26,31,-5,13,15.5,-5,518,533,-15,0,0,0,0,86,2,2,0.406977,0,0,10,23,false,true,false,0.344,0.656
24,15,9,24,15,9,498,43,455,0,0,0,0,93,1,1,0.397849,1,0,12,8,false,true,true,0.882,0.118
123,131,-8,17.571429,21.833333,-8,596,595,1,0,0,0,0,57,7,6,0.701754,1,0,8,15,false,true,false,0.43,0.57
326,303,23,18.111111,17.823529,23,1078,1130,-52,0,1,0,0.058824,-21,18,17,-1.857143,0,0,2,2,false,true,true,0.981,0.019
51,18,33,17,9,33,947,909,38,0,0,0,0,84,3,2,0.547619,1,0,10,30,false,true,true,0.83,0.17
264,151,113,29.333333,18.875,113,1075,1027,48,2,0,0.222222,0,34,9,8,1.088235,0,1,10,6,false,true,true,0.89,0.11
371,330,41,21.823529,19.411765,41,834,758,76,0,1,0,0.058824,-24,17,17,-1.5,0,0,2,3,false,true,true,0.998,0.002
90,29,61,45,29,61,791,885,-94,1,0,0.5,0,84,2,1,0.452381,0,0,13,19,false,true,false,0.395,0.605
14,29,-15,14,29,-15,1203,1221,-18,0,0,0,0,93,1,1,0.376344,0,0,15,22,false,true,false,0.272,0.728
143,112,31,23.833333,18.666667,31,1153,1065,88,0,1,0,0.166667,49,6,6,0.571429,0,0,19,19,false,true,true,0.914,0.086
136,177,-41,22.666667,29.5,-41,1305,1218,87,0,0,0,0,49,6,6,0.77551,1,0,8,15,false,true,false,0.205,0.795
84,67,17,16.8,16.75,17,831,830,1,0,0,0,0,69,5,4,0.536232,1,0,19,10,false,true,true,0.802,0.198
358,195,163,21.058824,12.1875,163,786,757,29,1,0,0.058824,0,-6,17,16,-6.5,0,0,25,14,false,true,true,1,0
254,234,20,16.933333,15.6,20,450,412,38,0,0,0,0,-6,15,15,-6.333333,0,0,17,13,false,true,true,0.906,0.094
69,50,19,23,25,19,1406,1454,-48,0,0,0,0,78,3,2,0.435897,1,0,13,16,false,true,true,0.722,0.278
163,120,43,23.285714,17.142857,43,1115,1078,37,0,0,0,0,52,7,7,0.653846,1,0,16,8,false,true,true,0.898,0.102
346,359,-13,23.066667,25.642857,-13,1762,1538,224,1,2,0.066667,0.142857,-2,15,14,-17,0,0,4,5,false,true,true,0.996,0.004
244,252,-8,20.333333,22.909091,-8,971,761,210,0,0,0,0,16,12,11,1.875,0,0,12,14,false,true,false,0.176,0.824
171,133,38,17.1,14.777778,38,1221,1438,-217,0,0,0,0,40,10,9,1.125,0,2,7,8,false,true,true,0.669,0.331
293,141,152,19.533333,10.071429,152,993,897,96,1,0,0.066667,0,4,15,14,11.75,0,1,24,22,false,true,true,1,0
224,233,-9,16,16.642857,-9,908,859,49,0,0,0,0,11,14,14,3.545455,0,0,19,14,false,true,true,0.713,0.287
35,34,1,11.666667,17,1,1065,1030,35,0,0,0,0,83,3,2,0.409639,0,0,26,11,false,true,false,0.327,0.673
37,38,-1,12.333333,12.666667,-1,416,374,42,0,0,0,0,85,3,3,0.541176,1,0,6,14,false,true,true,0.782,0.218
305,201,104,16.052632,11.166667,104,1128,889,239,0,1,0,0.055556,-8,19,18,-5.875,0,1,12,15,false,true,true,1,0
346,323,23,19.222222,19,23,1334,1270,64,1,0,0.055556,0,-9,18,17,-4.111111,0,0,2,2,false,true,true,0.881,0.119
353,298,55,20.764706,18.625,55,892,819,73,0,1,0,0.0625,-14,17,16,-2.428571,0,0,4,2,false,true,true,0.995,0.005
285,217,68,15.833333,12.764706,68,416,374,42,0,0,0,0,3,18,17,15.333333,0,0,11,7,false,true,true,0.989,0.011
302,302,0,13.727273,13.727273,0,613,549,64,0,0,0,0,-35,22,22,-1.257143,0,0,1,1,true,true,true,0.999,0.001
91,106,-15,13,15.142857,-15,1221,1438,-217,0,0,0,0,58,7,7,0.775862,0,2,19,5,false,true,false,0.118,0.882
422,403,19,30.142857,28.785714,19,1935,2020,-85,0,1,0,0.071429,-11,14,14,-2.818182,0,0,3,2,false,true,true,1,0
50,41,9,25,20.5,9,1645,1777,-132,1,0,0.5,0,79,2,2,0.316456,0,0,19,10,false,true,true,0.823,0.177
298,257,41,21.285714,18.357143,41,948,933,15,1,0,0.071429,0,16,14,14,2.375,0,0,16,10,false,true,true,0.915,0.085
37,43,-6,12.333333,14.333333,-6,95,378,-283,0,0,0,0,78,3,3,0.448718,0,0,11,7,false,true,false,0.285,0.715
299,290,9,23,24.166667,9,1320,1339,-19,2,1,0.153846,0.083333,14,13,12,2.785714,0,0,24,16,false,true,true,0.785,0.215
20,0,20,20,0,20,310,359,-49,0,0,0,0,96,1,0,0.510417,0,0,10,0,false,true,false,0.29,0.71
214,151,63,26.75,21.571429,63,1297,1606,-309,1,0,0.125,0,43,8,7,0.697674,0,0,9,18,false,true,true,0.928,0.072
203,158,45,29,22.571429,45,1023,1070,-47,1,0,0.142857,0,46,7,7,0.695652,1,0,17,7,false,true,true,0.895,0.105
139,113,26,17.375,14.125,26,1011,921,90,0,0,0,0,49,8,8,1,0,0,12,22,false,true,true,0.684,0.316
6,16,-10,6,16,-10,1550,1546,4,0,0,0,0,92,1,1,0.326087,0,0,21,9,false,true,false,0.31,0.69
227,171,56,25.222222,21.375,56,695,671,24,0,0,0,0,32,9,8,1.03125,0,0,7,11,false,true,true,0.938,0.062
360,283,77,22.5,17.6875,77,904,668,236,0,0,0,0,-25,16,16,-1.36,0,0,2,1,false,true,true,1,0
307,205,102,19.1875,13.666667,102,1091,1078,13,0,0,0,0,9,16,15,4.777778,0,0,10,11,false,true,true,1,0
160,151,9,20,21.571429,9,838,786,52,0,1,0,0.142857,46,8,7,0.695652,1,0,10,13,false,true,true,0.64,0.36
322,316,6,20.125,19.75,6,786,976,-190,0,0,0,0,-11,16,16,-2.909091,0,0,4,2,true,true,true,0.812,0.188
136,88,48,19.428571,14.666667,48,913,871,42,0,0,0,0,55,7,6,0.781818,0,0,7,17,false,true,true,0.845,0.155
120,74,46,17.142857,10.571429,46,859,719,140,0,1,0,0.142857,47,7,7,1.12766,0,2,19,8,false,true,true,0.891,0.109
148,174,-26,21.142857,24.857143,-26,1177,1214,-37,0,0,0,0,51,7,7,0.686275,0,0,16,8,false,true,false,0.273,0.727
328,252,76,20.5,16.8,76,971,658,313,0,0,0,0,-8,16,15,-4.5,1,0,6,6,false,true,true,1,0
169,124,45,15.363636,12.4,45,1048,1000,48,0,0,0,0,40,11,10,1,0,1,15,15,false,true,true,0.832,0.168
370,171,199,33.636364,17.1,199,1513,1482,31,1,0,0.090909,0,16,11,10,2.0625,0,0,9,12,false,true,true,1,0
392,384,8,30.153846,29.538462,8,1302,1349,-47,0,1,0,0.076923,-7,13,13,-4,0,0,1,12,false,true,true,0.998,0.002
384,319,65,27.428571,24.538462,65,1408,1454,-46,1,0,0.071429,0,2,14,13,16,0,0,8,9,false,true,true,1,0
245,141,104,35,23.5,104,1510,1583,-73,1,0,0.142857,0,44,7,6,0.727273,0,0,10,9,false,true,true,0.986,0.014
22,0,22,22,0,22,1636,1576,60,0,0,0,0,95,1,0,0.357895,0,0,12,0,false,true,true,0.565,0.435
14,0,14,14,0,14,778,758,20,0,0,0,0,96,1,0,0.40625,0,0,7,0,false,true,true,0.568,0.432
248,230,18,17.714286,17.692308,18,1214,1176,38,0,0,0,0,20,14,13,1.8,0,0,12,11,false,true,true,0.61,0.39
54,14,40,27,14,40,1439,1294,145,0,0,0,0,86,2,1,0.418605,0,0,11,7,false,true,true,0.618,0.382
226,139,87,14.125,8.6875,87,310,359,-49,0,0,0,0,-3,16,16,-16.333333,0,0,7,17,false,true,true,1,0
112,88,24,22.4,22,24,1161,1166,-5,1,0,0.2,0,66,5,4,0.530303,0,1,8,15,false,true,true,0.532,0.468
233,169,64,21.181818,16.9,64,1270,1315,-45,0,0,0,0,27,11,10,1.333333,1,0,9,26,false,true,true,0.976,0.024
402,365,37,22.333333,21.470588,37,1144,1014,130,0,0,0,0,-22,18,17,-1.636364,0,0,1,1,false,true,true,1,0
66,72,-6,16.5,18,-6,1011,921,90,0,0,0,0,72,4,4,0.680556,0,0,12,14,false,true,false,0.479,0.521
86,33,53,28.666667,16.5,53,1530,1550,-20,0,0,0,0,82,3,2,0.414634,0,0,18,8,false,true,true,0.714,0.286
269,236,33,14.944444,13.882353,33,613,502,111,0,0,0,0,-12,18,17,-4.083333,1,0,9,21,false,true,true,0.981,0.019
256,180,76,21.333333,16.363636,76,1055,1050,5,0,0,0,0,23,12,11,1.478261,0,0,16,8,false,true,true,0.982,0.018
100,144,-44,16.666667,24,-44,1885,1846,39,0,1,0,0.166667,49,6,6,0.591837,1,0,11,9,false,true,false,0.308,0.692
248,279,-31,22.545455,27.9,-31,1419,1488,-69,0,1,0,0.1,14,11,10,2,1,0,8,10,false,true,false,0.191,0.809
187,158,29,15.583333,14.363636,29,758,750,8,0,0,0,0,20,12,11,1.85,0,1,19,8,false,true,true,0.814,0.186
396,205,191,30.461538,17.083333,191,820,783,37,1,0,0.076923,0,9,13,12,3.666667,0,0,7,13,false,true,true,1,0
333,246,87,37,27.333333,87,1645,1777,-132,2,0,0.222222,0,13,9,9,1.923077,0,0,13,7,false,true,true,1,0
154,171,-17,25.666667,34.2,-17,1489,1558,-69,0,1,0,0.2,59,6,5,0.474576,0,0,13,9,false,true,false,0.272,0.728
44,24,20,22,24,20,1176,1127,49,0,0,0,0,88,2,1,0.420455,0,0,16,14,false,true,false,0.44,0.56
249,243,6,19.153846,18.692308,6,1388,1477,-89,1,0,0.076923,0,16,13,13,3,1,0,10,12,false,true,true,0.603,0.397
127,109,18,21.166667,21.8,18,1040,925,115,0,0,0,0,61,6,5,0.704918,1,0,22,10,false,true,true,0.864,0.136
121,62,59,24.2,15.5,59,830,907,-77,1,0,0.2,0,68,5,4,0.573529,0,1,9,8,false,true,false,0.423,0.577
343,256,87,18.052632,13.473684,87,1048,1000,48,0,0,0,0,-15,19,19,-2.666667,0,1,1,2,false,true,true,1,0
236,207,29,23.6,23,29,290,416,-126,0,0,0,0,33,10,9,1.030303,0,0,11,14,false,true,true,0.755,0.245
111,90,21,15.857143,12.857143,21,303,342,-39,0,0,0,0,53,7,7,0.716981,1,0,22,14,false,true,true,0.729,0.271
335,240,95,25.769231,18.461538,95,1014,948,66,1,0,0.076923,0,9,13,13,3.666667,0,0,11,10,false,true,true,1,0
110,90,20,18.333333,15,20,1266,1247,19,0,0,0,0,57,6,6,0.561404,0,0,11,16,false,true,false,0.427,0.573
286,281,5,19.066667,20.071429,5,1334,1270,64,1,0,0.066667,0,11,15,14,3.363636,1,0,18,10,false,true,false,0.355,0.645
114,138,-24,16.285714,23,-24,334,446,-112,0,0,0,0,55,7,6,0.727273,0,0,11,10,false,true,false,0.079,0.921
90,37,53,22.5,12.333333,53,1397,1422,-25,1,0,0.25,0,78,4,3,0.461538,0,1,10,12,false,true,true,0.555,0.445
265,195,70,29.444444,24.375,70,1397,1195,202,1,0,0.111111,0,37,9,8,0.945946,0,0,18,10,false,true,true,0.851,0.149
224,190,34,20.363636,17.272727,34,885,719,166,0,0,0,0,27,11,11,1.407407,1,0,8,10,false,true,true,0.895,0.105
47,78,-31,15.666667,26,-31,1731,1691,40,0,0,0,0,78,3,3,0.435897,1,0,9,9,false,true,false,0.431,0.569
312,240,72,28.363636,24,72,1735,1770,-35,2,1,0.181818,0.1,14,11,10,2,0,1,17,11,false,true,true,0.876,0.124
239,260,-21,17.071429,20,-21,999,1011,-12,0,0,0,0,11,14,13,4.181818,1,0,12,25,false,true,false,0.103,0.897
242,111,131,30.25,13.875,131,1295,1477,-182,2,0,0.25,0,45,8,8,1.022222,0,0,25,7,false,true,true,0.947,0.053
234,269,-35,21.272727,26.9,-35,907,752,155,0,1,0,0.1,26,11,10,1.269231,0,0,10,15,false,true,false,0.079,0.921
195,120,75,27.857143,17.142857,75,976,965,11,1,0,0.142857,0,44,7,7,0.727273,0,1,10,15,false,true,true,0.872,0.128
187,248,-61,15.583333,20.666667,-61,999,1011,-12,0,0,0,0,20,12,12,2.3,0,0,10,25,false,true,false,0.01,0.99
409,284,125,14.103448,10.142857,125,1413,1422,-9,0,0,0,0,-32,29,28,-1.78125,0,0,3,1,true,true,true,1,0
190,94,96,14.615385,7.230769,96,859,719,140,0,1,0,0.076923,17,13,13,3.117647,0,1,17,13,false,true,true,0.99,0.01
296,213,83,29.6,23.666667,83,1148,1164,-16,1,1,0.1,0.111111,19,10,9,1.315789,0,0,16,9,false,true,true,0.986,0.014
189,151,38,27,25.166667,38,1210,1253,-43,0,1,0,0.166667,47,7,6,0.723404,0,0,19,16,false,true,true,0.852,0.148
240,172,68,20,15.636364,68,739,480,259,1,0,0.083333,0,23,12,11,1.565217,0,1,11,9,false,true,true,0.948,0.052
350,325,25,23.333333,21.666667,25,1344,1325,19,1,0,0.066667,0,-14,15,15,-2.214286,0,0,2,3,false,true,true,1,0
116,93,23,16.571429,15.5,23,864,808,56,1,0,0.142857,0,48,7,6,0.708333,1,0,7,11,false,true,true,0.935,0.065
294,257,37,13.363636,12.238095,37,947,909,38,0,0,0,0,-35,22,21,-1.314286,0,0,1,15,false,true,true,1,0
205,155,50,22.777778,19.375,50,856,897,-41,0,0,0,0,31,9,8,1.129032,0,1,9,17,false,true,true,0.802,0.198
165,133,32,16.5,14.777778,32,777,830,-53,0,0,0,0,39,10,9,1.051282,0,0,14,12,false,true,true,0.709,0.291
89,53,36,22.25,17.666667,36,1305,1390,-85,0,0,0,0,75,4,3,0.48,0,0,23,16,false,true,true,0.666,0.334
139,64,75,19.857143,10.666667,75,415,518,-103,0,0,0,0,60,7,6,0.633333,1,0,7,26,false,true,true,0.979,0.021
359,281,78,19.944444,16.529412,78,1551,1550,1,0,0,0,0,-19,18,17,-2.210526,0,1,5,6,false,true,true,1,0
220,141,79,20,14.1,79,566,542,24,0,0,0,0,29,11,10,1.413793,0,1,20,7,false,true,true,0.951,0.049
351,305,46,18.473684,16.944444,46,904,783,121,0,0,0,0,-19,19,18,-2.210526,1,0,3,5,false,true,true,1,0
310,213,97,34.444444,23.666667,97,1245,1241,4,1,1,0.111111,0.111111,26,9,9,1.115385,0,0,15,10,false,true,true,0.989,0.011
213,178,35,15.214286,13.692308,35,1029,1075,-46,0,0,0,0,24,14,13,2,2,0,6,23,false,true,true,0.817,0.183
132,91,41,22,15.166667,41,1069,917,152,0,0,0,0,61,6,6,0.557377,0,1,7,7,false,true,true,0.847,0.153
138,121,17,19.714286,17.285714,17,971,658,313,0,0,0,0,53,7,7,0.679245,0,1,15,16,false,true,true,0.524,0.476
319,305,14,18.764706,19.0625,14,786,847,-61,0,0,0,0,-11,17,16,-3.090909,0,0,2,4,false,true,false,0.44,0.56
356,323,33,29.666667,29.363636,33,1428,1452,-24,1,2,0.083333,0.181818,10,12,11,3.1,0,0,9,17,false,true,true,0.94,0.06
288,268,20,22.153846,22.333333,20,795,830,-35,1,1,0.076923,0.083333,10,13,12,4.2,0,0,14,10,false,true,true,0.902,0.098
108,57,51,15.428571,8.142857,51,1428,1302,126,0,0,0,0,55,7,7,0.963636,0,1,19,15,false,true,true,0.88,0.12
10,33,-23,10,33,-23,1211,1173,38,0,0,0,0,93,1,1,0.376344,0,0,17,13,false,true,false,0.271,0.729
344,318,26,22.933333,21.2,26,1014,1303,-289,1,0,0.066667,0,-7,15,15,-5.428571,0,0,6,13,false,true,true,0.988,0.012
0,0,0,0,0,0,1093,1100,-7,0,0,0,0,100,1,0,0.32,0,0,12,0,false,true,true,0.555,0.445
67,201,-134,16.75,50.25,-134,1554,1716,-162,0,1,0,0.25,62,4,4,0.564516,1,0,7,7,false,true,false,0.03,0.97
351,320,31,23.4,22.857143,31,971,761,210,1,0,0.066667,0,-9,15,14,-3.333333,0,0,7,11,false,true,true,0.999,0.001
244,120,124,24.4,12,124,554,342,212,0,0,0,0,27,10,10,1.333333,0,0,9,21,false,true,true,0.996,0.004
61,28,33,30.5,28,33,1153,1065,88,0,0,0,0,87,2,1,0.321839,0,1,15,25,false,true,false,0.43,0.57
332,216,116,19.529412,13.5,116,925,801,124,1,0,0.058824,0,-2,17,16,-20,0,0,7,9,false,true,true,1,0
26,34,-8,13,34,-8,1606,1544,62,0,0,0,0,92,2,1,0.48913,1,0,14,7,false,true,false,0.443,0.557
285,250,35,15,13.888889,35,826,771,55,0,0,0,0,-5,19,18,-9,0,0,7,7,false,true,true,0.994,0.006
164,221,-57,23.428571,31.571429,-57,1554,1716,-162,1,1,0.142857,0.142857,43,7,7,0.813953,0,0,18,8,false,true,false,0.302,0.698
73,53,20,14.6,10.6,20,1069,1040,29,0,0,0,0,64,5,5,0.6875,0,2,22,10,false,true,true,0.658,0.342
277,256,21,23.083333,21.333333,21,758,796,-38,0,0,0,0,16,12,12,2.375,0,0,11,8,false,true,true,0.89,0.11
379,287,92,23.6875,17.9375,92,1394,1118,276,0,1,0,0.0625,-8,16,16,-4.625,0,0,14,2,false,true,true,1,0
24,18,6,24,18,6,1510,1583,-73,0,0,0,0,89,1,1,0.359551,1,0,7,22,false,true,true,0.728,0.272
88,84,4,22,21,4,1237,1277,-40,0,0,0,0,66,4,4,0.439394,0,0,19,20,false,true,false,0.452,0.548
264,264,0,16.5,16.5,0,859,822,37,0,0,0,0,-5,16,16,-7.6,1,0,9,8,false,true,true,0.843,0.157
428,408,20,26.75,27.2,20,1935,2020,-85,0,1,0,0.066667,-17,16,15,-1.823529,0,0,1,2,true,true,true,0.996,0.004
359,288,71,32.636364,26.181818,71,1197,1127,70,0,0,0,0,10,11,11,3,1,0,14,9,false,true,true,1,0
341,317,24,20.058824,19.8125,24,869,820,49,0,1,0,0.0625,-16,17,16,-2.3125,0,0,4,5,false,true,true,0.912,0.088
399,319,80,15.346154,12.76,80,1583,1422,161,1,0,0.038462,0,-18,26,25,-2.833333,0,0,2,7,true,true,true,1,0
330,336,-6,17.368421,18.666667,-6,1782,1512,270,1,1,0.052632,0.055556,-21,19,18,-2,0,0,2,1,false,true,true,1,0
315,264,51,19.6875,17.6,51,1210,1253,-43,0,1,0,0.066667,-8,16,15,-4.375,1,0,4,11,false,true,true,0.984,0.016
319,286,33,17.722222,15.888889,33,1159,1051,108,0,0,0,0,-15,18,18,-2.666667,0,0,5,8,false,true,true,0.997,0.003
245,224,21,20.416667,20.363636,21,1782,1512,270,1,1,0.083333,0.090909,24,12,11,1.75,0,0,11,12,false,true,true,1,0
193,106,87,27.571429,17.666667,87,1051,1030,21,0,0,0,0,52,7,6,0.576923,0,0,11,7,false,true,true,0.952,0.048
369,312,57,23.0625,20.8,57,1554,1622,-68,2,0,0.125,0,-19,16,15,-1.631579,0,0,3,4,true,true,true,1,0
83,116,-33,13.833333,23.2,-33,1265,1045,220,0,0,0,0,58,6,5,0.724138,0,2,20,6,false,true,false,0.104,0.896
248,258,-10,20.666667,21.5,-10,1100,1008,92,1,0,0.083333,0,17,12,12,2.117647,0,0,18,8,false,true,false,0.299,0.701
368,321,47,21.647059,18.882353,47,960,1070,-110,1,0,0.058824,0,-17,17,17,-2.058824,0,0,1,1,false,true,true,1,0
273,184,89,34.125,26.285714,89,1826,1656,170,2,0,0.25,0,35,8,7,0.771429,0,0,7,13,false,true,true,1,0
317,289,28,22.642857,22.230769,28,992,1100,-108,2,0,0.142857,0,6,14,13,5.666667,0,0,14,16,false,true,true,0.862,0.138
57,33,24,14.25,8.25,24,1176,1076,100,0,0,0,0,81,4,4,0.728395,0,0,17,7,false,true,true,0.736,0.264
400,314,86,26.666667,20.933333,86,971,1180,-209,1,1,0.066667,0.066667,-6,15,15,-5.333333,0,0,3,3,false,true,true,1,0
320,258,62,16.842105,13.578947,62,566,542,24,0,0,0,0,-14,19,19,-2.928571,0,0,4,1,false,true,true,1,0
363,308,55,27.923077,25.666667,55,1454,1531,-77,1,1,0.076923,0.083333,0,13,12,0,0,0,8,8,false,true,true,0.991,0.009
42,31,11,14,15.5,11,1156,1114,42,0,0,0,0,77,3,2,0.415584,1,0,8,7,false,true,true,0.571,0.429
156,209,-53,17.333333,23.222222,-53,947,810,137,0,1,0,0.111111,39,9,9,1.076923,0,0,31,13,false,true,false,0.378,0.622
158,122,36,22.571429,17.428571,36,1397,1422,-25,1,0,0.142857,0,57,7,7,0.631579,0,2,7,8,false,true,true,0.681,0.319
231,184,47,23.1,18.4,47,1170,1156,14,1,0,0.1,0,28,10,10,1.357143,1,0,8,13,false,true,true,0.958,0.042
61,34,27,20.333333,11.333333,27,1181,1069,112,0,0,0,0,77,3,3,0.480519,1,0,12,17,false,true,true,0.887,0.113
288,262,26,16,14.555556,26,371,435,-64,0,0,0,0,-18,18,18,-2.444444,0,0,4,3,false,true,true,0.984,0.016
208,139,69,18.909091,12.636364,69,415,518,-103,0,0,0,0,34,11,11,1.117647,1,0,12,20,false,true,true,0.98,0.02
124,79,45,20.666667,13.166667,45,904,783,121,0,0,0,0,64,6,6,0.65625,1,0,15,27,false,true,true,0.927,0.073
28,0,28,28,0,28,916,837,79,0,0,0,0,96,1,0,0.416667,0,0,10,0,false,true,true,0.703,0.297
262,261,1,18.714286,20.076923,1,1181,1149,32,0,1,0,0.076923,20,14,13,2.25,1,0,8,21,false,true,true,0.508,0.492
320,219,101,21.333333,15.642857,101,1055,1050,5,0,0,0,0,4,15,14,8.5,1,0,6,9,false,true,true,1,0
543,193,350,36.2,13.785714,350,1431,825,606,2,1,0.133333,0.071429,0,15,14,0,0,0,4,16,false,true,true,1,0
350,336,14,16.666667,16,14,1782,1512,270,1,1,0.047619,0.047619,-26,21,21,-1.615385,0,0,1,1,true,true,true,1,0
85,69,16,21.25,17.25,16,904,783,121,0,0,0,0,73,4,4,0.575342,1,0,11,18,false,true,true,0.869,0.131
161,134,27,26.833333,22.333333,27,1030,998,32,0,0,0,0,53,6,6,0.716981,0,0,7,15,false,true,true,0.735,0.265
268,284,-16,24.363636,25.818182,-16,1636,1576,60,0,2,0,0.181818,15,11,11,2.266667,0,0,17,18,false,true,false,0.421,0.579
184,157,27,20.444444,17.444444,27,518,533,-15,1,0,0.111111,0,35,9,9,1,0,0,14,7,false,true,true,0.889,0.111
232,214,18,21.090909,19.454545,18,1078,1130,-52,0,1,0,0.090909,25,11,11,1.56,0,0,11,27,false,true,true,0.73,0.27
93,107,-14,15.5,17.833333,-14,1221,1266,-45,0,0,0,0,56,6,6,0.625,0,0,7,16,false,true,false,0.272,0.728
370,300,70,23.125,18.75,70,804,988,-184,2,0,0.125,0,-17,16,16,-1.941176,0,0,1,3,false,true,true,1,0
216,233,-17,24,29.125,-17,1885,1846,39,1,1,0.111111,0.125,27,9,8,1.074074,1,0,24,8,false,true,true,0.583,0.417
356,219,137,27.384615,18.25,137,1075,1027,48,2,0,0.153846,0,9,13,12,4.111111,0,1,26,9,false,true,true,1,0
402,262,140,19.142857,13.1,140,1413,1422,-9,0,0,0,0,-20,21,20,-2.85,0,0,5,7,false,true,true,1,0
216,200,16,24,22.222222,16,977,976,1,0,0,0,0,42,9,9,0.809524,1,0,8,7,false,true,true,0.758,0.242
182,150,32,18.2,15,32,416,306,110,0,0,0,0,36,10,10,1.166667,0,0,14,13,false,true,true,0.934,0.066
94,38,56,31.333333,19,56,809,868,-59,1,0,0.333333,0,78,3,2,0.410256,0,0,16,7,false,true,true,0.63,0.37
113,110,3,14.125,13.75,3,719,614,105,0,0,0,0,49,8,8,0.877551,0,1,18,9,false,true,true,0.642,0.358
76,18,58,25.333333,9,58,1127,1176,-49,0,0,0,0,81,3,2,0.518519,0,0,18,11,false,true,true,0.657,0.343
168,125,43,24,17.857143,43,1489,1445,44,0,0,0,0,48,7,7,0.666667,0,0,12,11,false,true,true,0.61,0.39
396,310,86,24.75,20.666667,86,1428,1606,-178,1,0,0.0625,0,-15,16,15,-2.133333,0,0,2,1,false,true,true,1,0
359,265,94,17.95,13.25,94,925,801,124,1,0,0.05,0,-21,20,20,-1.904762,0,0,2,4,true,true,true,1,0
218,229,-11,27.25,28.625,-11,1075,1009,66,1,0,0.125,0,37,8,8,0.864865,0,0,8,7,false,true,false,0.45,0.55
192,171,21,21.333333,21.375,21,892,788,104,1,0,0.111111,0,46,9,8,0.934783,0,0,10,16,false,true,false,0.438,0.562
80,80,0,16,16,0,1176,1127,49,0,0,0,0,64,5,5,0.578125,0,0,11,11,false,true,false,0.331,0.669
113,85,28,18.833333,17,28,1029,1075,-46,0,0,0,0,63,6,5,0.761905,1,0,6,13,false,true,true,0.636,0.364
328,312,16,16.4,15.6,16,947,810,137,0,1,0,0.05,-24,20,20,-1.75,0,0,2,7,false,true,true,0.902,0.098
103,99,4,14.714286,16.5,4,908,859,49,0,0,0,0,55,7,6,0.709091,1,0,11,15,false,true,true,0.569,0.431
52,98,-46,26,49,-46,834,844,-10,0,1,0,0.5,81,2,2,0.444444,0,0,10,17,false,true,false,0.272,0.728
302,275,27,15.894737,15.277778,27,95,360,-265,0,1,0,0.055556,-24,19,18,-1.666667,0,0,2,3,false,true,true,0.998,0.002
208,198,10,23.111111,22,10,907,752,155,0,0,0,0,36,9,9,0.916667,0,1,13,10,false,true,true,0.566,0.434
52,49,3,26,24.5,3,921,1072,-151,0,0,0,0,83,2,2,0.457831,0,0,9,9,false,true,false,0.218,0.782
330,311,19,16.5,16.368421,19,1078,1130,-52,0,1,0,0.052632,-30,20,19,-1.3,0,0,1,1,true,true,true,1,0
67,27,40,16.75,9,40,777,830,-53,0,0,0,0,76,4,3,0.539474,0,0,14,10,false,true,true,0.568,0.432
164,203,-39,18.222222,22.555556,-39,1277,1166,111,0,1,0,0.111111,37,9,9,0.972973,0,0,16,9,false,true,false,0.264,0.736
61,46,15,15.25,15.333333,15,947,909,38,0,0,0,0,78,4,3,0.589744,1,0,18,25,false,true,true,0.814,0.186
149,69,80,29.8,13.8,80,976,965,11,0,0,0,0,62,5,5,0.516129,0,0,14,26,false,true,true,0.957,0.043
391,285,106,24.4375,19,106,1050,1144,-94,0,1,0,0.066667,-11,16,15,-3.454545,0,0,7,15,false,true,true,1,0
318,285,33,15.9,14.25,33,904,857,47,0,0,0,0,-24,20,20,-1.708333,0,0,8,1,false,true,true,1,0
232,216,16,23.2,21.6,16,948,933,15,1,0,0.1,0,39,10,10,0.974359,0,0,9,13,false,true,true,0.642,0.358
367,309,58,22.9375,19.3125,58,1216,1228,-12,1,0,0.0625,0,-8,16,16,-4.125,0,0,7,1,false,true,true,1,0
118,60,58,39.333333,20,58,791,885,-94,1,0,0.333333,0,74,3,3,0.513514,0,0,14,12,false,true,false,0.377,0.623
178,120,58,29.666667,20,58,1210,1252,-42,1,0,0.166667,0,56,6,6,0.571429,0,0,8,31,false,true,true,0.886,0.114
379,307,72,21.055556,18.058824,72,1089,1063,26,1,0,0.055556,0,-17,18,17,-2.235294,0,0,1,6,false,true,true,1,0
403,313,90,21.210526,17.388889,90,1075,1152,-77,0,1,0,0.055556,-19,19,18,-2.105263,0,0,2,6,false,true,true,1,0
259,145,114,32.375,20.714286,114,1237,1277,-40,0,0,0,0,40,8,7,0.725,1,1,8,9,false,true,true,0.951,0.049
264,238,26,16.5,15.866667,26,904,857,47,0,0,0,0,1,16,15,41,1,0,17,10,false,true,true,0.9,0.1
56,6,50,28,6,50,1408,1454,-46,0,0,0,0,90,2,1,0.355556,2,0,5,9,false,true,true,0.821,0.179
174,152,22,24.857143,21.714286,22,907,752,155,0,0,0,0,52,7,7,0.634615,0,0,9,11,false,true,true,0.699,0.301
313,265,48,19.5625,17.666667,48,1572,1550,22,1,0,0.0625,0,-1,16,15,-39,0,1,16,8,false,true,true,1,0
403,341,62,26.866667,24.357143,62,1408,1454,-46,1,0,0.066667,0,-4,15,14,-8,0,0,2,5,false,true,true,1,0
177,89,88,29.5,17.8,88,1156,1114,42,1,0,0.166667,0,51,6,5,0.627451,0,0,19,10,false,true,true,0.969,0.031
111,81,30,18.5,13.5,30,527,581,-54,0,0,0,0,58,6,6,0.724138,1,0,6,20,false,true,true,0.785,0.215
270,237,33,27,23.7,33,1142,1095,47,1,0,0.1,0,22,10,10,1.590909,0,0,16,16,false,true,true,0.852,0.148
371,274,97,23.1875,17.125,97,1651,1691,-40,1,0,0.0625,0,-14,16,16,-2.428571,1,0,3,3,false,true,true,1,0
241,197,44,21.909091,17.909091,44,1548,1493,55,1,0,0.090909,0,25,11,11,1.64,0,0,7,18,false,true,true,0.969,0.031
322,285,37,23,21.923077,37,1096,1009,87,2,0,0.142857,0,22,14,13,2,0,0,10,10,false,true,true,0.9,0.1
99,77,22,11,8.555556,22,310,359,-49,0,0,0,0,38,9,9,1.289474,1,0,6,18,false,true,true,0.944,0.056
282,191,91,18.8,13.642857,91,1227,1060,167,0,1,0,0.071429,7,15,14,5.714286,0,0,14,16,false,true,true,0.988,0.012
326,328,-2,21.733333,21.866667,-2,1100,1008,92,1,0,0.066667,0,-6,15,15,-6,0,0,7,4,false,true,false,0.435,0.565
165,78,87,27.5,15.6,87,1334,1256,78,1,0,0.166667,0,64,6,5,0.484375,0,0,13,8,false,true,true,0.977,0.023
101,114,-13,11.222222,12.666667,-13,539,632,-93,0,0,0,0,49,9,9,0.938776,0,1,25,13,false,true,false,0.275,0.725
323,270,53,17,15,53,450,412,38,0,0,0,0,-27,19,18,-1.407407,0,0,1,3,false,true,true,1,0
360,207,153,17.142857,9.857143,153,1176,1076,100,0,0,0,0,6,21,21,9.833333,0,0,10,16,false,true,true,1,0
302,295,7,15.894737,15.526316,7,500,567,-67,0,0,0,0,-10,19,19,-4.4,0,0,6,15,false,true,true,0.817,0.183
218,212,6,21.8,21.2,6,1344,1209,135,1,1,0.1,0.1,25,10,10,1.36,0,0,10,18,false,true,true,0.659,0.341
81,108,-27,13.5,18,-27,576,494,82,0,0,0,0,63,6,6,0.698413,0,0,10,16,false,true,true,0.511,0.489
92,28,64,18.4,7,64,901,889,12,0,0,0,0,78,5,4,0.551282,1,1,8,9,false,true,true,0.693,0.307
309,242,67,20.6,17.285714,67,1551,1550,1,0,0,0,0,0,15,14,0,0,1,15,13,false,true,true,1,0
373,300,73,17.761905,15,73,505,95,410,0,1,0,0.05,-21,21,20,-2.095238,0,0,2,5,false,true,true,0.985,0.015
164,130,34,18.222222,16.25,34,1397,1422,-25,1,0,0.111111,0,50,9,8,0.72,0,2,9,18,false,true,false,0.294,0.706
305,259,46,25.416667,23.545455,46,1154,1062,92,2,0,0.166667,0,18,12,11,1.944444,0,0,19,10,false,true,true,0.949,0.051
183,166,17,20.333333,20.75,17,1572,1550,22,1,0,0.111111,0,42,9,8,0.928571,0,0,16,7,false,true,false,0.41,0.59
184,165,19,23,20.625,19,1170,1156,14,1,0,0.125,0,43,8,8,0.883721,1,0,15,18,false,true,true,0.809,0.191
183,171,12,15.25,15.545455,12,576,494,82,0,0,0,0,32,12,11,1.375,0,0,9,16,false,true,true,0.704,0.296
154,101,53,22,16.833333,53,1305,1390,-85,0,0,0,0,55,7,6,0.654545,0,0,7,20,false,true,true,0.587,0.413
302,255,47,20.133333,17,47,1221,1258,-37,1,0,0.066667,0,8,15,15,4.875,0,0,7,10,false,true,true,0.961,0.039
340,326,14,16.190476,15.52381,14,1127,1176,-49,0,0,0,0,-20,21,21,-2.1,0,0,2,1,true,true,true,1,0
56,70,-14,11.2,14,-14,826,771,55,0,0,0,0,72,5,5,0.625,0,0,8,21,false,true,true,0.507,0.493
244,180,64,22.181818,16.363636,64,1055,1050,5,0,0,0,0,27,11,11,1.259259,0,0,14,8,false,true,true,0.978,0.022
438,288,150,15.103448,9.931034,150,1176,1076,100,0,0,0,0,-32,29,29,-1.84375,0,0,1,3,false,true,true,1,0
101,74,27,20.2,18.5,27,691,473,218,0,0,0,0,65,5,4,0.553846,0,0,17,10,false,true,true,0.724,0.276
170,103,67,21.25,14.714286,67,834,758,76,0,0,0,0,50,8,7,0.72,0,1,16,10,false,true,true,0.949,0.051
318,285,33,15.142857,14.25,33,904,857,47,0,0,0,0,-24,21,20,-1.708333,0,0,8,1,true,true,true,1,0
52,29,23,26,29,23,704,691,13,0,0,0,0,88,2,1,0.431818,0,0,14,10,false,true,true,0.602,0.398
388,238,150,20.421053,12.526316,150,303,342,-39,0,0,0,0,-21,19,19,-1.809524,0,0,1,1,true,true,true,1,0
24,20,4,24,20,4,786,757,29,0,0,0,0,90,1,1,0.433333,0,0,16,14,false,true,true,0.652,0.348
239,173,66,23.9,19.222222,66,1295,1281,14,0,0,0,0,40,10,9,0.95,0,1,7,16,false,true,true,0.796,0.204
97,39,58,48.5,19.5,58,992,1100,-108,1,0,0.5,0,81,2,2,0.419753,1,0,7,13,false,true,true,0.773,0.227
54,68,-14,13.5,17,-14,1100,1008,92,0,0,0,0,77,4,4,0.467532,2,0,7,13,false,true,true,0.873,0.127
86,13,73,43,13,73,371,336,35,1,0,0.5,0,85,2,1,0.447059,1,0,10,10,false,true,true,0.933,0.067
125,115,10,15.625,16.428571,10,1176,1127,49,0,0,0,0,44,8,7,0.840909,0,0,13,26,false,true,false,0.474,0.526
382,346,36,27.285714,24.714286,36,1454,1531,-77,1,1,0.071429,0.071429,-9,14,14,-3.333333,0,0,3,4,false,true,true,0.999,0.001
28,0,28,28,0,28,1513,1482,31,0,0,0,0,94,1,0,0.351064,0,0,12,0,false,true,true,0.574,0.426
224,170,54,28,21.25,54,1167,1216,-49,1,0,0.125,0,42,8,8,0.97619,1,0,10,14,false,true,true,0.951,0.049
78,78,0,13,13,0,719,614,105,0,0,0,0,60,6,6,0.716667,0,2,22,14,false,true,false,0.468,0.532
337,286,51,19.823529,16.823529,51,1572,1550,22,1,0,0.058824,0,-9,17,17,-4.333333,0,0,11,3,false,true,true,0.997,0.003
394,330,64,23.176471,19.411765,64,901,1159,-258,2,0,0.117647,0,-18,17,17,-1.944444,0,0,10,4,false,true,true,1,0
77,33,44,38.5,16.5,44,1348,1331,17,0,0,0,0,83,2,2,0.289157,1,0,14,9,false,true,true,0.744,0.256
321,238,83,35.666667,26.444444,83,1197,1127,70,0,0,0,0,25,9,9,1.2,0,0,13,11,false,true,true,1,0
143,135,8,23.833333,22.5,8,844,821,23,0,0,0,0,66,6,6,0.636364,0,0,12,7,false,true,true,0.649,0.351
208,124,84,23.111111,15.5,84,939,907,32,0,0,0,0,47,9,8,0.851064,1,0,13,17,false,true,true,0.996,0.004
42,110,-68,21,55,-68,1454,1531,-77,0,1,0,0.5,84,2,2,0.357143,1,0,10,11,false,true,false,0.442,0.558
245,237,8,17.5,18.230769,8,95,378,-283,0,0,0,0,2,14,13,17.5,0,0,16,10,false,true,true,0.53,0.47
98,126,-28,12.25,18,-28,450,412,38,0,0,0,0,46,8,7,0.826087,1,0,19,12,false,true,true,0.525,0.475
0,0,0,0,0,0,1388,1506,-118,0,0,0,0,100,1,0,0.34,1,0,6,0,false,true,true,0.58,0.42
248,211,37,19.076923,17.583333,37,468,542,-74,0,0,0,0,16,13,12,2.4375,1,0,13,10,false,true,true,0.901,0.099
271,88,183,19.357143,6.769231,183,896,818,78,0,0,0,0,29,14,13,1.517241,1,1,13,6,false,true,true,1,0
133,109,24,19,15.571429,24,1164,1201,-37,0,0,0,0,53,7,7,0.792453,0,1,19,11,false,true,true,0.746,0.254
56,41,15,18.666667,20.5,15,1029,1227,-198,0,0,0,0,79,3,2,0.405063,0,0,16,16,false,true,false,0.207,0.793
66,88,-22,16.5,22,-22,1583,1422,161,0,0,0,0,75,4,4,0.68,0,0,17,11,false,true,false,0.295,0.705
162,136,26,16.2,15.111111,26,859,822,37,0,0,0,0,34,10,9,1.117647,0,0,19,16,false,true,true,0.691,0.309
345,308,37,19.166667,17.111111,37,1221,1258,-37,1,0,0.055556,0,-12,18,18,-3.25,1,0,3,5,false,true,true,0.999,0.001
336,314,22,17.684211,16.526316,22,758,796,-38,0,0,0,0,-23,19,19,-1.652174,0,0,1,1,true,true,true,1,0
327,247,80,20.4375,15.4375,80,518,533,-15,1,0,0.0625,0,-16,16,16,-2.1875,0,0,5,1,false,true,true,1,0
349,278,71,14.541667,12.086957,71,272,288,-16,0,0,0,0,-26,24,23,-2,0,0,1,2,false,true,true,1,0
199,122,77,24.875,17.428571,77,866,949,-83,0,0,0,0,47,8,7,0.851064,0,0,12,16,false,true,true,0.833,0.167
35,22,13,17.5,22,13,1237,1277,-40,0,0,0,0,86,2,1,0.337209,0,0,7,7,false,true,true,0.503,0.497
338,314,24,17.789474,16.526316,24,1270,1348,-78,0,0,0,0,-17,19,19,-2.235294,0,0,2,4,true,true,true,1,0
145,111,34,18.125,13.875,34,363,668,-305,0,0,0,0,58,8,8,0.741379,0,0,9,21,false,true,true,0.718,0.282
187,235,-48,18.7,26.111111,-48,1501,1473,28,0,0,0,0,30,10,9,1.2,0,1,25,16,false,true,false,0.002,0.998
185,125,60,30.833333,25,60,992,1100,-108,2,0,0.333333,0,57,6,5,0.596491,0,0,15,10,false,true,true,0.902,0.098
197,149,48,21.888889,18.625,48,916,837,79,0,0,0,0,46,9,8,0.869565,0,0,12,12,false,true,true,0.876,0.124
88,66,22,29.333333,22,22,995,912,83,1,0,0.333333,0,80,3,3,0.55,0,0,8,14,false,true,true,0.615,0.385
272,184,88,18.133333,13.142857,88,272,288,-16,0,0,0,0,22,15,14,2.363636,0,0,12,15,false,true,true,0.977,0.023
52,19,33,26,19,33,1349,1302,47,0,0,0,0,89,2,1,0.325843,2,0,6,9,false,true,true,0.772,0.228
387,392,-5,27.642857,30.153846,-5,1489,1558,-69,0,1,0,0.076923,-8,14,13,-3.5,0,0,6,6,false,true,true,0.502,0.498
325,242,83,23.214286,18.615385,83,901,1159,-258,2,0,0.142857,0,8,14,13,4.375,1,0,9,7,false,true,true,0.977,0.023
166,174,-8,27.666667,29,-8,791,885,-94,1,1,0.166667,0.166667,53,6,6,0.716981,0,0,20,11,false,true,true,0.659,0.341
210,215,-5,16.153846,16.538462,-5,272,238,34,0,0,0,0,10,13,13,4,0,0,20,7,false,true,true,0.845,0.155
149,69,80,24.833333,13.8,80,1159,1031,128,1,0,0.166667,0,54,6,5,0.722222,0,0,19,14,false,true,true,0.967,0.033
350,279,71,21.875,17.4375,71,1004,653,351,0,0,0,0,-21,16,16,-1.666667,0,0,3,1,false,true,true,1,0
357,283,74,23.8,20.214286,74,1216,1228,-12,1,0,0.066667,0,4,15,14,8.25,0,1,16,8,false,true,true,1,0
357,244,113,19.833333,13.555556,113,1281,1339,-58,0,0,0,0,-4,18,18,-10.25,0,0,9,3,false,true,true,1,0
346,251,95,26.615385,19.307692,95,977,976,1,1,0,0.076923,0,12,13,13,2.833333,1,0,7,10,false,true,true,1,0
187,125,62,23.375,17.857143,62,1489,1445,44,0,0,0,0,44,8,7,0.727273,0,0,14,11,false,true,true,0.663,0.337
96,129,-33,16,25.8,-33,613,611,2,0,0,0,0,57,6,5,0.666667,0,0,7,21,false,true,false,0.105,0.895
337,299,38,16.047619,14.238095,38,1040,925,115,0,0,0,0,-34,21,21,-1.264706,0,0,10,1,false,true,true,1,0
50,49,1,16.666667,16.333333,1,719,651,68,0,0,0,0,84,3,3,0.535714,1,0,23,9,false,true,true,0.885,0.115
154,168,-14,14,15.272727,-14,904,857,47,0,0,0,0,31,11,11,1.322581,0,0,10,14,false,true,true,0.52,0.48
92,108,-16,23,27,-16,1333,1331,2,0,0,0,0,66,4,4,0.454545,1,0,20,14,false,true,true,0.621,0.379
238,199,39,21.636364,19.9,39,1210,1253,-43,0,1,0,0.1,24,11,10,1.458333,1,0,9,13,false,true,true,0.947,0.053
336,318,18,16,15.142857,18,628,658,-30,0,0,0,0,-22,21,21,-2.090909,0,0,3,5,false,true,true,1,0
420,296,124,24.705882,18.5,124,1101,1078,23,1,0,0.058824,0,-15,17,16,-2.2,0,1,1,1,true,true,true,1,0
398,285,113,30.615385,23.75,113,1645,1777,-132,2,0,0.153846,0,-9,13,12,-2.777778,0,0,3,1,true,true,true,1,0
32,16,16,16,16,16,1077,1094,-17,0,0,0,0,85,2,1,0.494118,0,0,22,21,false,true,false,0.494,0.506
281,206,75,25.545455,18.727273,75,1216,1217,-1,1,0,0.090909,0,19,11,11,1.789474,0,0,9,11,false,true,true,0.99,0.01
317,224,93,21.133333,14.933333,93,518,533,-15,1,0,0.066667,0,-9,15,15,-3.888889,0,0,9,9,false,true,true,1,0
12,23,-11,12,23,-11,480,518,-38,0,0,0,0,93,1,1,0.494624,0,0,10,14,false,true,false,0.271,0.729
387,309,78,35.181818,30.9,78,1348,1331,17,4,1,0.363636,0.1,-4,11,10,-6,0,0,1,9,false,true,true,0.996,0.004
421,294,127,26.3125,18.375,127,1023,1070,-47,2,0,0.125,0,-15,16,16,-2.133333,0,0,1,11,true,true,true,1,0
226,208,18,20.545455,18.909091,18,804,988,-184,1,0,0.090909,0,22,11,11,1.5,1,0,6,19,false,true,true,0.858,0.142
251,213,38,16.733333,14.2,38,777,830,-53,0,0,0,0,8,15,15,5.125,0,0,19,10,false,true,true,0.929,0.071
221,202,19,20.090909,20.2,19,1127,1134,-7,0,0,0,0,22,11,10,1.363636,0,1,20,9,false,true,false,0.342,0.658
238,164,74,21.636364,14.909091,74,561,526,35,0,0,0,0,13,11,11,2.692308,0,0,7,14,false,true,true,0.995,0.005
334,176,158,18.555556,9.777778,158,421,306,115,0,1,0,0.055556,-9,18,18,-4.888889,0,0,11,9,false,true,true,1,0
105,123,-18,15,20.5,-18,95,360,-265,0,1,0,0.166667,47,7,6,0.851064,0,0,9,19,false,true,false,0.441,0.559
18,13,5,9,13,5,1221,1258,-37,0,0,0,0,91,2,1,0.428571,0,0,13,15,false,true,false,0.324,0.676
37,46,-9,18.5,23,-9,1550,1466,84,0,0,0,0,86,2,2,0.430233,1,0,6,24,false,true,false,0.432,0.568
324,268,56,19.058824,16.75,56,864,808,56,1,0,0.058824,0,-23,17,16,-1.478261,0,0,10,5,false,true,true,0.997,0.003
195,138,57,27.857143,19.714286,57,1388,1506,-118,2,1,0.285714,0.142857,51,7,7,0.666667,0,0,12,16,false,true,true,0.975,0.025
138,171,-33,15.333333,21.375,-33,262,306,-44,0,0,0,0,50,9,8,0.92,0,0,13,9,false,true,false,0.154,0.846
12,14,-2,12,14,-2,859,822,37,0,0,0,0,91,1,1,0.417582,0,0,13,7,false,true,true,0.563,0.437
227,203,24,16.214286,14.5,24,613,502,111,0,0,0,0,6,14,14,8.166667,1,1,7,18,false,true,true,0.74,0.26
247,197,50,35.285714,28.142857,50,1890,2020,-130,1,1,0.142857,0.142857,36,7,7,0.805556,0,0,13,7,false,true,true,0.939,0.061
177,120,57,29.5,20,57,880,952,-72,0,0,0,0,57,6,6,0.614035,0,0,15,13,false,true,true,0.834,0.166
204,218,-14,20.4,24.222222,-14,971,761,210,0,0,0,0,30,10,9,1,0,0,11,13,false,true,false,0.197,0.803
326,336,-10,18.111111,18.666667,-10,1782,1512,270,1,1,0.055556,0.055556,-19,18,18,-2.210526,0,0,3,1,false,true,true,1,0
177,137,40,16.090909,12.454545,40,584,565,19,0,0,0,0,29,11,11,1.586207,0,0,7,9,false,true,true,0.991,0.009
219,117,102,27.375,16.714286,102,904,668,236,0,0,0,0,42,8,7,0.809524,0,0,9,12,false,true,true,0.977,0.023
340,224,116,26.153846,18.666667,116,1167,1216,-49,1,0,0.076923,0,18,13,12,2.277778,0,0,16,13,false,true,true,1,0
253,274,-21,15.8125,17.125,-21,1043,1055,-12,0,0,0,0,-7,16,16,-5.285714,1,0,18,4,false,true,false,0.469,0.531
171,77,94,34.2,15.4,94,986,856,130,1,0,0.2,0,59,5,5,0.525424,1,0,7,22,false,true,true,0.989,0.011
159,134,25,22.714286,19.142857,25,711,876,-165,0,0,0,0,52,7,7,0.826923,0,0,10,9,false,true,true,0.541,0.459
219,216,3,24.333333,27,3,1096,1009,87,1,0,0.111111,0,50,9,8,0.88,0,0,11,13,false,true,false,0.249,0.751
128,78,50,32,19.5,50,1220,1261,-41,1,0,0.25,0,73,4,4,0.616438,0,0,10,13,false,true,true,0.735,0.265
99,155,-56,19.8,31,-56,758,952,-194,0,0,0,0,53,5,5,0.754717,0,0,14,13,false,true,false,0.072,0.928
258,195,63,28.666667,24.375,63,992,1100,-108,2,0,0.222222,0,33,9,8,1.030303,0,0,11,11,false,true,true,0.936,0.064
383,240,143,31.916667,21.818182,143,1023,1070,-47,2,0,0.166667,0,11,12,11,2.909091,0,0,10,21,false,true,true,1,0
199,145,54,19.9,14.5,54,620,658,-38,0,0,0,0,33,10,10,1.090909,0,0,29,7,false,true,true,0.953,0.047
16,7,9,16,7,9,554,342,212,0,0,0,0,93,1,1,0.387097,0,0,19,17,false,true,true,0.782,0.218
14,29,-15,4.666667,14.5,-15,977,976,1,0,0,0,0,86,3,2,0.395349,0,0,23,7,false,true,false,0.281,0.719
59,38,21,19.666667,12.666667,21,880,952,-72,0,0,0,0,77,3,3,0.532468,0,0,10,7,false,true,true,0.558,0.442
149,100,49,29.8,20,49,1334,1477,-143,0,0,0,0,59,5,5,0.508475,0,2,14,18,false,true,true,0.574,0.426
62,67,-5,15.5,16.75,-5,1176,1127,49,0,0,0,0,70,4,4,0.528571,0,0,14,8,false,true,false,0.367,0.633
46,79,-33,11.5,19.75,-33,1211,1173,38,0,0,0,0,74,4,4,0.472973,0,1,21,6,false,true,false,0.272,0.728
293,244,49,17.235294,14.352941,49,804,683,121,0,0,0,0,-2,17,17,-22.5,0,1,9,14,false,true,true,1,0
246,148,98,30.75,18.5,98,996,1063,-67,1,1,0.125,0.125,34,8,8,0.941176,0,0,11,16,false,true,true,0.988,0.012
144,52,92,48,26,92,971,621,350,1,0,0.333333,0,79,3,2,0.405063,0,0,13,7,false,true,true,0.798,0.202
329,231,98,20.5625,15.4,98,1227,1060,167,0,1,0,0.066667,-1,16,15,-40,0,1,10,7,false,true,true,1,0
107,115,-8,17.833333,19.166667,-8,1142,1176,-34,0,0,0,0,55,6,6,0.654545,1,0,9,16,false,true,false,0.455,0.545
312,181,131,34.666667,20.111111,131,1684,1320,364,1,0,0.111111,0,23,9,9,1.304348,0,1,9,8,false,true,true,1,0
192,177,15,19.2,17.7,15,791,774,17,1,0,0.1,0,43,10,10,0.953488,0,0,9,11,false,true,true,0.728,0.272
214,188,26,17.833333,17.090909,26,1127,1176,-49,0,0,0,0,26,12,11,1.615385,0,1,21,8,false,true,true,0.571,0.429
328,178,150,20.5,11.866667,150,1067,95,972,1,0,0.0625,0,-5,16,15,-6.8,1,0,2,12,false,true,true,1,0
218,99,119,24.222222,12.375,119,1159,1031,128,1,0,0.111111,0,37,9,8,1.054054,1,0,17,14,false,true,true,0.996,0.004
95,131,-36,15.833333,21.833333,-36,596,595,1,0,0,0,0,61,6,6,0.655738,1,0,16,15,false,true,false,0.464,0.536
69,58,11,17.25,14.5,11,491,398,93,0,0,0,0,75,4,4,0.48,0,1,9,14,false,true,true,0.792,0.208
278,208,70,25.272727,20.8,70,306,169,137,0,0,0,0,13,11,10,2.615385,0,1,10,7,false,true,true,0.961,0.039
266,190,76,26.6,21.111111,76,1023,1070,-47,1,0,0.1,0,29,10,9,1.103448,1,0,11,22,false,true,true,0.967,0.033
186,165,21,18.6,18.333333,21,921,1072,-151,1,0,0.1,0,41,10,9,0.926829,0,0,15,7,false,true,true,0.599,0.401
43,51,-8,14.333333,17,-8,1156,1184,-28,0,0,0,0,74,3,3,0.378378,1,0,13,19,false,true,true,0.646,0.354
87,156,-69,12.428571,22.285714,-69,892,788,104,0,0,0,0,60,7,7,0.716667,1,0,15,14,false,true,false,0.412,0.588
32,35,-3,16,17.5,-3,1142,1176,-34,0,0,0,0,84,2,2,0.428571,0,0,7,18,false,true,false,0.396,0.604
339,206,133,26.076923,17.166667,133,939,907,32,1,0,0.076923,0,22,13,12,1.818182,0,0,11,7,false,true,true,1,0
319,311,8,19.9375,19.4375,8,1334,1270,64,1,0,0.0625,0,2,16,16,18.5,0,1,10,5,false,true,false,0.449,0.551
28,0,28,28,0,28,594,605,-11,0,0,0,0,95,1,0,0.389474,0,0,10,0,false,true,true,0.624,0.376
97,46,51,19.4,11.5,51,777,830,-53,0,0,0,0,70,5,4,0.585714,0,0,10,7,false,true,true,0.766,0.234
209,167,42,26.125,20.875,42,1034,1040,-6,1,0,0.125,0,41,8,8,0.853659,1,0,7,20,false,true,true,0.929,0.071
262,162,100,23.818182,16.2,100,1220,1261,-41,2,0,0.181818,0,36,11,10,1.25,0,0,20,16,false,true,true,0.95,0.05
310,245,65,20.666667,17.5,65,971,658,313,0,0,0,0,-2,15,14,-18,1,0,8,10,false,true,true,1,0
57,38,19,14.25,12.666667,19,576,494,82,0,0,0,0,77,4,3,0.571429,0,0,7,21,false,true,true,0.629,0.371
400,230,170,22.222222,13.529412,170,1295,1477,-182,3,0,0.166667,0,-5,18,17,-9.2,0,0,13,11,false,true,true,1,0
301,227,74,21.5,16.214286,74,1170,1156,14,1,0,0.071429,0,4,14,14,9.5,0,0,8,7,false,true,true,0.99,0.01
367,275,92,15.956522,12.5,92,1606,1544,62,0,0,0,0,-16,23,22,-2.8125,0,0,2,2,true,true,true,1,0
353,166,187,27.153846,13.833333,187,1211,1173,38,0,0,0,0,22,13,12,1.590909,0,2,9,7,false,true,true,1,0
199,117,82,28.428571,19.5,82,695,671,24,0,0,0,0,50,7,6,0.66,0,1,9,11,false,true,true,0.947,0.053
316,294,22,19.75,18.375,22,561,526,35,0,0,0,0,-18,16,16,-1.944444,0,0,8,9,false,true,true,0.953,0.047
168,91,77,24,15.166667,77,1489,1445,44,0,0,0,0,53,7,6,0.603774,0,0,12,8,false,true,true,0.829,0.171
386,322,64,19.3,16.1,64,539,500,39,0,0,0,0,-30,20,20,-1.333333,0,0,4,1,true,true,true,1,0
289,207,82,24.083333,18.818182,82,1216,1228,-12,1,0,0.083333,0,27,12,11,1.222222,0,0,11,11,false,true,true,0.987,0.013
219,213,6,19.909091,19.363636,6,349,315,34,0,0,0,0,11,11,11,3.090909,0,0,7,14,false,true,true,0.784,0.216
107,68,39,26.75,17,39,704,691,13,0,0,0,0,71,4,4,0.535211,0,0,12,11,false,true,true,0.921,0.079
214,130,84,23.777778,16.25,84,808,639,169,0,0,0,0,37,9,8,1.108108,0,0,15,10,false,true,true,0.963,0.037
108,77,31,21.6,15.4,31,834,758,76,0,0,0,0,66,5,5,0.545455,0,1,11,12,false,true,true,0.857,0.143
324,276,48,24.923077,23,48,1554,1573,-19,1,0,0.076923,0,18,13,12,1.888889,0,1,19,9,false,true,true,0.837,0.163
455,363,92,37.916667,33,92,1885,1793,92,0,0,0,0,5,12,11,5.4,0,0,7,8,false,true,true,1,0
251,185,66,22.818182,16.818182,66,580,620,-40,1,0,0.090909,0,30,11,11,1.433333,0,0,12,7,false,true,true,0.947,0.053
22,0,22,22,0,22,1439,1294,145,0,0,0,0,94,1,0,0.382979,0,0,17,0,false,true,true,0.596,0.404
14,0,14,14,0,14,834,758,76,0,0,0,0,95,1,0,0.378947,0,0,8,0,false,true,true,0.619,0.381
16,0,16,16,0,16,1885,1846,39,0,0,0,0,95,1,0,0.305263,1,0,8,0,false,true,true,0.724,0.276
173,123,50,28.833333,24.6,50,1489,1555,-66,1,0,0.166667,0,54,6,5,0.537037,0,0,11,18,false,true,true,0.661,0.339
123,150,-27,17.571429,21.428571,-27,596,595,1,0,0,0,0,54,7,7,0.740741,1,0,8,12,false,true,true,0.511,0.489
382,247,135,17.363636,11.761905,135,595,543,52,0,0,0,0,-29,22,21,-1.62069,0,0,7,5,false,true,true,1,0
224,243,-19,14.933333,16.2,-19,500,567,-67,0,0,0,0,18,15,15,2.444444,0,1,9,10,false,true,false,0.287,0.713
406,229,177,29,17.615385,177,1101,1078,23,1,0,0.071429,0,1,14,13,33,0,1,10,17,false,true,true,1,0
134,100,34,26.8,20,34,691,675,16,0,0,0,0,66,5,5,0.560606,0,1,8,7,false,true,true,0.855,0.145
373,265,108,28.692308,22.083333,108,1245,1241,4,2,1,0.153846,0.083333,-9,13,12,-3.222222,0,0,6,8,false,true,true,1,0
372,364,8,18.6,19.157895,8,1265,1045,220,0,1,0,0.052632,-30,20,19,-1.4,0,0,1,4,false,true,true,0.547,0.453
358,268,90,21.058824,16.75,90,1516,1397,119,0,1,0,0.0625,-14,17,16,-2.357143,0,1,1,6,true,true,true,1,0
197,126,71,21.888889,15.75,71,830,907,-77,1,0,0.111111,0,40,9,8,0.975,0,0,9,17,false,true,true,0.945,0.055
97,62,35,19.4,15.5,35,500,567,-67,0,0,0,0,74,5,4,0.594595,0,0,7,10,false,true,false,0.491,0.509
120,80,40,40,26.666667,40,1344,1325,19,1,0,0.333333,0,71,3,3,0.43662,0,0,12,19,false,true,true,0.583,0.417
134,74,60,44.666667,24.666667,60,416,282,134,1,0,0.333333,0,74,3,3,0.459459,0,0,22,22,false,true,true,0.917,0.083
54,45,9,27,22.5,9,576,532,44,0,0,0,0,83,2,2,0.554217,1,0,8,7,false,true,true,0.84,0.16
24,0,24,24,0,24,830,907,-77,0,0,0,0,95,1,0,0.410526,0,0,11,0,false,true,false,0.428,0.572
320,224,96,26.666667,18.666667,96,1167,1216,-49,1,0,0.083333,0,21,12,12,1.952381,0,0,9,13,false,true,true,0.999,0.001
98,152,-54,24.5,38,-54,1454,1531,-77,0,1,0,0.25,69,4,4,0.434783,2,0,9,9,false,true,false,0.464,0.536
334,235,99,23.857143,16.785714,99,596,595,1,1,0,0.071429,0,6,14,14,6.666667,0,0,7,23,false,true,true,1,0
310,176,134,28.181818,16,134,1482,1394,88,2,0,0.181818,0,24,11,11,1.5,0,0,10,11,false,true,true,1,0
302,265,37,21.571429,20.384615,37,786,976,-190,0,0,0,0,2,14,13,16,0,0,8,14,false,true,false,0.476,0.524
248,164,84,19.076923,13.666667,84,1281,1339,-58,0,0,0,0,30,13,12,1.366667,0,0,16,7,false,true,true,0.987,0.013
332,295,37,20.75,19.666667,37,315,294,21,0,1,0,0.066667,-20,16,15,-1.75,0,0,6,3,false,true,true,0.992,0.008
218,188,30,14.533333,12.533333,30,416,374,42,0,0,0,0,19,15,15,2.421053,0,0,14,10,false,true,true,0.955,0.045
319,237,82,24.538462,19.75,82,1050,1144,-94,0,1,0,0.083333,12,13,12,3.166667,0,1,15,9,false,true,true,0.997,0.003
419,237,182,29.928571,16.928571,182,1513,1482,31,1,0,0.071429,0,-5,14,14,-6.6,0,1,5,19,false,true,true,1,0
46,0,46,46,0,46,290,416,-126,0,0,0,0,95,1,0,0.357895,0,0,9,0,false,true,false,0.478,0.522
315,258,57,15,12.9,57,299,315,-16,0,0,0,0,-37,21,20,-1.135135,0,0,2,4,false,true,true,1,0
316,203,113,15.8,10.684211,113,1128,889,239,0,1,0,0.052632,-12,20,19,-3.916667,0,1,10,15,false,true,true,1,0
22,0,22,22,0,22,1022,1095,-73,0,0,0,0,97,1,0,0.340206,0,0,20,0,false,true,true,0.549,0.451
139,114,25,17.375,16.285714,25,527,514,13,0,0,0,0,45,8,7,0.866667,0,1,10,21,false,true,true,0.527,0.473
287,290,-3,22.076923,22.307692,-3,1210,1252,-42,1,0,0.076923,0,7,13,13,4.571429,0,0,7,10,false,true,false,0.244,0.756
47,42,5,11.75,14,5,826,771,55,0,0,0,0,82,4,3,0.54878,0,0,8,13,false,true,false,0.463,0.537
134,152,-18,26.8,38,-18,1419,1488,-69,0,1,0,0.25,54,5,4,0.518519,0,0,18,13,false,true,false,0.279,0.721
173,147,26,24.714286,21,26,1782,1512,270,1,1,0.142857,0.142857,54,7,7,0.777778,0,0,12,11,false,true,true,1,0
103,129,-26,14.714286,21.5,-26,262,306,-44,0,0,0,0,65,7,6,0.707692,0,1,20,9,false,true,false,0.002,0.998
264,217,47,24,19.727273,47,892,819,73,0,1,0,0.090909,18,11,11,1.888889,0,0,7,12,false,true,true,0.986,0.014
70,70,0,23.333333,23.333333,0,1482,1394,88,0,0,0,0,81,3,3,0.444444,1,0,6,19,false,true,true,0.525,0.475
175,110,65,21.875,13.75,65,939,913,26,0,0,0,0,54,8,8,0.740741,0,1,7,9,false,true,true,0.94,0.06
315,263,52,31.5,29.222222,52,1875,1793,82,2,1,0.2,0.111111,24,10,9,1.25,0,0,10,10,false,true,true,0.982,0.018
131,193,-62,14.555556,21.444444,-62,316,306,10,0,2,0,0.222222,38,9,9,1,0,0,22,16,false,true,true,0.62,0.38
300,159,141,21.428571,11.357143,141,1067,95,972,1,0,0.071429,0,4,14,14,8.5,1,1,6,21,false,true,true,1,0
376,289,87,25.066667,20.642857,87,1156,1114,42,1,0,0.066667,0,-13,15,14,-2.461538,0,0,3,7,false,true,true,1,0
40,14,26,20,14,26,695,523,172,0,0,0,0,85,2,1,0.435294,0,1,11,12,false,true,true,0.78,0.22
310,197,113,44.285714,32.833333,113,1348,1331,17,2,0,0.285714,0,39,7,6,0.615385,0,0,13,12,false,true,true,1,0
307,240,67,20.466667,16,67,711,876,-165,0,0,0,0,0,15,15,0,0,1,11,8,false,true,true,1,0
358,266,92,18.842105,14,92,711,876,-165,0,0,0,0,-14,19,19,-3.071429,0,0,3,2,false,true,true,1,0
293,261,32,16.277778,15.352941,32,719,614,105,0,1,0,0.058824,-16,18,17,-2.6875,0,0,15,9,false,true,true,0.983,0.017
339,307,32,18.833333,18.058824,32,1094,1030,64,0,0,0,0,-20,18,17,-1.8,0,0,2,2,false,true,true,0.999,0.001
215,223,-8,19.545455,20.272727,-8,971,658,313,0,0,0,0,22,11,11,1.636364,0,0,14,9,false,true,false,0.399,0.601
343,191,152,17.15,9.55,152,421,306,115,0,1,0,0.05,-18,20,20,-2.444444,0,0,8,5,false,true,true,1,0
138,127,11,17.25,15.875,11,859,822,37,0,0,0,0,43,8,8,0.883721,0,0,21,18,false,true,true,0.678,0.322
312,250,62,26,20.833333,62,880,952,-72,0,0,0,0,15,12,12,2.333333,0,0,16,10,false,true,true,0.953,0.047
0,0,0,0,0,0,1220,1261,-41,0,0,0,0,100,1,0,0.45,1,0,14,0,false,true,true,0.57,0.43
141,93,48,35.25,23.25,48,1093,1197,-104,1,0,0.25,0,68,4,4,0.455882,0,0,16,13,false,true,false,0.352,0.648
358,265,93,22.375,17.666667,93,1073,1177,-104,1,0,0.0625,0,-14,16,15,-2.285714,0,0,2,1,false,true,true,1,0
30,27,3,15,27,3,1434,1493,-59,0,0,0,0,86,2,1,0.430233,0,0,8,11,false,true,false,0.282,0.718
304,273,31,21.714286,21,31,1710,1636,74,1,1,0.071429,0.076923,10,14,13,3.6,1,0,8,9,false,true,true,0.875,0.125
132,97,35,22,16.166667,35,1245,1232,13,1,0,0.166667,0,49,6,6,0.591837,0,0,20,22,false,true,true,0.773,0.227
16,13,3,16,13,3,527,503,24,0,0,0,0,94,1,1,0.43617,1,0,11,7,false,true,true,0.783,0.217
93,43,50,46.5,21.5,50,1245,1241,4,1,1,0.5,0.5,79,2,2,0.367089,0,0,7,23,false,true,true,0.937,0.063
400,360,40,30.769231,30,40,1890,2020,-130,1,2,0.076923,0.166667,-9,13,12,-3.222222,0,0,6,3,false,true,true,0.982,0.018
355,318,37,19.722222,18.705882,37,1244,1361,-117,2,1,0.111111,0.058824,-6,18,17,-6.333333,0,0,2,14,false,true,true,0.842,0.158
346,295,51,21.625,19.666667,51,1513,1479,34,0,0,0,0,-9,16,15,-3.777778,0,1,1,5,false,true,true,1,0
70,37,33,23.333333,18.5,33,1096,1009,87,0,0,0,0,88,3,2,0.5,1,0,21,20,false,true,true,0.882,0.118
16,14,2,16,14,2,871,999,-128,0,0,0,0,92,1,1,0.521739,0,0,14,23,false,true,false,0.208,0.792
305,252,53,20.333333,18,53,1090,1244,-154,0,0,0,0,-2,15,14,-18.5,0,1,23,11,false,true,true,1,0
278,174,104,18.533333,12.428571,104,871,867,4,0,0,0,0,11,15,14,3.909091,0,1,17,16,false,true,true,1,0
335,290,45,19.705882,17.058824,45,904,783,121,0,0,0,0,-9,17,17,-4.666667,1,0,11,10,false,true,true,1,0
183,139,44,18.3,15.444444,44,1029,1075,-46,0,0,0,0,41,10,9,1.170732,2,0,5,7,false,true,true,0.986,0.014
0,28,-28,0,28,-28,1153,1065,88,0,0,0,0,95,1,1,0.294737,0,1,0,25,false,true,false,0.067,0.933
220,171,49,22,19,49,613,569,44,0,0,0,0,31,10,9,1.258065,1,0,21,7,false,true,true,0.928,0.072
85,76,9,14.166667,15.2,9,699,448,251,0,0,0,0,67,6,5,0.597015,0,0,17,8,false,true,true,0.518,0.482
207,181,26,23,20.111111,26,1548,1493,55,1,0,0.111111,0,36,9,9,1.138889,0,0,12,8,false,true,true,0.639,0.361
193,151,42,24.125,21.571429,42,1153,1065,88,0,1,0,0.142857,31,8,7,0.903226,0,0,14,22,false,true,true,0.854,0.146
8,0,8,8,0,8,721,689,32,0,0,0,0,96,1,0,0.354167,0,0,9,0,false,true,true,0.57,0.43
402,329,73,26.8,21.933333,73,1875,1793,82,2,1,0.133333,0.066667,-10,15,15,-3,0,0,5,2,true,true,true,1,0
229,210,19,17.615385,16.153846,19,1452,1469,-17,0,1,0,0.076923,12,13,13,3.166667,1,0,9,25,false,true,true,0.906,0.094
229,152,77,22.9,16.888889,77,1022,1095,-73,0,0,0,0,30,10,9,1.1,0,1,14,11,false,true,true,0.858,0.142
182,208,-26,20.222222,23.111111,-26,1244,1361,-117,1,1,0.111111,0.111111,46,9,9,0.826087,1,0,9,21,false,true,false,0.22,0.78
128,140,-12,16,20,-12,999,1011,-12,0,0,0,0,49,8,7,0.938776,0,0,13,15,false,true,false,0.264,0.736
12,0,12,12,0,12,1055,1050,5,0,0,0,0,95,1,0,0.357895,0,0,8,0,false,true,true,0.562,0.438
244,240,4,18.769231,18.461538,4,1334,1270,64,1,0,0.076923,0,21,13,13,1.761905,1,0,16,16,false,true,true,0.554,0.446
27,34,-7,13.5,17,-7,1073,1177,-104,0,0,0,0,88,2,2,0.363636,0,1,11,22,false,true,false,0.104,0.896
39,20,19,19.5,20,19,976,965,11,0,0,0,0,86,2,1,0.372093,0,0,11,26,false,true,false,0.404,0.596
167,99,68,20.875,14.142857,68,609,620,-11,0,0,0,0,49,8,7,0.755102,0,0,13,10,false,true,true,0.965,0.035
389,323,66,22.882353,20.1875,66,630,786,-156,1,0,0.058824,0,-9,17,16,-3.888889,0,0,1,2,false,true,true,1,0
133,113,20,22.166667,22.6,20,758,796,-38,0,0,0,0,58,6,5,0.655172,0,0,16,8,false,true,true,0.564,0.436
166,136,30,18.444444,15.111111,30,786,976,-190,0,0,0,0,45,9,9,0.711111,0,0,12,13,false,true,true,0.634,0.366
182,136,46,20.222222,17,46,1244,1361,-117,1,0,0.111111,0,53,9,8,0.716981,1,1,9,6,false,true,false,0.269,0.731
114,95,19,19,19,19,363,668,-305,0,0,0,0,73,6,5,0.589041,1,0,6,13,false,true,false,0.255,0.745
154,115,39,15.4,12.777778,39,658,817,-159,0,0,0,0,47,10,9,0.808511,0,0,23,13,false,true,true,0.584,0.416
223,240,-17,20.272727,24,-17,1554,1573,-19,0,0,0,0,34,11,10,1,0,1,7,6,false,true,false,0.082,0.918
214,115,99,23.777778,14.375,99,1004,653,351,0,0,0,0,32,9,8,1.09375,0,0,15,25,false,true,true,0.983,0.017
376,295,81,19.789474,16.388889,81,880,952,-72,0,0,0,0,-21,19,18,-1.952381,0,0,2,3,false,true,true,1,0
278,251,27,18.533333,17.928571,27,95,378,-283,0,0,0,0,-5,15,14,-7,0,0,6,10,false,true,true,0.851,0.149
267,238,29,24.272727,23.8,29,1244,1361,-117,2,1,0.181818,0.1,33,11,10,1.151515,0,0,16,12,false,true,true,0.921,0.079
333,295,38,19.588235,17.352941,38,448,598,-150,0,0,0,0,-15,17,17,-2.4,0,0,4,8,false,true,true,1,0
190,124,66,15.833333,11.272727,66,1128,889,239,0,1,0,0.090909,32,12,11,1.46875,0,0,24,23,false,true,true,0.982,0.018
290,231,59,29,23.1,59,1004,840,164,1,0,0.1,0,16,10,10,1.875,0,0,10,13,false,true,true,1,0
79,66,13,26.333333,33,13,1302,1234,68,0,0,0,0,80,3,2,0.3875,1,0,6,10,false,true,true,0.621,0.379
57,10,47,28.5,10,47,1210,1253,-43,0,0,0,0,87,2,1,0.402299,0,0,7,9,false,true,true,0.564,0.436
302,222,80,16.777778,13.058824,80,691,675,16,0,0,0,0,-14,18,17,-2.714286,0,0,1,12,false,true,true,1,0
272,197,75,16,12.3125,75,892,768,124,0,0,0,0,9,17,16,4.777778,0,0,14,12,false,true,true,0.988,0.012
82,79,3,16.4,15.8,3,908,859,49,0,0,0,0,64,5,5,0.609375,0,0,8,18,false,true,true,0.554,0.446
42,16,26,21,16,26,1244,1361,-117,0,0,0,0,90,2,1,0.422222,0,0,15,17,false,true,false,0.239,0.761
306,286,20,25.5,26,20,907,752,155,0,1,0,0.090909,19,12,11,1.736842,0,0,8,18,false,true,true,0.685,0.315
288,243,45,13.714286,12.15,45,947,909,38,0,0,0,0,-29,21,20,-1.586207,0,1,4,26,false,true,true,1,0
145,215,-70,14.5,23.888889,-70,613,611,2,0,0,0,0,29,10,9,1.310345,1,0,8,7,false,true,false,0.036,0.964
117,197,-80,14.625,24.625,-80,613,611,2,0,0,0,0,39,8,8,0.974359,0,0,8,13,false,true,false,0.021,0.979
162,121,41,18,15.125,41,1221,1438,-217,0,0,0,0,45,9,8,1,0,2,7,5,false,true,true,0.592,0.408
169,124,45,16.9,13.777778,45,1048,1000,48,0,0,0,0,40,10,9,1,0,1,11,17,false,true,true,0.798,0.202
283,194,89,17.6875,12.125,89,913,871,42,0,0,0,0,4,16,16,10.75,0,1,9,17,false,true,true,1,0
29,20,9,14.5,20,9,1539,1537,2,0,0,0,0,93,2,1,0.344086,0,0,12,9,false,true,false,0.292,0.708
293,222,71,29.3,22.2,71,1510,1583,-73,1,0,0.1,0,18,10,10,1.777778,0,0,18,12,false,true,true,0.989,0.011
276,228,48,27.6,22.8,48,795,830,-35,1,1,0.1,0.1,20,10,10,2.1,0,0,14,13,false,true,true,0.977,0.023
22,0,22,22,0,22,262,306,-44,0,0,0,0,96,1,0,0.479167,0,0,16,0,false,true,false,0.353,0.647
140,69,71,35,17.25,71,996,1063,-67,1,1,0.25,0.25,67,4,4,0.477612,0,0,12,8,false,true,true,0.988,0.012
326,245,81,15.52381,11.666667,81,913,871,42,0,0,0,0,-22,21,21,-1.954545,0,0,3,2,false,true,true,1,0
130,123,7,16.25,15.375,7,566,542,24,0,0,0,0,45,8,8,0.911111,0,1,28,10,false,true,true,0.912,0.088
178,103,75,29.666667,17.166667,75,976,965,11,0,0,0,0,54,6,6,0.592593,0,1,7,17,false,true,true,0.927,0.073
77,106,-29,15.4,21.2,-29,416,306,110,0,0,0,0,69,5,5,0.608696,0,1,19,6,false,true,true,0.516,0.484
255,206,49,15,12.875,49,416,374,42,0,0,0,0,10,17,16,4.6,0,0,19,7,false,true,true,0.966,0.034
356,301,55,25.428571,21.5,55,1210,1253,-43,0,1,0,0.071429,-13,14,14,-2.615385,0,0,8,13,false,true,true,0.995,0.005
129,109,20,25.8,21.8,20,809,868,-59,1,0,0.2,0,57,5,5,0.561404,0,0,19,19,false,true,false,0.26,0.74
19,17,2,9.5,17,2,691,675,16,0,0,0,0,89,2,1,0.426966,0,0,16,14,false,true,false,0.423,0.577
320,359,-39,22.857143,25.642857,-39,1762,1538,224,1,2,0.071429,0.142857,1,14,14,34,0,0,16,5,false,true,true,0.995,0.005
36,28,8,18,14,8,916,876,40,0,0,0,0,83,2,2,0.409639,0,0,8,15,false,true,true,0.658,0.342
80,67,13,16,16.75,13,921,1072,-151,0,0,0,0,70,5,4,0.542857,0,0,8,9,false,true,false,0.195,0.805
361,294,67,19,15.473684,67,791,774,17,1,0,0.052632,0,-16,19,19,-2.5625,0,0,2,1,false,true,true,1,0
195,81,114,27.857143,11.571429,114,1394,1118,276,0,0,0,0,49,7,7,0.755102,0,0,14,7,false,true,true,0.993,0.007
241,173,68,16.066667,12.357143,68,1069,1040,29,0,0,0,0,3,15,14,14.666667,0,2,7,5,false,true,true,1,0
288,185,103,22.153846,14.230769,103,539,500,39,0,0,0,0,8,13,13,5,0,0,13,8,false,true,true,0.997,0.003
305,239,66,23.461538,19.916667,66,995,912,83,2,0,0.153846,0,24,13,12,1.833333,0,0,11,14,false,true,true,0.988,0.012
359,351,8,23.933333,25.071429,8,1636,1576,60,0,2,0,0.142857,-6,15,14,-5.666667,0,0,4,19,false,true,false,0.154,0.846
301,195,106,23.153846,16.25,106,518,533,-15,1,0,0.076923,0,7,13,12,5,0,0,7,13,false,true,true,0.997,0.003
105,82,23,17.5,13.666667,23,786,847,-61,0,0,0,0,61,6,6,0.557377,0,0,12,14,false,true,true,0.607,0.393
354,286,68,32.181818,26,68,1489,1405,84,2,0,0.181818,0,13,11,11,2.153846,0,0,8,9,false,true,true,1,0
363,300,63,20.166667,16.666667,63,539,500,39,0,0,0,0,-21,18,18,-1.904762,0,0,14,4,false,true,true,1,0
90,82,8,18,16.4,8,695,523,172,0,0,0,0,61,5,5,0.606557,0,1,11,10,false,true,true,0.728,0.272
213,196,17,19.363636,17.818182,17,1388,1477,-89,1,0,0.090909,0,27,11,11,1.777778,0,0,14,12,false,true,true,0.716,0.284
86,13,73,43,13,73,993,897,96,1,0,0.5,0,86,2,1,0.546512,0,0,10,8,false,true,true,0.796,0.204
263,227,36,29.222222,25.222222,36,1320,1339,-19,2,1,0.222222,0.111111,28,9,9,1.392857,0,0,19,13,false,true,true,0.983,0.017
72,81,-9,14.4,16.2,-9,971,761,210,0,0,0,0,63,5,5,0.47619,0,1,14,12,false,true,true,0.513,0.487
434,340,94,24.111111,20,94,791,885,-94,1,1,0.055556,0.058824,-23,18,17,-1.652174,0,0,1,3,false,true,true,1,0
320,318,2,22.857143,22.714286,2,1355,1210,145,1,0,0.071429,0,5,14,14,6,1,0,6,8,false,true,true,0.972,0.028
193,138,55,17.545455,12.545455,55,872,818,54,0,1,0,0.090909,39,11,11,1.051282,0,0,8,8,false,true,true,0.995,0.005
198,137,61,22,17.125,61,1388,1477,-89,1,0,0.111111,0,39,9,8,1.230769,0,0,13,14,false,true,true,0.975,0.025
231,230,1,14.4375,15.333333,1,480,518,-38,0,0,0,0,8,16,15,5.75,1,0,7,16,false,true,true,0.577,0.423
49,55,-6,12.25,13.75,-6,1159,1051,108,0,0,0,0,76,4,4,0.526316,0,0,23,17,false,true,false,0.468,0.532
87,69,18,29,23,18,1388,1506,-118,1,1,0.333333,0.333333,74,3,3,0.459459,0,0,9,27,false,true,true,0.922,0.078
297,265,32,14.142857,12.619048,32,371,435,-64,0,0,0,0,-29,21,21,-1.517241,0,0,1,2,false,true,true,1,0
61,56,5,15.25,14,5,947,909,38,0,0,0,0,75,4,4,0.613333,1,0,18,28,false,true,true,0.829,0.171
184,200,-16,15.333333,18.181818,-16,1176,1127,49,0,0,0,0,21,12,11,1.761905,1,0,12,23,false,true,false,0.479,0.521
175,135,40,25,22.5,40,1344,1209,135,1,1,0.142857,0.166667,49,7,6,0.693878,0,0,13,19,false,true,true,0.902,0.098
341,223,118,31,22.3,118,1793,1897,-104,2,0,0.181818,0,19,11,10,1.578947,0,1,14,6,false,true,true,1,0
190,142,48,15.833333,11.833333,48,1128,889,239,0,1,0,0.083333,29,12,12,1.62069,0,0,24,20,false,true,true,0.977,0.023
317,181,136,35.222222,22.625,136,1396,1454,-58,2,0,0.222222,0,35,9,8,0.942857,0,0,9,10,false,true,true,1,0
323,319,4,26.916667,29,4,1419,1488,-69,1,1,0.083333,0.090909,3,12,11,9.333333,1,0,9,16,false,true,true,0.637,0.363
50,86,-36,16.666667,28.666667,-36,1710,1636,74,0,0,0,0,81,3,3,0.444444,0,0,16,12,false,true,false,0.287,0.713
99,176,-77,16.5,29.333333,-77,758,952,-194,0,0,0,0,49,6,6,0.816327,0,0,24,10,false,true,false,0.071,0.929
49,24,25,24.5,12,25,540,518,22,0,0,0,0,89,2,2,0.449438,0,1,14,7,false,true,true,0.773,0.227
208,120,88,26,17.142857,88,976,965,11,1,0,0.125,0,41,8,7,0.780488,0,1,7,15,false,true,true,0.872,0.128
104,80,24,17.333333,13.333333,24,1050,1144,-94,0,0,0,0,61,6,6,0.622951,0,0,23,10,false,true,true,0.71,0.29
14,34,-20,14,34,-20,1428,1606,-178,0,0,0,0,90,1,1,0.355556,1,0,6,20,false,true,false,0.107,0.893
194,175,19,38.8,35,19,1633,1580,53,2,0,0.4,0,54,5,5,0.518519,0,0,17,9,false,true,true,0.565,0.435
258,195,63,18.428571,13.928571,63,566,542,24,0,0,0,0,11,14,14,3.727273,0,1,16,6,false,true,true,0.968,0.032
273,262,11,21,21.833333,11,315,294,21,0,1,0,0.083333,5,13,12,7,0,0,21,12,false,true,true,0.895,0.105
201,129,72,25.125,16.125,72,1550,1546,4,0,0,0,0,49,8,8,0.612245,1,0,13,7,false,true,true,0.97,0.03
238,212,26,21.636364,21.2,26,1344,1209,135,1,1,0.090909,0.1,22,11,10,1.545455,0,0,9,18,false,true,true,0.857,0.143
92,108,-16,15.333333,18,-16,691,675,16,0,0,0,0,56,6,6,0.678571,0,0,25,7,false,true,true,0.51,0.49
366,321,45,22.875,21.4,45,1439,1397,42,1,2,0.0625,0.133333,-13,16,15,-2.615385,0,0,1,15,false,true,true,0.963,0.037
310,160,150,23.846154,13.333333,150,1033,1037,-4,0,1,0,0.083333,18,13,12,2.5,0,0,18,9,false,true,true,1,0
288,225,63,22.153846,18.75,63,847,952,-105,0,0,0,0,20,13,12,1.8,0,0,13,12,false,true,true,0.789,0.211
254,231,23,14.111111,12.833333,23,1016,1037,-21,0,0,0,0,4,18,18,12,1,0,8,20,false,true,true,0.949,0.051
165,124,41,20.625,17.714286,41,825,907,-82,1,0,0.125,0,48,8,7,0.833333,0,0,25,8,false,true,true,0.624,0.376
62,71,-9,20.666667,23.666667,-9,1304,1040,264,0,0,0,0,76,3,3,0.434211,1,0,6,19,false,true,true,0.651,0.349
139,158,-19,15.444444,19.75,-19,95,378,-283,0,0,0,0,39,9,8,0.897436,0,0,13,9,false,true,false,0.21,0.79
140,157,-17,11.666667,14.272727,-17,826,771,55,0,0,0,0,39,12,11,1.153846,0,1,18,9,false,true,false,0.432,0.568
348,238,110,34.8,26.444444,110,1197,1127,70,0,0,0,0,22,10,9,1.363636,1,0,9,11,false,true,true,1,0
10,0,10,10,0,10,1261,1349,-88,0,0,0,0,97,1,0,0.134021,0,0,8,0,false,true,true,0.556,0.444
65,44,21,21.666667,22,21,1023,1110,-87,0,0,0,0,77,3,2,0.38961,0,1,8,16,false,true,false,0.247,0.753
290,232,58,26.363636,23.2,58,416,282,134,1,0,0.090909,0,22,11,10,1.545455,0,0,17,11,false,true,true,0.969,0.031
198,161,37,28.285714,26.833333,37,1004,840,164,1,0,0.142857,0,45,7,6,0.666667,1,0,12,13,false,true,true,0.678,0.322
135,160,-25,19.285714,26.666667,-25,1125,1227,-102,0,0,0,0,45,7,6,0.666667,1,0,16,12,false,true,false,0.384,0.616
320,213,107,20,14.2,107,831,830,1,0,0,0,0,-2,16,15,-18.5,0,0,14,11,false,true,true,1,0
210,155,55,26.25,19.375,55,795,830,-35,1,1,0.125,0.125,35,8,8,1.2,1,0,15,16,false,true,true,0.988,0.012
276,267,9,23,22.25,9,1142,1176,-34,1,0,0.083333,0,18,12,12,2,1,0,25,15,false,true,true,0.538,0.462
398,277,121,19.9,13.85,121,942,1003,-61,0,0,0,0,-28,20,20,-1.607143,1,0,6,3,false,true,true,1,0
300,239,61,23.076923,19.916667,61,1305,1218,87,1,0,0.076923,0,10,13,12,3.8,0,0,17,11,false,true,true,0.957,0.043
356,282,74,19.777778,16.588235,74,1004,653,351,0,0,0,0,-25,18,17,-1.4,0,0,1,1,true,true,true,1,0
168,62,106,21,8.857143,106,1176,1076,100,0,0,0,0,61,8,7,0.967213,0,1,8,15,false,true,true,0.951,0.049
406,273,133,29,19.5,133,1101,1078,23,1,0,0.071429,0,-2,14,14,-16.5,0,1,10,5,false,true,true,1,0
229,229,0,25.444444,28.625,0,1075,1009,66,1,0,0.111111,0,34,9,8,0.941176,0,0,11,7,false,true,false,0.396,0.604
403,279,124,31,21.461538,124,1023,1070,-47,2,0,0.153846,0,2,13,13,16,0,0,7,15,false,true,true,1,0
135,50,85,45,16.666667,85,925,801,124,1,0,0.333333,0,79,3,3,0.506329,1,0,8,9,false,true,true,0.959,0.041
146,62,84,29.2,15.5,84,1439,1353,86,1,0,0.2,0,63,5,4,0.47619,0,0,18,9,false,true,true,0.897,0.103
211,223,-12,19.181818,20.272727,-12,942,976,-34,0,0,0,0,24,11,11,1.666667,0,0,11,7,false,true,false,0.282,0.718
384,293,91,22.588235,17.235294,91,1394,1118,276,0,1,0,0.058824,-12,17,17,-3.083333,0,0,12,1,false,true,true,1,0
231,181,50,23.1,20.111111,50,1548,1493,55,1,0,0.1,0,32,10,9,1.28125,0,0,11,8,false,true,true,0.83,0.17
44,38,6,14.666667,12.666667,6,576,494,82,0,0,0,0,82,3,3,0.536585,0,0,9,21,false,true,true,0.707,0.293
22,20,2,22,20,2,1142,1176,-34,0,0,0,0,92,1,1,0.391304,0,0,8,10,false,true,true,0.554,0.446
87,105,-18,21.75,35,-18,1030,1144,-114,0,1,0,0.333333,71,4,3,0.492958,0,0,14,15,false,true,false,0.274,0.726
134,110,24,26.8,27.5,24,1030,998,32,0,0,0,0,63,5,4,0.603175,0,0,9,7,false,true,true,0.535,0.465
218,193,25,19.818182,19.3,25,892,788,104,2,0,0.181818,0,30,11,10,1.433333,0,0,7,13,false,true,true,0.975,0.025
113,79,34,22.6,15.8,34,1245,1232,13,1,0,0.2,0,58,5,5,0.5,0,0,18,19,false,true,true,0.741,0.259
54,46,8,13.5,15.333333,8,566,542,24,0,0,0,0,76,4,3,0.539474,0,1,10,14,false,true,false,0.414,0.586
270,244,26,22.5,20.333333,26,809,868,-59,1,0,0.083333,0,15,12,12,2.133333,0,0,11,7,false,true,true,0.751,0.249
77,50,27,25.666667,16.666667,27,1034,1040,-6,0,0,0,0,79,3,3,0.443038,0,0,25,10,false,true,true,0.797,0.203
395,393,2,30.384615,30.230769,2,1935,2020,-85,0,1,0,0.076923,-4,13,13,-7.75,0,0,7,4,false,true,true,0.996,0.004
277,255,22,18.466667,18.214286,22,1159,1051,108,0,0,0,0,6,15,14,6.666667,0,0,10,7,false,true,true,0.584,0.416
249,128,121,31.125,18.285714,121,1270,1322,-52,1,0,0.125,0,47,8,7,0.808511,1,0,11,24,false,true,true,0.991,0.009
288,264,24,22.153846,20.307692,24,1161,1166,-5,1,0,0.076923,0,3,13,13,11.666667,0,1,10,18,false,true,true,0.716,0.284
282,197,85,31.333333,24.625,85,1510,1583,-73,1,0,0.111111,0,29,9,8,1.103448,0,0,7,15,false,true,true,0.997,0.003
338,259,79,28.166667,21.583333,79,1203,1221,-18,2,0,0.166667,0,21,12,12,1.666667,0,0,10,9,false,true,true,1,0
214,167,47,21.4,18.555556,47,1513,1479,34,0,0,0,0,34,10,9,1,1,0,10,13,false,true,true,0.827,0.173
158,49,109,39.5,12.25,109,539,500,39,0,0,0,0,63,4,4,0.634921,0,1,14,24,false,true,true,0.95,0.05
35,13,22,17.5,6.5,22,527,503,24,0,0,0,0,88,2,2,0.465909,2,0,11,10,false,true,true,0.922,0.078
351,271,80,23.4,18.066667,80,902,866,36,0,0,0,0,-20,15,15,-1.6,0,0,1,4,false,true,true,1,0
175,165,10,17.5,16.5,10,371,435,-64,0,0,0,0,26,10,10,1.692308,0,0,9,10,false,true,true,0.782,0.218
290,219,71,18.125,13.6875,71,415,518,-103,0,0,0,0,-7,16,16,-5.428571,0,0,6,17,false,true,true,1,0
103,44,59,25.75,14.666667,59,1075,1027,48,1,0,0.25,0,70,4,3,0.528571,0,0,17,15,false,true,true,0.782,0.218
350,265,85,20.588235,15.588235,85,971,658,313,0,0,0,0,-17,17,17,-2.117647,0,0,1,3,false,true,true,1,0
517,299,218,43.083333,27.181818,218,991,996,-5,3,0,0.25,0,6,12,11,5,0,0,11,8,false,true,true,1,0
253,168,85,21.083333,15.272727,85,746,796,-50,0,1,0,0.090909,19,12,11,2.526316,0,1,23,9,false,true,true,0.884,0.116
289,258,31,22.230769,19.846154,31,1244,1361,-117,2,1,0.153846,0.076923,20,13,13,1.9,0,0,18,11,false,true,true,0.945,0.055
237,191,46,23.7,21.222222,46,1489,1445,44,0,0,0,0,32,10,9,1,1,0,7,13,false,true,true,0.747,0.253
337,297,40,15.318182,13.5,40,826,771,55,0,0,0,0,-26,22,22,-1.730769,0,0,2,1,false,true,true,1,0
302,242,60,30.2,26.888889,60,1075,1009,66,2,0,0.2,0,24,10,9,1.333333,0,0,19,16,false,true,true,0.999,0.001
182,176,6,22.75,22,6,1266,1144,122,0,0,0,0,44,8,8,0.772727,1,0,8,12,false,true,true,0.696,0.304
291,271,20,20.785714,20.846154,20,1439,1294,145,1,0,0.071429,0,5,14,13,7.2,1,0,8,20,false,true,true,0.794,0.206
119,115,4,13.222222,12.777778,4,658,817,-159,0,0,0,0,49,9,9,0.77551,0,0,23,13,false,true,false,0.418,0.582
111,55,56,22.2,11,56,1482,1554,-72,0,0,0,0,71,5,5,0.507042,1,0,9,18,false,true,true,0.944,0.056
48,37,11,24,37,11,1030,998,32,0,0,0,0,90,2,1,0.422222,1,0,7,12,false,true,true,0.573,0.427
101,126,-25,16.833333,21,-25,1100,1008,92,0,0,0,0,65,6,6,0.553846,2,0,5,11,false,true,true,0.74,0.26
207,228,-21,15.923077,17.538462,-21,527,514,13,0,0,0,0,7,13,13,5.571429,0,0,10,11,false,true,false,0.495,0.505
396,308,88,26.4,20.533333,88,1331,1399,-68,1,0,0.066667,0,-13,15,15,-2.692308,0,0,5,4,false,true,true,1,0
375,338,37,20.833333,18.777778,37,1014,1303,-289,1,0,0.055556,0,-25,18,18,-1.52,0,0,1,4,false,true,true,1,0
141,80,61,35.25,26.666667,61,1344,1325,19,1,0,0.25,0,67,4,3,0.462687,0,0,14,19,false,true,true,0.618,0.382
146,113,33,20.857143,16.142857,33,1551,1550,1,0,0,0,0,51,7,7,0.823529,0,1,14,15,false,true,true,0.505,0.495
83,72,11,20.75,18,11,1513,1479,34,0,0,0,0,72,4,4,0.472222,1,0,18,7,false,true,true,0.732,0.268
462,257,205,28.875,16.0625,205,918,619,299,2,0,0.125,0,-14,16,16,-2.5,0,0,6,1,false,true,true,1,0
214,121,93,26.75,17.285714,93,526,370,156,0,0,0,0,47,8,7,0.744681,0,0,7,15,false,true,true,0.972,0.028
251,265,-14,31.375,33.125,-14,1935,2020,-85,0,1,0,0.125,34,8,8,0.911765,1,0,9,17,false,true,false,0.479,0.521
265,192,73,37.857143,27.428571,73,1197,1127,70,0,0,0,0,39,7,7,0.769231,0,0,10,17,false,true,true,1,0
100,132,-32,14.285714,22,-32,725,771,-46,0,1,0,0.166667,54,7,6,0.851852,0,0,17,15,false,true,false,0.27,0.73
113,93,20,14.125,13.285714,20,719,614,105,0,0,0,0,51,8,7,0.843137,0,1,18,15,false,true,true,0.61,0.39
254,217,37,16.933333,15.5,37,450,412,38,0,0,0,0,-2,15,14,-19,0,0,17,9,false,true,true,0.943,0.057
234,263,-29,23.4,26.3,-29,1431,802,629,0,0,0,0,23,10,10,1.391304,0,0,7,7,false,true,true,0.999,0.001
256,270,-14,23.272727,24.545455,-14,974,995,-21,0,1,0,0.090909,18,11,11,1.833333,0,0,16,14,false,true,false,0.46,0.54
364,351,13,26,25.071429,13,1670,1770,-100,1,1,0.071429,0.071429,-12,14,14,-2.666667,0,1,8,6,false,true,true,0.912,0.088
388,385,3,19.4,20.263158,3,1320,1339,-19,2,1,0.1,0.052632,-27,20,19,-1.444444,0,0,1,1,true,true,false,0.019,0.981
215,205,10,15.357143,14.642857,10,1583,1422,161,0,0,0,0,31,14,14,1.645161,2,0,8,20,false,true,true,0.984,0.016
326,310,16,18.111111,17.222222,16,859,786,73,0,0,0,0,-23,18,18,-1.652174,0,0,3,1,false,true,true,0.963,0.037
104,73,31,17.333333,14.6,31,1050,1144,-94,0,0,0,0,64,6,5,0.59375,0,0,23,9,false,true,true,0.532,0.468
26,10,16,13,5,16,450,412,38,0,0,0,0,89,2,2,0.426966,0,1,7,9,false,true,true,0.733,0.267
354,333,21,20.823529,19.588235,21,1265,1045,220,0,1,0,0.058824,-15,17,17,-2.8,0,0,5,6,false,true,true,0.742,0.258
65,70,-5,32.5,70,-5,1030,1144,-114,0,1,0,1,85,2,1,0.411765,0,0,8,12,false,true,true,0.646,0.354
42,56,-14,14,18.666667,-14,518,533,-15,0,0,0,0,81,3,3,0.432099,0,0,8,18,false,true,false,0.238,0.762
182,108,74,26,18,74,1270,1315,-45,0,0,0,0,52,7,6,0.692308,0,0,10,11,false,true,true,0.87,0.13
103,93,10,20.6,18.6,10,947,909,38,0,0,0,0,68,5,5,0.676471,1,0,13,31,false,true,true,0.783,0.217
333,247,86,23.785714,19,86,902,866,36,0,0,0,0,-10,14,13,-3.2,0,0,9,15,false,true,true,1,0
86,100,-14,17.2,25,-14,1304,1040,264,0,0,0,0,69,5,4,0.478261,1,0,6,19,false,true,false,0.407,0.593
322,269,53,16.947368,14.944444,53,671,725,-54,0,0,0,0,-20,19,18,-1.85,0,0,4,1,true,true,true,1,0
360,321,39,27.692308,24.692308,39,1793,1897,-104,2,0,0.153846,0,0,13,13,0,0,0,12,13,false,true,true,1,0
36,23,13,18,23,13,1583,1422,161,0,0,0,0,90,2,1,0.566667,0,0,20,10,false,true,false,0.371,0.629
276,200,76,21.230769,16.666667,76,1170,1156,14,1,0,0.076923,0,12,13,12,3.166667,0,0,11,13,false,true,true,0.988,0.012
262,234,28,20.153846,19.5,28,971,658,313,0,0,0,0,9,13,12,4,0,0,18,7,false,true,true,0.525,0.475
363,298,65,18.15,14.9,65,791,774,17,1,0,0.05,0,-20,20,20,-2.05,0,0,1,1,false,true,true,1,0
119,110,9,17,15.714286,9,1029,1075,-46,0,0,0,0,56,7,7,0.857143,1,0,10,9,false,true,true,0.611,0.389
364,306,58,28,25.5,58,1659,1782,-123,1,0,0.076923,0,-1,13,12,-29,0,1,8,13,false,true,true,1,0
49,23,26,24.5,23,26,594,605,-11,0,0,0,0,88,2,1,0.420455,0,0,11,12,false,true,true,0.649,0.351
30,15,15,15,7.5,15,1069,1040,29,0,0,0,0,84,2,2,0.52381,0,1,12,10,false,true,true,0.562,0.438
119,110,9,13.222222,13.75,9,719,614,105,0,0,0,0,46,9,8,0.934783,0,1,15,9,false,true,true,0.538,0.462
62,78,-16,20.666667,26,-16,505,95,410,0,1,0,0.333333,83,3,3,0.53012,0,0,12,9,false,true,true,0.516,0.484
208,223,-15,14.857143,17.153846,-15,500,567,-67,0,0,0,0,25,14,13,1.76,0,2,9,14,false,true,false,0,1
12,13,-1,12,13,-1,1221,1258,-37,0,0,0,0,94,1,1,0.414894,0,0,9,15,false,true,false,0.489,0.511
52,41,11,26,20.5,11,609,620,-11,0,0,0,0,84,2,2,0.440476,0,0,21,15,false,true,true,0.763,0.237
270,113,157,18,7.533333,157,859,719,140,0,1,0,0.066667,5,15,15,10.6,0,1,10,16,false,true,true,1,0
102,41,61,34,13.666667,61,993,897,96,1,0,0.333333,0,72,3,3,0.652778,0,0,10,7,false,true,true,0.861,0.139
112,0,112,112,0,112,1397,1361,36,1,0,1,0,93,1,0,0.311828,0,0,9,0,false,true,true,1,0
67,99,-32,13.4,24.75,-32,1897,1793,104,0,1,0,0.25,76,5,4,0.421053,0,0,8,19,false,true,true,0.996,0.004
121,59,62,20.166667,11.8,62,1651,1691,-40,0,0,0,0,69,6,5,0.492754,1,0,9,17,false,true,true,0.943,0.057
40,14,26,20,14,26,859,786,73,0,0,0,0,89,2,1,0.426966,0,1,16,9,false,true,true,0.57,0.43
96,65,31,24,21.666667,31,1334,1270,64,1,0,0.25,0,74,4,3,0.5,0,0,18,14,false,true,true,0.58,0.42
396,289,107,28.285714,20.642857,107,1735,1770,-35,2,1,0.142857,0.071429,-9,14,14,-3.111111,0,1,11,3,true,true,true,1,0
142,72,70,28.4,18,70,306,169,137,0,0,0,0,65,5,4,0.523077,0,1,11,12,false,true,true,0.95,0.05
293,146,147,19.533333,9.733333,147,993,897,96,1,0,0.066667,0,2,15,15,23.5,0,1,24,20,false,true,true,1,0
30,0,30,30,0,30,691,473,218,0,0,0,0,95,1,0,0.378947,0,0,19,0,false,true,true,0.82,0.18
174,189,-15,43.5,63,-15,1370,1431,-61,1,1,0.25,0.333333,61,4,3,0.377049,0,0,10,8,false,true,false,0.141,0.859
157,145,12,15.7,16.111111,12,272,288,-16,0,0,0,0,48,10,9,1.083333,0,0,24,13,false,true,true,0.555,0.445
361,323,38,24.066667,23.071429,38,1305,1242,63,2,1,0.133333,0.071429,-5,15,14,-6.8,0,0,5,8,false,true,true,0.988,0.012
128,108,20,32,27,20,948,933,15,1,0,0.25,0,70,4,4,0.542857,0,0,10,10,false,true,true,0.566,0.434
306,331,-25,20.4,22.066667,-25,1210,1252,-42,1,0,0.066667,0,-6,15,15,-5.333333,1,0,2,4,false,true,false,0.123,0.877
297,123,174,37.125,15.375,174,1054,917,137,2,0,0.25,0,30,8,8,1.166667,0,0,17,14,false,true,true,1,0
16,0,16,16,0,16,554,342,212,0,0,0,0,96,1,0,0.375,0,0,19,0,false,true,true,0.784,0.216
145,119,26,24.166667,23.8,26,820,822,-2,0,0,0,0,57,6,5,0.684211,0,0,12,9,false,true,true,0.596,0.404
271,212,59,19.357143,16.307692,59,808,639,169,0,0,0,0,12,14,13,3.416667,0,1,11,6,false,true,true,0.876,0.124
244,193,51,27.111111,24.125,51,416,282,134,1,0,0.111111,0,39,9,8,0.871795,1,0,6,12,false,true,true,0.953,0.047
343,273,70,22.866667,19.5,70,904,668,236,0,0,0,0,-17,15,14,-2,0,0,4,6,false,true,true,1,0
332,309,23,16.6,15.45,23,719,614,105,0,1,0,0.05,-28,20,20,-1.535714,0,0,3,2,false,true,true,0.973,0.027
348,290,58,24.857143,22.307692,58,965,1013,-48,1,0,0.071429,0,-2,14,13,-16.5,0,1,7,8,false,true,true,1,0
350,300,50,18.421053,15.789474,50,1572,1550,22,1,0,0.052632,0,-24,19,19,-1.625,0,0,3,1,false,true,true,1,0
393,380,13,19.65,19,13,1096,1009,87,2,0,0.1,0,-19,20,20,-2.315789,0,0,3,1,false,true,true,1,0
74,6,68,24.666667,3,68,1101,1078,23,0,0,0,0,86,3,2,0.383721,0,0,13,16,false,true,true,0.829,0.171
320,224,96,26.666667,20.363636,96,1167,1216,-49,1,0,0.083333,0,21,12,11,1.952381,0,0,9,8,false,true,true,0.997,0.003
123,81,42,20.5,16.2,42,1043,1055,-12,0,0,0,0,59,6,5,0.627119,0,0,22,11,false,true,true,0.677,0.323
375,314,61,22.058824,18.470588,61,1482,1394,88,2,0,0.117647,0,-15,17,17,-2.4,0,0,2,2,false,true,true,1,0
345,204,141,31.363636,20.4,141,1023,1070,-47,2,0,0.181818,0,19,11,10,1.684211,0,0,18,20,false,true,true,1,0
12,0,12,12,0,12,491,398,93,0,0,0,0,97,1,0,0.371134,0,0,16,0,false,true,true,0.781,0.219
102,71,31,17,11.833333,31,1069,1040,29,0,0,0,0,57,6,6,0.77193,0,2,16,8,false,true,true,0.787,0.213
26,28,-2,26,28,-2,996,1063,-67,0,1,0,1,88,1,1,0.363636,0,0,9,13,false,true,false,0.362,0.638
37,27,10,12.333333,13.5,10,95,378,-283,0,0,0,0,82,3,2,0.426829,0,0,11,11,false,true,false,0.27,0.73
238,201,37,19.833333,18.272727,37,1040,925,115,0,0,0,0,14,12,11,3.071429,0,0,13,10,false,true,true,0.625,0.375
193,100,93,24.125,12.5,93,786,757,29,1,0,0.125,0,49,8,8,0.795918,0,0,8,22,false,true,true,0.994,0.006
283,291,-8,20.214286,20.785714,-8,869,820,49,0,1,0,0.071429,0,14,14,0,0,0,12,16,false,true,true,0.77,0.23
302,320,-18,17.764706,18.823529,-18,491,398,93,0,0,0,0,-9,17,17,-4,1,0,5,6,false,true,false,0.126,0.874
346,284,62,28.833333,25.818182,62,1454,1531,-77,1,1,0.083333,0.090909,6,12,11,5,0,0,11,17,false,true,true,0.988,0.012
212,199,13,30.285714,33.166667,13,1265,1237,28,1,0,0.142857,0,38,7,6,0.789474,0,0,12,24,false,true,false,0.476,0.524
163,110,53,18.111111,13.75,53,913,871,42,0,0,0,0,45,9,8,0.955556,0,1,11,16,false,true,true,0.911,0.089
401,299,102,28.642857,21.357143,102,1334,1477,-143,2,1,0.142857,0.071429,-12,14,14,-2.5,0,0,2,4,false,true,true,1,0
236,204,32,18.153846,17,32,448,598,-150,0,0,0,0,11,13,12,3.272727,0,0,17,13,false,true,true,0.729,0.271
319,289,30,13.869565,13.136364,30,804,683,121,0,0,0,0,-28,23,22,-1.607143,0,1,12,2,true,true,true,0.771,0.229
362,281,81,22.625,17.5625,81,1065,1030,35,0,1,0,0.0625,-15,16,16,-2.266667,0,0,2,3,false,true,true,1,0
82,89,-7,16.4,22.25,-7,1548,1493,55,0,0,0,0,66,5,4,0.621212,2,0,8,16,false,true,true,0.505,0.495
197,185,12,15.153846,15.416667,12,540,518,22,0,0,0,0,18,13,12,2.222222,0,0,9,11,false,true,true,0.764,0.236
108,14,94,36,7,94,1004,653,351,0,0,0,0,76,3,2,0.460526,0,0,9,12,false,true,true,0.86,0.14
352,308,44,27.076923,25.666667,44,1397,1195,202,1,0,0.076923,0,8,13,12,4.375,0,0,15,12,false,true,true,0.999,0.001
190,80,110,27.142857,13.333333,110,1586,1782,-196,0,0,0,0,53,7,6,0.754717,1,0,9,7,false,true,true,0.992,0.008
156,94,62,31.2,23.5,62,1493,1513,-20,1,0,0.2,0,66,5,4,0.5,0,1,10,6,false,true,true,0.588,0.412
70,53,17,17.5,17.666667,17,371,435,-64,0,0,0,0,72,4,3,0.611111,0,0,9,10,false,true,false,0.302,0.698
344,245,99,20.235294,15.3125,99,844,821,23,0,0,0,0,9,17,16,4.666667,0,0,7,7,false,true,true,1,0
386,290,96,21.444444,17.058824,96,769,527,242,1,0,0.055556,0,-25,18,17,-1.44,0,0,2,2,false,true,true,1,0
20,26,-6,10,26,-6,1142,1095,47,0,0,0,0,91,2,1,0.384615,1,0,15,11,false,true,false,0.422,0.578
0,0,0,0,0,0,1507,1554,-47,0,0,0,0,100,1,0,0.29,0,0,10,0,false,true,true,0.531,0.469
42,36,6,14,18,6,272,238,34,0,0,0,0,80,3,2,0.5,1,0,6,20,false,true,true,0.726,0.274
326,276,50,25.076923,23,50,1093,1090,3,1,2,0.076923,0.166667,15,13,12,2.266667,0,0,18,15,false,true,true,0.985,0.015
408,314,94,25.5,20.933333,94,971,1180,-209,1,1,0.0625,0.066667,-10,16,15,-3.2,0,0,3,3,false,true,true,1,0
268,202,66,22.333333,18.363636,66,1406,1454,-48,0,1,0,0.090909,15,12,11,2.266667,1,1,11,9,false,true,true,0.872,0.128
131,110,21,21.833333,22,21,871,999,-128,0,0,0,0,60,6,5,0.8,0,0,8,7,false,true,false,0.225,0.775
302,203,99,27.454545,18.454545,99,1030,998,32,1,0,0.090909,0,17,11,11,2.235294,0,0,11,11,false,true,true,0.999,0.001
169,187,-18,18.777778,20.777778,-18,838,786,52,0,1,0,0.111111,35,9,9,0.914286,1,0,9,7,false,true,false,0.498,0.502
386,224,162,29.692308,18.666667,162,1101,1078,23,1,0,0.076923,0,11,13,12,3,0,1,10,15,false,true,true,1,0
38,26,12,19,26,12,826,771,55,0,0,0,0,89,2,1,0.505618,0,0,7,9,false,true,false,0.463,0.537
366,273,93,21.529412,17.0625,93,1216,1217,-1,1,0,0.058824,0,-16,17,16,-2.125,0,0,4,2,false,true,true,1,0
227,250,-23,20.636364,25,-23,1305,1242,63,1,1,0.090909,0.1,28,11,10,1.214286,1,0,6,12,false,true,false,0.139,0.861
117,21,96,23.4,4.2,96,1033,1037,-4,0,0,0,0,69,5,5,0.652174,0,0,13,8,false,true,true,0.992,0.008
263,239,24,26.3,23.9,24,1554,1622,-68,2,0,0.2,0,22,10,10,1.409091,1,0,9,10,false,true,true,0.94,0.06
301,276,25,20.066667,18.4,25,1548,1493,55,1,0,0.066667,0,1,15,15,41,0,0,7,9,false,true,true,0.887,0.113
335,230,105,23.928571,17.692308,105,1110,1039,71,0,0,0,0,2,14,13,18,0,0,8,10,false,true,true,1,0
24,20,4,24,20,4,916,876,40,0,0,0,0,90,1,1,0.377778,0,0,11,14,false,true,true,0.601,0.399
312,287,25,18.352941,17.9375,25,859,786,73,0,0,0,0,-12,17,16,-3.166667,0,0,6,11,false,true,true,0.83,0.17
94,87,7,15.666667,17.4,7,864,808,56,1,0,0.166667,0,55,6,5,0.618182,1,0,9,11,false,true,true,0.889,0.111
147,76,71,24.5,12.666667,71,719,651,68,0,0,0,0,68,6,6,0.661765,0,0,28,9,false,true,true,0.973,0.027
155,166,-11,12.916667,15.090909,-11,611,584,27,0,0,0,0,33,12,11,1.333333,0,0,7,12,false,true,false,0.418,0.582
352,246,106,19.555556,14.470588,106,1181,1069,112,0,0,0,0,-19,18,17,-1.947368,0,0,2,3,false,true,true,1,0
157,139,18,17.444444,15.444444,18,786,847,-61,0,0,0,0,45,9,9,0.755556,1,0,14,16,false,true,true,0.596,0.404
124,85,39,31,21.25,39,866,949,-83,0,0,0,0,71,4,4,0.56338,0,1,9,9,false,true,true,0.602,0.398
29,29,0,14.5,14.5,0,1029,1075,-46,0,0,0,0,86,2,2,0.55814,0,0,26,10,false,true,true,0.604,0.396
384,287,97,22.588235,17.9375,97,1394,1118,276,0,1,0,0.0625,-10,17,16,-3.7,0,0,12,2,false,true,true,1,0
85,53,32,21.25,13.25,32,1439,1294,145,0,0,0,0,72,4,4,0.5,0,0,10,15,false,true,true,0.717,0.283
248,179,69,24.8,19.888889,69,971,1180,-209,1,0,0.1,0,36,10,9,0.888889,0,0,11,12,false,true,true,0.929,0.071
420,326,94,26.25,21.733333,94,791,885,-94,1,1,0.0625,0.066667,-12,16,15,-3.166667,0,0,3,8,false,true,true,1,0
337,313,24,15.318182,14.904762,24,719,614,105,0,1,0,0.047619,-33,22,21,-1.30303,0,0,2,2,true,true,true,0.999,0.001
378,312,66,25.2,22.285714,66,1093,1090,3,1,2,0.066667,0.142857,3,15,14,11.333333,0,0,8,19,false,true,true,0.987,0.013
251,100,151,22.818182,10,151,1067,95,972,0,0,0,0,36,11,10,0.944444,0,0,18,9,false,true,true,1,0
187,228,-41,15.583333,20.727273,-41,999,1011,-12,0,0,0,0,24,12,11,1.916667,0,0,10,20,false,true,false,0.017,0.983
298,252,46,17.529412,15.75,46,808,639,169,0,0,0,0,-4,17,16,-10.25,0,1,6,7,false,true,true,1,0
99,72,27,19.8,18,27,1513,1479,34,0,0,0,0,68,5,4,0.5,1,0,19,7,false,true,true,0.728,0.272
113,103,10,28.25,25.75,10,1305,1242,63,1,0,0.25,0,70,4,4,0.485714,0,1,9,14,false,true,true,0.549,0.451
273,225,48,21,18.75,48,838,786,52,0,1,0,0.083333,17,13,12,1.882353,0,0,10,10,false,true,true,0.969,0.031
61,47,14,20.333333,23.5,14,613,549,64,0,0,0,0,79,3,2,0.556962,0,0,13,8,false,true,true,0.747,0.253
84,96,-12,16.8,19.2,-12,808,639,169,0,0,0,0,60,5,5,0.683333,0,0,26,9,false,true,true,0.577,0.423
116,29,87,38.666667,14.5,87,1513,1482,31,1,0,0.333333,0,75,3,2,0.44,0,0,10,25,false,true,true,0.914,0.086
292,246,46,16.222222,13.666667,46,698,742,-44,1,0,0.055556,0,-3,18,18,-13.666667,0,0,11,8,false,true,true,0.921,0.079
24,20,4,24,20,4,695,671,24,0,0,0,0,89,1,1,0.370787,0,0,23,12,false,true,true,0.741,0.259
214,169,45,23.777778,21.125,45,1156,1184,-28,1,0,0.111111,0,33,9,8,0.848485,0,0,14,9,false,true,true,0.835,0.165
245,162,83,24.5,16.2,83,1220,1261,-41,2,0,0.2,0,38,10,10,1.184211,0,0,20,16,false,true,true,0.952,0.048
392,259,133,23.058824,16.1875,133,778,758,20,0,1,0,0.0625,-16,17,16,-2.4375,0,0,3,5,false,true,true,1,0
361,241,120,24.066667,17.214286,120,1029,1227,-198,1,0,0.066667,0,-21,15,14,-1.52381,0,0,1,5,false,true,true,1,0
410,250,160,37.272727,25,160,1824,1793,31,1,0,0.090909,0,15,11,10,1.866667,0,0,10,10,false,true,true,1,0
238,211,27,19.833333,17.583333,27,468,542,-74,0,0,0,0,22,12,12,1.772727,0,0,7,10,false,true,true,0.809,0.191
409,362,47,25.5625,24.133333,47,1030,1144,-114,0,2,0,0.133333,-9,16,15,-3.888889,1,0,5,4,false,true,true,0.989,0.011
74,83,-9,18.5,20.75,-9,999,1011,-12,0,0,0,0,70,4,4,0.657143,0,0,11,25,false,true,false,0.254,0.746
90,38,52,30,12.666667,52,1586,1782,-196,0,0,0,0,78,3,3,0.512821,0,0,19,18,false,true,true,0.638,0.362
252,177,75,15.75,11.8,75,1069,1040,29,0,0,0,0,-3,16,15,-14.666667,0,2,17,5,false,true,true,1,0
388,304,84,21.555556,17.882353,84,892,788,104,3,0,0.166667,0,-13,18,17,-3.307692,0,0,6,9,false,true,true,1,0
351,280,71,25.071429,20,71,1302,1234,68,1,1,0.071429,0.071429,-6,14,14,-5.166667,0,0,6,2,false,true,true,0.992,0.008
35,34,1,11.666667,17,1,613,502,111,0,0,0,0,79,3,2,0.620253,0,0,9,11,false,true,true,0.592,0.408
93,120,-27,23.25,30,-27,1530,1550,-20,0,1,0,0.25,68,4,4,0.5,0,1,17,10,false,true,false,0.273,0.727
295,215,80,21.071429,15.357143,80,539,500,39,0,0,0,0,0,14,14,0,0,0,11,10,false,true,true,0.997,0.003
93,208,-115,18.6,41.6,-115,1762,1538,224,0,2,0,0.4,58,5,5,0.586207,0,0,11,8,false,true,true,0.996,0.004
337,296,41,16.047619,14.8,41,1040,925,115,0,0,0,0,-32,21,20,-1.34375,0,0,10,1,false,true,true,1,0
233,207,26,25.888889,23,26,1519,1782,-263,1,0,0.111111,0,35,9,9,0.942857,0,0,12,8,false,true,true,0.519,0.481
261,192,69,20.076923,16,69,746,796,-50,0,1,0,0.083333,15,13,12,3.2,0,1,23,6,false,true,true,0.879,0.121
323,330,-7,24.846154,27.5,-7,1030,1144,-114,0,2,0,0.166667,14,13,12,2.5,1,0,15,10,false,true,true,0.605,0.395
255,279,-24,15.9375,17.4375,-24,1075,989,86,0,0,0,0,9,16,16,4.333333,1,0,10,12,false,true,false,0.204,0.796
185,173,12,16.818182,17.3,12,95,378,-283,0,0,0,0,24,11,10,1.458333,0,0,10,13,false,true,true,0.593,0.407
256,172,84,17.066667,11.466667,84,1128,889,239,0,1,0,0.066667,13,15,15,3.615385,0,0,18,19,false,true,true,0.988,0.012
317,247,70,17.611111,14.529412,70,1091,1078,13,0,0,0,0,-3,18,17,-14.333333,0,0,10,8,false,true,true,1,0
35,8,27,11.666667,4,27,1394,1230,164,0,0,0,0,81,3,2,0.469136,0,0,13,8,false,true,true,0.643,0.357
107,51,56,26.75,17,56,704,691,13,0,0,0,0,74,4,3,0.513514,0,0,12,11,false,true,true,0.913,0.087
346,293,53,38.444444,36.625,53,1885,1793,92,0,0,0,0,24,9,8,1.125,1,0,15,12,false,true,true,1,0
230,93,137,38.333333,18.6,137,1349,1302,47,0,0,0,0,52,6,5,0.557692,0,0,10,14,false,true,true,0.989,0.011
44,34,10,22,17,10,808,639,169,0,0,0,0,82,2,2,0.5,0,0,19,11,false,true,true,0.784,0.216
184,191,-7,15.333333,15.916667,-7,450,412,38,0,0,0,0,16,12,12,2.375,0,0,11,12,false,true,true,0.691,0.309
12,25,-13,12,25,-13,719,785,-66,0,0,0,0,92,1,1,0.391304,0,2,19,5,false,true,false,0.001,0.999
44,46,-2,14.666667,15.333333,-2,1159,1051,108,0,0,0,0,82,3,3,0.487805,0,0,16,19,false,true,false,0.472,0.528
36,0,36,36,0,36,746,796,-50,0,0,0,0,94,1,0,0.510638,0,0,9,0,false,true,true,0.514,0.486
304,291,13,20.266667,20.785714,13,869,820,49,0,1,0,0.071429,-4,15,14,-9.25,0,0,13,16,false,true,true,0.82,0.18
234,155,79,16.714286,11.923077,79,1069,1040,29,0,0,0,0,9,14,13,4.888889,0,2,7,8,false,true,true,1,0
249,234,15,24.9,26,15,1331,1399,-68,0,0,0,0,27,10,9,1.296296,0,0,19,8,false,true,false,0.335,0.665
288,137,151,20.571429,10.538462,151,993,897,96,1,0,0.071429,0,8,14,13,5.875,0,1,15,19,false,true,true,1,0
57,111,-54,11.4,22.2,-54,1156,1184,-28,0,0,0,0,63,5,5,0.444444,1,0,6,13,false,true,false,0.259,0.741
305,229,76,16.052632,12.722222,76,415,518,-103,0,0,0,0,-20,19,18,-1.9,0,0,1,11,false,true,true,1,0
43,5,38,21.5,5,38,869,820,49,0,0,0,0,90,2,1,0.411111,0,1,16,6,false,true,true,0.572,0.428
42,26,16,21,26,16,1181,1149,32,0,0,0,0,89,2,1,0.505618,0,0,9,15,false,true,false,0.324,0.676
50,43,7,16.666667,14.333333,7,1489,1445,44,0,0,0,0,77,3,3,0.415584,0,0,24,9,false,true,true,0.611,0.389
263,222,41,23.909091,22.2,41,1089,1063,26,1,0,0.090909,0,27,11,10,1.407407,1,0,9,11,false,true,true,0.896,0.104
72,35,37,18,11.666667,37,1482,1554,-72,0,0,0,0,81,4,3,0.444444,1,0,18,22,false,true,true,0.709,0.291
229,161,68,16.357143,12.384615,68,947,909,38,0,0,0,0,9,14,13,5.111111,0,0,11,34,false,true,true,0.986,0.014
77,68,9,19.25,22.666667,9,869,820,49,0,1,0,0.333333,77,4,3,0.480519,0,0,19,19,false,true,false,0.461,0.539
367,306,61,24.466667,20.4,61,880,952,-72,0,0,0,0,-4,15,15,-8.75,0,0,4,6,false,true,true,1,0
351,294,57,17.55,15.473684,57,1548,1493,55,1,0,0.05,0,-24,20,19,-1.708333,0,0,1,3,false,true,true,1,0
259,291,-32,16.1875,18.1875,-32,1388,1477,-89,1,0,0.0625,0,2,16,16,24,1,0,12,20,false,true,false,0.08,0.92
272,219,53,22.666667,19.909091,53,1047,1094,-47,1,1,0.083333,0.090909,26,12,11,1.384615,0,0,12,11,false,true,true,0.986,0.014
214,130,84,26.75,18.571429,84,758,796,-38,0,0,0,0,44,8,7,0.863636,0,0,11,10,false,true,true,0.961,0.039
350,305,45,23.333333,21.785714,45,834,758,76,0,1,0,0.071429,-5,15,14,-7.2,0,0,10,10,false,true,true,0.943,0.057
91,73,18,15.166667,14.6,18,491,398,93,0,0,0,0,68,6,5,0.529412,0,1,10,13,false,true,true,0.644,0.356
47,49,-2,23.5,24.5,-2,820,822,-2,0,0,0,0,86,2,2,0.453488,0,0,17,10,false,true,true,0.559,0.441
33,43,-10,16.5,21.5,-10,1023,1070,-47,0,0,0,0,86,2,2,0.372093,1,0,18,8,false,true,true,0.731,0.269
98,43,55,24.5,10.75,55,1270,1348,-78,0,0,0,0,74,4,4,0.513514,1,0,13,18,false,true,true,0.843,0.157
289,202,87,22.230769,16.833333,87,1516,1397,119,0,1,0,0.083333,6,13,12,5.5,0,0,24,9,false,true,true,0.993,0.007
138,80,58,23,16,58,786,788,-2,0,0,0,0,53,6,5,0.641509,0,0,13,17,false,true,true,0.928,0.072
263,198,65,16.4375,13.2,65,566,542,24,0,0,0,0,6,16,15,6.833333,0,1,20,6,false,true,true,0.99,0.01
8,6,2,8,6,2,721,689,32,0,0,0,0,90,1,1,0.377778,0,0,9,13,false,true,true,0.684,0.316
285,225,60,21.923077,17.307692,60,859,811,48,0,0,0,0,11,13,13,3.272727,1,1,10,12,false,true,true,0.96,0.04
180,139,41,36,27.8,41,416,282,134,1,0,0.2,0,63,5,5,0.539683,0,0,13,21,false,true,true,0.93,0.07
408,319,89,20.4,15.95,89,1075,1152,-77,0,1,0,0.05,-26,20,20,-1.538462,0,0,2,3,true,true,true,1,0
140,92,48,35,30.666667,48,1983,2020,-37,1,0,0.25,0,71,4,3,0.366197,0,1,19,7,false,true,true,0.563,0.437
23,15,8,11.5,7.5,8,1270,1348,-78,0,0,0,0,91,2,2,0.417582,0,0,14,9,false,true,true,0.544,0.456
160,93,67,32,23.25,67,1093,1197,-104,1,0,0.2,0,64,5,4,0.484375,0,0,14,13,false,true,true,0.629,0.371
207,148,59,25.875,18.5,59,1482,1394,88,1,0,0.125,0,48,8,8,0.75,1,0,7,9,false,true,true,0.942,0.058
144,120,24,20.571429,17.142857,24,613,461,152,0,0,0,0,47,7,7,0.787234,0,0,11,8,false,true,true,0.824,0.176
18,49,-31,6,16.333333,-31,1221,1258,-37,0,0,0,0,85,3,3,0.458824,0,0,12,9,false,true,false,0.271,0.729
54,89,-35,10.8,17.8,-35,1093,1090,3,0,0,0,0,71,5,5,0.478873,1,0,13,7,false,true,false,0.298,0.702
343,244,99,31.181818,22.181818,99,1245,1241,4,1,1,0.090909,0.090909,10,11,11,2.9,1,0,11,8,false,true,true,1,0
292,279,13,20.857143,21.461538,13,771,754,17,0,0,0,0,2,14,13,16,0,0,16,7,false,true,true,0.61,0.39
335,247,88,19.705882,15.4375,88,518,533,-15,1,0,0.058824,0,-18,17,16,-1.944444,0,0,3,1,false,true,true,1,0
333,193,140,19.588235,12.0625,140,872,818,54,0,1,0,0.0625,5,17,16,8.2,0,0,15,10,false,true,true,1,0
87,133,-46,12.428571,22.166667,-46,892,788,104,0,0,0,0,63,7,6,0.68254,1,0,15,12,false,true,true,0.502,0.498
268,283,-15,20.615385,21.769231,-15,758,952,-194,0,0,0,0,3,13,13,13.333333,0,0,16,7,false,true,false,0.115,0.885
210,186,24,19.090909,16.909091,24,719,785,-66,0,1,0,0.090909,25,11,11,1.44,0,0,16,18,false,true,true,0.92,0.08
272,243,29,22.666667,20.25,29,1047,1094,-47,1,1,0.083333,0.083333,21,12,12,1.714286,0,0,12,9,false,true,true,0.979,0.021
374,263,111,26.714286,20.230769,111,1550,1466,84,1,0,0.071429,0,4,14,13,9.25,0,0,10,10,false,true,true,1,0
351,321,30,18.473684,17.833333,30,825,907,-82,1,0,0.052632,0,-17,19,18,-2.352941,0,0,1,10,false,true,true,0.984,0.016
46,6,40,23,6,40,859,811,48,0,0,0,0,88,2,1,0.409091,0,0,10,10,false,true,true,0.759,0.241
162,151,11,23.142857,21.571429,11,1266,1144,122,0,0,0,0,49,7,7,0.693878,1,0,9,11,false,true,true,0.822,0.178
304,285,19,20.266667,20.357143,19,1277,1166,111,0,1,0,0.071429,-2,15,14,-18,0,0,10,11,false,true,true,0.662,0.338
306,265,41,18,15.588235,41,450,412,38,0,0,0,0,-17,17,17,-2.235294,0,0,2,4,false,true,true,0.996,0.004
254,249,5,25.4,27.666667,5,1102,1245,-143,1,0,0.1,0,12,10,9,2.333333,0,0,13,8,false,true,false,0.231,0.769
66,35,31,33,35,31,1364,1093,271,0,0,0,0,87,2,1,0.436782,0,0,12,8,false,true,true,0.665,0.335
113,51,62,37.666667,25.5,62,1762,1616,146,1,0,0.333333,0,79,3,2,0.379747,0,0,11,10,false,true,true,0.646,0.354
301,262,39,15.842105,14.555556,39,904,857,47,0,0,0,0,-14,19,18,-2.928571,0,0,9,3,false,true,true,0.999,0.001
269,198,71,19.214286,14.142857,71,1091,1078,13,0,0,0,0,20,14,14,2.15,0,0,7,8,false,true,true,0.993,0.007
341,249,92,28.416667,20.75,92,1156,1114,42,1,0,0.083333,0,6,12,12,5.333333,0,0,10,18,false,true,true,1,0
347,241,106,26.692308,18.538462,106,1305,1390,-85,0,1,0,0.076923,4,13,13,9,0,1,10,18,false,true,true,1,0
318,267,51,15.9,14.052632,51,904,857,47,0,0,0,0,-22,20,19,-1.863636,0,0,8,1,false,true,true,1,0
179,173,6,16.272727,15.727273,6,871,999,-128,0,0,0,0,29,11,11,1.655172,0,0,8,10,false,true,false,0.244,0.756
301,259,42,15.05,12.95,42,346,231,115,0,0,0,0,-40,20,20,-1.025,0,1,13,1,false,true,true,1,0
39,31,8,19.5,15.5,8,1048,1000,48,0,0,0,0,86,2,2,0.465116,0,0,17,13,false,true,true,0.581,0.419
446,378,68,21.238095,18.9,68,1220,1261,-41,2,0,0.095238,0,-23,21,20,-1.956522,0,0,1,2,false,true,true,1,0
370,353,17,24.666667,23.533333,17,907,752,155,0,1,0,0.066667,-5,15,15,-6.6,0,0,5,4,false,true,true,0.831,0.169
261,329,-68,23.727273,32.9,-68,834,844,-10,1,2,0.090909,0.2,14,11,10,2.571429,0,0,12,7,false,true,false,0.025,0.975
68,94,-26,17,23.5,-26,1885,1846,39,0,1,0,0.25,62,4,4,0.467742,1,0,11,10,false,true,false,0.39,0.61
91,65,26,22.75,21.666667,26,1364,1093,271,0,0,0,0,74,4,3,0.513514,0,1,12,6,false,true,true,0.509,0.491
299,298,1,12.458333,12.416667,1,1029,1075,-46,0,0,0,0,-25,24,24,-1.92,0,0,1,1,true,true,true,0.884,0.116
166,144,22,18.444444,16,22,695,523,172,0,0,0,0,30,9,9,1.233333,0,0,13,26,false,true,true,0.662,0.338
61,44,17,15.25,11,17,1069,1040,29,0,0,0,0,71,4,4,0.619718,0,2,20,8,false,true,true,0.589,0.411
239,243,-4,15.933333,16.2,-4,908,859,49,0,0,0,0,5,15,15,7.8,0,0,17,12,false,true,true,0.795,0.205
165,118,47,41.25,29.5,47,1571,1554,17,2,1,0.5,0.25,62,4,4,0.532258,0,0,9,11,false,true,true,0.941,0.059
50,52,-2,12.5,17.333333,-2,1093,1090,3,0,0,0,0,80,4,3,0.425,1,0,13,12,false,true,false,0.418,0.582
261,162,99,26.1,16.2,99,1651,1691,-40,1,0,0.1,0,35,10,10,0.971429,0,0,10,11,false,true,true,0.989,0.011
409,278,131,16.36,11.12,131,1413,1422,-9,0,0,0,0,-28,25,25,-2.035714,0,0,3,2,false,true,true,1,0
171,216,-45,14.25,18,-45,628,658,-30,0,0,0,0,28,12,12,1.642857,0,0,16,11,false,true,false,0.15,0.85
159,48,111,31.8,12,111,1216,1217,-1,1,0,0.2,0,65,5,4,0.523077,0,0,12,27,false,true,true,0.988,0.012
377,338,39,22.176471,21.125,39,1388,1506,-118,2,1,0.117647,0.0625,-12,17,16,-2.833333,0,0,1,3,false,true,true,0.962,0.038
366,351,15,22.875,23.4,15,992,1100,-108,2,0,0.125,0,-10,16,15,-3.4,0,0,1,4,false,true,true,0.998,0.002
231,166,65,19.25,13.833333,65,871,867,4,0,0,0,0,23,12,12,1.869565,0,1,13,16,false,true,true,0.948,0.052
180,172,8,18,17.2,8,808,812,-4,0,0,0,0,31,10,10,1.193548,1,0,7,9,false,true,true,0.833,0.167
230,212,18,19.166667,19.272727,18,518,448,70,0,0,0,0,20,12,11,1.7,0,0,10,17,false,true,true,0.68,0.32
94,32,62,31.333333,10.666667,62,1144,1014,130,0,0,0,0,78,3,3,0.461538,1,0,10,13,false,true,true,0.894,0.106
298,219,79,19.866667,15.642857,79,844,821,23,0,0,0,0,21,15,14,2,0,0,14,8,false,true,true,0.985,0.015
300,291,9,21.428571,22.384615,9,1431,802,629,0,0,0,0,-4,14,13,-8,0,0,4,8,false,true,true,1,0
342,304,38,21.375,20.266667,38,847,952,-105,0,0,0,0,-1,16,15,-36,0,1,6,6,false,true,true,1,0
124,86,38,20.666667,14.333333,38,1551,1550,1,0,0,0,0,59,6,6,0.711864,0,1,14,17,false,true,true,0.586,0.414
387,243,144,20.368421,13.5,144,1011,921,90,1,0,0.052632,0,-11,19,18,-4.454545,0,0,6,14,false,true,true,1,0
87,110,-23,12.428571,15.714286,-23,523,480,43,0,0,0,0,53,7,7,0.622642,1,0,18,9,false,true,true,0.68,0.32
211,102,109,26.375,14.571429,109,1651,1691,-40,1,0,0.125,0,51,8,7,0.666667,0,0,14,10,false,true,true,0.988,0.012
230,188,42,15.333333,12.533333,42,218,86,132,0,0,0,0,-4,15,15,-10,0,0,22,12,false,true,true,0.986,0.014
323,302,21,20.1875,18.875,21,771,754,17,0,0,0,0,-12,16,16,-2.666667,0,0,6,5,true,true,true,0.94,0.06
337,292,45,17.736842,16.222222,45,725,771,-46,0,1,0,0.055556,-13,19,18,-3.538462,0,0,7,10,false,true,true,0.998,0.002
206,125,81,25.75,17.857143,81,1334,1256,78,1,0,0.125,0,47,8,7,0.659574,0,0,9,8,false,true,true,0.983,0.017
355,234,121,20.882353,13.764706,121,303,342,-39,0,0,0,0,-10,17,17,-3.8,0,0,8,4,false,true,true,1,0
294,225,69,21,16.071429,69,1270,1315,-45,0,0,0,0,5,14,14,7.2,0,0,9,38,false,true,true,0.974,0.026
162,52,110,54,26,110,1054,917,137,0,0,0,0,74,3,2,0.472973,0,0,7,12,false,true,true,0.99,0.01
218,194,24,21.8,21.555556,24,1344,1209,135,1,1,0.1,0.111111,27,10,9,1.259259,0,0,10,20,false,true,true,0.757,0.243
229,166,63,16.357143,11.857143,63,947,909,38,0,0,0,0,6,14,14,7.666667,0,0,11,34,false,true,true,0.986,0.014
106,80,26,21.2,20,26,1691,1692,-1,0,0,0,0,64,5,4,0.46875,0,0,11,7,false,true,false,0.397,0.603
304,251,53,25.333333,22.818182,53,1554,1573,-19,1,0,0.083333,0,23,12,11,1.478261,0,1,21,8,false,true,true,0.866,0.134
333,211,122,23.785714,15.071429,122,1482,1554,-72,1,0,0.071429,0,6,14,14,6,0,0,10,10,false,true,true,1,0
49,46,3,12.25,15.333333,3,1159,1051,108,0,0,0,0,79,4,3,0.506329,0,0,23,19,false,true,false,0.427,0.573
265,160,105,37.857143,26.666667,105,1197,1127,70,0,0,0,0,44,7,6,0.681818,0,0,10,16,false,true,true,1,0
41,39,2,13.666667,19.5,2,1885,1846,39,0,1,0,0.5,74,3,2,0.391892,1,0,9,12,false,true,true,0.602,0.398
131,177,-46,14.555556,22.125,-46,316,306,10,0,2,0,0.25,42,9,8,0.904762,0,0,22,17,false,true,true,0.614,0.386
54,27,27,27,13.5,27,1439,1294,145,0,0,0,0,83,2,2,0.433735,0,0,11,7,false,true,true,0.658,0.342
304,276,28,16.888889,15.333333,28,808,639,169,0,0,0,0,-14,18,18,-2.928571,0,0,5,3,false,true,true,0.972,0.028
20,40,-20,6.666667,20,-20,844,821,23,0,0,0,0,87,3,2,0.482759,0,0,27,10,false,true,false,0.274,0.726
36,46,-10,9,15.333333,-10,977,976,1,0,0,0,0,79,4,3,0.43038,0,0,25,9,false,true,false,0.283,0.717
370,296,74,21.764706,18.5,74,1036,1181,-145,0,0,0,0,-6,17,16,-5.666667,1,0,5,5,false,true,true,1,0
71,70,1,23.666667,23.333333,1,892,819,73,0,1,0,0.333333,74,3,3,0.459459,1,0,23,12,false,true,true,0.85,0.15
363,287,76,22.6875,17.9375,76,1731,1691,40,1,0,0.0625,0,-13,16,16,-2.615385,0,0,2,12,false,true,true,1,0
165,93,72,41.25,31,72,991,996,-5,1,0,0.25,0,71,4,3,0.422535,0,0,15,9,false,true,true,0.759,0.241
318,232,86,26.5,21.090909,86,1510,1583,-73,1,0,0.083333,0,14,12,11,2.285714,0,0,9,10,false,true,true,0.999,0.001
77,121,-44,15.4,30.25,-44,719,785,-66,0,1,0,0.25,66,5,4,0.545455,0,0,9,7,false,true,false,0.271,0.729
137,80,57,34.25,20,57,908,1070,-162,1,0,0.25,0,67,4,4,0.447761,1,0,22,17,false,true,true,0.787,0.213
190,102,88,21.111111,11.333333,88,1069,917,152,0,0,0,0,45,9,9,0.755556,0,1,13,7,false,true,true,0.951,0.049
299,197,102,19.933333,13.133333,102,1281,1339,-58,0,0,0,0,14,15,15,2.928571,0,0,20,9,false,true,true,1,0
32,0,32,32,0,32,576,532,44,0,0,0,0,96,1,0,0.479167,1,0,8,0,false,true,true,0.874,0.126
107,83,24,26.75,20.75,24,971,906,65,0,0,0,0,69,4,4,0.463768,0,0,12,13,false,true,true,0.773,0.227
228,195,33,17.538462,15,33,371,435,-64,0,0,0,0,11,13,13,4,0,0,14,8,false,true,true,0.925,0.075
333,147,186,41.625,18.375,186,1550,1624,-74,1,0,0.125,0,44,8,8,0.681818,0,1,9,15,false,true,true,1,0
252,167,85,22.909091,15.181818,85,1065,1030,35,0,0,0,0,23,11,11,1.478261,1,0,9,10,false,true,true,0.996,0.004
360,317,43,18,16.684211,43,1221,1258,-37,1,0,0.05,0,-21,20,19,-1.857143,1,0,0,5,true,true,true,1,0
386,313,73,27.571429,22.357143,73,1075,1027,48,2,1,0.142857,0.071429,-5,14,14,-7.4,0,0,17,5,false,true,true,1,0
236,232,4,19.666667,19.333333,4,892,788,104,2,0,0.166667,0,19,12,12,2.263158,0,0,12,22,false,true,true,0.891,0.109
84,14,70,28,7,70,1093,1100,-7,1,0,0.333333,0,87,3,2,0.367816,0,1,19,10,false,true,true,0.523,0.477
14,0,14,14,0,14,1027,856,171,0,0,0,0,97,1,0,0.340206,0,0,9,0,false,true,true,0.763,0.237
115,93,22,19.166667,18.6,22,947,909,38,0,0,0,0,66,6,5,0.69697,1,0,9,31,false,true,true,0.563,0.437
10,12,-2,10,12,-2,918,619,299,0,0,0,0,93,1,1,0.376344,0,0,7,18,false,true,true,0.522,0.478
303,250,53,16.833333,14.705882,53,1221,1438,-217,0,0,0,0,7,18,17,6.428571,0,1,16,7,false,true,true,1,0
22,0,22,22,0,22,869,820,49,0,0,0,0,95,1,0,0.389474,0,0,18,0,false,true,true,0.593,0.407
133,77,56,22.166667,15.4,56,1305,1390,-85,0,0,0,0,62,6,5,0.580645,0,0,10,20,false,true,true,0.633,0.367
317,279,38,15.095238,13.95,38,804,683,121,0,0,0,0,-21,21,20,-2.142857,0,1,13,3,false,true,true,1,0
71,47,24,17.75,15.666667,24,620,513,107,0,0,0,0,76,4,3,0.592105,0,0,7,18,false,true,true,0.697,0.303
309,129,180,16.263158,7.166667,180,859,719,140,0,1,0,0.055556,-16,19,18,-3.3125,0,1,24,16,false,true,true,1,0
367,275,92,16.681818,12.5,92,1606,1544,62,0,0,0,0,-16,22,22,-2.8125,0,0,2,2,false,true,true,1,0
18,19,-1,18,19,-1,1349,1302,47,0,0,0,0,92,1,1,0.315217,0,0,13,9,false,true,false,0.476,0.524
345,290,55,19.166667,17.058824,55,904,783,121,0,0,0,0,-12,18,17,-3.5,1,0,7,10,false,true,true,1,0
157,90,67,26.166667,18,67,1115,1078,37,0,0,0,0,59,6,5,0.576271,1,0,13,11,false,true,true,0.911,0.089
48,32,16,16,16,16,1164,1201,-37,0,0,0,0,81,3,2,0.518519,0,1,15,11,false,true,true,0.517,0.483
376,260,116,18.8,13,116,1281,1339,-58,0,0,0,0,-14,20,20,-2.928571,0,0,1,1,false,true,true,1,0
40,73,-33,20,36.5,-33,1762,1582,180,0,1,0,0.5,87,2,2,0.367816,0,0,15,14,false,true,true,1,0
413,402,11,27.533333,28.714286,11,1428,1452,-24,1,2,0.066667,0.142857,-11,15,14,-2.818182,0,0,1,2,false,true,true,0.648,0.352
238,259,-21,21.636364,23.545455,-21,1154,1062,92,1,0,0.090909,0,25,11,11,1.4,1,0,6,10,false,true,false,0.135,0.865
235,141,94,26.111111,17.625,94,971,1180,-209,1,0,0.111111,0,41,9,8,0.780488,0,0,7,12,false,true,true,0.946,0.054
26,42,-16,13,21,-16,611,584,27,0,0,0,0,87,2,2,0.505747,0,0,21,16,false,true,false,0.499,0.501
54,50,4,18,16.666667,4,1051,1030,21,0,0,0,0,76,3,3,0.394737,0,0,8,10,false,true,true,0.535,0.465
146,98,48,20.857143,16.333333,48,1091,1078,13,0,0,0,0,60,7,6,0.716667,0,0,9,11,false,true,true,0.733,0.267
10,21,-11,10,21,-11,95,360,-265,0,0,0,0,92,1,1,0.434783,0,0,9,16,false,true,false,0.189,0.811
123,111,12,17.571429,18.5,12,1043,1055,-12,0,0,0,0,56,7,6,0.660714,0,0,23,7,false,true,false,0.366,0.634
57,42,15,14.25,14,15,825,907,-82,0,0,0,0,77,4,3,0.519481,2,0,12,10,false,true,true,0.765,0.235
271,208,63,24.636364,18.909091,63,971,1180,-209,1,0,0.090909,0,24,11,11,1.333333,0,1,8,6,false,true,true,0.587,0.413
239,213,26,26.555556,23.666667,26,1030,1144,-114,0,1,0,0.111111,40,9,9,0.875,0,1,12,14,false,true,true,0.64,0.36
18,37,-19,6,18.5,-19,1221,1258,-37,0,0,0,0,88,3,2,0.443182,0,0,12,10,false,true,false,0.27,0.73
131,81,50,21.833333,13.5,50,804,683,121,0,0,0,0,58,6,6,0.775862,0,1,19,13,false,true,true,0.949,0.051
333,308,25,27.75,25.666667,25,1397,1195,202,1,0,0.083333,0,11,12,12,3.181818,0,0,10,12,false,true,true,0.999,0.001
309,216,93,22.071429,15.428571,93,518,533,-15,1,0,0.071429,0,-3,14,14,-11.666667,0,0,7,12,false,true,true,0.999,0.001
227,177,50,16.214286,12.642857,50,698,742,-44,1,0,0.071429,0,23,14,14,1.782609,0,0,7,24,false,true,true,0.935,0.065
55,18,37,18.333333,9,37,1516,1397,119,0,0,0,0,82,3,2,0.402439,0,1,22,7,false,true,true,0.555,0.445
409,270,139,29.214286,20.769231,139,1826,1803,23,1,0,0.071429,0,-2,14,13,-15,1,0,2,5,false,true,true,1,0
420,287,133,28,20.5,133,1826,1803,23,1,0,0.066667,0,-10,15,14,-3,1,0,2,2,false,true,true,1,0
93,45,48,23.25,11.25,48,804,683,121,0,0,0,0,69,4,4,0.652174,0,1,19,6,false,true,true,0.934,0.066
93,94,-1,31,31.333333,-1,1197,1127,70,0,0,0,0,77,3,3,0.38961,1,0,8,14,false,true,true,0.738,0.262
295,277,18,17.352941,17.3125,18,947,810,137,0,1,0,0.0625,-6,17,16,-7,1,0,12,13,false,true,true,0.967,0.033
374,370,4,17.809524,18.5,4,1265,1045,220,0,1,0,0.05,-35,21,20,-1.2,0,0,1,2,false,true,true,0.796,0.204
12,0,12,12,0,12,691,675,16,0,0,0,0,97,1,0,0.391753,0,0,16,0,false,true,true,0.571,0.429
0,20,-20,0,20,-20,977,976,1,0,0,0,0,97,1,1,0.350515,0,0,17,9,false,true,false,0.28,0.72
158,189,-31,22.571429,27,-31,1439,1397,42,0,2,0,0.285714,45,7,7,0.755556,0,0,8,10,false,true,false,0.278,0.722
330,292,38,20.625,19.466667,38,518,448,70,0,0,0,0,-9,16,15,-3.777778,0,0,1,10,false,true,true,0.988,0.012
314,218,96,22.428571,15.571429,96,580,620,-40,1,0,0.071429,0,9,14,14,4.777778,0,0,9,14,false,true,true,0.989,0.011
246,207,39,22.363636,18.818182,39,820,822,-2,0,0,0,0,24,11,11,1.625,0,0,13,7,false,true,true,0.949,0.051
366,316,50,19.263158,17.555556,50,1295,1281,14,0,0,0,0,-10,19,18,-3.8,0,0,15,4,false,true,true,1,0
84,95,-11,16.8,19,-11,1244,1361,-117,0,0,0,0,73,5,5,0.520548,0,1,11,15,false,true,false,0.077,0.923
126,138,-12,14,15.333333,-12,1214,1176,38,0,0,0,0,46,9,9,0.782609,0,0,11,21,false,true,false,0.44,0.56
189,247,-58,27,35.285714,-58,1636,1576,60,0,2,0,0.285714,37,7,7,0.918919,0,0,12,18,false,true,false,0.172,0.828
213,100,113,30.428571,16.666667,113,1054,917,137,1,0,0.142857,0,44,7,6,0.795455,1,0,9,8,false,true,true,0.992,0.008
247,223,24,24.7,24.777778,24,1710,1636,74,1,1,0.1,0.111111,31,10,9,1.16129,1,0,9,15,false,true,true,0.875,0.125
288,253,35,22.153846,19.461538,35,847,952,-105,0,0,0,0,18,13,13,2,0,0,13,11,false,true,true,0.623,0.377
51,32,19,17,16,19,892,768,124,0,0,0,0,84,3,2,0.511905,0,0,11,17,false,true,true,0.604,0.396
32,27,5,16,27,5,758,750,8,0,0,0,0,87,2,1,0.425287,1,0,6,7,false,true,true,0.563,0.437
268,224,44,22.333333,18.666667,44,791,774,17,1,0,0.083333,0,28,12,12,1.464286,0,0,13,10,false,true,true,0.913,0.087
355,284,71,23.666667,18.933333,71,804,988,-184,2,0,0.133333,0,-11,15,15,-3,0,0,7,3,false,true,true,1,0
324,300,24,13.5,12.5,24,871,999,-128,0,0,0,0,-39,24,24,-1.230769,0,0,1,1,true,true,true,0.945,0.055
267,163,104,33.375,23.285714,104,1148,1164,-16,1,1,0.125,0.142857,33,8,7,0.757576,0,0,9,13,false,true,true,0.988,0.012
357,301,56,19.833333,16.722222,56,1547,1439,108,1,0,0.055556,0,-19,18,18,-1.947368,0,0,4,3,false,true,true,1,0
105,98,7,21,19.6,7,1388,1506,-118,1,1,0.2,0.2,65,5,5,0.523077,1,0,9,20,false,true,true,0.933,0.067
215,181,34,21.5,20.111111,34,1040,925,115,0,0,0,0,28,10,9,1.535714,0,0,13,10,false,true,true,0.584,0.416
344,247,97,28.666667,20.583333,97,1489,1555,-66,1,0,0.083333,0,8,12,12,3.625,0,0,10,13,false,true,true,1,0
208,181,27,23.111111,22.625,27,907,752,155,0,0,0,0,41,9,8,0.804878,0,0,13,8,false,true,true,0.56,0.44
0,12,-12,0,12,-12,1397,1422,-25,0,0,0,0,97,1,1,0.371134,0,0,8,14,false,true,false,0.28,0.72
301,250,51,18.8125,16.666667,51,1159,1031,128,1,0,0.0625,0,-10,16,15,-3.9,0,0,7,10,false,true,true,0.98,0.02
73,96,-23,18.25,24,-23,1659,1782,-123,0,0,0,0,69,4,4,0.42029,0,0,7,7,false,true,false,0.278,0.722
249,254,-5,24.9,25.4,-5,1670,1770,-100,1,1,0.1,0.1,29,10,10,1.103448,0,0,10,11,false,true,true,0.552,0.448
300,247,53,16.666667,13.722222,53,566,542,24,0,0,0,0,-9,18,18,-4.555556,0,0,12,3,false,true,true,0.998,0.002
284,293,-9,25.818182,26.636364,-9,1762,1582,180,2,3,0.181818,0.272727,12,11,11,2.666667,0,0,7,24,false,true,true,0.882,0.118
222,136,86,37,22.666667,86,1396,1454,-58,1,0,0.166667,0,50,6,6,0.66,1,0,6,15,false,true,true,0.986,0.014
207,106,101,34.5,17.666667,101,1935,2020,-85,0,0,0,0,57,6,6,0.54386,1,0,6,10,false,true,true,0.985,0.015
204,103,101,34,20.6,101,1148,1164,-16,1,0,0.166667,0,53,6,5,0.471698,0,1,15,10,false,true,true,0.872,0.128
112,144,-32,22.4,36,-32,834,844,-10,0,1,0,0.25,61,5,4,0.590164,0,0,9,8,false,true,false,0.27,0.73
179,116,63,29.833333,23.2,63,795,830,-35,1,1,0.166667,0.2,51,6,5,0.823529,1,0,16,8,false,true,true,0.985,0.015
303,118,185,16.833333,6.941176,185,859,719,140,0,1,0,0.058824,-8,18,17,-6.625,0,1,24,16,false,true,true,1,0
85,150,-65,14.166667,25,-65,1075,989,86,0,0,0,0,64,6,6,0.609375,0,0,33,14,false,true,false,0.447,0.553
84,27,57,28,13.5,57,1507,1554,-47,0,0,0,0,81,3,2,0.358025,1,0,6,16,false,true,true,0.765,0.235
371,340,31,23.1875,21.25,31,856,897,-41,0,1,0,0.0625,-19,16,16,-1.842105,0,0,5,1,false,true,true,0.977,0.023
293,221,72,22.538462,18.416667,72,1439,1413,26,0,0,0,0,20,13,12,1.8,1,0,13,7,false,true,true,0.99,0.01
71,73,-2,17.75,18.25,-2,620,513,107,0,0,0,0,73,4,4,0.616438,0,0,7,11,false,true,true,0.682,0.318
104,145,-41,11.555556,16.111111,-41,826,771,55,0,0,0,0,52,9,9,0.865385,0,1,11,8,false,true,false,0.235,0.765
230,122,108,32.857143,20.333333,108,1349,1302,47,0,0,0,0,49,7,6,0.591837,0,0,10,9,false,true,true,0.953,0.047
325,322,3,17.105263,16.947368,3,1388,1477,-89,1,0,0.052632,0,-16,19,19,-3,1,0,4,8,false,true,true,0.734,0.266
251,186,65,19.307692,14.307692,65,1037,950,87,1,0,0.076923,0,13,13,13,2.384615,0,0,8,18,false,true,true,0.995,0.005
364,338,26,22.75,21.125,26,1388,1506,-118,2,1,0.125,0.0625,-8,16,16,-4.25,0,0,1,3,false,true,true,0.962,0.038
400,268,132,16.666667,11.166667,132,1011,921,90,1,0,0.041667,0,-23,24,24,-2.130435,0,0,1,11,false,true,true,1,0
63,65,-2,21,21.666667,-2,1148,1164,-16,0,0,0,0,77,3,3,0.324675,0,0,15,8,false,true,true,0.523,0.477
156,89,67,31.2,17.8,67,901,1159,-258,2,0,0.4,0,63,5,5,0.555556,0,0,10,17,false,true,true,0.894,0.106
326,293,33,40.75,36.625,33,1885,1793,92,0,0,0,0,27,8,8,1,1,0,8,12,false,true,true,1,0
385,232,153,20.263158,12.888889,153,1586,1782,-196,0,0,0,0,-22,19,18,-1.818182,1,0,0,3,false,true,true,1,0
417,318,99,27.8,22.714286,99,1093,1100,-7,3,3,0.2,0.214286,-8,15,14,-4,0,1,1,4,false,true,true,0.992,0.008
396,335,61,23.294118,19.705882,61,1220,1261,-41,2,0,0.117647,0,-7,17,17,-6.428571,0,0,15,12,false,true,true,1,0
274,243,31,14.421053,12.789474,31,1016,1037,-21,0,0,0,0,-2,19,19,-24,1,0,6,16,false,true,true,0.968,0.032
135,132,3,15,16.5,3,864,808,56,1,0,0.111111,0,34,9,8,1,1,0,10,15,false,true,true,0.894,0.106
89,42,47,22.25,14,47,1210,1253,-43,0,0,0,0,73,4,3,0.479452,0,0,10,18,false,true,true,0.574,0.426
0,48,-48,0,48,-48,1554,1573,-19,0,0,0,0,95,1,1,0.357895,0,0,7,16,false,true,false,0.028,0.972
88,93,-5,22,31,-5,1302,1234,68,0,0,0,0,70,4,3,0.442857,1,0,9,8,false,true,false,0.467,0.533
18,16,2,18,16,2,1065,1030,35,0,0,0,0,93,1,1,0.365591,0,0,19,11,false,true,true,0.56,0.44
408,247,161,21.473684,13.722222,161,777,830,-53,1,0,0.052632,0,-20,19,18,-2.05,0,0,4,6,false,true,true,1,0
240,115,125,30,16.428571,125,1408,1454,-46,1,0,0.125,0,47,8,7,0.680851,0,0,12,19,false,true,true,0.988,0.012
336,277,59,21,18.466667,59,892,788,104,3,0,0.1875,0,-1,16,15,-43,0,0,21,10,false,true,true,0.993,0.007
80,0,80,80,0,80,971,621,350,1,0,1,0,93,1,0,0.344086,0,0,12,0,false,true,true,0.784,0.216
44,30,14,14.666667,15,14,1651,1691,-40,0,0,0,0,88,3,2,0.386364,0,0,18,14,false,true,false,0.299,0.701
571,360,211,40.785714,25.714286,211,991,996,-5,3,0,0.214286,0,-9,14,14,-3.333333,0,0,6,7,false,true,true,1,0
340,274,66,24.285714,19.571429,66,804,988,-184,2,0,0.142857,0,-5,14,14,-6.6,0,0,11,4,false,true,true,0.998,0.002
127,89,38,21.166667,14.833333,38,272,288,-16,0,0,0,0,59,6,6,0.881356,1,0,13,20,false,true,true,0.758,0.242
385,375,10,24.0625,23.4375,10,1397,1195,202,1,0,0.0625,0,-12,16,16,-2.916667,0,0,5,2,false,true,true,0.992,0.008
113,65,48,22.6,16.25,48,885,719,166,0,0,0,0,72,5,4,0.527778,0,1,14,9,false,true,true,0.84,0.16
43,18,25,21.5,9,25,947,909,38,0,0,0,0,87,2,2,0.528736,1,0,7,30,false,true,true,0.847,0.153
215,169,46,30.714286,24.142857,46,2219,2106,113,1,0,0.142857,0,42,7,7,0.642857,0,0,9,10,false,true,true,0.995,0.005
150,86,64,25,17.2,64,939,907,32,0,0,0,0,64,6,5,0.625,1,0,17,12,false,true,true,0.91,0.09
259,300,-41,16.1875,18.75,-41,999,1011,-12,0,0,0,0,-2,16,16,-23,1,0,11,7,false,true,false,0.083,0.917
183,124,59,22.875,17.714286,59,1572,1550,22,1,0,0.125,0,47,8,7,0.829787,0,0,23,7,false,true,true,0.847,0.153
315,320,-5,19.6875,21.333333,-5,971,906,65,0,0,0,0,-14,16,15,-2.285714,1,0,3,4,false,true,false,0.432,0.568
327,241,86,29.727273,21.909091,86,1489,1555,-66,1,0,0.090909,0,14,11,11,2.071429,0,0,9,9,false,true,true,1,0
194,125,69,24.25,15.625,69,1115,1078,37,0,0,0,0,46,8,8,0.73913,1,0,15,11,false,true,true,0.993,0.007
354,292,62,23.6,19.466667,62,1220,1261,-41,2,0,0.133333,0,7,15,15,6.428571,1,0,15,7,false,true,true,1,0
299,226,73,19.933333,16.142857,73,880,952,-72,0,0,0,0,2,15,14,20.5,0,0,20,10,false,true,true,0.989,0.011
215,163,52,19.545455,14.818182,52,831,830,1,0,0,0,0,27,11,11,1.37037,1,0,26,10,false,true,true,0.993,0.007
266,189,77,19,13.5,77,415,518,-103,0,0,0,0,9,14,14,4.222222,0,0,8,19,false,true,true,0.983,0.017
96,81,15,24,20.25,15,941,926,15,1,0,0.25,0,68,4,4,0.558824,0,0,20,9,false,true,true,0.571,0.429
207,163,44,17.25,13.583333,44,913,871,42,0,0,0,0,26,12,12,1.653846,0,0,14,25,false,true,true,0.962,0.038
244,287,-43,20.333333,23.916667,-43,971,761,210,0,0,0,0,12,12,12,2.5,0,0,12,14,false,true,false,0.078,0.922
339,260,79,19.941176,15.294118,79,1170,1156,14,1,0,0.058824,0,-18,17,17,-2.111111,0,0,4,4,false,true,true,1,0
386,350,36,29.692308,29.166667,36,1428,1452,-24,1,2,0.076923,0.166667,3,13,12,10.333333,0,0,8,17,false,true,true,0.943,0.057
200,152,48,20,16.888889,48,847,952,-105,0,0,0,0,47,10,9,0.765957,0,1,7,17,false,true,false,0.449,0.551
149,108,41,16.555556,13.5,41,448,598,-150,0,0,0,0,41,9,8,0.878049,1,0,19,12,false,true,true,0.867,0.133
371,258,113,30.916667,23.454545,113,1396,1454,-58,2,0,0.166667,0,14,12,11,2.357143,0,0,7,12,false,true,true,1,0
202,91,111,40.4,22.75,111,1684,1320,364,1,0,0.2,0,59,5,4,0.508475,0,0,11,12,false,true,true,1,0
188,117,71,26.857143,19.5,71,1482,1394,88,1,0,0.142857,0,55,7,6,0.654545,1,0,9,16,false,true,true,0.943,0.057
122,129,-7,30.5,32.25,-7,1489,1558,-69,0,1,0,0.25,65,4,4,0.430769,0,0,18,11,false,true,false,0.477,0.523
158,121,37,19.75,17.285714,37,971,658,313,0,0,0,0,49,8,7,0.734694,0,1,12,16,false,true,true,0.526,0.474
148,63,85,29.6,15.75,85,769,527,242,1,0,0.2,0,60,5,4,0.6,1,0,21,9,false,true,true,0.984,0.016
339,328,11,24.214286,25.230769,11,1102,1245,-143,2,0,0.142857,0,-24,14,13,-1.166667,0,0,1,1,false,true,true,0.999,0.001
245,164,81,24.5,16.4,81,1216,1230,-14,1,0,0.1,0,35,10,10,0.914286,0,0,11,10,false,true,true,0.988,0.012
330,199,131,30,19.9,131,1334,1256,78,2,0,0.181818,0,21,11,10,1.47619,0,0,7,12,false,true,true,1,0
108,111,-3,15.428571,18.5,-3,999,1011,-12,0,0,0,0,56,7,6,0.821429,0,0,12,21,false,true,false,0.246,0.754
329,213,116,16.45,10.65,116,1428,1302,126,0,0,0,0,-17,20,20,-3.117647,0,1,14,13,false,true,true,1,0
247,131,116,30.875,16.375,116,1439,1353,86,1,0,0.125,0,43,8,8,0.697674,1,0,8,10,false,true,true,0.994,0.006
18,0,18,18,0,18,316,306,10,0,0,0,0,97,1,0,0.391753,1,0,11,0,false,true,true,0.774,0.226
308,278,30,15.4,13.9,30,1030,1045,-15,1,0,0.05,0,-15,20,20,-3.066667,0,0,10,9,false,true,true,0.978,0.022
336,304,32,16.8,15.2,32,363,668,-305,0,0,0,0,-17,20,20,-2.529412,0,0,7,1,false,true,true,1,0
110,77,33,27.5,25.666667,33,1428,1452,-24,0,0,0,0,76,4,3,0.407895,0,0,15,11,false,true,true,0.565,0.435
450,322,128,22.5,16.1,128,1167,1216,-49,1,0,0.05,0,-15,20,20,-2.733333,0,0,1,2,false,true,true,1,0
70,127,-57,10,18.142857,-57,1221,1258,-37,0,0,0,0,58,7,7,0.672414,1,0,11,10,false,true,false,0.267,0.733
356,314,42,16.952381,14.952381,42,795,830,-35,1,1,0.047619,0.047619,-25,21,21,-1.68,0,0,1,4,true,true,true,1,0
111,67,44,18.5,13.4,44,527,581,-54,0,0,0,0,61,6,5,0.688525,1,0,6,19,false,true,true,0.789,0.211
125,94,31,17.857143,15.666667,31,1048,1000,48,0,0,0,0,57,7,6,0.701754,0,1,7,7,false,true,false,0.45,0.55
313,282,31,14.904762,14.1,31,808,639,169,0,0,0,0,-24,21,20,-1.708333,0,0,3,1,true,true,true,1,0
357,195,162,19.833333,11.470588,162,872,818,54,0,1,0,0.058824,-1,18,17,-41,0,0,8,10,false,true,true,1,0
22,21,1,11,21,1,801,807,-6,0,0,0,0,87,2,1,0.402299,0,0,7,20,false,true,false,0.28,0.72
306,328,-22,34,36.444444,-22,2219,2029,190,0,0,0,0,17,9,9,1.529412,0,0,15,11,false,true,true,1,0
168,170,-2,16.8,17,-2,859,786,73,0,0,0,0,31,10,10,1.225806,1,0,22,7,false,true,true,0.804,0.196
438,249,189,19.909091,11.857143,189,1295,1477,-182,3,0,0.136364,0,-24,22,21,-1.916667,0,0,1,1,false,true,true,1,0
172,127,45,24.571429,21.166667,45,758,796,-38,0,0,0,0,52,7,6,0.730769,0,0,12,7,false,true,true,0.818,0.182
450,322,128,21.428571,16.1,128,1167,1216,-49,1,0,0.047619,0,-15,21,20,-2.733333,0,0,1,2,true,true,true,1,0
279,236,43,21.461538,18.153846,43,1295,1281,14,0,0,0,0,23,13,13,1.652174,0,1,7,9,false,true,true,0.731,0.269
173,92,81,34.6,18.4,81,971,1180,-209,1,0,0.2,0,65,5,5,0.492308,0,0,8,10,false,true,true,0.934,0.066
218,136,82,24.222222,15.111111,82,1065,1030,35,0,0,0,0,39,9,9,0.871795,1,0,9,7,false,true,true,0.996,0.004
86,81,5,12.285714,13.5,5,218,86,132,0,0,0,0,55,7,6,0.727273,0,0,26,10,false,true,true,0.652,0.348
223,133,90,22.3,13.3,90,1159,1031,128,1,0,0.1,0,26,10,10,1.5,1,0,15,17,false,true,true,0.996,0.004
390,295,95,21.666667,16.388889,95,1394,1118,276,0,1,0,0.055556,-17,18,18,-2.176471,0,0,11,1,false,true,true,1,0
458,235,223,28.625,15.666667,223,820,783,37,1,1,0.0625,0.066667,-14,16,15,-2.357143,0,0,3,1,false,true,true,1,0
359,257,102,19.944444,15.117647,102,831,830,1,0,0,0,0,-13,18,17,-2.846154,0,0,8,6,false,true,true,1,0
184,142,42,20.444444,17.75,42,518,533,-15,1,0,0.111111,0,38,9,8,0.921053,0,0,14,8,false,true,true,0.886,0.114
346,319,27,15.727273,14.5,27,1221,1438,-217,0,0,0,0,-21,22,22,-2.142857,0,0,2,1,false,true,true,1,0
169,184,-15,16.9,18.4,-15,628,658,-30,0,0,0,0,35,10,10,1.314286,0,0,16,7,false,true,false,0.352,0.648
322,205,117,26.833333,18.636364,117,769,527,242,1,0,0.083333,0,10,12,11,3.6,0,0,10,9,false,true,true,1,0
251,189,62,31.375,27,62,1935,2020,-85,0,1,0,0.142857,43,8,7,0.72093,1,0,9,9,false,true,true,0.896,0.104
29,32,-3,14.5,16,-3,1452,1469,-17,0,0,0,0,85,2,2,0.447059,0,0,10,10,false,true,false,0.409,0.591
267,188,79,24.272727,18.8,79,596,595,1,1,0,0.090909,0,27,11,10,1.481481,0,0,7,15,false,true,true,0.972,0.028
60,75,-15,15,18.75,-15,1452,1469,-17,0,0,0,0,70,4,4,0.542857,0,0,16,14,false,true,false,0.276,0.724
18,12,6,18,12,6,1078,1130,-52,0,0,0,0,90,1,1,0.433333,0,1,24,12,false,true,true,0.531,0.469
169,131,38,24.142857,18.714286,38,820,822,-2,0,0,0,0,50,7,7,0.78,0,0,11,10,false,true,true,0.929,0.071
279,218,61,21.461538,18.166667,61,1364,1093,271,0,1,0,0.083333,14,13,12,2.714286,0,0,20,10,false,true,true,0.947,0.053
334,238,96,17.578947,13.222222,96,539,632,-93,0,0,0,0,-7,19,18,-6.571429,0,0,11,10,false,true,true,1,0
25,45,-20,12.5,22.5,-20,926,854,72,0,0,0,0,85,2,2,0.4,0,0,11,16,false,true,false,0.312,0.688
344,241,103,28.666667,21.909091,103,1489,1555,-66,1,0,0.083333,0,11,12,11,2.636364,0,0,10,9,false,true,true,1,0
231,191,40,19.25,17.363636,40,711,876,-165,0,0,0,0,22,12,11,1.954545,0,0,10,7,false,true,true,0.661,0.339
53,67,-14,13.25,16.75,-14,831,830,1,0,0,0,0,73,4,4,0.506849,0,0,18,10,false,true,false,0.384,0.616
182,178,4,30.333333,29.666667,4,1096,1009,87,1,0,0.166667,0,65,6,6,0.676923,0,0,8,13,false,true,true,0.532,0.468
209,134,75,41.8,26.8,75,1197,1127,70,0,0,0,0,56,5,5,0.535714,0,0,20,8,false,true,true,0.976,0.024
263,181,82,23.909091,18.1,82,976,965,11,1,0,0.090909,0,18,11,10,1.777778,1,1,11,19,false,true,true,0.888,0.112
319,168,151,26.583333,15.272727,151,778,758,20,0,1,0,0.090909,11,12,11,3.545455,0,0,8,17,false,true,true,1,0
77,62,15,25.666667,20.666667,15,691,473,218,0,0,0,0,76,3,3,0.473684,0,0,7,12,false,true,true,0.77,0.23
312,161,151,17.333333,8.944444,151,993,897,96,1,0,0.055556,0,-11,18,18,-4.272727,0,1,25,25,false,true,true,1,0
196,126,70,39.2,25.2,70,1320,1339,-19,2,1,0.4,0.2,56,5,5,0.696429,0,0,9,22,false,true,true,0.988,0.012
279,212,67,23.25,17.666667,67,1110,1039,71,0,0,0,0,14,12,12,2.571429,0,0,13,13,false,true,true,0.982,0.018
10,0,10,10,0,10,628,658,-30,0,0,0,0,96,1,0,0.479167,0,0,26,0,false,true,true,0.548,0.452
35,49,-14,11.666667,16.333333,-14,491,398,93,0,0,0,0,81,3,3,0.444444,0,1,15,16,false,true,true,0.566,0.434
72,69,3,18,23,3,1548,1493,55,0,0,0,0,73,4,3,0.561644,1,0,6,8,false,true,false,0.364,0.636
343,346,-3,22.866667,23.066667,-3,1501,1473,28,1,0,0.066667,0,-9,15,15,-4,0,0,6,4,false,true,true,0.934,0.066
228,168,60,28.5,21,60,1109,1065,44,0,0,0,0,34,8,8,0.970588,0,0,7,12,false,true,true,0.94,0.06
325,336,-11,21.666667,24,-11,1127,1134,-7,0,1,0,0.071429,-10,15,14,-3,0,0,5,8,false,true,false,0.048,0.952
245,223,22,27.222222,24.777778,22,1710,1636,74,1,1,0.111111,0.111111,33,9,9,1.090909,1,0,9,15,false,true,true,0.906,0.094
215,205,10,16.538462,15.769231,10,1583,1422,161,0,0,0,0,31,13,13,1.645161,1,0,9,20,false,true,true,0.843,0.157
352,215,137,29.333333,17.916667,137,986,856,130,1,0,0.083333,0,2,12,12,15.5,0,0,12,14,false,true,true,1,0
4,11,-7,4,11,-7,596,595,1,0,0,0,0,94,1,1,0.425532,0,1,14,13,false,true,false,0.41,0.59
109,80,29,27.25,20,29,1127,1176,-49,0,0,0,0,69,4,4,0.608696,0,0,14,13,false,true,true,0.614,0.386
336,308,28,16,15.4,28,628,658,-30,0,0,0,0,-19,21,20,-2.421053,0,0,3,8,false,true,true,1,0
263,230,33,23.909091,20.909091,33,1089,1063,26,1,0,0.090909,0,23,11,11,1.652174,1,0,9,11,false,true,true,0.932,0.068
317,336,-19,22.642857,24,-19,1127,1134,-7,0,1,0,0.071429,-4,14,14,-7.5,0,0,5,8,false,true,false,0.076,0.924
283,220,63,20.214286,16.923077,63,921,1072,-151,1,0,0.071429,0,15,14,13,2.533333,0,1,12,11,false,true,true,0.836,0.164
334,282,52,16.7,14.1,52,416,374,42,0,0,0,0,-14,20,20,-3.285714,0,0,6,4,false,true,true,1,0
32,20,12,16,20,12,1142,1176,-34,0,0,0,0,88,2,1,0.409091,0,0,7,10,false,true,false,0.472,0.528
64,120,-56,9.142857,17.142857,-56,480,518,-38,0,0,0,0,64,7,7,0.71875,0,1,10,6,false,true,false,0.059,0.941
329,299,30,20.5625,18.6875,30,1094,1030,64,0,0,0,0,-12,16,16,-3,0,0,4,4,false,true,true,0.986,0.014
139,99,40,17.375,14.142857,40,371,435,-64,0,0,0,0,43,8,7,1.023256,0,0,10,9,false,true,true,0.869,0.131
172,211,-39,14.333333,17.583333,-39,699,448,251,0,0,0,0,25,12,12,1.6,0,0,12,7,false,true,false,0.127,0.873
149,100,49,24.833333,16.666667,49,1334,1477,-143,0,0,0,0,59,6,6,0.508475,0,2,15,8,false,true,true,0.591,0.409
352,290,62,19.555556,16.111111,62,719,785,-66,0,1,0,0.055556,-15,18,18,-2.4,0,0,4,2,true,true,true,1,0
278,188,90,13.9,9.4,90,310,359,-49,0,0,0,0,-32,20,20,-1.53125,0,0,10,26,false,true,true,1,0
358,268,90,22.375,16.75,90,1516,1397,119,0,1,0,0.0625,-14,16,16,-2.357143,0,1,1,6,false,true,true,1,0
286,139,147,19.066667,9.928571,147,1176,1076,100,0,0,0,0,36,15,14,1.638889,0,0,10,11,false,true,true,1,0
200,214,-14,16.666667,17.833333,-14,361,493,-132,1,0,0.083333,0,11,12,12,3.727273,0,0,11,20,false,true,false,0.483,0.517
101,102,-1,16.833333,20.4,-1,1100,1008,92,0,0,0,0,68,6,5,0.529412,2,0,5,15,false,true,true,0.779,0.221
262,241,21,18.714286,17.214286,21,334,446,-112,0,0,0,0,-2,14,14,-20,0,1,8,12,false,true,true,0.772,0.228
192,139,53,21.333333,17.375,53,1127,1075,52,1,0,0.111111,0,39,9,8,0.794872,0,1,12,9,false,true,true,0.852,0.148
153,77,76,17,9.625,76,859,719,140,0,1,0,0.125,37,9,8,1.432432,0,2,19,9,false,true,true,0.929,0.071
67,53,14,16.75,13.25,14,346,231,115,0,0,0,0,69,4,4,0.594203,0,0,11,14,false,true,true,0.796,0.204
361,237,124,21.235294,14.8125,124,1011,921,90,1,0,0.058824,0,0,17,16,0,0,0,11,16,false,true,true,1,0
343,280,63,22.866667,18.666667,63,904,668,236,0,0,0,0,-20,15,15,-1.7,0,0,4,3,false,true,true,1,0
140,148,-8,23.333333,24.666667,-8,290,416,-126,0,0,0,0,58,6,6,0.586207,0,0,13,12,false,true,false,0.313,0.687
125,166,-41,13.888889,20.75,-41,1075,989,86,0,0,0,0,56,9,8,0.696429,0,0,26,17,false,true,false,0.419,0.581
335,255,80,20.9375,17,80,691,473,218,0,0,0,0,-9,16,15,-4,1,0,2,4,false,true,true,1,0
6,8,-2,3,8,-2,901,1159,-258,0,0,0,0,94,2,1,0.37234,0,0,10,21,false,true,false,0.155,0.845
185,98,87,37,24.5,87,992,1100,-108,2,0,0.4,0,61,5,4,0.557377,0,0,7,11,false,true,true,0.927,0.073
296,290,6,26.909091,29,6,1297,1606,-309,1,1,0.090909,0.1,19,11,10,1.578947,0,0,10,9,false,true,true,0.549,0.451
131,115,16,21.833333,23,16,1302,1234,68,0,0,0,0,57,6,5,0.54386,1,0,10,17,false,true,true,0.59,0.41
131,86,45,32.75,21.5,45,1762,1616,146,1,0,0.25,0,66,4,4,0.454545,0,0,10,18,false,true,true,0.643,0.357
67,74,-7,11.166667,14.8,-7,523,480,43,0,0,0,0,65,6,5,0.507692,0,0,22,8,false,true,true,0.538,0.462
315,304,11,17.5,17.882353,11,527,514,13,0,0,0,0,-18,18,17,-2.166667,0,0,3,1,false,true,true,0.681,0.319
260,153,107,20,12.75,107,1586,1782,-196,0,0,0,0,17,13,12,2.352941,1,0,9,14,false,true,true,0.999,0.001
39,13,26,19.5,13,26,416,222,194,0,0,0,0,88,2,1,0.625,1,0,6,7,false,true,true,0.786,0.214
256,150,106,28.444444,16.666667,106,1014,948,66,1,0,0.111111,0,40,9,9,0.825,0,0,8,21,false,true,true,0.995,0.005
59,33,26,19.666667,16.5,26,1539,1537,2,0,0,0,0,87,3,2,0.367816,0,0,9,10,false,true,false,0.437,0.563
114,106,8,19,17.666667,8,916,876,40,0,0,0,0,54,6,6,0.62963,1,0,12,11,false,true,true,0.806,0.194
83,37,46,20.75,12.333333,46,939,913,26,0,0,0,0,80,4,3,0.5,0,0,11,7,false,true,true,0.694,0.306
66,18,48,22,9,48,834,758,76,0,0,0,0,81,3,2,0.444444,0,1,10,11,false,true,true,0.723,0.277
216,172,44,19.636364,17.2,44,786,847,-61,0,0,0,0,32,11,10,1.0625,0,0,9,10,false,true,true,0.819,0.181
352,361,-9,22,24.066667,-9,1762,1538,224,1,2,0.0625,0.133333,-9,16,15,-3.777778,0,0,1,4,false,true,true,0.999,0.001
132,108,24,18.857143,15.428571,24,1266,1247,19,0,0,0,0,50,7,7,0.64,0,0,10,19,false,true,false,0.439,0.561
334,238,96,18.555556,13.222222,96,371,336,35,2,0,0.111111,0,-26,18,18,-1.461538,0,0,1,13,false,true,true,1,0
401,252,149,30.846154,19.384615,149,1501,1622,-121,2,0,0.153846,0,3,13,13,10.333333,0,0,15,7,false,true,true,1,0
146,122,24,18.25,17.428571,24,831,830,1,0,0,0,0,51,8,7,0.72549,0,0,20,9,false,true,true,0.671,0.329
152,122,30,25.333333,20.333333,30,971,906,65,0,0,0,0,53,6,6,0.603774,0,0,14,11,false,true,true,0.818,0.182
137,54,83,27.4,13.5,83,1586,1782,-196,0,0,0,0,66,5,4,0.606061,1,0,8,16,false,true,true,0.878,0.122
301,242,59,21.5,17.285714,59,1551,1550,1,0,0,0,0,4,14,14,10.5,0,1,12,13,false,true,true,1,0
316,287,29,19.75,19.133333,29,1127,1176,-49,0,0,0,0,0,16,15,0,0,0,9,10,false,true,true,0.646,0.354
315,252,63,18.529412,15.75,63,1270,1315,-45,0,0,0,0,-11,17,16,-3.272727,0,0,1,28,false,true,true,1,0
235,216,19,16.785714,16.615385,19,613,549,64,0,0,0,0,12,14,13,3.666667,1,0,7,12,false,true,true,0.819,0.181
308,262,46,15.4,13.789474,46,1030,1045,-15,1,0,0.05,0,-11,20,19,-4.181818,0,0,10,8,false,true,true,0.996,0.004
362,308,54,22.625,19.25,54,1220,1261,-41,2,0,0.125,0,1,16,16,45,1,0,15,12,false,true,true,1,0
385,318,67,25.666667,21.2,67,1355,1210,145,2,0,0.133333,0,-2,15,15,-15,1,0,6,8,true,true,true,1,0
279,219,60,23.25,19.909091,60,1295,1281,14,0,0,0,0,29,12,11,1.310345,0,1,7,8,false,true,true,0.771,0.229
409,275,134,17.782609,11.956522,134,1413,1422,-9,0,0,0,0,-26,23,23,-2.192308,0,0,3,3,false,true,true,1,0
41,20,21,20.5,10,21,859,822,37,0,0,0,0,80,2,2,0.475,0,0,22,7,false,true,true,0.675,0.325
201,154,47,15.461538,12.833333,47,218,86,132,0,0,0,0,12,13,12,3.333333,0,0,22,9,false,true,true,0.952,0.048
288,208,80,24,18.909091,80,306,169,137,0,0,0,0,9,12,11,3.777778,0,1,10,7,false,true,true,0.965,0.035
409,274,135,27.266667,18.266667,135,986,856,130,1,0,0.066667,0,-18,15,15,-1.722222,0,0,3,2,false,true,true,1,0
85,105,-20,21.25,26.25,-20,1305,1218,87,0,0,0,0,68,4,4,0.558824,1,1,9,6,false,true,false,0.366,0.634
61,63,-2,15.25,21,-2,1050,1144,-94,0,0,0,0,78,4,3,0.487179,0,0,7,9,false,true,false,0.166,0.834
14,20,-6,14,20,-6,1265,1237,28,0,0,0,0,92,1,1,0.326087,0,0,12,18,false,true,false,0.297,0.703
122,130,-8,15.25,18.571429,-8,272,238,34,0,0,0,0,46,8,7,0.869565,0,0,11,9,false,true,true,0.532,0.468
293,213,80,29.3,23.666667,80,1510,1583,-73,1,0,0.1,0,23,10,9,1.391304,0,0,18,13,false,true,true,0.976,0.024
70,63,7,17.5,15.75,7,371,435,-64,0,0,0,0,69,4,4,0.637681,0,0,9,11,false,true,false,0.401,0.599
215,239,-24,15.357143,17.071429,-24,719,614,105,0,1,0,0.071429,7,14,14,6.142857,0,0,21,11,false,true,true,0.829,0.171
350,265,85,19.444444,14.722222,85,719,651,68,0,1,0,0.055556,-6,18,18,-7.5,0,0,10,10,false,true,true,1,0
143,96,47,15.888889,12,47,498,43,455,0,0,0,0,40,9,8,0.925,0,0,12,11,false,true,true,0.612,0.388
61,35,26,20.333333,11.666667,26,872,818,54,0,0,0,0,78,3,3,0.525641,0,1,10,9,false,true,true,0.604,0.396
143,107,36,20.428571,17.833333,36,349,315,34,0,0,0,0,49,7,6,0.693878,0,0,12,9,false,true,true,0.906,0.094
130,73,57,26,18.25,57,1127,1075,52,1,0,0.2,0,69,5,4,0.449275,0,0,17,10,false,true,true,0.676,0.324
403,268,135,20.15,14.105263,135,939,907,32,1,0,0.05,0,-18,20,19,-2.222222,0,0,1,1,false,true,true,1,0
249,272,-23,16.6,18.133333,-23,527,514,13,0,0,0,0,-5,15,15,-7.8,0,0,17,8,false,true,true,0.576,0.424
113,72,41,37.666667,24,41,1762,1616,146,1,0,0.333333,0,76,3,3,0.394737,0,0,11,14,false,true,true,0.594,0.406
375,303,72,22.058824,18.9375,72,1482,1394,88,2,0,0.117647,0,-13,17,16,-2.769231,0,0,2,3,false,true,true,1,0
275,220,55,30.555556,27.5,55,1454,1531,-77,1,1,0.111111,0.125,27,9,8,1.111111,0,0,17,7,false,true,true,0.922,0.078
359,345,14,21.117647,21.5625,14,1096,1009,87,2,0,0.117647,0,1,17,16,44,0,0,12,15,false,true,true,0.741,0.259
26,0,26,26,0,26,791,885,-94,0,0,0,0,94,1,0,0.404255,1,0,6,0,false,true,false,0.376,0.624
271,166,105,33.875,23.714286,105,1245,1241,4,1,1,0.125,0.142857,40,8,7,0.725,0,0,14,12,false,true,true,0.988,0.012
413,315,98,21.736842,17.5,98,1550,1466,84,1,0,0.052632,0,-22,19,18,-1.681818,0,0,1,1,true,true,true,1,0
278,208,70,27.8,23.111111,70,1762,1582,180,2,2,0.2,0.222222,26,10,9,1.230769,0,0,7,20,false,true,true,0.989,0.011
345,251,94,19.166667,14.764706,94,1606,1544,62,0,0,0,0,-2,18,17,-22.5,0,0,10,10,false,true,true,1,0
231,165,66,21,16.5,66,1516,1397,119,0,1,0,0.1,19,11,10,1.736842,0,0,30,14,false,true,true,0.931,0.069
169,145,24,16.9,14.5,24,913,871,42,0,0,0,0,37,10,10,1.162162,0,0,11,19,false,true,true,0.838,0.162
221,190,31,22.1,21.111111,31,1334,1270,64,1,0,0.1,0,37,10,9,1,0,0,14,7,false,true,true,0.553,0.447
249,231,18,17.785714,17.769231,18,448,598,-150,0,0,0,0,3,14,13,12,0,0,16,7,false,true,true,0.523,0.477
286,296,-10,15.052632,15.578947,-10,613,549,64,0,0,0,0,-23,19,19,-1.913043,0,0,3,2,false,true,true,0.582,0.418
202,100,102,28.857143,14.285714,102,801,925,-124,1,0,0.142857,0,44,7,7,0.795455,1,0,25,16,false,true,true,0.975,0.025
120,115,5,17.142857,16.428571,5,1176,1127,49,0,0,0,0,48,7,7,0.770833,0,0,14,26,false,true,false,0.492,0.508
388,385,3,20.421053,20.263158,3,1320,1339,-19,2,1,0.105263,0.052632,-27,19,19,-1.444444,0,0,1,1,false,true,true,0.737,0.263
264,130,134,20.307692,10.833333,134,595,543,52,0,0,0,0,25,13,12,1.88,0,0,8,11,false,true,true,0.998,0.002
223,180,43,20.272727,16.363636,43,691,473,218,0,0,0,0,24,11,11,1.5,0,0,14,19,false,true,true,0.878,0.122
150,62,88,21.428571,10.333333,88,939,913,26,0,0,0,0,66,7,6,0.606061,0,0,10,12,false,true,true,0.987,0.013
378,286,92,17.181818,13,92,719,651,68,0,1,0,0.045455,-31,22,22,-1.451613,0,0,1,1,false,true,true,1,0
318,246,72,26.5,22.363636,72,965,1013,-48,1,0,0.083333,0,9,12,11,3.666667,0,1,8,10,false,true,true,0.989,0.011
122,144,-22,15.25,18,-22,272,238,34,0,0,0,0,42,8,8,0.952381,0,0,11,12,false,true,true,0.518,0.482
268,199,69,22.333333,18.090909,69,1364,1093,271,0,1,0,0.090909,21,12,11,1.809524,0,0,16,12,false,true,true,0.97,0.03
398,197,201,39.8,21.888889,201,1571,1554,17,2,1,0.2,0.111111,18,10,9,1.833333,1,0,12,14,false,true,true,1,0
74,42,32,18.5,10.5,32,1181,1069,112,0,0,0,0,72,4,4,0.513889,1,0,12,16,false,true,true,0.893,0.107
356,260,96,19.777778,15.294118,96,527,503,24,0,0,0,0,-6,18,17,-6.833333,0,0,6,7,false,true,true,1,0
234,246,-12,19.5,22.363636,-12,594,605,-11,0,0,0,0,18,12,11,2.055556,1,0,15,10,false,true,false,0.443,0.557
334,275,59,22.266667,18.333333,59,1731,1691,40,1,0,0.066667,0,-7,15,15,-4.857143,0,0,8,15,false,true,true,1,0
14,0,14,14,0,14,1203,1221,-18,0,0,0,0,96,1,0,0.364583,0,0,15,0,false,true,true,0.562,0.438
394,293,101,17.130435,12.73913,101,539,632,-93,0,0,0,0,-32,23,23,-1.4375,0,0,1,4,true,true,true,1,0
80,31,49,26.666667,15.5,49,1078,1130,-52,0,0,0,0,83,3,2,0.46988,0,1,8,12,false,true,true,0.554,0.446
231,179,52,23.1,19.888889,52,1170,1156,14,1,0,0.1,0,30,10,9,1.266667,1,0,8,16,false,true,true,0.941,0.059
36,47,-11,18,23.5,-11,1554,1716,-162,0,0,0,0,86,2,2,0.406977,1,0,9,9,false,true,true,0.653,0.347
245,141,104,27.222222,17.625,104,880,952,-72,0,0,0,0,43,9,8,0.813953,0,0,22,19,false,true,true,0.902,0.098
234,227,7,16.714286,16.214286,7,527,581,-54,0,0,0,0,5,14,14,8.4,0,0,20,17,false,true,true,0.561,0.439
290,247,43,24.166667,22.454545,43,992,1100,-108,2,0,0.166667,0,17,12,11,2,0,0,16,19,false,true,true,0.913,0.087
29,22,7,14.5,22,7,1547,1439,108,0,0,0,0,91,2,1,0.406593,1,0,6,7,false,true,false,0.366,0.634
37,43,-6,12.333333,14.333333,-6,1159,1031,128,0,0,0,0,75,3,3,0.52,1,0,15,15,false,true,true,0.803,0.197
299,269,30,14.238095,12.809524,30,613,502,111,0,0,0,0,-26,21,21,-1.884615,0,0,5,15,false,true,true,1,0
245,186,59,24.5,18.6,59,1051,1030,21,0,0,0,0,26,10,10,1.153846,0,0,10,7,false,true,true,0.961,0.039
312,238,74,24,19.833333,74,613,569,44,0,0,0,0,11,13,12,3.545455,1,0,10,7,false,true,true,1,0
382,303,79,29.384615,23.307692,79,1349,1302,47,0,0,0,0,-4,13,13,-7.25,0,0,17,2,false,true,true,1,0
194,178,16,13.857143,13.692308,16,826,771,55,0,0,0,0,25,14,13,1.8,0,1,17,9,false,true,true,0.838,0.162
96,62,34,24,20.666667,34,941,926,15,1,0,0.25,0,71,4,3,0.535211,0,0,20,8,false,true,true,0.581,0.419
238,274,-36,14.875,17.125,-36,576,494,82,0,0,0,0,1,16,16,44,0,1,12,6,false,true,false,0.06,0.94
266,251,15,16.625,16.733333,15,613,549,64,0,0,0,0,-2,16,15,-22,0,0,13,7,false,true,true,0.841,0.159
213,162,51,23.666667,18,51,1036,1181,-145,0,0,0,0,44,9,9,0.772727,0,0,19,7,false,true,true,0.604,0.396
79,71,8,13.166667,14.2,8,299,315,-16,0,0,0,0,66,6,5,0.636364,0,0,7,21,false,true,false,0.227,0.773
201,151,50,22.333333,18.875,50,1513,1479,34,0,0,0,0,41,9,8,0.829268,1,0,7,13,false,true,true,0.834,0.166
354,217,137,25.285714,16.692308,137,939,907,32,1,0,0.071429,0,16,14,13,2.5,0,0,9,7,false,true,true,1,0
84,38,46,16.8,7.6,46,1428,1302,126,0,0,0,0,67,5,5,0.791045,0,1,10,18,false,true,true,0.677,0.323
154,125,29,17.111111,15.625,29,758,750,8,0,0,0,0,36,9,8,1.027778,0,1,9,11,false,true,true,0.632,0.368
184,170,14,23,21.25,14,1548,1493,55,1,0,0.125,0,42,8,8,0.97619,0,0,13,8,false,true,true,0.563,0.437
238,243,-5,13.222222,13.5,-5,1029,1075,-46,0,0,0,0,3,18,18,16,2,0,9,12,false,true,true,0.897,0.103
169,156,13,15.363636,14.181818,13,1048,1000,48,0,0,0,0,37,11,11,1.081081,0,1,15,6,false,true,true,0.678,0.322
134,51,83,19.142857,8.5,83,1176,1076,100,0,0,0,0,66,7,6,0.893939,0,0,12,16,false,true,true,0.985,0.015
30,15,15,30,15,15,892,819,73,0,1,0,1,89,1,1,0.382022,0,0,24,9,false,true,true,0.957,0.043
138,118,20,19.714286,16.857143,20,1220,1261,-41,1,0,0.142857,0,58,7,7,0.775862,0,0,12,11,false,true,true,0.676,0.324
259,287,-28,17.266667,19.133333,-28,999,1011,-12,0,0,0,0,1,15,15,46,1,0,9,16,false,true,false,0.384,0.616
249,234,15,27.666667,26,15,908,1070,-162,1,0,0.111111,0,33,9,9,0.909091,0,0,8,14,false,true,false,0.457,0.543
223,158,65,27.875,19.75,65,1245,1232,13,1,0,0.125,0,30,8,8,0.966667,0,0,19,14,false,true,true,0.96,0.04
188,130,58,23.5,18.571429,58,1439,1294,145,1,0,0.125,0,46,8,7,0.782609,0,0,10,25,false,true,true,0.876,0.124
200,156,44,28.571429,26,44,1489,1555,-66,1,0,0.142857,0,47,7,6,0.617021,1,0,6,13,false,true,true,0.896,0.104
68,38,30,17,12.666667,30,859,822,37,0,0,0,0,70,4,3,0.542857,0,0,30,9,false,true,true,0.756,0.244
183,156,27,18.3,15.6,27,1159,1051,108,0,0,0,0,38,10,10,1.052632,0,0,12,12,false,true,true,0.707,0.293
98,89,9,12.25,11.125,9,904,857,47,0,0,0,0,49,8,8,0.836735,0,1,22,17,false,true,true,0.679,0.321
339,276,63,22.6,19.714286,63,995,912,83,2,0,0.133333,0,11,15,14,4,0,0,11,8,false,true,true,0.996,0.004
36,46,-10,12,15.333333,-10,566,542,24,0,0,0,0,79,3,3,0.518987,0,1,9,14,false,true,false,0.436,0.564
200,138,62,16.666667,12.545455,62,1011,921,90,0,0,0,0,32,12,11,1.53125,1,0,7,18,false,true,true,0.977,0.023
257,202,55,23.363636,20.2,55,1406,1454,-48,0,1,0,0.1,18,11,10,1.888889,1,1,10,18,false,true,true,0.807,0.193
52,33,19,26,16.5,19,892,819,73,0,1,0,0.5,81,2,2,0.419753,0,0,17,14,false,true,true,0.912,0.088
113,166,-53,14.125,20.75,-53,1075,989,86,0,0,0,0,58,8,8,0.672414,0,0,27,17,false,true,false,0.453,0.547
112,82,30,18.666667,13.666667,30,971,658,313,0,0,0,0,60,6,6,0.6,0,0,22,14,false,true,true,0.622,0.378
220,175,45,18.333333,14.583333,45,566,542,24,0,0,0,0,24,12,12,1.708333,0,1,24,7,false,true,true,0.948,0.052
34,39,-5,11.333333,13,-5,856,897,-41,0,0,0,0,77,3,3,0.454545,1,0,11,9,false,true,true,0.574,0.426
255,232,23,23.181818,23.2,23,1344,1325,19,1,0,0.090909,0,19,11,10,1.631579,0,0,10,17,false,true,false,0.353,0.647
204,143,61,25.5,17.875,61,1270,1315,-45,0,0,0,0,42,8,8,0.857143,0,0,7,25,false,true,true,0.943,0.057
28,0,28,28,0,28,1101,1078,23,0,0,0,0,95,1,0,0.347368,0,0,23,0,false,true,true,0.727,0.273
114,75,39,22.8,15,39,609,620,-11,0,0,0,0,67,5,5,0.552239,0,0,11,11,false,true,true,0.938,0.062
171,200,-29,19,25,-29,971,761,210,0,0,0,0,36,9,8,0.833333,0,0,20,15,false,true,false,0.349,0.651
253,221,32,21.083333,20.090909,32,1127,1134,-7,0,0,0,0,16,12,11,1.875,0,1,10,6,false,true,false,0.459,0.541
59,68,-9,19.666667,22.666667,-9,869,820,49,0,1,0,0.333333,80,3,3,0.4625,0,0,15,19,false,true,false,0.388,0.612
145,220,-75,14.5,22,-75,613,611,2,0,0,0,0,25,10,10,1.52,1,0,8,7,false,true,false,0.062,0.938
361,290,71,19,16.111111,71,791,774,17,1,0,0.052632,0,-13,19,18,-3.153846,0,0,2,3,false,true,true,1,0
446,382,64,19.391304,17.363636,64,1220,1261,-41,2,0,0.086957,0,-27,23,22,-1.666667,0,0,1,1,true,true,true,1,0
332,217,115,13.833333,9.041667,115,1428,1302,126,0,0,0,0,-24,24,24,-2.208333,0,1,13,11,false,true,true,1,0
162,123,39,14.727273,12.3,39,1016,1037,-21,0,0,0,0,38,11,10,1.263158,0,0,7,24,false,true,true,0.915,0.085
205,188,17,22.777778,20.888889,17,856,897,-41,0,0,0,0,28,9,9,1.25,0,1,9,14,false,true,true,0.619,0.381
216,180,36,30.857143,25.714286,36,1101,1078,23,0,0,0,0,47,7,7,0.702128,0,1,7,7,false,true,true,0.715,0.285
436,257,179,31.142857,19.769231,179,1550,1624,-74,2,0,0.142857,0,6,14,13,5,1,0,4,7,false,true,true,1,0
314,285,29,17.444444,16.764706,29,947,810,137,0,1,0,0.058824,-12,18,17,-3.5,0,0,10,11,false,true,true,0.968,0.032
194,179,15,19.4,19.888889,15,1572,1550,22,1,0,0.1,0,36,10,9,1.083333,0,1,21,8,false,true,false,0.329,0.671
438,351,87,23.052632,18.473684,87,791,885,-94,1,1,0.052632,0.052632,-28,19,19,-1.357143,0,0,1,1,true,true,true,1,0
32,40,-8,10.666667,13.333333,-8,1142,1176,-34,0,0,0,0,80,3,3,0.45,0,0,16,17,false,true,false,0.316,0.684
342,312,30,20.117647,18.352941,30,825,907,-82,1,0,0.058824,0,-9,17,17,-4.444444,0,0,5,11,false,true,true,0.948,0.052
257,204,53,32.125,25.5,53,1320,1339,-19,2,1,0.25,0.125,35,8,8,1.114286,0,0,8,15,false,true,true,0.988,0.012
204,193,11,20.4,19.3,11,892,788,104,2,0,0.2,0,34,10,10,1.264706,0,0,7,13,false,true,true,0.968,0.032
307,173,134,25.583333,15.727273,134,801,925,-124,1,0,0.083333,0,18,12,11,1.944444,1,0,10,9,false,true,true,0.996,0.004
338,226,112,21.125,15.066667,112,916,837,79,1,0,0.0625,0,2,16,15,20,0,0,8,10,false,true,true,1,0
336,251,85,19.764706,14.764706,85,830,907,-77,1,0,0.058824,0,-7,17,17,-5.571429,0,1,16,4,false,true,true,1,0
107,77,30,13.375,11,30,880,952,-72,0,0,0,0,53,8,7,0.773585,0,0,16,9,false,true,true,0.62,0.38
298,254,44,22.923077,21.166667,44,1388,1506,-118,2,1,0.153846,0.083333,17,13,12,2,0,0,11,21,false,true,true,0.944,0.056
358,277,81,18.842105,14.578947,81,719,651,68,0,1,0,0.052632,-14,19,19,-3.214286,0,0,7,5,false,true,true,1,0
136,145,-9,17,18.125,-9,613,549,64,0,0,0,0,41,8,8,1.073171,0,0,26,20,false,true,true,0.559,0.441
85,156,-71,14.166667,26,-71,1077,1094,-17,0,0,0,0,59,6,6,0.711864,0,0,27,14,false,true,false,0.304,0.696
350,320,30,23.333333,22.857143,30,1344,1325,19,1,0,0.066667,0,-10,15,14,-3.1,0,0,2,3,false,true,true,0.999,0.001
24,0,24,24,0,24,1388,1477,-89,0,0,0,0,95,1,0,0.505263,0,0,7,0,false,true,true,0.561,0.439
80,153,-73,20,51,-73,1885,1793,92,0,0,0,0,68,4,3,0.397059,0,0,13,10,false,true,false,0.035,0.965
111,113,-2,18.5,18.833333,-2,518,533,-15,1,0,0.166667,0,55,6,6,0.636364,0,0,21,7,false,true,false,0.448,0.552
324,285,39,17.052632,15.833333,39,334,446,-112,0,0,0,0,-28,19,18,-1.428571,0,0,2,7,false,true,true,1,0
60,46,14,20,15.333333,14,699,448,251,0,0,0,0,81,3,3,0.493827,0,0,9,7,false,true,true,0.767,0.233
204,162,42,15.692308,13.5,42,691,675,16,0,0,0,0,17,13,12,2.235294,0,0,13,21,false,true,true,0.961,0.039
232,223,9,16.571429,15.928571,9,695,523,172,0,0,0,0,-1,14,14,-37,0,0,20,20,false,true,true,0.827,0.173
302,176,126,20.133333,12.571429,126,421,306,115,0,1,0,0.071429,-2,15,14,-22,0,0,17,9,false,true,true,1,0
162,131,31,18,16.375,31,859,786,73,0,0,0,0,42,9,8,0.904762,1,0,23,16,false,true,true,0.863,0.137
270,172,98,19.285714,13.230769,98,1253,1166,87,1,0,0.071429,0,21,14,13,2.047619,0,0,12,19,false,true,true,0.993,0.007
257,270,-13,17.133333,18,-13,1388,1477,-89,1,0,0.066667,0,7,15,15,6.857143,1,0,10,16,false,true,false,0.362,0.638
203,140,63,20.3,15.555556,63,804,683,121,0,0,0,0,39,10,9,1.153846,0,1,18,10,false,true,true,0.945,0.055
270,239,31,24.545455,23.9,31,1554,1622,-68,2,0,0.181818,0,18,11,10,1.722222,1,0,10,10,false,true,true,0.934,0.066
394,384,10,28.142857,27.428571,10,1302,1349,-47,0,1,0,0.071429,-9,14,14,-3.111111,0,0,1,12,true,true,true,0.975,0.025
432,249,183,20.571429,11.857143,183,1295,1477,-182,3,0,0.142857,0,-20,21,21,-2.3,0,0,2,1,false,true,true,1,0
86,53,33,17.2,13.25,33,303,342,-39,0,0,0,0,72,5,4,0.527778,1,0,16,17,false,true,false,0.483,0.517
319,180,139,18.764706,11.25,139,871,867,4,0,0,0,0,0,17,16,0,0,1,10,16,false,true,true,1,0
325,189,136,23.214286,13.5,136,1033,1037,-4,0,1,0,0.071429,8,14,14,5.625,0,1,23,9,false,true,true,1,0
168,84,84,15.272727,8.4,84,859,719,140,0,1,0,0.1,28,11,10,1.892857,0,2,19,13,false,true,true,0.957,0.043
358,279,79,21.058824,17.4375,79,859,811,48,0,0,0,0,-14,17,16,-2.571429,0,1,2,4,false,true,true,1,0
12,0,12,12,0,12,1253,1166,87,0,0,0,0,97,1,0,0.443299,0,0,8,0,false,true,true,0.562,0.438
263,222,41,26.3,22.2,41,1266,1144,122,0,0,0,0,26,10,10,1.307692,1,0,9,17,false,true,true,0.957,0.043
382,247,135,16.608696,10.73913,135,595,543,52,0,0,0,0,-29,23,23,-1.62069,0,0,7,5,false,true,true,1,0
0,12,-12,0,12,-12,1266,1247,19,0,0,0,0,97,1,1,0.329897,0,0,16,12,false,true,false,0.286,0.714
254,115,139,28.222222,12.777778,139,1295,1477,-182,2,0,0.222222,0,40,9,9,1.15,0,0,25,10,false,true,true,0.948,0.052
288,265,23,26.181818,24.090909,23,1670,1770,-100,1,1,0.090909,0.090909,20,11,11,1.6,0,1,9,7,false,true,true,0.868,0.132
73,35,38,24.333333,17.5,38,1127,1134,-7,0,0,0,0,79,3,2,0.379747,1,0,14,15,false,true,true,0.745,0.255
68,27,41,17,9,41,561,526,35,0,0,0,0,70,4,3,0.5,1,0,7,17,false,true,true,0.882,0.118
28,48,-20,9.333333,24,-20,941,926,15,0,0,0,0,81,3,2,0.469136,1,0,6,8,false,true,false,0.294,0.706
371,267,104,30.916667,22.25,104,1396,1454,-58,2,0,0.166667,0,10,12,12,3.3,0,0,7,20,false,true,true,1,0
225,62,163,20.454545,6.2,163,1176,1076,100,0,0,0,0,52,11,10,1.134615,0,1,12,15,false,true,true,1,0
154,101,53,30.8,20.2,53,1331,1399,-68,0,0,0,0,58,5,5,0.603448,0,0,7,25,false,true,true,0.764,0.236
305,243,62,21.785714,17.357143,62,1452,1469,-17,1,1,0.071429,0.071429,1,14,14,38,0,0,9,27,false,true,true,0.973,0.027
181,131,50,12.928571,9.357143,50,310,359,-49,0,0,0,0,7,14,14,7,0,0,7,18,false,true,true,0.974,0.026
294,264,30,16.333333,15.529412,30,95,360,-265,0,1,0,0.058824,-17,18,17,-2.352941,0,0,6,7,false,true,true,0.967,0.033
281,209,72,23.416667,17.416667,72,1216,1217,-1,1,0,0.083333,0,16,12,12,2.125,0,0,12,11,false,true,true,0.988,0.012
200,123,77,22.222222,15.375,77,1551,1550,1,0,0,0,0,43,9,8,0.976744,0,1,8,15,false,true,true,0.847,0.153
291,210,81,41.571429,30,81,1824,1793,31,1,0,0.142857,0,44,7,7,0.636364,1,0,15,14,false,true,true,1,0
343,283,60,19.055556,16.647059,60,880,952,-72,0,0,0,0,-16,18,17,-2.5625,0,0,3,6,false,true,true,1,0
18,0,18,18,0,18,1033,1037,-4,0,0,0,0,94,1,0,0.478723,0,0,7,0,false,true,true,0.562,0.438
332,141,191,30.181818,14.1,191,1211,1173,38,0,0,0,0,32,11,10,1.09375,0,1,8,15,false,true,true,1,0
131,139,-8,18.714286,23.166667,-8,1519,1782,-263,0,0,0,0,54,7,6,0.611111,0,0,7,11,false,true,false,0.074,0.926
119,53,66,39.666667,17.666667,66,986,856,130,1,0,0.333333,0,76,3,3,0.407895,0,0,12,13,false,true,true,0.677,0.323
146,86,60,20.857143,14.333333,60,1551,1550,1,0,0,0,0,55,7,6,0.763636,0,1,14,17,false,true,true,0.677,0.323
27,14,13,13.5,14,13,1089,1063,26,0,0,0,0,92,2,1,0.413043,1,0,15,9,false,true,true,0.713,0.287
131,138,-7,14.555556,17.25,-7,908,859,49,0,0,0,0,45,9,8,0.866667,1,1,14,8,false,true,false,0.306,0.694
295,249,46,24.583333,20.75,46,1051,1030,21,0,0,0,0,11,12,12,2.727273,2,0,5,18,false,true,true,1,0
375,289,86,23.4375,19.266667,86,995,912,83,2,0,0.125,0,4,16,15,11,0,0,10,9,false,true,true,1,0
116,46,70,29,11.5,70,1115,1078,37,0,0,0,0,70,4,4,0.485714,0,0,14,15,false,true,true,0.948,0.052
172,134,38,28.666667,26.8,38,1078,1130,-52,0,1,0,0.2,59,6,5,0.661017,0,0,7,9,false,true,true,0.85,0.15
325,318,7,25,24.461538,7,907,752,155,0,1,0,0.076923,8,13,13,4.125,0,0,7,11,false,true,true,0.658,0.342
33,22,11,16.5,22,11,948,933,15,0,0,0,0,90,2,1,0.422222,1,1,15,10,false,true,true,0.561,0.439
109,21,88,54.5,10.5,88,1396,1454,-58,1,0,0.5,0,83,2,2,0.39759,0,0,16,7,false,true,true,0.733,0.267
150,230,-80,25,38.333333,-80,1636,1576,60,0,2,0,0.333333,44,6,6,0.772727,0,0,10,21,false,true,false,0.052,0.948
285,252,33,21.923077,21,33,1304,1040,264,1,0,0.076923,0,16,13,12,2.0625,0,0,10,11,false,true,true,0.567,0.433
233,223,10,25.888889,24.777778,10,974,995,-21,0,1,0,0.111111,32,9,9,1.03125,0,0,18,10,false,true,true,0.847,0.153
299,243,56,13.590909,11.045455,56,310,359,-49,0,0,0,0,-42,22,22,-1.166667,0,0,12,12,false,true,true,1,0
52,38,14,26,19,14,704,691,13,0,0,0,0,85,2,2,0.447059,0,0,14,7,false,true,true,0.669,0.331
363,294,69,18.15,15.473684,69,791,774,17,1,0,0.05,0,-18,20,19,-2.277778,0,0,1,1,false,true,true,1,0
343,296,47,28.583333,26.909091,47,1762,1616,146,2,0,0.166667,0,7,12,11,4.285714,1,0,7,10,false,true,true,1,0
357,179,178,15.521739,8.136364,178,859,719,140,0,1,0,0.045455,-33,23,22,-1.606061,0,1,12,9,false,true,true,1,0
287,235,52,15.105263,13.055556,52,1030,1045,-15,1,0,0.052632,0,-6,19,18,-7.666667,0,0,19,9,false,true,true,0.947,0.053
12,0,12,12,0,12,1159,1031,128,0,0,0,0,97,1,0,0.402062,1,0,13,0,false,true,true,0.736,0.264
255,186,69,15.9375,12.4,69,1037,950,87,1,0,0.0625,0,11,16,15,2.818182,0,0,8,18,true,true,true,0.991,0.009
345,313,32,18.157895,16.473684,32,613,611,2,0,0,0,0,-29,19,19,-1.310345,0,0,2,1,true,true,true,1,0
18,15,3,18,15,3,613,549,64,0,0,0,0,92,1,1,0.478261,0,0,10,17,false,true,true,0.777,0.223
148,92,56,29.6,18.4,56,866,949,-83,0,0,0,0,63,5,5,0.634921,0,1,10,9,false,true,true,0.704,0.296
227,205,22,18.916667,17.083333,22,859,786,73,0,0,0,0,18,12,12,2.111111,0,0,20,10,false,true,true,0.854,0.146
115,82,33,23,16.4,33,1210,1253,-43,0,1,0,0.2,59,5,5,0.59322,0,1,21,15,false,true,true,0.871,0.129
394,318,76,23.176471,18.705882,76,995,912,83,2,0,0.117647,0,-4,17,17,-11,0,0,7,14,false,true,true,1,0
59,51,8,19.666667,17,8,695,523,172,0,0,0,0,74,3,3,0.5,0,1,14,6,false,true,true,0.779,0.221
79,58,21,19.75,14.5,21,1029,1075,-46,0,0,0,0,75,4,4,0.64,0,0,17,11,false,true,true,0.59,0.41
384,251,133,27.428571,17.928571,133,1167,1216,-49,1,0,0.071429,0,12,14,14,3.416667,0,0,8,11,false,true,true,1,0
262,244,18,26.2,27.111111,18,1885,1846,39,1,1,0.1,0.111111,20,10,9,1.45,1,0,25,8,false,true,true,0.758,0.242
102,54,48,25.5,18,48,691,675,16,0,0,0,0,76,4,3,0.486842,0,1,10,10,false,true,true,0.802,0.198
341,260,81,15.5,11.818182,81,1128,889,239,0,1,0,0.045455,-31,22,22,-1.516129,0,0,3,1,false,true,true,1,0
446,382,64,20.272727,17.363636,64,1220,1261,-41,2,0,0.090909,0,-27,22,22,-1.666667,0,0,1,1,false,true,true,1,0
105,123,-18,21,24.6,-18,942,976,-34,0,0,0,0,62,5,5,0.645161,1,0,11,19,false,true,true,0.505,0.495
198,158,40,19.8,17.555556,40,885,719,166,0,0,0,0,38,10,9,1,1,1,8,6,false,true,true,0.748,0.252
328,278,50,20.5,17.375,50,719,785,-66,0,1,0,0.0625,-6,16,16,-6,0,0,9,5,false,true,true,0.994,0.006
334,245,89,20.875,15.3125,89,691,675,16,0,0,0,0,-6,16,16,-6.166667,0,1,5,7,false,true,true,1,0
398,268,130,22.111111,15.764706,130,939,907,32,1,0,0.055556,0,-14,18,17,-2.857143,0,0,2,1,false,true,true,1,0
332,249,83,22.133333,17.785714,83,1216,1217,-1,1,0,0.066667,0,-3,15,14,-11.333333,0,0,6,7,false,true,true,1,0
378,246,132,18,12.3,132,620,513,107,0,0,0,0,-20,21,20,-2.25,0,0,1,3,false,true,true,1,0
77,38,39,15.4,9.5,39,880,952,-72,0,0,0,0,74,5,4,0.554054,0,0,12,10,false,true,false,0.442,0.558
96,63,33,16,12.6,33,303,342,-39,0,0,0,0,64,6,5,0.59375,1,0,18,17,false,true,true,0.518,0.482
120,137,-17,24,27.4,-17,1394,1424,-30,0,1,0,0.2,63,5,5,0.507937,0,0,21,10,false,true,false,0.306,0.694
95,70,25,19,17.5,25,628,658,-30,0,0,0,0,68,5,4,0.676471,0,0,25,13,false,true,true,0.694,0.306
257,248,9,17.133333,16.533333,9,695,523,172,0,0,0,0,-8,15,15,-4.625,0,0,15,8,false,true,true,0.793,0.207
115,56,59,38.333333,18.666667,59,908,1070,-162,1,0,0.333333,0,75,3,3,0.4,1,0,9,11,false,true,true,0.755,0.245
292,262,30,16.222222,14.555556,30,904,857,47,0,0,0,0,-12,18,18,-3.416667,0,0,17,3,false,true,true,0.978,0.022
275,244,31,22.916667,22.181818,31,1710,1636,74,1,1,0.083333,0.090909,20,12,11,1.8,1,0,16,14,false,true,true,0.889,0.111
20,0,20,20,0,20,1885,1793,92,0,0,0,0,96,1,1,0.28125,0,1,22,7,false,true,true,0.598,0.402
60,69,-9,12,13.8,-9,658,817,-159,0,0,0,0,72,5,5,0.527778,0,1,23,9,false,true,false,0.278,0.722
239,183,56,29.875,22.875,56,1431,825,606,1,1,0.125,0.125,35,8,8,0.971429,0,0,9,19,false,true,true,1,0
293,257,36,13.952381,12.238095,36,584,565,19,0,0,0,0,-29,21,21,-1.586207,0,0,13,3,false,true,true,1,0
324,264,60,24.923077,20.307692,60,1127,1075,52,1,1,0.076923,0.076923,4,13,13,7.75,0,1,15,6,false,true,true,0.877,0.123
149,112,37,29.8,28,37,1004,840,164,1,0,0.2,0,63,5,4,0.47619,1,0,13,13,false,true,true,0.691,0.309
289,254,35,20.642857,18.142857,35,1210,1253,-43,0,1,0,0.071429,1,14,14,35,1,0,6,16,false,true,true,0.983,0.017
140,99,41,23.333333,16.5,41,1388,1477,-89,1,0,0.166667,0,56,6,6,0.857143,0,0,8,9,false,true,true,0.92,0.08
262,231,31,13.789474,12.833333,31,947,909,38,0,0,0,0,-18,19,18,-2.555556,0,1,10,24,false,true,true,1,0
109,88,21,18.166667,14.666667,21,913,871,42,0,0,0,0,58,6,6,0.741379,0,0,13,17,false,true,true,0.758,0.242
187,120,67,23.375,15,67,1075,1152,-77,0,0,0,0,50,8,8,0.8,0,1,10,7,false,true,true,0.835,0.165
180,181,-1,16.363636,18.1,-1,500,567,-67,0,0,0,0,36,11,10,1.222222,0,0,9,22,false,true,false,0.258,0.742
135,154,-19,15,17.111111,-19,864,808,56,1,0,0.111111,0,30,9,9,1.133333,1,1,10,6,false,true,true,0.543,0.457
41,27,14,13.666667,13.5,14,1176,1076,100,0,0,0,0,88,3,2,0.670455,0,0,8,7,false,true,false,0.363,0.637
319,281,38,17.722222,16.529412,38,1159,1051,108,0,0,0,0,-13,18,17,-3.076923,0,0,5,12,false,true,true,0.993,0.007
157,162,-5,17.444444,18,-5,1050,1144,-94,0,1,0,0.111111,44,9,9,0.863636,0,0,25,11,false,true,true,0.695,0.305
102,93,9,14.571429,13.285714,9,719,614,105,0,0,0,0,55,7,7,0.781818,0,1,13,15,false,true,true,0.626,0.374
457,371,86,35.153846,30.916667,86,1770,1689,81,1,1,0.076923,0.083333,-16,13,12,-1.625,0,0,1,8,false,true,true,1,0
129,43,86,32.25,14.333333,86,976,965,11,0,0,0,0,69,4,3,0.463768,0,0,16,22,false,true,true,0.955,0.045
137,37,100,34.25,12.333333,100,371,336,35,1,0,0.25,0,66,4,3,0.575758,0,0,11,10,false,true,true,0.99,0.01
201,192,9,22.333333,24,9,1047,1094,-47,1,1,0.111111,0.125,38,9,8,0.947368,0,0,28,9,false,true,true,0.861,0.139
329,213,116,14.954545,10.142857,116,1428,1302,126,0,0,0,0,-17,22,21,-3.117647,0,1,14,13,false,true,true,1,0
25,22,3,12.5,11,3,1093,1090,3,0,0,0,0,89,2,2,0.382022,0,0,15,13,false,true,true,0.525,0.475
378,344,34,22.235294,20.235294,34,856,897,-41,0,1,0,0.058824,-24,17,17,-1.458333,0,0,3,1,false,true,true,0.998,0.002
254,170,84,23.090909,17,84,859,811,48,0,0,0,0,28,11,10,1.285714,0,1,8,9,false,true,true,0.955,0.045
279,201,78,23.25,18.272727,78,1110,1039,71,0,0,0,0,17,12,11,2.117647,0,0,13,10,false,true,true,0.977,0.023
432,294,138,25.411765,17.294118,138,1167,1216,-49,1,0,0.058824,0,-5,17,17,-8.2,0,0,4,5,false,true,true,1,0
177,98,79,22.125,14,79,1091,1078,13,0,0,0,0,57,8,7,0.754386,1,0,8,15,false,true,true,0.989,0.011
328,282,46,21.866667,18.8,46,820,822,-2,0,0,0,0,0,15,15,0,0,0,11,6,false,true,true,0.978,0.022
139,123,16,19.857143,17.571429,16,1516,1397,119,0,1,0,0.142857,47,7,7,0.702128,0,0,16,13,false,true,false,0.364,0.636
356,353,3,22.25,22.0625,3,1501,1473,28,1,0,0.0625,0,-14,16,16,-2.571429,0,0,4,2,false,true,true,0.988,0.012
8,0,8,8,0,8,1214,1176,38,0,0,0,0,97,1,0,0.371134,0,0,13,0,false,true,true,0.561,0.439
291,182,109,26.454545,18.2,109,1075,1027,48,2,0,0.181818,0,23,11,10,1.608696,0,1,14,6,false,true,true,0.908,0.092
136,62,74,15.111111,7.75,74,1428,1302,126,0,0,0,0,49,9,8,1.081633,0,1,12,15,false,true,true,0.877,0.123
350,261,89,19.444444,15.352941,89,916,837,79,1,0,0.055556,0,-12,18,17,-3.333333,0,0,7,11,false,true,true,1,0
213,182,31,19.363636,18.2,31,1388,1477,-89,1,0,0.090909,0,30,11,10,1.6,0,0,14,11,false,true,true,0.692,0.308
220,217,3,14.666667,15.5,3,540,518,22,0,0,0,0,5,15,14,8,0,0,9,16,false,true,true,0.72,0.28
63,74,-11,12.6,18.5,-11,825,907,-82,0,0,0,0,72,5,4,0.555556,2,0,12,10,false,true,true,0.508,0.492
318,309,9,18.705882,18.176471,9,758,952,-194,0,0,0,0,-20,17,17,-2,0,0,4,1,false,true,true,0.921,0.079
200,168,32,28.571429,24,32,1489,1555,-66,1,0,0.142857,0,43,7,7,0.674419,1,0,6,14,false,true,true,0.901,0.099
391,284,107,17,12.909091,107,746,796,-50,0,1,0,0.045455,-30,23,22,-1.6,0,0,1,1,false,true,true,1,0
0,0,0,0,0,0,1710,1636,74,0,0,0,0,100,1,1,0.36,0,1,14,9,false,true,false,0.34,0.66
228,199,29,19,18.090909,29,921,1072,-151,1,0,0.083333,0,29,12,11,1.310345,0,1,17,7,false,true,true,0.552,0.448
26,7,19,13,7,19,719,614,105,0,0,0,0,89,2,1,0.483146,0,1,14,11,false,true,true,0.701,0.299
31,40,-9,7.75,13.333333,-9,791,774,17,0,0,0,0,86,4,3,0.476744,1,0,7,14,false,true,false,0.422,0.578
90,51,39,15,10.2,39,595,543,52,0,0,0,0,66,6,5,0.712121,0,0,14,12,false,true,true,0.877,0.123
230,220,10,19.166667,18.333333,10,518,448,70,0,0,0,0,15,12,12,2.266667,0,0,10,18,false,true,true,0.794,0.206
36,7,29,18,3.5,29,1935,2020,-85,0,0,0,0,88,2,2,0.352273,1,0,7,29,false,true,true,0.821,0.179
461,313,148,27.117647,19.5625,148,1571,1554,17,2,1,0.117647,0.0625,-20,17,16,-1.65,1,0,0,2,true,true,true,1,0
379,315,64,27.071429,24.230769,64,1885,1846,39,1,1,0.071429,0.076923,-8,14,13,-3.625,0,0,3,2,false,true,true,1,0
200,157,43,15.384615,13.083333,43,698,742,-44,0,0,0,0,32,13,12,1.28125,1,0,6,14,false,true,true,0.94,0.06
109,78,31,15.571429,13,31,491,398,93,0,0,0,0,62,7,6,0.580645,0,1,8,16,false,true,true,0.803,0.197
136,55,81,45.333333,18.333333,81,1510,1583,-73,1,0,0.333333,0,70,3,3,0.457143,0,0,17,11,false,true,true,0.769,0.231
289,210,79,26.272727,21,79,995,912,83,2,0,0.181818,0,34,11,10,1.294118,0,0,11,7,false,true,true,0.989,0.011
250,254,-4,20.833333,23.090909,-4,758,952,-194,0,0,0,0,13,12,11,3.076923,1,0,9,16,false,true,false,0.114,0.886
386,365,21,24.125,22.8125,21,1670,1770,-100,1,1,0.0625,0.0625,-25,16,16,-1.28,0,0,4,2,true,true,true,0.989,0.011
379,281,98,23.6875,18.733333,98,769,527,242,1,0,0.0625,0,-14,16,15,-2.571429,0,0,4,4,false,true,true,1,0
54,35,19,18,17.5,19,1237,1277,-40,0,0,0,0,79,3,2,0.367089,0,0,8,10,false,true,true,0.526,0.474
225,190,35,17.307692,15.833333,35,859,822,37,0,0,0,0,14,13,12,2.714286,0,0,9,15,false,true,true,0.892,0.108
124,68,56,41.333333,22.666667,56,1408,1454,-46,1,0,0.333333,0,76,3,3,0.421053,0,0,10,17,false,true,true,0.663,0.337
140,151,-11,20,21.571429,-11,1297,1606,-309,0,0,0,0,50,7,7,0.6,2,0,10,18,false,true,false,0.476,0.524
175,143,32,14.583333,11.916667,32,1030,1045,-15,0,0,0,0,36,12,12,1.277778,0,0,9,16,false,true,true,0.967,0.033
72,127,-55,12,21.166667,-55,1156,1184,-28,0,0,0,0,55,6,6,0.509091,1,0,16,10,false,true,false,0.357,0.643
350,307,43,25,23.615385,43,1554,1716,-162,1,1,0.071429,0.076923,-2,14,13,-17.5,0,0,9,10,false,true,true,0.97,0.03
313,271,42,20.866667,18.066667,42,719,785,-66,0,1,0,0.066667,0,15,15,0,0,0,13,8,false,true,true,0.988,0.012
343,241,102,26.384615,18.538462,102,1144,1014,130,0,0,0,0,13,13,13,2.769231,0,1,9,6,false,true,true,1,0
186,192,-6,18.6,19.2,-6,921,1072,-151,1,0,0.1,0,38,10,10,1,0,0,15,7,false,true,false,0.436,0.564
296,225,71,22.769231,18.75,71,941,926,15,1,0,0.076923,0,18,13,12,2.111111,1,0,19,12,false,true,true,0.992,0.008
141,102,39,17.625,14.571429,39,698,742,-44,0,0,0,0,58,8,7,0.706897,0,0,8,13,false,true,true,0.724,0.276
157,69,88,39.25,23,88,1245,1241,4,1,1,0.25,0.333333,71,4,3,0.408451,0,0,13,22,false,true,true,0.987,0.013
320,301,19,15.238095,15.05,19,500,567,-67,0,0,0,0,-16,21,20,-2.75,0,0,2,14,false,true,true,0.999,0.001
288,232,56,24,19.333333,56,825,907,-82,1,0,0.083333,0,19,12,12,2.105263,0,0,16,15,false,true,true,0.896,0.104
119,58,61,23.8,14.5,61,916,837,79,0,0,0,0,73,5,4,0.547945,0,1,13,16,false,true,true,0.932,0.068
43,26,17,21.5,13,17,1501,1473,28,0,0,0,0,85,2,2,0.423529,0,1,14,10,false,true,true,0.557,0.443
318,176,142,19.875,11,142,421,306,115,0,1,0,0.0625,-4,16,16,-11,0,0,16,9,false,true,true,1,0
473,259,214,27.823529,15.235294,214,918,619,299,2,0,0.117647,0,-19,17,17,-1.842105,0,0,3,1,false,true,true,1,0
279,253,26,25.363636,25.3,26,1554,1716,-162,1,1,0.090909,0.1,18,11,10,1.944444,0,0,18,11,false,true,true,0.87,0.13
301,260,41,18.8125,16.25,41,1159,1031,128,1,0,0.0625,0,-13,16,16,-3,0,0,7,10,false,true,true,0.987,0.013
247,206,41,24.7,22.888889,41,1089,1063,26,1,0,0.1,0,38,10,9,1,0,0,8,8,false,true,true,0.811,0.189
162,115,47,18,14.375,47,1030,1045,-15,0,0,0,0,50,9,8,0.92,0,0,7,14,false,true,true,0.869,0.131
394,193,201,35.818182,19.3,201,1550,1624,-74,2,0,0.181818,0,23,11,10,1.304348,0,0,9,8,false,true,true,1,0
218,180,38,18.166667,16.363636,38,334,446,-112,0,0,0,0,19,12,11,2.105263,0,1,9,7,false,true,true,0.636,0.364
236,168,68,21.454545,15.272727,68,808,639,169,0,0,0,0,26,11,11,1.576923,0,0,19,17,false,true,true,0.967,0.033
268,253,15,14.888889,14.882353,15,361,493,-132,1,0,0.055556,0,-26,18,17,-1.576923,0,0,4,9,false,true,true,0.845,0.155
29,22,7,14.5,22,7,1221,1266,-45,0,0,0,0,88,2,1,0.397727,0,0,12,11,false,true,false,0.36,0.64
289,207,82,26.272727,18.818182,82,1216,1228,-12,1,0,0.090909,0,27,11,11,1.222222,0,0,8,11,false,true,true,0.99,0.01
140,99,41,17.5,14.142857,41,500,567,-67,0,0,0,0,55,8,7,0.8,0,0,8,22,false,true,true,0.782,0.218
349,283,66,13.423077,10.884615,66,272,288,-16,0,0,0,0,-28,26,26,-1.857143,0,0,1,1,true,true,true,1,0
253,228,25,19.461538,19,25,1572,1550,22,1,0,0.076923,0,19,13,12,2.052632,1,1,12,9,false,true,false,0.321,0.679
151,97,54,21.571429,16.166667,54,704,691,13,0,0,0,0,52,7,6,0.730769,1,0,7,18,false,true,true,0.938,0.062
245,112,133,22.272727,10.181818,133,993,897,96,1,0,0.090909,0,23,11,11,2.043478,0,0,10,19,false,true,true,0.996,0.004
394,256,138,23.176471,16,138,939,907,32,1,0,0.058824,0,-8,17,16,-5,0,0,3,3,false,true,true,1,0
65,55,10,16.25,13.75,10,1045,1009,36,0,0,0,0,76,4,4,0.5,0,0,10,18,false,true,true,0.521,0.479
22,5,17,22,5,17,869,820,49,0,0,0,0,92,1,1,0.402174,0,1,18,6,false,true,true,0.568,0.432
293,179,114,24.416667,16.272727,114,904,668,236,0,0,0,0,9,12,11,3.777778,0,2,8,5,false,true,true,1,0
380,307,73,22.352941,19.1875,73,1142,1095,47,1,0,0.058824,0,-18,17,16,-1.944444,0,0,3,5,false,true,true,1,0
139,196,-57,19.857143,32.666667,-57,834,844,-10,0,1,0,0.166667,48,7,6,0.75,0,1,13,7,false,true,false,0.087,0.913
47,99,-52,11.75,33,-52,1897,1793,104,0,1,0,0.333333,79,4,3,0.405063,0,0,8,17,false,true,true,0.995,0.005
14,0,14,14,0,14,947,909,38,0,0,0,0,96,1,0,0.479167,1,0,10,0,false,true,true,0.588,0.412
130,85,45,26,17,45,1127,1075,52,1,0,0.2,0,64,5,5,0.484375,0,0,17,22,false,true,true,0.762,0.238
12,0,12,12,0,12,1548,1493,55,0,0,0,0,97,1,0,0.42268,0,0,10,0,false,true,true,0.56,0.44
175,136,39,19.444444,17,39,505,95,410,0,1,0,0.125,52,9,8,0.846154,0,1,12,15,false,true,true,0.848,0.152
322,281,41,24.769231,21.615385,41,856,897,-41,0,1,0,0.076923,-2,13,13,-17.5,0,0,17,12,false,true,true,0.917,0.083
427,164,263,30.5,12.615385,263,1054,917,137,2,0,0.142857,0,-6,14,13,-5.833333,0,0,13,9,false,true,true,1,0
299,198,101,27.181818,18,101,1029,1227,-198,1,0,0.090909,0,10,11,11,3.2,0,0,10,11,false,true,true,0.986,0.014
100,89,11,16.666667,14.833333,11,371,435,-64,0,0,0,0,53,6,6,0.830189,0,0,16,12,false,true,true,0.679,0.321
387,255,132,29.769231,19.615385,132,986,856,130,1,0,0.076923,0,-7,13,13,-4.428571,0,0,11,5,false,true,true,1,0
52,20,32,26,20,32,1266,1144,122,0,0,0,0,82,2,1,0.414634,0,1,8,9,false,true,true,0.555,0.445
209,187,22,20.9,18.7,22,784,758,26,0,0,0,0,27,10,10,1.296296,0,0,11,9,false,true,true,0.883,0.117
374,304,70,23.375,20.266667,70,1530,1550,-20,1,1,0.0625,0.066667,-13,16,15,-2.615385,0,0,2,5,false,true,true,1,0
375,296,79,31.25,24.666667,79,1197,1127,70,0,0,0,0,4,12,12,7.5,1,0,17,11,false,true,true,1,0
94,67,27,18.8,16.75,27,1266,1247,19,0,0,0,0,67,5,4,0.477612,0,0,7,7,false,true,false,0.491,0.509
217,191,26,19.727273,17.363636,26,711,876,-165,0,0,0,0,26,11,11,1.653846,0,0,7,7,false,true,true,0.65,0.35
109,165,-56,21.8,33,-56,1023,1110,-87,0,1,0,0.2,54,5,5,0.555556,0,0,12,10,false,true,false,0.27,0.73
394,348,46,21.888889,20.470588,46,1203,1221,-18,2,0,0.111111,0,-13,18,17,-2.692308,0,0,4,2,true,true,true,1,0
329,242,87,20.5625,15.125,87,1227,1060,167,0,1,0,0.0625,-5,16,16,-8,0,1,10,8,false,true,true,1,0
199,231,-32,19.9,23.1,-32,869,820,49,0,1,0,0.1,37,10,10,1,0,1,7,6,false,true,false,0.122,0.878
244,203,41,17.428571,15.615385,41,725,771,-46,0,1,0,0.076923,14,14,13,3.285714,1,0,6,15,false,true,true,0.993,0.007
362,299,63,22.625,18.6875,63,1075,1152,-77,0,1,0,0.0625,-6,16,16,-6.666667,0,0,14,9,false,true,true,0.998,0.002
141,98,43,35.25,24.5,43,1344,1325,19,1,0,0.25,0,63,4,4,0.492063,0,0,14,14,false,true,true,0.586,0.414
300,259,41,20,17.266667,41,921,1072,-151,1,0,0.066667,0,7,15,15,5.428571,0,1,9,16,false,true,true,0.794,0.206
306,265,41,19.125,17.666667,41,1547,1439,108,1,0,0.0625,0,-2,16,15,-18.5,0,0,14,10,false,true,true,0.943,0.057
319,199,120,24.538462,15.307692,120,778,758,20,0,1,0,0.076923,5,13,13,7.8,0,0,22,15,false,true,true,0.997,0.003
66,74,-8,22,24.666667,-8,1826,1656,170,0,0,0,0,73,3,3,0.369863,0,0,7,11,false,true,false,0.41,0.59
87,97,-10,17.4,19.4,-10,1023,1070,-47,0,0,0,0,64,5,5,0.5,1,0,15,11,false,true,true,0.691,0.309
215,108,107,21.5,12,107,786,757,29,1,0,0.1,0,38,10,9,1.026316,0,0,10,20,false,true,true,0.995,0.005
287,157,130,28.7,17.444444,130,1482,1394,88,2,0,0.2,0,33,10,9,1.090909,0,0,12,10,false,true,true,0.994,0.006
375,285,90,18.75,14.25,90,844,821,23,0,0,0,0,-8,20,20,-5.25,0,0,3,4,false,true,true,1,0
125,110,15,17.857143,15.714286,15,1048,1000,48,0,0,0,0,54,7,7,0.740741,0,1,7,16,false,true,false,0.365,0.635
15,8,7,7.5,8,7,995,912,83,0,0,0,0,93,2,1,0.473118,1,0,9,10,false,true,true,0.687,0.313
169,97,72,24.142857,13.857143,72,1004,653,351,0,0,0,0,45,7,7,0.777778,0,0,9,21,false,true,true,0.948,0.052
192,207,-15,21.333333,23,-15,290,416,-126,0,0,0,0,37,9,9,0.918919,0,0,17,14,false,true,false,0.357,0.643
26,0,26,26,0,26,1935,2020,-85,0,0,0,0,94,1,0,0.329787,1,0,8,0,false,true,true,0.734,0.266
179,162,17,25.571429,23.142857,17,892,819,73,0,1,0,0.142857,48,7,7,0.708333,0,0,7,7,false,true,true,0.862,0.138
121,106,15,17.285714,17.666667,15,916,876,40,0,0,0,0,50,7,6,0.68,1,0,13,11,false,true,true,0.759,0.241
315,316,-1,19.6875,21.066667,-1,1431,802,629,0,0,0,0,-16,16,15,-2,0,0,2,3,false,true,true,1,0
359,295,64,18.894737,15.526316,64,505,95,410,0,1,0,0.052632,-13,19,19,-3.384615,0,0,5,9,false,true,true,0.964,0.036
45,26,19,15,13,19,416,222,194,0,0,0,0,81,3,2,0.679012,1,1,6,8,false,true,true,0.784,0.216
385,227,158,29.615385,18.916667,158,1439,1353,86,1,0,0.076923,0,7,13,12,4.285714,0,0,14,22,false,true,true,1,0
12,13,-1,12,13,-1,416,222,194,0,0,0,0,93,1,1,0.591398,0,0,13,7,false,true,true,0.779,0.221
84,41,43,28,13.666667,43,830,907,-77,1,0,0.333333,0,77,3,3,0.506494,0,0,10,12,false,true,true,0.674,0.326
339,238,101,21.1875,15.866667,101,527,503,24,0,0,0,0,4,16,15,10.25,0,0,9,7,false,true,true,1,0
304,188,116,17.882353,11.75,116,272,288,-16,0,0,0,0,13,17,16,4,0,0,10,17,false,true,true,1,0
332,267,65,13.833333,11.608696,65,1016,1037,-21,0,0,0,0,-24,24,23,-2,0,0,1,12,false,true,true,1,0
380,317,63,21.111111,18.647059,63,1142,1095,47,1,0,0.055556,0,-21,18,17,-1.666667,0,0,3,5,true,true,true,1,0
66,40,26,16.5,13.333333,26,913,871,42,0,0,0,0,71,4,3,0.605634,0,0,11,19,false,true,true,0.7,0.3
191,115,76,31.833333,19.166667,76,1826,1803,23,1,0,0.166667,0,51,6,6,0.588235,1,0,9,7,false,true,true,0.967,0.033
123,111,12,20.5,18.5,12,1043,1055,-12,0,0,0,0,56,6,6,0.660714,0,0,22,7,false,true,true,0.582,0.418
94,14,80,47,14,80,416,282,134,1,0,0.5,0,85,2,1,0.4,0,0,19,16,false,true,true,0.8,0.2
244,165,79,22.181818,16.5,79,1439,1294,145,1,0,0.090909,0,28,11,10,1.285714,0,0,10,35,false,true,true,0.986,0.014
226,159,67,22.6,15.9,67,1115,1078,37,0,0,0,0,31,10,10,1.096774,1,1,13,8,false,true,true,0.933,0.067
138,89,49,23,14.833333,49,786,788,-2,0,0,0,0,49,6,6,0.693878,0,0,13,16,false,true,true,0.947,0.053
277,180,97,30.777778,22.5,97,1349,1302,47,0,0,0,0,32,9,8,0.90625,0,0,9,17,false,true,true,0.995,0.005
287,185,102,19.133333,13.214286,102,1295,1477,-182,2,0,0.133333,0,15,15,14,3.066667,1,0,15,14,false,true,true,0.949,0.051
298,251,47,16.555556,13.944444,47,299,315,-16,0,0,0,0,-25,18,18,-1.68,0,0,4,8,false,true,true,1,0
387,298,89,24.1875,18.625,89,1156,1114,42,1,0,0.0625,0,-19,16,16,-1.684211,0,0,3,3,true,true,true,1,0
132,72,60,22,14.4,60,916,837,79,0,0,0,0,66,6,5,0.606061,0,1,11,13,false,true,true,0.93,0.07
209,191,18,26.125,23.875,18,1344,1325,19,1,0,0.125,0,38,8,8,0.815789,0,0,10,11,false,true,true,0.578,0.422
136,173,-37,15.111111,21.625,-37,1100,1008,92,0,0,0,0,48,9,8,0.75,2,0,11,14,false,true,true,0.638,0.362
317,302,15,19.8125,18.875,15,901,889,12,0,1,0,0.0625,-3,16,16,-14.333333,0,0,14,11,false,true,true,0.874,0.126
155,178,-23,11.923077,13.692308,-23,826,771,55,0,0,0,0,30,13,13,1.5,1,1,24,9,false,true,true,0.515,0.485
205,181,24,22.777778,20.111111,24,1493,1513,-20,1,0,0.111111,0,39,9,9,0.846154,0,2,20,13,false,true,true,0.767,0.233
121,132,-11,17.285714,22,-11,613,549,64,0,0,0,0,50,7,6,0.88,0,0,12,18,false,true,true,0.508,0.492
181,69,112,36.2,17.25,112,996,1063,-67,1,1,0.2,0.25,62,5,4,0.516129,0,0,21,8,false,true,true,0.988,0.012
228,212,16,25.333333,23.555556,16,1305,1218,87,1,0,0.111111,0,31,9,9,1.225806,0,0,32,8,false,true,true,0.797,0.203
145,87,58,18.125,10.875,58,954,1078,-124,0,1,0,0.125,44,8,8,0.863636,1,0,14,21,false,true,true,0.988,0.012
22,26,-4,11,26,-4,566,542,24,0,0,0,0,90,2,1,0.455556,0,0,12,12,false,true,false,0.333,0.667
65,60,5,16.25,20,5,596,595,1,0,0,0,0,77,4,3,0.519481,1,0,12,12,false,true,true,0.74,0.26
286,239,47,20.428571,18.384615,47,784,758,26,0,0,0,0,3,14,13,11.666667,1,0,6,18,false,true,true,0.969,0.031
144,86,58,20.571429,14.333333,58,1055,1050,5,0,0,0,0,56,7,6,0.607143,0,0,13,11,false,true,true,0.889,0.111
44,0,44,44,0,44,2219,2106,113,0,0,0,0,95,1,0,0.284211,0,0,16,0,false,true,true,1,0
69,53,16,13.8,13.25,16,1159,1031,128,0,0,0,0,65,5,4,0.6,1,0,8,17,false,true,true,0.657,0.343
141,85,56,28.2,21.25,56,1550,1466,84,1,0,0.2,0,64,5,4,0.578125,1,0,10,27,false,true,true,0.949,0.051
188,124,64,23.5,17.714286,64,1110,1039,71,0,0,0,0,49,8,7,0.734694,0,0,21,10,false,true,true,0.944,0.056
337,325,12,16.85,17.105263,12,1164,1201,-37,0,0,0,0,-27,20,19,-1.555556,0,0,2,3,false,true,true,1,0
302,241,61,16.777778,14.176471,61,416,306,110,0,0,0,0,-10,18,17,-4.2,1,0,5,6,false,true,true,0.993,0.007
416,294,122,26,18.375,122,1189,1266,-77,1,0,0.0625,0,-15,16,16,-2.266667,0,0,1,1,false,true,true,1,0
428,408,20,28.533333,27.2,20,1935,2020,-85,0,1,0,0.066667,-17,15,15,-1.823529,0,0,1,2,false,true,true,1,0
178,115,63,19.777778,12.777778,63,954,1078,-124,0,1,0,0.111111,39,9,9,0.974359,1,0,10,21,false,true,true,0.987,0.013
104,93,11,17.333333,15.5,11,1090,1244,-154,0,0,0,0,58,6,6,0.637931,0,0,15,19,false,true,false,0.199,0.801
212,232,-20,23.555556,25.777778,-20,1539,1537,2,0,1,0,0.111111,39,9,9,0.820513,0,0,11,8,false,true,false,0.271,0.729
36,0,36,18,0,36,1935,2020,-85,0,0,0,0,91,2,1,0.340659,1,0,7,30,false,true,true,0.723,0.277
344,265,79,20.235294,15.588235,79,691,473,218,0,0,0,0,-15,17,17,-2.4,1,0,0,1,false,true,true,1,0
278,180,98,19.857143,12.857143,98,1281,1339,-58,0,0,0,0,21,14,14,1.952381,0,0,19,10,false,true,true,0.999,0.001
358,327,31,19.888889,19.235294,31,1710,1636,74,1,1,0.055556,0.058824,-18,18,17,-2,0,0,1,2,false,true,true,0.935,0.065
30,13,17,30,13,17,620,513,107,0,0,0,0,92,1,1,0.48913,0,0,9,11,false,true,true,0.786,0.214
159,124,35,22.714286,17.714286,35,1572,1550,22,1,0,0.142857,0,50,7,7,0.78,0,0,24,7,false,true,true,0.662,0.338
143,115,28,23.833333,23,28,804,988,-184,1,0,0.166667,0,57,6,5,0.578947,0,0,12,19,false,true,false,0.32,0.68
12,0,12,12,0,12,611,584,27,0,0,0,0,97,1,0,0.453608,0,0,23,0,false,true,true,0.599,0.401
128,179,-51,16,22.375,-51,999,1011,-12,0,0,0,0,44,8,8,1.045455,0,0,13,11,false,true,false,0.24,0.76
241,145,96,21.909091,14.5,96,1606,1544,62,0,0,0,0,39,11,10,1.153846,0,0,12,8,false,true,true,0.993,0.007
331,296,35,23.642857,22.769231,35,971,1180,-209,1,1,0.071429,0.076923,4,14,13,8,0,0,15,7,false,true,true,0.852,0.148
238,159,79,21.636364,15.9,79,1115,1078,37,0,0,0,0,28,11,10,1.214286,1,1,11,8,false,true,true,0.925,0.075
47,41,6,15.666667,20.5,6,1227,1060,167,0,0,0,0,84,3,2,0.47619,0,0,14,10,false,true,false,0.409,0.591
26,23,3,26,23,3,1583,1422,161,0,0,0,0,92,1,1,0.554348,0,0,17,10,false,true,true,0.531,0.469
345,312,33,19.166667,18.352941,33,825,907,-82,1,0,0.055556,0,-12,18,17,-3.333333,0,0,3,11,false,true,true,0.931,0.069
270,260,10,19.285714,18.571429,10,1572,1550,22,1,0,0.071429,0,10,14,14,3.9,1,1,11,7,false,true,false,0.3,0.7
390,295,95,20.526316,16.388889,95,1394,1118,276,0,1,0,0.055556,-17,19,18,-2.176471,0,0,11,1,true,true,true,1,0
30,0,30,30,0,30,892,819,73,0,0,0,0,96,1,0,0.354167,0,0,24,0,false,true,true,0.836,0.164
182,183,-1,20.222222,20.333333,-1,971,658,313,0,0,0,0,37,9,9,0.972973,0,0,10,14,false,true,false,0.45,0.55
38,35,3,38,35,3,1364,1093,271,0,0,0,0,91,1,1,0.417582,0,0,14,8,false,true,true,0.749,0.251
210,155,55,23.333333,19.375,55,1221,1266,-45,0,0,0,0,35,9,8,1,1,0,11,7,false,true,true,0.841,0.159
290,287,3,16.111111,15.944444,3,1043,1055,-12,0,0,0,0,-18,18,18,-2.055556,0,0,4,3,false,true,true,0.941,0.059
206,205,1,17.166667,17.083333,1,1583,1422,161,0,0,0,0,35,12,12,1.457143,1,0,7,17,false,true,true,0.684,0.316
260,189,71,20,15.75,71,804,683,121,0,0,0,0,20,13,12,2.25,0,1,10,9,false,true,true,0.929,0.071
379,258,121,27.071429,18.428571,121,1691,1692,-1,0,0,0,0,0,14,14,0,1,0,2,5,false,true,true,1,0
14,40,-26,14,40,-26,1305,1242,63,0,0,0,0,94,1,1,0.361702,0,0,16,14,false,true,false,0.25,0.75
116,107,9,19.333333,17.833333,9,1027,856,171,1,0,0.166667,0,49,6,6,0.673469,0,1,12,10,false,true,true,0.561,0.439
281,195,86,23.416667,16.25,86,518,533,-15,1,0,0.083333,0,10,12,12,3.5,0,0,14,13,false,true,true,0.994,0.006
263,197,66,32.875,24.625,66,1510,1583,-73,1,0,0.125,0,32,8,8,1,0,0,7,15,false,true,true,0.984,0.016
256,184,72,21.333333,15.333333,72,1055,1050,5,0,0,0,0,20,12,12,1.7,0,0,16,13,false,true,true,0.992,0.008
70,90,-20,14,22.5,-20,1154,1062,92,0,0,0,0,72,5,4,0.486111,0,0,11,23,false,true,false,0.335,0.665
226,184,42,17.384615,14.153846,42,299,315,-16,0,0,0,0,11,13,13,3.818182,0,0,10,18,false,true,true,0.972,0.028
323,289,34,21.533333,19.266667,34,892,819,73,0,1,0,0.066667,-5,15,15,-6.8,0,0,5,4,false,true,true,0.987,0.013
296,245,51,21.142857,17.5,51,971,658,313,0,0,0,0,2,14,14,18,0,0,11,10,false,true,true,0.927,0.073
10,16,-6,10,16,-6,1051,1030,21,0,0,0,0,91,1,1,0.32967,0,0,14,10,false,true,false,0.491,0.509
40,13,27,20,13,27,1034,1040,-6,0,0,0,0,91,2,1,0.384615,0,0,21,9,false,true,true,0.579,0.421
319,323,-4,29,29.363636,-4,1428,1452,-24,1,2,0.090909,0.181818,14,11,11,2.214286,0,0,9,17,false,true,true,0.824,0.176
114,60,54,16.285714,10,54,1281,1339,-58,0,0,0,0,64,7,6,0.640625,1,1,15,9,false,true,true,0.572,0.428
87,64,23,17.4,16,23,913,871,42,0,0,0,0,66,5,4,0.651515,0,0,8,12,false,true,true,0.626,0.374
166,109,57,18.444444,13.625,57,299,315,-16,0,0,0,0,45,9,8,0.933333,1,0,6,17,false,true,true,0.973,0.027
240,241,-1,18.461538,18.538462,-1,942,976,-34,0,0,0,0,10,13,13,4,0,0,20,8,false,true,true,0.571,0.429
65,61,4,21.666667,20.333333,4,908,859,49,0,0,0,0,76,3,3,0.513158,0,0,8,19,false,true,true,0.639,0.361
22,0,22,22,0,22,1014,948,66,0,0,0,0,95,1,0,0.347368,1,0,14,0,false,true,true,0.778,0.222
17,26,-9,8.5,26,-9,421,306,115,0,0,0,0,91,2,1,0.483516,0,1,14,8,false,true,false,0.384,0.616
175,180,-5,15.909091,16.363636,-5,371,435,-64,0,0,0,0,22,11,11,2,0,0,18,7,false,true,true,0.664,0.336
187,184,3,15.583333,15.333333,3,904,857,47,0,0,0,0,22,12,12,1.863636,1,0,9,10,false,true,true,0.764,0.236
328,270,58,21.866667,18,58,1004,653,351,0,0,0,0,-15,15,15,-2.333333,0,0,8,2,false,true,true,1,0
0,14,-14,0,14,-14,1089,1063,26,0,0,0,0,96,1,1,0.395833,0,0,15,9,false,true,false,0.302,0.698
226,135,91,22.6,15,91,1253,1166,87,1,0,0.1,0,40,10,9,1.075,0,0,8,22,false,true,true,0.99,0.01
82,31,51,41,15.5,51,742,696,46,0,0,0,0,85,2,2,0.376471,0,1,11,6,false,true,true,0.926,0.074
66,66,0,13.2,16.5,0,539,632,-93,0,0,0,0,75,5,4,0.613333,0,0,8,9,false,true,false,0.141,0.859
177,101,76,35.4,20.2,76,1826,1803,23,1,0,0.2,0,58,5,5,0.517241,1,0,15,8,false,true,true,0.966,0.034
97,39,58,48.5,39,58,1684,1320,364,1,0,0.5,0,85,2,1,0.352941,0,0,9,15,false,true,true,0.999,0.001
301,223,78,16.722222,13.117647,78,892,768,124,0,0,0,0,4,18,17,10.75,0,0,10,13,false,true,true,0.996,0.004
249,183,66,20.75,15.25,66,576,532,44,0,0,0,0,23,12,12,2,0,0,16,7,false,true,true,0.984,0.016
310,278,32,23.846154,23.166667,32,974,995,-21,0,1,0,0.083333,9,13,12,3.666667,0,0,8,14,false,true,true,0.739,0.261
127,132,-5,15.875,16.5,-5,864,808,56,1,0,0.125,0,38,8,8,0.894737,1,0,9,15,false,true,true,0.906,0.094
340,324,16,17.894737,18,16,1127,1176,-49,0,0,0,0,-18,19,18,-2.333333,0,0,2,2,false,true,true,0.998,0.002
204,127,77,25.5,18.142857,77,986,856,130,1,0,0.125,0,40,8,7,0.775,1,0,6,16,false,true,true,0.976,0.024
159,132,27,15.9,13.2,27,218,86,132,0,0,0,0,28,10,10,1.428571,0,0,26,13,false,true,true,0.945,0.055
134,37,97,44.666667,12.333333,97,539,500,39,0,0,0,0,71,3,3,0.56338,0,1,17,26,false,true,true,0.945,0.055
156,171,-15,19.5,21.375,-15,1077,1094,-17,0,0,0,0,47,8,8,0.893617,0,0,15,10,false,true,false,0.275,0.725
12,14,-2,12,14,-2,1320,1339,-19,0,0,0,0,92,1,1,0.423913,0,0,10,8,false,true,true,0.526,0.474
33,31,2,16.5,15.5,2,1069,917,152,0,0,0,0,84,2,2,0.404762,0,1,12,11,false,true,false,0.491,0.509
198,142,56,24.75,17.75,56,820,822,-2,0,0,0,0,43,8,8,0.906977,0,0,7,10,false,true,true,0.958,0.042
120,81,39,24,20.25,39,1302,1082,220,0,0,0,0,58,5,4,0.517241,0,0,17,14,false,true,true,0.671,0.329
385,330,55,21.388889,19.411765,55,834,758,76,0,1,0,0.058824,-26,18,17,-1.384615,0,0,2,3,false,true,true,1,0
228,189,39,19,15.75,39,804,683,121,0,0,0,0,23,12,12,1.956522,0,1,18,9,false,true,true,0.897,0.103
350,270,80,19.444444,15,80,916,837,79,1,0,0.055556,0,-15,18,18,-2.666667,0,0,7,7,false,true,true,1,0
231,191,40,19.25,15.916667,40,711,876,-165,0,0,0,0,22,12,12,1.954545,0,1,10,12,false,true,true,0.59,0.41
300,275,25,21.428571,19.642857,25,847,952,-105,0,0,0,0,11,14,14,3.272727,0,0,12,7,false,true,false,0.474,0.526
248,192,56,24.8,19.2,56,971,1180,-209,1,0,0.1,0,33,10,10,0.969697,0,1,11,10,false,true,false,0.47,0.53
437,271,166,29.133333,18.066667,166,1513,1482,31,1,0,0.066667,0,-11,15,15,-3,0,0,3,9,false,true,true,1,0
323,317,6,14.043478,14.409091,6,999,1011,-12,0,0,0,0,-33,23,22,-1.393939,1,0,1,5,false,true,true,1,0
439,328,111,39.909091,32.8,111,1770,1689,81,0,1,0,0.1,2,11,10,13,1,0,6,18,false,true,true,1,0
22,34,-12,11,17,-12,786,847,-61,0,0,0,0,88,2,2,0.386364,0,1,11,8,false,true,false,0.255,0.745
336,328,8,19.764706,20.5,8,1277,1166,111,0,1,0,0.0625,-14,17,16,-2.571429,0,0,2,4,false,true,false,0.117,0.883
26,0,26,26,0,26,1170,1156,14,0,0,0,0,97,1,0,0.391753,1,0,13,0,false,true,true,0.735,0.265
304,236,68,23.384615,18.153846,68,1731,1691,40,1,0,0.076923,0,6,13,13,5.666667,0,0,7,26,false,true,true,0.998,0.002
367,275,92,17.47619,13.75,92,1606,1544,62,0,0,0,0,-16,21,20,-2.8125,0,0,2,2,false,true,true,1,0
315,238,77,22.5,18.307692,77,1036,1181,-145,0,0,0,0,14,14,13,2.428571,1,0,17,7,false,true,true,0.972,0.028
171,61,110,34.2,15.25,110,986,856,130,1,0,0.2,0,65,5,4,0.476923,1,0,7,11,false,true,true,0.982,0.018
24,0,24,12,0,24,1519,1782,-263,0,0,0,0,95,2,1,0.347368,0,1,13,11,false,true,false,0.211,0.789
270,209,61,24.545455,20.9,61,1295,1281,14,0,0,0,0,34,11,10,1.117647,0,1,10,9,false,true,true,0.81,0.19
295,91,204,19.666667,6.5,204,896,818,78,0,0,0,0,23,15,14,1.913043,1,1,9,6,false,true,true,1,0
127,89,38,18.142857,14.833333,38,272,288,-16,0,0,0,0,59,7,6,0.881356,1,0,13,20,false,true,true,0.589,0.411
219,129,90,27.375,16.125,90,904,668,236,0,0,0,0,38,8,8,0.894737,0,1,9,9,false,true,true,0.951,0.049
110,113,-3,22,22.6,-3,758,796,-38,0,0,0,0,63,5,5,0.603175,0,0,7,8,false,true,true,0.523,0.477
195,157,38,24.375,19.625,38,901,889,12,0,1,0,0.125,50,8,8,0.86,0,0,13,7,false,true,true,0.892,0.108
97,111,-14,16.166667,18.5,-14,758,750,8,0,0,0,0,50,6,6,0.74,1,1,18,6,false,true,true,0.559,0.441
216,165,51,15.428571,12.692308,51,218,86,132,0,0,0,0,7,14,13,5.714286,0,0,19,9,false,true,true,0.973,0.027
99,102,-3,11,12.75,-3,416,222,194,0,0,0,0,48,9,8,1.145833,1,0,12,17,false,true,true,0.535,0.465
294,290,4,18.375,18.125,4,95,378,-283,0,0,0,0,-16,16,16,-2.1875,0,0,5,1,false,true,true,0.761,0.239
288,262,26,13.090909,12.47619,26,611,584,27,0,0,0,0,-24,22,21,-1.833333,0,0,1,3,false,true,true,1,0
111,41,70,37,20.5,70,795,830,-35,1,1,0.333333,0.5,74,3,2,0.567568,1,0,15,11,false,true,true,0.95,0.05
59,28,31,19.666667,14,31,880,952,-72,0,0,0,0,80,3,2,0.5125,0,0,10,7,false,true,true,0.544,0.456
52,40,12,26,20,12,1094,1030,64,0,0,0,0,82,2,2,0.439024,0,0,9,8,false,true,true,0.578,0.422
385,260,125,29.615385,20,125,1439,1353,86,1,0,0.076923,0,3,13,13,10,0,0,14,15,false,true,true,1,0
334,240,94,27.833333,20,94,1093,1197,-104,2,0,0.166667,0,15,12,12,2.066667,1,1,6,21,false,true,true,0.993,0.007
366,247,119,21.529412,15.4375,119,596,595,1,1,0,0.058824,0,-11,17,16,-3.636364,0,0,5,19,false,true,true,1,0
426,193,233,35.5,16.083333,233,1431,825,606,2,1,0.166667,0.083333,12,12,12,2.833333,0,0,9,16,false,true,true,1,0
246,257,-11,24.6,25.7,-11,974,995,-21,0,1,0,0.1,25,10,10,1.32,0,0,17,7,false,true,true,0.546,0.454
328,308,20,23.428571,23.692308,20,1142,1176,-34,1,0,0.071429,0,7,14,13,5.142857,1,0,16,10,false,true,true,0.881,0.119
338,179,159,42.25,22.375,159,1571,1554,17,2,1,0.25,0.125,29,8,8,1.137931,0,0,20,9,false,true,true,1,0
22,9,13,22,9,13,1067,95,972,0,0,0,0,92,1,1,0.369565,0,0,17,14,false,true,true,1,0
23,38,-15,11.5,19,-15,491,398,93,0,0,0,0,87,2,2,0.413793,0,1,16,16,false,true,true,0.55,0.45
211,129,82,26.375,16.125,82,1651,1691,-40,1,0,0.125,0,47,8,8,0.723404,0,0,14,9,false,true,true,0.987,0.013
65,57,8,21.666667,19,8,1181,1149,32,0,0,0,0,81,3,3,0.555556,0,0,10,17,false,true,false,0.425,0.575
128,89,39,14.222222,11.125,39,1016,1037,-21,0,0,0,0,51,9,8,0.941176,0,0,7,24,false,true,true,0.818,0.182
254,111,143,28.222222,13.875,143,1295,1477,-182,2,0,0.222222,0,42,9,8,1.095238,0,0,25,7,false,true,true,0.947,0.053
317,267,50,15.095238,12.714286,50,1016,1037,-21,0,0,0,0,-17,21,21,-2.823529,0,0,6,12,false,true,true,1,0
134,131,3,26.8,26.2,3,1030,998,32,0,0,0,0,59,5,5,0.644068,0,0,9,15,false,true,false,0.453,0.547
379,368,11,22.294118,23,11,907,752,155,0,1,0,0.0625,-10,17,16,-3.3,0,0,3,4,true,true,false,0.281,0.719
363,241,122,25.928571,18.538462,122,1144,1014,130,0,0,0,0,10,14,13,3.6,0,1,7,6,false,true,true,1,0
270,120,150,24.545455,12,150,554,342,212,0,0,0,0,24,11,10,1.5,0,0,7,21,false,true,true,0.998,0.002
138,158,-20,17.25,22.571429,-20,1181,1149,32,0,1,0,0.142857,56,8,7,0.803571,0,0,10,20,false,true,false,0.271,0.729
119,76,43,23.8,15.2,43,719,651,68,0,0,0,0,72,5,5,0.625,0,0,28,8,false,true,true,0.973,0.027
14,8,6,14,8,6,1530,1550,-20,0,0,0,0,91,1,1,0.373626,0,0,25,8,false,true,true,0.698,0.302
208,137,71,34.666667,22.833333,71,1762,1582,180,2,1,0.333333,0.166667,53,6,6,0.603774,0,0,10,12,false,true,true,0.988,0.012
254,181,73,28.222222,20.111111,73,1156,1114,42,1,0,0.111111,0,26,9,9,1.230769,0,0,20,16,false,true,true,0.966,0.034
12,16,-4,12,16,-4,620,658,-38,0,0,0,0,91,1,1,0.395604,1,0,11,11,false,true,true,0.557,0.443
201,194,7,13.4,13.857143,7,826,771,55,0,0,0,0,19,15,14,2.368421,0,1,19,6,false,true,true,0.835,0.165
128,82,46,21.333333,16.4,46,1029,1227,-198,1,0,0.166667,0,54,6,5,0.592593,0,0,11,25,false,true,true,0.826,0.174
406,341,65,25.375,21.3125,65,1408,1454,-46,1,0,0.0625,0,-6,16,16,-5.333333,0,0,2,5,true,true,true,1,0
20,32,-12,20,32,-12,334,446,-112,0,0,0,0,94,1,1,0.425532,0,0,9,11,false,true,false,0.21,0.79
102,59,43,25.5,19.666667,43,609,620,-11,0,0,0,0,74,4,3,0.5,0,0,12,10,false,true,true,0.85,0.15
16,99,-83,5.333333,33,-83,1897,1793,104,0,1,0,0.333333,83,3,3,0.385542,0,0,11,17,false,true,true,0.996,0.004
159,136,23,17.666667,15.111111,23,859,822,37,0,0,0,0,37,9,9,1.027027,0,0,16,16,false,true,true,0.849,0.151
392,333,59,24.5,22.2,59,1266,1144,122,0,0,0,0,-14,16,15,-2.428571,0,0,4,16,false,true,true,1,0
402,326,76,26.8,21.733333,76,791,885,-94,1,1,0.066667,0.066667,-8,15,15,-4.75,0,0,9,8,false,true,true,1,0
12,0,12,12,0,12,416,222,194,0,0,0,0,96,1,0,0.572917,0,0,13,0,false,true,true,0.784,0.216
354,240,114,22.125,16,114,596,595,1,1,0,0.0625,0,-4,16,15,-10,0,0,9,25,false,true,true,1,0
184,65,119,23,8.125,119,896,818,78,0,0,0,0,58,8,8,0.758621,0,0,12,7,false,true,true,0.996,0.004
418,257,161,32.153846,19.769231,161,1550,1624,-74,2,0,0.153846,0,10,13,13,3,1,0,10,7,false,true,true,1,0
124,101,23,15.5,12.625,23,1281,1339,-58,0,0,0,0,56,8,8,0.732143,1,1,20,8,false,true,true,0.566,0.434
91,71,20,11.375,8.875,20,310,359,-49,0,0,0,0,45,8,8,1.088889,2,0,5,20,false,true,true,0.913,0.087
134,139,-5,19.142857,19.857143,-5,1452,1469,-17,0,1,0,0.142857,47,7,7,0.808511,0,1,8,12,false,true,false,0.297,0.703
321,220,101,32.1,24.444444,101,1762,1616,146,2,0,0.2,0,18,10,9,1.666667,1,0,6,17,false,true,true,1,0
408,314,94,25.5,19.625,94,971,1180,-209,1,1,0.0625,0.0625,-10,16,16,-3.2,0,0,3,3,true,true,true,1,0
20,0,20,20,0,20,1645,1777,-132,0,0,0,0,95,1,0,0.263158,0,0,15,0,false,true,true,0.563,0.437
107,36,71,53.5,36,71,1493,1513,-20,1,0,0.5,0,85,2,1,0.388235,0,0,14,12,false,true,true,0.619,0.381
102,39,63,51,19.5,63,1770,1689,81,0,0,0,0,79,2,2,0.329114,0,1,10,17,false,true,true,0.812,0.188
300,221,79,27.272727,22.1,79,1556,1591,-35,1,0,0.090909,0,23,11,10,1.565217,0,0,15,10,false,true,true,0.98,0.02
352,295,57,20.705882,18.4375,57,1434,1493,-59,1,0,0.058824,0,-10,17,16,-3.7,0,0,6,2,false,true,true,1,0
250,246,4,16.666667,16.4,4,95,360,-265,0,1,0,0.066667,-3,15,15,-13.333333,1,0,10,9,false,true,true,0.946,0.054
140,101,39,35,25.25,39,1983,2020,-37,1,0,0.25,0,68,4,4,0.382353,0,1,19,12,false,true,true,0.563,0.437
384,289,95,29.538462,22.230769,95,1735,1770,-35,2,1,0.153846,0.076923,-6,13,13,-4.666667,0,1,11,3,false,true,true,1,0
103,115,-12,17.166667,19.166667,-12,808,639,169,0,0,0,0,53,6,6,0.773585,0,0,25,8,false,true,true,0.552,0.448
136,111,25,17,15.857143,25,758,750,8,0,0,0,0,45,8,7,0.822222,0,1,11,9,false,true,true,0.568,0.432
249,204,45,17.785714,14.571429,45,758,750,8,0,0,0,0,7,14,14,5.285714,0,1,12,7,false,true,true,0.943,0.057
249,190,59,27.666667,21.111111,59,1388,1506,-118,2,1,0.222222,0.111111,36,9,9,0.944444,0,0,7,27,false,true,true,0.947,0.053
280,260,20,15.555556,15.294118,20,699,448,251,0,0,0,0,-5,18,17,-8,0,0,15,7,false,true,true,0.787,0.213
119,78,41,23.8,19.5,41,1034,1040,-6,0,0,0,0,68,5,4,0.514706,0,1,18,6,false,true,true,0.673,0.327
250,174,76,22.727273,15.818182,76,526,370,156,0,0,0,0,21,11,11,1.666667,1,0,8,7,false,true,true,0.996,0.004
236,186,50,16.857143,13.285714,50,913,871,42,0,0,0,0,14,14,14,3.071429,0,0,12,27,false,true,true,0.983,0.017
251,197,54,19.307692,15.153846,54,1221,1438,-217,0,0,0,0,26,13,13,1.730769,0,1,20,10,false,true,true,0.861,0.139
45,43,2,15,14.333333,2,416,222,194,0,0,0,0,77,3,3,0.714286,1,1,6,10,false,true,true,0.783,0.217
25,24,1,12.5,24,1,926,854,72,0,0,0,0,88,2,1,0.386364,0,0,11,20,false,true,false,0.334,0.666
16,19,-3,8,9.5,-3,561,526,35,0,0,0,0,84,2,2,0.416667,2,0,16,16,false,true,true,0.914,0.086
269,208,61,20.692308,17.333333,61,1221,1258,-37,1,0,0.076923,0,22,13,12,1.772727,0,0,7,7,false,true,true,0.985,0.015
192,172,20,17.454545,17.2,20,808,812,-4,0,0,0,0,28,11,10,1.321429,1,0,9,9,false,true,true,0.8,0.2
99,74,25,19.8,18.5,25,1501,1473,28,0,0,0,0,66,5,4,0.545455,0,1,19,9,false,true,false,0.409,0.591
324,261,63,18,14.5,63,1253,1166,87,1,0,0.055556,0,-7,18,18,-6.142857,0,0,10,11,false,true,true,0.998,0.002
293,280,13,13.952381,13.333333,13,871,999,-128,0,0,0,0,-25,21,21,-1.92,0,0,8,7,false,true,true,1,0
57,75,-18,11.4,18.75,-18,1156,1184,-28,0,0,0,0,66,5,4,0.424242,1,0,6,19,false,true,false,0.276,0.724
454,302,152,32.428571,21.571429,152,1571,1554,17,2,1,0.142857,0.071429,-13,14,14,-2.538462,1,0,2,4,false,true,true,1,0
84,58,26,16.8,14.5,26,808,812,-4,0,0,0,0,64,5,4,0.578125,0,1,16,11,false,true,true,0.573,0.427
387,325,62,35.181818,29.545455,62,1348,1331,17,4,1,0.363636,0.090909,-9,11,11,-2.666667,0,0,1,3,false,true,true,0.996,0.004
307,220,87,30.7,22,87,1397,1361,36,1,0,0.1,0,18,10,10,1.611111,0,0,16,13,false,true,true,1,0
297,219,78,17.470588,13.6875,78,415,518,-103,0,0,0,0,-10,17,16,-3.8,0,0,3,17,false,true,true,1,0
328,271,57,20.5,18.066667,57,719,785,-66,0,1,0,0.066667,-3,16,15,-12,0,0,9,8,false,true,true,0.992,0.008
381,274,107,29.307692,21.076923,107,1334,1477,-143,2,1,0.153846,0.076923,-3,13,13,-10,0,0,10,9,false,true,true,1,0
126,110,16,21,18.333333,16,695,523,172,0,0,0,0,54,6,6,0.685185,0,1,11,6,false,true,true,0.784,0.216
310,233,77,23.846154,19.416667,77,902,866,36,0,0,0,0,-3,13,12,-10.666667,1,0,13,11,false,true,true,1,0
55,12,43,18.333333,6,43,896,818,78,0,0,0,0,86,3,2,0.511628,0,0,14,11,false,true,true,0.785,0.215
350,325,25,21.875,21.666667,25,1344,1325,19,1,0,0.0625,0,-14,16,15,-2.214286,0,0,2,3,true,true,true,0.945,0.055
243,188,55,15.1875,12.533333,55,416,374,42,0,0,0,0,17,16,15,2.705882,0,0,16,10,false,true,true,0.97,0.03
178,104,74,29.666667,20.8,74,1210,1252,-42,1,0,0.166667,0,60,6,5,0.533333,0,0,8,21,false,true,true,0.945,0.055
193,190,3,21.444444,23.75,3,1406,1454,-48,0,1,0,0.125,31,9,8,1.096774,1,1,11,10,false,true,false,0.403,0.597
290,296,-6,14.5,15.578947,-6,613,549,64,0,0,0,0,-26,20,19,-1.692308,0,0,2,2,false,true,false,0.498,0.502
319,276,43,17.722222,15.333333,43,468,542,-74,0,0,0,0,-14,18,18,-2.785714,0,0,3,1,false,true,true,1,0
374,242,132,28.769231,18.615385,132,1270,1322,-52,1,0,0.076923,0,10,13,13,3.8,0,0,13,16,false,true,true,1,0
18,25,-7,9,12.5,-7,847,952,-105,0,0,0,0,92,2,2,0.391304,0,0,24,19,false,true,false,0.17,0.83
38,25,13,19,25,13,1227,1060,167,0,0,0,0,92,2,1,0.434783,0,0,7,11,false,true,false,0.41,0.59
352,252,100,18.526316,14,100,1181,1069,112,0,0,0,0,-23,19,18,-1.608696,0,0,2,3,true,true,true,1,0
216,262,-46,19.636364,23.818182,-46,1076,1176,-100,0,1,0,0.090909,18,11,11,1.777778,0,0,28,15,false,true,false,0.004,0.996
361,239,122,21.235294,14.058824,122,1011,921,90,1,0,0.058824,0,-2,17,17,-24.5,0,0,11,16,false,true,true,1,0
103,71,32,20.6,17.75,32,1043,1055,-12,0,0,0,0,67,5,4,0.552239,0,0,11,10,false,true,true,0.558,0.442
252,232,20,18,16.571429,20,885,719,166,0,0,0,0,7,14,14,5.428571,0,0,10,12,false,true,true,0.82,0.18
226,134,92,22.6,14.888889,92,808,639,169,0,0,0,0,32,10,9,1.28125,0,0,22,13,false,true,true,0.971,0.029
278,305,-27,14.631579,16.944444,-27,999,1011,-12,0,0,0,0,-19,19,18,-2.421053,1,0,9,7,false,true,false,0.115,0.885
341,259,82,17.947368,14.388889,82,830,907,-77,1,0,0.052632,0,-13,19,18,-3,0,1,14,1,false,true,true,1,0
359,256,103,23.933333,18.285714,103,1030,998,32,1,0,0.066667,0,-2,15,14,-19,1,0,6,16,false,true,true,1,0
101,103,-2,16.833333,20.6,-2,1482,1394,88,0,0,0,0,64,6,5,0.5625,1,0,12,17,false,true,false,0.442,0.558
73,67,6,14.6,13.4,6,859,822,37,0,0,0,0,63,5,5,0.603175,0,0,30,13,false,true,true,0.765,0.235
191,200,-9,17.363636,20,-9,1077,1094,-17,0,0,0,0,34,11,10,1.235294,0,0,7,8,false,true,false,0.256,0.744
88,40,48,14.666667,8,48,1016,1037,-21,0,0,0,0,67,6,5,0.716418,0,1,9,13,false,true,true,0.711,0.289
357,219,138,25.5,15.642857,138,954,1078,-124,1,1,0.071429,0.071429,3,14,14,12.666667,0,0,11,10,false,true,true,1,0
164,262,-98,20.5,32.75,-98,1125,1227,-102,0,1,0,0.125,32,8,8,0.9375,1,0,12,12,false,true,false,0.036,0.964
335,263,72,20.9375,16.4375,72,691,473,218,0,0,0,0,-11,16,16,-3.272727,1,0,2,2,false,true,true,1,0
92,42,50,18.4,10.5,50,1181,1069,112,0,0,0,0,68,5,4,0.544118,1,0,19,16,false,true,true,0.902,0.098
81,74,7,20.25,18.5,7,1501,1473,28,0,0,0,0,69,4,4,0.521739,0,1,21,9,false,true,false,0.466,0.534
160,81,79,22.857143,13.5,79,1270,1348,-78,0,0,0,0,58,7,6,0.655172,0,0,16,17,false,true,true,0.906,0.094
279,245,34,13.95,12.25,34,611,584,27,0,0,0,0,-17,20,20,-2.588235,1,0,1,11,false,true,true,0.994,0.006
0,28,-28,0,28,-28,1554,1622,-68,0,0,0,0,95,1,1,0.326316,0,0,10,18,false,true,false,0.271,0.729
12,0,12,12,0,12,518,533,-15,0,0,0,0,97,1,0,0.360825,0,0,11,0,false,true,true,0.55,0.45
170,137,33,18.888889,17.125,33,831,830,1,0,0,0,0,44,9,8,0.840909,0,0,20,11,false,true,true,0.864,0.136
291,270,21,20.785714,20.769231,21,594,605,-11,0,0,0,0,2,14,13,18.5,0,0,13,9,false,true,true,0.791,0.209
66,57,9,22,28.5,9,1419,1488,-69,0,0,0,0,77,3,2,0.363636,0,0,9,13,false,true,false,0.312,0.688
264,139,125,18.857143,9.928571,125,1176,1076,100,0,0,0,0,40,14,14,1.475,0,0,10,11,false,true,true,0.999,0.001
255,251,4,23.181818,25.1,4,1096,1009,87,1,0,0.090909,0,38,11,10,1.157895,0,0,7,12,false,true,false,0.171,0.829
56,26,30,18.666667,13,30,1089,1063,26,0,0,0,0,86,3,2,0.44186,1,0,12,20,false,true,true,0.831,0.169
85,31,54,28.333333,15.5,54,1295,1281,14,0,0,0,0,81,3,2,0.469136,0,0,25,11,false,true,true,0.78,0.22
192,178,14,21.333333,19.777778,14,892,788,104,1,0,0.111111,0,43,9,9,1,0,0,10,16,false,true,true,0.671,0.329
8,18,-10,8,18,-10,1770,1689,81,0,0,0,0,91,1,1,0.285714,0,1,10,20,false,true,false,0.271,0.729
250,281,-31,20.833333,23.416667,-31,758,952,-194,0,0,0,0,10,12,12,4,1,0,9,7,false,true,false,0.131,0.869
115,67,48,28.75,22.333333,48,992,1100,-108,1,0,0.25,0,70,4,3,0.485714,1,0,6,16,false,true,true,0.758,0.242
240,167,73,21.818182,16.7,73,527,503,24,0,0,0,0,40,11,10,1.025,0,0,13,11,false,true,true,0.958,0.042
261,188,73,21.75,17.090909,73,830,907,-77,1,0,0.083333,0,23,12,11,1.695652,0,0,9,23,false,true,true,0.945,0.055
236,202,34,23.6,20.2,34,1406,1454,-48,0,1,0,0.1,21,10,10,1.619048,1,1,13,18,false,true,true,0.77,0.23
294,216,78,21,15.428571,78,746,796,-50,0,1,0,0.071429,8,14,14,6,0,1,14,7,false,true,true,0.994,0.006
134,112,22,33.5,28,22,1004,840,164,1,0,0.25,0,65,4,4,0.461538,1,0,13,13,false,true,true,0.713,0.287
129,97,32,21.5,19.4,32,1034,1040,-6,0,0,0,0,59,6,5,0.59322,0,1,18,8,false,true,true,0.601,0.399
245,208,37,20.416667,18.909091,37,1210,1253,-43,0,1,0,0.090909,18,12,11,1.944444,1,0,9,17,false,true,true,0.948,0.052
62,10,52,31,10,52,1197,1127,70,0,0,0,0,89,2,1,0.337079,1,0,9,23,false,true,true,0.886,0.114
35,18,17,11.666667,9,17,721,689,32,0,0,0,0,77,3,2,0.441558,0,0,14,16,false,true,true,0.741,0.259
195,239,-44,21.666667,26.555556,-44,758,952,-194,0,0,0,0,30,9,9,1.333333,1,0,11,7,false,true,false,0.162,0.838
231,175,56,38.5,35,56,1633,1580,53,2,0,0.333333,0,51,6,5,0.54902,0,0,9,9,false,true,true,0.835,0.165
293,290,3,20.928571,22.307692,3,1210,1252,-42,1,0,0.071429,0,4,14,13,8,1,0,8,10,false,true,false,0.385,0.615
184,172,12,20.444444,21.5,12,809,868,-59,1,0,0.111111,0,36,9,8,0.888889,0,0,11,17,false,true,false,0.237,0.763
282,217,65,28.2,21.7,65,630,786,-156,1,0,0.1,0,27,10,10,1.296296,0,0,11,15,false,true,true,0.906,0.094
339,280,59,19.941176,17.5,59,1406,1454,-48,0,2,0,0.125,-11,17,16,-3.090909,0,0,2,11,false,true,true,0.996,0.004
37,48,-11,12.333333,24,-11,1102,1245,-143,0,0,0,0,79,3,2,0.35443,0,0,8,12,false,true,false,0.087,0.913
42,13,29,21,13,29,303,342,-39,0,0,0,0,92,2,1,0.413043,0,0,20,15,false,true,true,0.553,0.447
224,168,56,22.4,16.8,56,1055,1050,5,0,0,0,0,35,10,10,0.971429,0,0,19,7,false,true,true,0.95,0.05
174,151,23,15.818182,15.1,23,859,822,37,0,0,0,0,28,11,10,1.357143,0,0,16,14,false,true,true,0.677,0.323
368,358,10,20.444444,21.058824,10,1501,1473,28,1,0,0.055556,0,-22,18,17,-1.636364,0,0,1,1,false,true,true,0.985,0.015
312,337,-25,18.352941,19.823529,-25,1439,1294,145,1,0,0.058824,0,-20,17,17,-1.8,1,0,2,5,false,true,false,0.466,0.534
363,286,77,27.923077,23.833333,77,1885,1846,39,1,1,0.076923,0.083333,2,13,12,14.5,0,0,10,8,false,true,true,0.996,0.004
90,106,-16,15,21.2,-16,1583,1422,161,0,0,0,0,66,6,5,0.772727,1,0,17,9,false,true,false,0.465,0.535
271,227,44,18.066667,15.133333,44,804,683,121,0,0,0,0,8,15,15,5.625,0,1,15,11,false,true,true,0.866,0.134
228,195,33,17.538462,16.25,33,371,435,-64,0,0,0,0,11,13,12,4,0,0,14,7,false,true,true,0.85,0.15
77,78,-1,19.25,19.5,-1,349,315,34,0,0,0,0,69,4,4,0.492754,0,0,10,10,false,true,true,0.783,0.217
409,299,110,27.266667,21.357143,110,1334,1477,-143,2,1,0.133333,0.071429,-15,15,14,-2,0,0,2,4,false,true,true,1,0
70,81,-11,10,13.5,-11,826,771,55,0,0,0,0,66,7,6,0.681818,0,0,11,17,false,true,true,0.501,0.499
8,14,-6,8,14,-6,1334,1256,78,0,0,0,0,93,1,1,0.333333,1,0,16,15,false,true,true,0.655,0.345
145,208,-63,18.125,26,-63,594,605,-11,0,0,0,0,46,8,8,0.804348,1,0,6,7,false,true,false,0.041,0.959
14,46,-32,4.666667,15.333333,-32,977,976,1,0,0,0,0,82,3,3,0.414634,0,0,23,9,false,true,false,0.276,0.724
375,392,-17,28.846154,30.153846,-17,1489,1558,-69,0,1,0,0.076923,-4,13,13,-7,0,0,6,6,false,true,false,0.494,0.506
83,86,-3,11.857143,14.333333,-3,658,817,-159,0,0,0,0,63,7,6,0.603175,0,0,33,10,false,true,false,0.184,0.816
22,6,16,11,6,16,1253,1166,87,0,0,0,0,90,2,1,0.477778,0,0,9,21,false,true,false,0.386,0.614
337,281,56,42.125,35.125,56,1348,1331,17,2,0,0.25,0,25,8,8,0.96,0,0,10,7,false,true,true,1,0
164,218,-54,20.5,31.142857,-54,1076,1176,-100,0,1,0,0.142857,44,8,7,0.727273,0,0,22,11,false,true,false,0.246,0.754
310,271,39,20.666667,18.066667,39,948,933,15,1,0,0.066667,0,11,15,15,3.454545,0,0,16,7,false,true,true,0.918,0.082
416,283,133,24.470588,16.647059,133,1221,1266,-45,1,0,0.058824,0,-24,17,17,-1.458333,0,0,13,5,false,true,true,1,0
98,54,44,32.666667,27,44,1256,1232,24,1,0,0.333333,0,78,3,2,0.384615,0,1,17,11,false,true,true,0.562,0.438
113,89,24,12.555556,11.125,24,892,768,124,0,0,0,0,54,9,8,0.796296,0,0,7,18,false,true,true,0.601,0.399
378,308,70,18.9,16.210526,70,880,952,-72,0,0,0,0,-26,20,19,-1.576923,0,0,1,1,false,true,true,1,0
14,0,14,14,0,14,1109,1065,44,0,0,0,0,97,1,0,0.340206,0,0,15,0,false,true,true,0.563,0.437
537,505,32,48.818182,45.909091,32,1370,1431,-61,3,1,0.272727,0.090909,-5,11,11,-4.6,0,0,10,4,false,true,true,0.82,0.18
52,30,22,17.333333,15,22,913,871,42,0,0,0,0,79,3,2,0.544304,0,0,8,19,false,true,true,0.649,0.351
230,145,85,38.333333,24.166667,85,1397,1361,36,1,0,0.166667,0,48,6,6,0.604167,0,0,11,10,false,true,true,0.954,0.046
110,99,11,15.714286,16.5,11,566,542,24,0,0,0,0,54,7,6,0.759259,0,0,21,11,false,true,true,0.679,0.321
216,155,61,30.857143,25.833333,61,1101,1078,23,0,0,0,0,50,7,6,0.66,0,1,7,10,false,true,true,0.804,0.196
96,36,60,32,18,60,1826,1803,23,0,0,0,0,82,3,2,0.365854,0,0,9,12,false,true,true,0.603,0.397
320,268,52,24.615385,22.333333,52,1434,1493,-59,1,0,0.076923,0,6,13,12,6.166667,0,1,15,6,false,true,true,0.936,0.064
329,233,96,20.5625,15.533333,96,620,658,-38,0,0,0,0,-4,16,15,-9,0,0,15,11,false,true,true,1,0
359,359,0,23.933333,23.933333,0,1636,1576,60,0,2,0,0.133333,-9,15,15,-3.777778,0,0,4,15,false,true,false,0.254,0.746
11,29,-18,5.5,14.5,-18,977,976,1,0,0,0,0,89,2,2,0.382022,0,0,14,7,false,true,false,0.341,0.659
119,64,55,23.8,12.8,55,1875,1793,82,1,0,0.2,0,69,5,5,0.434783,1,0,13,8,false,true,true,0.963,0.037
78,85,-7,11.142857,14.166667,-7,539,632,-93,0,0,0,0,63,7,6,0.730159,0,1,18,7,false,true,false,0.101,0.899
162,116,46,18,12.888889,46,1069,1040,29,0,0,0,0,38,9,9,1.157895,0,2,7,5,false,true,true,0.869,0.131
39,36,3,13,12,3,847,952,-105,0,0,0,0,86,3,3,0.418605,0,0,20,15,false,true,false,0.21,0.79
234,232,2,16.714286,16.571429,2,859,822,37,0,0,0,0,6,14,14,6.333333,0,0,9,9,false,true,true,0.72,0.28
197,105,92,24.625,15,92,960,1070,-110,1,0,0.125,0,47,8,7,0.744681,0,0,12,23,false,true,true,0.946,0.054
88,70,18,12.571429,11.666667,18,904,857,47,0,0,0,0,58,7,6,0.706897,0,1,22,15,false,true,false,0.376,0.624
351,298,53,16.714286,14.9,53,1548,1493,55,1,0,0.047619,0,-28,21,20,-1.464286,0,0,1,3,true,true,true,1,0
22,26,-4,11,13,-4,1253,1166,87,0,0,0,0,87,2,2,0.494253,0,0,9,18,false,true,false,0.303,0.697
365,239,126,17.380952,11.380952,126,896,818,78,0,1,0,0.047619,-21,21,21,-2.095238,1,0,5,5,false,true,true,1,0
109,49,60,27.25,16.333333,60,871,867,4,0,0,0,0,73,4,3,0.589041,0,0,11,10,false,true,true,0.857,0.143
99,129,-30,16.5,21.5,-30,262,306,-44,0,0,0,0,67,6,6,0.686567,0,1,22,9,false,true,false,0.002,0.998
340,328,12,21.25,20.5,12,974,995,-21,0,1,0,0.0625,-11,16,16,-3,0,0,2,1,false,true,true,0.821,0.179
342,283,59,20.117647,16.647059,59,791,774,17,1,0,0.058824,0,-4,17,17,-10.25,0,0,7,5,false,true,true,0.998,0.002
315,320,-5,19.6875,20,-5,971,906,65,0,0,0,0,-14,16,16,-2.285714,1,0,3,4,true,true,false,0.311,0.689
100,106,-6,16.666667,21.2,-6,725,771,-46,0,1,0,0.2,57,6,5,0.807018,0,1,17,16,false,true,false,0.413,0.587
118,34,84,29.5,11.333333,84,960,1070,-110,1,0,0.25,0,72,4,3,0.486111,0,0,12,17,false,true,true,0.908,0.092
134,158,-24,19.142857,26.333333,-24,869,820,49,0,1,0,0.166667,59,7,6,0.627119,0,0,13,10,false,true,false,0.273,0.727
426,249,177,21.3,12.45,177,1295,1477,-182,3,0,0.15,0,-17,20,20,-2.705882,0,0,4,1,false,true,true,1,0
60,30,30,20,15,30,859,811,48,0,0,0,0,80,3,2,0.45,0,0,14,12,false,true,true,0.724,0.276
260,163,97,28.888889,18.111111,97,795,830,-35,1,1,0.111111,0.111111,28,9,9,1.5,0,0,8,14,false,true,true,0.988,0.012
302,246,56,15.894737,13.666667,56,698,742,-44,1,0,0.052632,0,-5,19,18,-8.2,0,0,7,8,false,true,true,0.985,0.015
392,344,48,30.153846,28.666667,48,1302,1349,-47,0,1,0,0.083333,-2,13,12,-14,0,1,1,21,false,true,true,1,0
69,60,9,17.25,20,9,468,542,-74,0,0,0,0,80,4,3,0.4875,0,0,19,7,false,true,false,0.23,0.77
329,309,20,14.954545,14.714286,20,500,567,-67,0,0,0,0,-20,22,21,-2.2,0,0,2,11,false,true,true,1,0
24,16,8,24,16,8,808,639,169,0,0,0,0,90,1,1,0.455556,0,0,9,11,false,true,true,0.781,0.219
222,199,23,27.75,28.428571,23,1428,1606,-178,1,0,0.125,0,40,8,7,0.8,1,0,13,10,false,true,false,0.37,0.63
330,309,21,20.625,19.3125,21,518,448,70,0,0,0,0,-13,16,16,-2.615385,0,0,1,1,false,true,true,0.977,0.023
103,149,-46,14.714286,21.285714,-46,262,306,-44,0,0,0,0,63,7,7,0.730159,0,0,20,10,false,true,false,0.15,0.85
26,25,1,26,25,1,1227,1060,167,0,0,0,0,94,1,1,0.425532,0,0,7,11,false,true,true,0.534,0.466
131,89,42,21.833333,14.833333,42,1181,1069,112,0,0,0,0,59,6,6,0.627119,0,0,17,12,false,true,true,0.861,0.139
243,149,94,40.5,24.833333,94,1507,1554,-47,1,1,0.166667,0.166667,44,6,6,0.659091,0,0,15,10,false,true,true,0.986,0.014
265,109,156,26.5,12.111111,156,801,925,-124,1,0,0.1,0,32,10,9,1.09375,1,0,12,23,false,true,true,0.961,0.039
161,103,58,17.888889,12.875,58,791,774,17,1,0,0.111111,0,54,9,8,0.759259,1,0,10,20,false,true,true,0.956,0.044
270,205,65,20.769231,15.769231,65,1270,1315,-45,0,0,0,0,12,13,13,3,0,0,9,30,false,true,true,0.981,0.019
291,242,49,14.55,12.736842,49,584,565,19,0,0,0,0,-22,20,19,-2.090909,0,0,15,7,false,true,true,1,0
279,228,51,21.461538,19,51,1295,1281,14,0,0,0,0,27,13,12,1.407407,0,1,7,11,false,true,true,0.694,0.306
342,313,29,20.117647,19.5625,29,1244,1361,-117,2,1,0.117647,0.0625,2,17,16,19,0,0,7,14,false,true,true,0.837,0.163
249,213,36,27.666667,26.625,36,908,1070,-162,1,0,0.111111,0,37,9,8,0.810811,0,0,8,13,false,true,true,0.52,0.48
134,102,32,16.75,14.571429,32,777,830,-53,0,0,0,0,51,8,7,0.803922,0,0,14,10,false,true,true,0.706,0.294
254,201,53,19.538462,16.75,53,844,821,23,0,0,0,0,34,13,12,1.235294,0,0,19,7,false,true,true,0.874,0.126
300,281,19,17.647059,16.529412,19,1159,1051,108,0,0,0,0,-8,17,17,-5,1,0,5,12,false,true,true,0.928,0.072
312,220,92,26,20,92,880,952,-72,0,0,0,0,21,12,11,1.666667,0,0,16,8,false,true,true,0.969,0.031
216,177,39,27,25.285714,39,1004,840,164,1,0,0.125,0,39,8,7,0.769231,1,0,9,11,false,true,true,0.735,0.265
231,197,34,21,19.7,34,901,1159,-258,2,0,0.181818,0,25,11,10,1.4,0,0,14,7,false,true,true,0.929,0.071
369,285,84,19.421053,15,84,613,569,44,0,0,0,0,-21,19,19,-1.857143,0,0,1,1,false,true,true,1,0
62,22,40,31,22,40,746,796,-50,0,1,0,1,82,2,1,0.585366,0,0,10,9,false,true,true,0.945,0.055
408,342,66,27.2,24.428571,66,1237,1277,-40,0,0,0,0,-15,15,14,-1.933333,0,0,6,1,true,true,true,1,0
245,168,77,17.5,12.923077,77,498,43,455,0,0,0,0,7,14,13,5.285714,0,0,10,10,false,true,true,0.982,0.018
161,110,51,20.125,15.714286,51,1055,1050,5,0,0,0,0,49,8,7,0.693878,0,0,13,12,false,true,true,0.868,0.132
109,47,62,27.25,15.666667,62,1078,1130,-52,0,0,0,0,77,4,3,0.506494,0,1,10,9,false,true,true,0.803,0.197
196,149,47,28,24.833333,47,1344,1325,19,1,0,0.142857,0,47,7,6,0.659574,0,0,7,13,false,true,true,0.649,0.351
142,21,121,23.666667,3.5,121,1033,1037,-4,0,0,0,0,66,6,6,0.681818,0,0,11,8,false,true,true,0.996,0.004
244,196,48,17.428571,15.076923,48,864,808,56,1,0,0.071429,0,-2,14,13,-17,0,1,13,10,false,true,true,0.883,0.117
257,254,3,16.0625,15.875,3,262,306,-44,0,0,0,0,-4,16,16,-11.5,0,0,7,11,false,true,true,0.699,0.301
135,137,-2,22.5,22.833333,-2,1266,1144,122,0,0,0,0,54,6,6,0.62963,1,0,11,11,false,true,true,0.773,0.227
221,178,43,17,13.692308,43,1048,1000,48,0,0,0,0,25,13,13,1.6,0,1,12,13,false,true,true,0.852,0.148
303,295,8,25.25,26.818182,8,908,1070,-162,1,0,0.083333,0,11,12,11,2.727273,0,0,11,9,false,true,false,0.283,0.717
358,229,129,23.866667,15.266667,129,742,696,46,0,0,0,0,-15,15,15,-2.133333,0,0,6,2,false,true,true,1,0
381,321,60,19.05,16.05,60,1551,1550,1,0,0,0,0,-36,20,20,-1.166667,0,0,1,2,false,true,true,1,0
40,6,34,40,6,34,859,811,48,0,0,0,0,92,1,1,0.391304,0,0,7,10,false,true,true,0.793,0.207
40,20,20,20,20,20,1189,1266,-77,0,0,0,0,88,2,1,0.386364,1,0,10,14,false,true,true,0.7,0.3
189,131,58,18.9,14.555556,58,871,867,4,0,0,0,0,39,10,9,1.102564,0,0,10,12,false,true,true,0.973,0.027
18,14,4,18,14,4,859,786,73,0,0,0,0,92,1,1,0.413043,0,1,12,9,false,true,true,0.563,0.437
349,242,107,23.266667,16.133333,107,1110,1039,71,0,0,0,0,-7,15,15,-5.142857,0,0,17,13,false,true,true,1,0
175,124,51,15.909091,11.272727,51,1128,889,239,0,1,0,0.090909,34,11,11,1.382353,0,0,25,23,false,true,true,0.975,0.025
352,204,148,29.333333,18.545455,148,986,856,130,1,0,0.083333,0,5,12,11,6.2,0,0,12,9,false,true,true,1,0
243,176,67,22.090909,17.6,67,1022,1095,-73,0,0,0,0,21,11,10,1.571429,0,1,16,12,false,true,true,0.86,0.14
47,60,-13,15.666667,20,-13,468,542,-74,0,0,0,0,83,3,3,0.46988,0,0,17,7,false,true,false,0.215,0.785
455,425,30,37.916667,35.416667,30,1885,1793,92,0,0,0,0,-3,12,12,-9,0,0,7,2,false,true,true,1,0
317,312,5,22.642857,22.285714,5,992,1100,-108,2,0,0.142857,0,2,14,14,17,0,0,14,7,false,true,true,0.675,0.325
248,234,14,19.076923,18,14,1127,1176,-49,0,0,0,0,14,13,13,3,0,0,21,15,false,true,true,0.655,0.345
276,272,4,23,22.666667,4,1210,1252,-42,1,0,0.083333,0,13,12,12,2.461538,0,0,7,11,false,true,false,0.363,0.637
181,132,49,22.625,18.857143,49,804,988,-184,1,0,0.125,0,46,8,7,0.717391,0,0,12,19,false,true,true,0.881,0.119
195,125,70,24.375,17.857143,70,1036,1181,-145,0,0,0,0,56,8,7,0.607143,0,0,21,12,false,true,true,0.604,0.396
53,42,11,17.666667,14,11,527,514,13,0,0,0,0,82,3,3,0.47561,0,0,10,12,false,true,true,0.776,0.224
99,65,34,24.75,21.666667,34,907,752,155,0,0,0,0,79,4,3,0.417722,1,0,12,9,false,true,true,0.884,0.116
166,144,22,23.714286,24,22,1885,1846,39,1,1,0.142857,0.166667,42,7,6,0.690476,1,0,17,9,false,true,true,0.923,0.077
80,58,22,20,14.5,22,498,43,455,0,0,0,0,71,4,4,0.521127,1,0,8,12,false,true,true,0.779,0.221
211,234,-23,21.1,23.4,-23,771,754,17,0,0,0,0,30,10,10,1.066667,0,1,11,16,false,true,false,0.061,0.939
20,0,20,20,0,20,1090,1244,-154,0,0,0,0,96,1,0,0.385417,0,0,9,0,false,true,false,0.22,0.78
329,285,44,15.666667,14.25,44,826,771,55,0,0,0,0,-17,21,20,-2.647059,0,0,4,3,false,true,true,1,0
366,364,2,22.875,22.75,2,992,1100,-108,2,0,0.125,0,-13,16,16,-2.615385,0,0,1,1,false,true,true,0.998,0.002
109,63,46,21.8,15.75,46,1048,1000,48,0,0,0,0,70,5,4,0.571429,0,1,7,9,false,true,true,0.599,0.401
191,166,25,21.222222,20.75,25,1302,1082,220,0,0,0,0,28,9,8,1.071429,1,0,20,7,false,true,true,0.811,0.189
143,77,66,20.428571,12.833333,66,791,774,17,1,0,0.142857,0,64,7,6,0.640625,0,0,9,18,false,true,true,0.966,0.034
136,59,77,19.428571,9.833333,77,1067,95,972,0,0,0,0,63,7,6,0.539683,0,0,15,7,false,true,true,1,0
372,370,2,26.571429,26.428571,2,1419,1488,-69,1,1,0.071429,0.071429,-10,14,14,-2.8,1,0,3,2,true,true,true,0.845,0.155
8,0,8,8,0,8,539,632,-93,0,0,0,0,96,1,0,0.479167,0,0,11,0,false,true,false,0.221,0.779
171,133,38,17.1,13.3,38,1221,1438,-217,0,0,0,0,40,10,10,1.125,0,2,7,23,false,true,true,0.612,0.388
324,311,13,23.142857,22.214286,13,974,995,-21,0,1,0,0.071429,1,14,14,33,0,0,13,5,false,true,true,0.716,0.284
241,125,116,26.777778,13.888889,116,778,758,20,0,0,0,0,33,9,9,1.181818,2,0,7,9,false,true,true,0.999,0.001
225,62,163,18.75,5.636364,163,1176,1076,100,0,0,0,0,52,12,11,1.134615,0,1,12,15,false,true,true,1,0
128,118,10,21.333333,19.666667,10,1029,1227,-198,1,0,0.166667,0,51,6,6,0.627451,0,0,11,18,false,true,false,0.337,0.663
231,177,54,15.4,12.642857,54,698,742,-44,1,0,0.066667,0,19,15,14,2.157895,0,0,8,24,false,true,true,0.915,0.085
335,263,72,25.769231,20.230769,72,1550,1466,84,1,0,0.076923,0,8,13,13,4.625,0,0,10,10,false,true,true,1,0
407,351,56,23.941176,20.647059,56,1554,1573,-19,1,0,0.058824,0,-11,17,17,-3.090909,0,0,2,2,true,true,true,1,0
300,267,33,23.076923,22.25,33,1142,1176,-34,1,0,0.076923,0,15,13,12,2.4,1,0,16,15,false,true,true,0.682,0.318
322,288,34,16.947368,15.157895,34,719,614,105,0,1,0,0.052632,-24,19,19,-1.791667,0,0,7,7,false,true,true,0.988,0.012
381,270,111,23.8125,16.875,111,1110,1039,71,0,0,0,0,-14,16,16,-2.571429,1,0,5,6,false,true,true,1,0
185,95,90,30.833333,15.833333,90,986,856,130,1,0,0.166667,0,52,6,6,0.596154,1,0,6,19,false,true,true,0.991,0.009
244,209,35,27.111111,23.222222,35,416,282,134,1,0,0.111111,0,36,9,9,0.944444,1,0,6,10,false,true,true,0.938,0.062
169,76,93,24.142857,12.666667,93,719,651,68,0,0,0,0,66,7,6,0.681818,0,0,19,9,false,true,true,0.957,0.043
40,49,-9,13.333333,16.333333,-9,1037,950,87,0,0,0,0,79,3,3,0.392405,1,0,8,17,false,true,true,0.637,0.363
344,270,74,20.235294,15.882353,74,620,658,-38,0,0,0,0,-16,17,17,-2.25,0,0,7,2,false,true,true,1,0
112,81,31,28,20.25,31,880,952,-72,0,0,0,0,69,4,4,0.507246,1,0,28,13,false,true,true,0.726,0.274
71,81,-10,11.833333,13.5,-10,218,86,132,0,0,0,0,59,6,6,0.677966,0,0,20,10,false,true,true,0.658,0.342
162,127,35,40.5,31.75,35,1633,1580,53,1,0,0.25,0,66,4,4,0.424242,0,0,14,16,false,true,true,0.587,0.413
97,46,51,19.4,11.5,51,939,913,26,0,0,0,0,75,5,4,0.533333,0,0,18,7,false,true,true,0.849,0.151
450,314,136,22.5,16.526316,136,1167,1216,-49,1,0,0.05,0,-13,20,19,-3.153846,0,0,1,2,false,true,true,1,0
300,309,-9,21.428571,22.071429,-9,1431,802,629,0,0,0,0,-8,14,14,-4,0,0,4,4,false,true,true,1,0
28,12,16,14,12,16,1265,1045,220,0,0,0,0,86,2,1,0.488372,0,1,22,18,false,true,false,0.469,0.531
175,134,41,21.875,16.75,41,885,719,166,0,0,0,0,49,8,8,0.77551,0,1,12,9,false,true,true,0.934,0.066
127,154,-27,14.111111,17.111111,-27,450,412,38,0,0,0,0,36,9,9,1.055556,0,0,11,12,false,true,true,0.509,0.491
256,139,117,19.692308,11.583333,117,1176,1076,100,0,0,0,0,44,13,12,1.340909,0,0,8,11,false,true,true,0.995,0.005
224,169,55,18.666667,14.083333,55,1181,1069,112,0,0,0,0,21,12,12,1.761905,1,0,9,11,false,true,true,0.987,0.013
362,331,31,15.73913,15.045455,31,1388,1477,-89,1,0,0.043478,0,-33,23,22,-1.454545,0,0,1,4,false,true,true,0.998,0.002
339,289,50,21.1875,19.266667,50,892,819,73,0,1,0,0.066667,-9,16,15,-3.777778,0,0,4,4,false,true,true,0.989,0.011
189,160,29,23.625,20,29,1210,1253,-43,0,1,0,0.125,38,8,8,0.921053,0,0,9,14,false,true,true,0.889,0.111
180,226,-46,12.857143,17.384615,-46,1075,989,86,0,0,0,0,24,14,13,1.625,1,0,19,20,false,true,false,0.26,0.74
87,19,68,43.5,19,68,795,830,-35,1,0,0.5,0,84,2,1,0.5,1,0,9,13,false,true,true,0.926,0.074
316,313,3,18.588235,18.411765,3,1782,1512,270,1,1,0.058824,0.058824,-14,17,17,-3,0,0,5,7,false,true,true,1,0
182,136,46,18.2,15.111111,46,786,788,-2,0,0,0,0,26,10,9,1.307692,1,0,11,15,false,true,true,0.971,0.029
321,295,26,20.0625,18.4375,26,448,598,-150,0,0,0,0,-13,16,16,-2.769231,0,0,6,8,false,true,true,0.941,0.059
132,106,26,18.857143,17.666667,26,468,542,-74,0,0,0,0,59,7,6,0.661017,0,0,18,20,false,true,true,0.696,0.304
314,267,47,22.428571,20.538462,47,1089,1063,26,1,0,0.071429,0,9,14,13,4.222222,0,0,12,12,false,true,true,0.91,0.09
20,14,6,20,14,6,1439,1353,86,0,0,0,0,92,1,1,0.326087,1,0,8,7,false,true,true,0.722,0.278
173,177,-4,21.625,25.285714,-4,771,754,17,0,0,0,0,44,8,7,0.727273,0,0,10,19,false,true,false,0.419,0.581
70,49,21,35,24.5,21,1388,1506,-118,1,0,0.5,0,84,2,2,0.404762,0,0,7,18,false,true,true,0.574,0.426
257,223,34,17.133333,15.928571,34,695,523,172,0,0,0,0,-5,15,14,-7.4,0,0,15,20,false,true,true,0.89,0.11
257,244,13,18.357143,18.769231,13,1078,1130,-52,0,1,0,0.076923,9,14,13,4.333333,0,0,15,29,false,true,true,0.649,0.351
16,0,16,16,0,16,960,1070,-110,0,0,0,0,96,1,0,0.364583,0,0,12,0,false,true,false,0.307,0.693
229,207,22,22.9,23,22,1047,1094,-47,1,1,0.1,0.111111,33,10,9,1.090909,0,0,21,8,false,true,true,0.881,0.119
458,247,211,28.625,15.4375,211,820,783,37,1,1,0.0625,0.0625,-19,16,16,-1.736842,0,0,3,1,false,true,true,1,0
351,313,38,25.071429,22.357143,38,630,786,-156,1,0,0.071429,0,4,14,14,8.75,0,0,10,6,false,true,true,0.983,0.017
138,102,36,27.6,25.5,36,1793,1897,-104,1,0,0.2,0,69,5,4,0.434783,0,0,10,17,false,true,true,0.524,0.476
228,342,-114,22.8,34.2,-114,1897,1793,104,1,3,0.1,0.3,37,10,10,0.864865,0,0,15,14,false,true,false,0.32,0.68
172,102,70,19.111111,12.75,70,303,342,-39,0,0,0,0,46,9,8,0.826087,1,0,17,14,false,true,true,0.976,0.024
448,333,115,32,25.615385,115,1489,1405,84,3,0,0.214286,0,-8,14,13,-3.5,0,0,5,2,false,true,true,1,0
130,115,15,16.25,16.428571,15,721,689,32,0,0,0,0,39,8,7,0.871795,0,0,22,12,false,true,true,0.659,0.341
0,0,0,0,0,0,1880,1777,103,0,0,0,0,100,1,0,0.28,0,0,11,0,false,true,true,0.954,0.046
425,226,199,30.357143,16.142857,199,918,619,299,2,0,0.142857,0,0,14,14,0,0,0,14,9,false,true,true,1,0
12,0,12,12,0,12,1370,1431,-61,0,0,0,0,97,1,0,0.237113,1,0,17,0,false,true,true,0.732,0.268
194,127,67,38.8,31.75,67,1633,1580,53,2,0,0.4,0,59,5,4,0.474576,0,0,17,16,false,true,true,0.876,0.124
264,233,31,22,19.416667,31,820,822,-2,0,0,0,0,16,12,12,2.4375,0,0,23,8,false,true,true,0.942,0.058
358,205,153,29.833333,18.636364,153,1439,1353,86,1,0,0.083333,0,14,12,11,2.142857,0,0,11,22,false,true,true,1,0
113,164,-51,18.833333,32.8,-51,1076,1176,-100,0,1,0,0.2,55,6,5,0.581818,0,1,18,6,false,true,false,0.266,0.734
145,154,-9,16.111111,19.25,-9,721,689,32,0,0,0,0,31,9,8,1.096774,0,0,21,12,false,true,false,0.484,0.516
130,154,-24,16.25,19.25,-24,721,689,32,0,0,0,0,33,8,8,1.030303,0,0,22,12,false,true,false,0.486,0.514
212,227,-15,26.5,28.375,-15,1554,1716,-162,1,1,0.125,0.125,36,8,8,0.972222,0,0,16,8,false,true,true,0.556,0.444
321,286,35,20.0625,19.066667,35,448,598,-150,0,0,0,0,-11,16,15,-3.272727,0,0,6,9,false,true,true,0.902,0.098
24,20,4,24,20,4,976,965,11,0,0,0,0,89,1,1,0.359551,0,0,8,26,false,true,true,0.54,0.46
288,285,3,22.153846,21.923077,3,795,830,-35,1,1,0.076923,0.076923,8,13,13,5.25,0,0,14,12,false,true,true,0.861,0.139
380,362,18,25.333333,24.133333,18,1030,1144,-114,0,2,0,0.133333,-6,15,15,-5.833333,1,0,13,4,false,true,true,0.973,0.027
270,234,36,24.545455,23.4,36,1710,1636,74,1,1,0.090909,0.1,25,11,10,1.44,1,0,15,17,false,true,true,0.917,0.083
151,92,59,21.571429,13.142857,59,1033,1037,-4,0,1,0,0.142857,55,7,7,0.818182,0,0,11,12,false,true,true,0.984,0.016
300,308,-8,23.076923,23.692308,-8,1142,1176,-34,1,0,0.076923,0,9,13,13,4,1,0,16,10,false,true,false,0.468,0.532
30,0,30,30,0,30,1266,1144,122,0,0,0,0,94,1,0,0.361702,0,0,12,0,false,true,true,0.621,0.379
162,148,14,27,29.6,14,974,995,-21,0,1,0,0.2,57,6,5,0.578947,0,0,15,10,false,true,true,0.637,0.363
280,240,40,20,17.142857,40,1159,1031,128,1,0,0.071429,0,-2,14,14,-19.5,0,0,9,7,false,true,true,0.986,0.014
307,194,113,30.7,19.4,113,1101,1078,23,1,0,0.1,0,28,10,10,1.178571,0,1,10,10,false,true,true,0.999,0.001
260,220,40,32.5,27.5,40,1454,1531,-77,1,1,0.125,0.125,30,8,8,1,0,0,16,7,false,true,true,0.897,0.103
376,298,78,25.066667,19.866667,78,1156,1114,42,1,0,0.066667,0,-16,15,15,-2,0,0,3,3,false,true,true,1,0
273,226,47,17.0625,14.125,47,786,788,-2,0,0,0,0,-16,16,16,-2.125,1,0,2,14,false,true,true,0.995,0.005
143,188,-45,20.428571,31.333333,-45,1501,1473,28,0,0,0,0,48,7,6,0.75,0,0,16,29,false,true,false,0.049,0.951
217,160,57,27.125,22.857143,57,695,671,24,0,0,0,0,41,8,7,0.804878,0,0,8,13,false,true,true,0.938,0.062
233,233,0,13.705882,13.705882,0,826,771,55,0,0,0,0,4,17,17,11.25,0,0,19,10,false,true,true,0.866,0.134
32,12,20,16,12,20,576,494,82,0,0,0,0,89,2,1,0.494382,0,0,7,28,false,true,true,0.686,0.314
34,35,-1,17,17.5,-1,1320,1339,-19,0,0,0,0,84,2,2,0.464286,0,0,7,12,false,true,false,0.453,0.547
300,198,102,21.428571,15.230769,102,939,913,26,0,1,0,0.076923,12,14,13,3.333333,0,0,10,19,false,true,true,0.996,0.004
324,287,37,19.058824,17.9375,37,1210,1253,-43,0,1,0,0.0625,-14,17,16,-2.5,0,0,3,3,false,true,true,0.986,0.014
176,113,63,22,16.142857,63,1691,1692,-1,0,0,0,0,43,8,7,0.697674,0,0,20,10,false,true,true,0.687,0.313
255,207,48,25.5,23,48,1519,1782,-263,1,0,0.1,0,32,10,9,1.03125,0,0,8,8,false,true,true,0.8,0.2
310,317,-7,22.142857,24.384615,-7,1320,1339,-19,2,1,0.142857,0.076923,9,14,13,4.333333,0,0,15,11,false,true,true,0.654,0.346
107,38,69,53.5,19,69,1270,1322,-52,1,0,0.5,0,83,2,2,0.457831,0,0,7,16,false,true,true,0.738,0.262
137,112,25,17.125,14,25,1606,1544,62,0,0,0,0,57,8,8,0.789474,1,0,13,7,false,true,true,0.708,0.292
137,46,91,34.25,15.333333,91,1513,1482,31,1,0,0.25,0,70,4,3,0.471429,0,0,8,23,false,true,true,0.938,0.062
0,0,0,0,0,0,1489,1558,-69,0,0,0,0,100,1,0,0.28,0,0,0,0,false,true,true,0.532,0.468
249,156,93,22.636364,14.181818,93,1397,1422,-25,2,0,0.181818,0,35,11,11,1.028571,0,2,16,16,false,true,true,0.845,0.155
173,116,57,28.833333,19.333333,57,971,1180,-209,1,0,0.166667,0,59,6,6,0.542373,0,0,16,14,false,true,true,0.808,0.192
249,166,83,19.153846,13.833333,83,871,867,4,0,0,0,0,20,13,12,2.15,0,1,12,16,false,true,true,0.986,0.014
260,162,98,20,12.461538,98,1586,1782,-196,0,0,0,0,15,13,13,2.666667,1,0,9,14,false,true,true,0.998,0.002
179,63,116,29.833333,12.6,116,942,1003,-61,0,0,0,0,59,6,5,0.762712,0,0,20,19,false,true,true,0.975,0.025
251,103,148,27.888889,12.875,148,1394,1118,276,0,0,0,0,40,9,8,0.925,0,1,11,6,false,true,true,0.984,0.016
342,166,176,28.5,13.833333,176,1211,1173,38,0,0,0,0,24,12,12,1.458333,0,2,10,7,false,true,true,1,0
383,243,140,19.15,12.15,140,872,818,54,0,1,0,0.05,-21,20,20,-1.952381,0,0,3,1,false,true,true,1,0
321,284,37,32.1,28.4,37,1762,1616,146,2,0,0.2,0,16,10,10,1.875,1,0,6,8,false,true,true,1,0
264,208,56,29.333333,23.111111,56,1762,1582,180,2,2,0.222222,0.222222,30,9,9,1.066667,0,0,10,20,false,true,true,0.989,0.011
367,301,66,22.9375,20.066667,66,1216,1228,-12,1,0,0.0625,0,-6,16,15,-5.5,0,0,7,1,false,true,true,1,0
6,4,2,6,4,2,450,412,38,0,0,0,0,93,1,1,0.408602,0,1,14,8,false,true,true,0.596,0.404
293,319,-26,22.538462,24.538462,-26,809,868,-59,1,1,0.076923,0.076923,5,13,13,6.4,1,0,9,12,false,true,false,0.311,0.689
287,165,122,28.7,16.5,122,1482,1394,88,2,0,0.2,0,31,10,10,1.16129,0,0,12,10,false,true,true,0.995,0.005
135,176,-41,19.285714,29.333333,-41,758,952,-194,0,0,0,0,46,7,6,0.869565,1,0,19,10,false,true,false,0.184,0.816
436,328,108,31.142857,25.230769,108,1803,1552,251,2,2,0.142857,0.153846,-8,14,13,-3.5,0,0,11,15,false,true,true,1,0
79,49,30,19.75,16.333333,30,1266,1144,122,0,0,0,0,71,4,3,0.478873,1,1,6,9,false,true,true,0.57,0.43
409,318,91,22.722222,18.705882,91,995,912,83,2,0,0.111111,0,-10,18,17,-4.4,0,0,3,14,false,true,true,1,0
180,153,27,22.5,21.857143,27,809,868,-59,1,0,0.125,0,43,8,7,0.744186,0,0,8,20,false,true,false,0.354,0.646
230,103,127,28.75,14.714286,127,1144,1014,130,0,0,0,0,47,8,7,0.765957,0,1,17,9,false,true,true,0.952,0.048
163,154,9,20.375,22,9,995,912,83,1,0,0.125,0,55,8,7,0.8,1,0,11,10,false,true,true,0.595,0.405
222,181,41,22.2,20.111111,41,1210,1253,-43,0,1,0,0.111111,29,10,9,1.206897,0,0,7,11,false,true,true,0.919,0.081
0,8,-8,0,8,-8,995,912,83,0,0,0,0,96,1,1,0.458333,0,0,14,10,false,true,false,0.388,0.612
226,114,112,37.666667,22.8,112,1684,1320,364,1,0,0.166667,0,50,6,5,0.6,0,1,8,6,false,true,true,0.992,0.008
344,209,135,21.5,13.0625,135,1413,1422,-9,0,0,0,0,4,16,16,14.25,0,0,9,17,false,true,true,1,0
28,23,5,28,23,5,594,605,-11,0,0,0,0,92,1,1,0.402174,0,0,10,12,false,true,true,0.638,0.362
129,83,46,21.5,16.6,46,704,691,13,0,0,0,0,61,6,5,0.622951,0,0,14,14,false,true,true,0.908,0.092
381,265,116,29.307692,22.083333,116,1334,1477,-143,2,1,0.153846,0.083333,-1,13,12,-30,0,0,10,9,false,true,true,1,0
97,94,3,19.4,23.5,3,869,820,49,0,1,0,0.25,71,5,4,0.521127,0,0,19,14,false,true,false,0.359,0.641
212,217,-5,16.307692,18.083333,-5,671,725,-54,0,0,0,0,14,13,12,2.642857,1,0,15,9,false,true,false,0.305,0.695
211,169,42,35.166667,33.8,42,1333,1331,2,1,0,0.166667,0,52,6,5,0.576923,0,0,9,11,false,true,true,0.571,0.429
13,12,1,6.5,12,1,1295,1477,-182,0,0,0,0,93,2,1,0.494624,0,0,7,9,false,true,false,0.147,0.853
87,71,16,21.75,23.666667,16,1023,1110,-87,0,0,0,0,70,4,3,0.428571,0,1,13,9,false,true,false,0.425,0.575
42,4,38,14,2,38,1033,1037,-4,0,0,0,0,81,3,2,0.555556,0,0,19,7,false,true,true,0.568,0.432
150,100,50,25,20,50,306,169,137,0,0,0,0,58,6,5,0.586207,0,1,11,15,false,true,true,0.944,0.056
320,309,11,15.238095,14.714286,11,500,567,-67,0,0,0,0,-18,21,21,-2.444444,0,0,2,11,false,true,true,0.999,0.001
172,157,15,15.636364,14.272727,15,913,871,42,0,0,0,0,31,11,11,1.387097,0,0,23,18,false,true,true,0.836,0.164
22,11,11,11,11,11,856,897,-41,0,0,0,0,87,2,1,0.402299,1,0,14,10,false,true,true,0.585,0.415
88,46,42,14.666667,7.666667,42,1016,1037,-21,0,0,0,0,65,6,6,0.738462,0,1,9,14,false,true,true,0.842,0.158
227,78,149,45.4,15.6,149,1513,1482,31,1,0,0.2,0,55,5,5,0.6,0,0,19,19,false,true,true,0.999,0.001
214,183,31,19.454545,16.636364,31,1221,1258,-37,1,0,0.090909,0,31,11,11,1.258065,0,0,23,9,false,true,true,0.908,0.092
40,19,21,20,19,21,1659,1782,-123,0,0,0,0,89,2,1,0.325843,0,0,10,16,false,true,false,0.431,0.569
317,283,34,22.642857,20.214286,34,1075,1152,-77,0,1,0,0.071429,5,14,14,8,0,0,14,11,false,true,true,0.885,0.115
195,142,53,21.666667,17.75,53,971,906,65,0,0,0,0,34,9,8,0.941176,0,0,7,18,false,true,true,0.868,0.132
257,261,-4,14.277778,15.352941,-4,540,518,22,0,0,0,0,-13,18,17,-3.076923,0,0,5,9,false,true,true,0.501,0.499
322,252,70,20.125,15.75,70,695,523,172,0,0,0,0,-14,16,16,-2.642857,0,0,5,7,false,true,true,1,0
335,392,-57,27.916667,32.666667,-57,1897,1793,104,2,3,0.166667,0.25,19,12,12,1.684211,0,0,17,15,false,true,false,0.266,0.734
206,163,43,22.888889,18.111111,43,825,907,-82,1,0,0.111111,0,36,9,9,1.111111,0,0,17,9,false,true,true,0.811,0.189
128,99,29,14.222222,11,29,1016,1037,-21,0,0,0,0,48,9,9,1,0,0,7,24,false,true,true,0.921,0.079
354,336,18,19.666667,18.666667,18,847,952,-105,0,0,0,0,-12,18,18,-3,0,1,2,2,true,true,true,1,0
426,247,179,17.04,10.291667,179,1176,1076,100,0,0,0,0,-17,25,24,-3.470588,0,0,6,16,false,true,true,1,0
294,278,16,22.615385,21.384615,16,1100,1008,92,1,0,0.076923,0,10,13,13,3.6,0,0,9,9,false,true,true,0.639,0.361
299,269,30,14.238095,13.45,30,613,502,111,0,0,0,0,-26,21,20,-1.884615,0,0,5,15,false,true,true,0.999,0.001
130,151,-21,16.25,18.875,-21,671,725,-54,0,0,0,0,41,8,8,0.902439,1,0,10,10,false,true,false,0.451,0.549
350,220,130,17.5,11.578947,130,871,867,4,0,0,0,0,-18,20,19,-2.388889,0,0,6,9,false,true,true,1,0
237,197,40,21.545455,17.909091,40,1513,1479,34,0,0,0,0,23,11,11,1.478261,1,0,10,16,false,true,true,0.944,0.056
204,147,57,22.666667,16.333333,57,1115,1078,37,0,0,0,0,39,9,9,0.871795,1,0,13,9,false,true,true,0.982,0.018
8,11,-3,8,11,-3,1281,1339,-58,0,0,0,0,93,1,1,0.44086,0,0,16,11,false,true,true,0.527,0.473
80,126,-46,11.428571,18,-46,450,412,38,0,0,0,0,49,7,7,0.77551,1,0,21,12,false,true,true,0.564,0.436
327,308,19,18.166667,18.117647,19,1295,1281,14,0,0,0,0,-1,18,17,-38,0,0,15,5,false,true,true,0.831,0.169
408,269,139,20.4,13.45,139,777,830,-53,1,0,0.05,0,-27,20,20,-1.518519,0,0,4,2,false,true,true,1,0
122,90,32,24.4,18,32,1115,1078,37,0,0,0,0,62,5,5,0.548387,0,0,17,11,false,true,true,0.7,0.3
364,314,50,15.826087,13.652174,50,725,771,-46,0,1,0,0.043478,-35,23,23,-1.314286,0,0,1,1,true,true,true,1,0
14,32,-18,14,32,-18,1040,925,115,0,0,0,0,93,1,1,0.462366,0,0,16,8,false,true,false,0.278,0.722
66,64,2,16.5,16,2,913,871,42,0,0,0,0,68,4,4,0.632353,0,0,11,12,false,true,true,0.599,0.401
264,143,121,26.4,15.888889,121,1144,1014,130,0,0,0,0,34,10,9,1.058824,0,1,14,9,false,true,true,0.971,0.029
164,101,63,23.428571,16.833333,63,859,811,48,0,0,0,0,54,7,6,0.666667,0,1,8,7,false,true,true,0.909,0.091
160,147,13,22.857143,21,13,1334,1270,64,1,0,0.142857,0,52,7,7,0.711538,0,0,20,9,false,true,true,0.569,0.431
103,104,-1,25.75,26,-1,1431,802,629,0,0,0,0,66,4,4,0.484848,0,0,9,12,false,true,true,1,0
242,181,61,26.888889,22.625,61,1210,1253,-43,0,1,0,0.125,31,9,8,1.096774,0,0,10,16,false,true,true,0.926,0.074
22,44,-22,7.333333,14.666667,-22,1100,1008,92,0,0,0,0,84,3,3,0.428571,0,0,18,9,false,true,false,0.284,0.716
294,214,80,17.294118,13.375,80,539,632,-93,0,0,0,0,5,17,16,9.2,0,0,10,9,false,true,true,0.999,0.001
300,319,-19,25,29,-19,1030,1144,-114,0,2,0,0.181818,19,12,11,1.842105,0,0,17,7,false,true,true,0.638,0.362
229,172,57,25.444444,19.111111,57,1051,1030,21,0,0,0,0,31,9,9,0.967742,0,0,9,7,false,true,true,0.949,0.051
391,258,133,19.55,13.578947,133,1413,1422,-9,0,0,0,0,-14,20,19,-4.071429,0,0,7,7,false,true,true,1,0
409,287,122,29.214286,20.5,122,1826,1803,23,1,0,0.071429,0,-6,14,14,-5,1,0,2,2,false,true,true,1,0
255,166,89,31.875,23.714286,89,1334,1477,-143,0,1,0,0.142857,42,8,7,0.714286,0,0,9,9,false,true,true,0.963,0.037
277,197,80,25.181818,19.7,80,758,796,-38,0,0,0,0,22,11,10,1.727273,0,1,7,15,false,true,true,0.907,0.093
101,99,2,25.25,24.75,2,518,448,70,0,0,0,0,73,4,4,0.465753,0,0,7,12,false,true,true,0.763,0.237
350,305,45,23.333333,20.333333,45,1397,1422,-25,3,1,0.2,0.066667,8,15,15,4.5,0,0,8,23,false,true,true,0.944,0.056
202,92,110,28.857143,13.142857,110,1295,1477,-182,2,0,0.285714,0,52,7,7,0.884615,0,0,22,8,false,true,true,0.947,0.053
144,133,11,20.571429,19,11,871,999,-128,0,0,0,0,49,7,7,0.979592,0,0,7,7,false,true,false,0.261,0.739
82,68,14,16.4,17,14,864,808,56,1,0,0.2,0,61,5,4,0.557377,0,0,9,11,false,true,true,0.694,0.306
283,256,27,18.866667,18.285714,27,942,976,-34,0,0,0,0,2,15,14,20,0,0,9,10,false,true,true,0.816,0.184
397,277,120,20.894737,15.388889,120,778,758,20,0,1,0,0.055556,-24,19,18,-1.625,0,0,1,1,false,true,true,1,0
350,257,93,20.588235,16.0625,93,971,658,313,0,0,0,0,-15,17,16,-2.4,0,0,1,4,false,true,true,1,0
216,182,34,21.6,18.2,34,844,821,23,0,0,0,0,45,10,10,0.933333,1,0,18,7,false,true,true,0.947,0.053
129,127,2,16.125,18.142857,2,1043,1055,-12,0,0,0,0,49,8,7,0.755102,1,0,22,7,false,true,true,0.609,0.391
52,24,28,17.333333,12,28,540,518,22,0,0,0,0,86,3,2,0.465116,0,1,14,7,false,true,true,0.604,0.396
376,244,132,18.8,12.842105,132,620,513,107,0,0,0,0,-16,20,19,-2.8125,0,0,2,4,false,true,true,1,0
213,196,17,17.75,17.818182,17,1388,1477,-89,1,0,0.083333,0,27,12,11,1.777778,0,0,12,12,false,true,false,0.271,0.729
257,261,-4,21.416667,21.75,-4,926,854,72,0,0,0,0,19,12,12,1.789474,0,0,7,12,false,true,false,0.447,0.553
134,54,80,22.333333,10.8,80,1413,1422,-9,0,0,0,0,61,6,5,0.934426,2,0,16,16,false,true,true,0.985,0.015
324,325,-1,21.6,23.214286,-1,1266,1144,122,0,0,0,0,-4,15,14,-8.5,1,0,7,16,false,true,true,0.982,0.018
317,212,105,35.222222,23.555556,105,1489,1405,84,2,0,0.222222,0,30,9,9,0.933333,0,0,10,17,false,true,true,1,0
318,286,32,21.2,20.428571,32,758,796,-38,0,0,0,0,-1,15,14,-38,0,0,4,10,false,true,true,0.759,0.241
217,171,46,27.125,21.375,46,695,671,24,0,0,0,0,38,8,8,0.868421,0,0,8,11,false,true,true,0.946,0.054
294,275,19,16.333333,15.277778,19,95,360,-265,0,1,0,0.055556,-20,18,18,-2,0,0,6,3,false,true,true,0.964,0.036
250,236,14,15.625,15.733333,14,361,493,-132,1,0,0.0625,0,-14,16,15,-2.928571,0,0,7,20,false,true,true,0.837,0.163
46,0,46,46,0,46,1348,1331,17,0,0,0,0,95,1,0,0.252632,0,0,16,0,false,true,true,0.735,0.265
334,255,79,19.647059,15,79,746,796,-50,0,1,0,0.058824,-5,17,17,-9.6,0,0,14,8,false,true,true,1,0
294,265,29,21,18.928571,29,1295,1281,14,0,0,0,0,15,14,14,2.533333,0,1,7,8,false,true,true,0.712,0.288
367,378,-11,30.583333,34.363636,-11,2219,2029,190,0,0,0,0,-7,12,11,-3.714286,0,0,2,15,false,true,true,0.998,0.002
363,294,69,24.2,19.6,69,1302,1234,68,1,1,0.066667,0.066667,-11,15,15,-2.818182,0,0,4,2,false,true,true,0.995,0.005
310,316,-6,20.666667,21.066667,-6,1431,802,629,0,0,0,0,-13,15,15,-2.461538,0,0,2,3,false,true,true,1,0
137,123,14,17.125,15.375,14,947,909,38,0,0,0,0,45,8,8,1.022222,1,0,12,35,false,true,true,0.673,0.327
144,108,36,20.571429,18,36,613,461,152,0,0,0,0,51,7,6,0.72549,0,0,11,11,false,true,true,0.779,0.221
261,351,-90,23.727273,31.909091,-90,834,844,-10,1,2,0.090909,0.181818,10,11,11,3.6,0,0,12,17,false,true,false,0,1
153,134,19,21.857143,19.142857,19,1547,1439,108,1,0,0.142857,0,54,7,7,0.685185,0,0,15,19,false,true,true,0.523,0.477
306,270,36,15.3,13.5,36,272,238,34,0,1,0,0.05,-31,20,20,-1.290323,0,0,7,1,true,true,true,0.999,0.001
81,41,40,27,20.5,40,904,668,236,0,0,0,0,80,3,2,0.425,0,0,24,16,false,true,true,0.878,0.122
416,322,94,37.818182,29.272727,94,1983,2020,-37,2,1,0.181818,0.090909,10,11,11,2.6,0,0,8,22,false,true,true,1,0
222,191,31,20.181818,19.1,31,971,906,65,0,0,0,0,20,11,10,1.6,0,0,9,18,false,true,true,0.57,0.43
316,208,108,15.8,10.4,108,1128,889,239,0,1,0,0.05,-15,20,20,-3.133333,0,1,10,14,false,true,true,1,0
138,197,-59,17.25,24.625,-59,1181,1149,32,0,1,0,0.125,50,8,8,0.9,0,0,10,22,false,true,false,0.136,0.864
103,96,7,17.166667,16,7,1606,1544,62,0,0,0,0,69,6,6,0.652174,1,0,14,10,false,true,true,0.514,0.486
195,207,-12,15,15.923077,-12,450,412,38,0,0,0,0,10,13,13,3.8,0,0,11,8,false,true,true,0.676,0.324
307,259,48,16.157895,13.631579,48,416,306,110,0,0,0,0,-17,19,19,-2.470588,1,0,4,3,false,true,true,0.994,0.006
228,147,81,20.727273,14.7,81,739,480,259,1,0,0.090909,0,30,11,10,1.2,0,1,13,7,false,true,true,0.951,0.049
140,62,78,23.333333,10.333333,78,993,897,96,1,0,0.166667,0,53,6,6,0.886792,0,0,9,18,false,true,true,0.991,0.009
47,90,-43,11.75,22.5,-43,691,675,16,0,0,0,0,71,4,4,0.535211,1,0,17,7,false,true,false,0.423,0.577
66,27,39,22,13.5,39,691,675,16,0,0,0,0,83,3,2,0.445783,1,1,18,8,false,true,true,0.635,0.365
47,28,19,23.5,14,19,1394,1118,276,0,0,0,0,82,2,2,0.45122,0,0,10,12,false,true,true,0.715,0.285
87,110,-23,21.75,27.5,-23,1762,1582,180,0,1,0,0.25,71,4,4,0.450704,1,0,9,12,false,true,true,0.775,0.225
397,298,99,26.466667,21.285714,99,1004,840,164,1,0,0.066667,0,-15,15,14,-2,0,0,3,3,false,true,true,1,0
273,164,109,45.5,27.333333,109,1824,1793,31,1,0,0.166667,0,49,6,6,0.571429,1,0,6,14,false,true,true,1,0
29,65,-36,9.666667,21.666667,-36,1554,1622,-68,1,0,0.333333,0,76,3,3,0.407895,0,1,13,13,false,true,true,0.504,0.496
395,377,18,32.916667,31.416667,18,1633,1580,53,3,1,0.25,0.083333,-1,12,12,-28,0,0,9,10,false,true,true,1,0
581,360,221,38.733333,24,221,991,996,-5,3,0,0.2,0,-14,15,15,-2.142857,0,0,6,7,true,true,true,1,0
100,108,-8,20,27,-8,1710,1636,74,0,0,0,0,69,5,4,0.521739,0,0,12,8,false,true,false,0.275,0.725
331,311,20,19.470588,18.294118,20,1115,1078,37,0,1,0,0.058824,-12,17,17,-2.833333,1,0,3,5,true,true,true,0.988,0.012
129,24,105,64.5,24,105,1397,1361,36,1,0,0.5,0,85,2,1,0.341176,0,0,8,10,false,true,true,0.657,0.343
14,8,6,14,8,6,1027,856,171,0,0,0,0,93,1,1,0.354839,0,0,9,7,false,true,true,0.773,0.227
262,218,44,52.4,54.5,44,1370,1431,-61,2,1,0.4,0.25,48,5,4,0.479167,0,0,13,15,false,true,true,1,0
175,125,50,35,31.25,50,1770,1689,81,0,0,0,0,58,5,4,0.448276,0,1,10,11,false,true,true,0.531,0.469
160,114,46,32,22.8,46,1093,1197,-104,1,0,0.2,0,61,5,5,0.508197,0,0,14,11,false,true,false,0.497,0.503
352,252,100,19.555556,14,100,1181,1069,112,0,0,0,0,-23,18,18,-1.608696,0,0,2,3,false,true,true,1,0
209,153,56,19,15.3,56,954,1078,-124,0,1,0,0.1,29,11,10,1.310345,1,0,15,15,false,true,true,0.987,0.013
187,91,96,37.4,18.2,96,1510,1583,-73,1,0,0.2,0,55,5,5,0.581818,0,1,17,15,false,true,true,0.871,0.129
67,29,38,16.75,9.666667,38,346,231,115,0,0,0,0,74,4,3,0.554054,0,1,11,9,false,true,true,0.834,0.166
132,158,-26,22,26.333333,-26,1102,1245,-143,0,0,0,0,44,6,6,0.636364,0,0,9,11,false,true,false,0.148,0.852
114,85,29,16.285714,12.142857,29,954,1078,-124,0,1,0,0.142857,49,7,7,0.77551,1,0,17,12,false,true,true,0.982,0.018
324,295,29,18,17.352941,29,1210,1253,-43,0,1,0,0.058824,-17,18,17,-2.058824,0,0,3,3,true,true,true,0.995,0.005
371,329,42,19.526316,17.315789,42,1244,1361,-117,2,1,0.105263,0.052632,-10,19,19,-3.8,0,0,2,5,true,true,true,0.965,0.035
252,170,82,28,18.888889,82,769,527,242,1,0,0.111111,0,27,9,9,1.333333,0,0,13,12,false,true,true,0.995,0.005
191,188,3,17.363636,17.090909,3,1127,1176,-49,0,0,0,0,29,11,11,1.448276,0,1,13,8,false,true,false,0.362,0.638
328,320,8,19.294118,18.823529,8,561,526,35,0,0,0,0,-27,17,17,-1.296296,0,0,3,9,false,true,true,0.953,0.047
168,192,-24,15.272727,17.454545,-24,719,614,105,0,1,0,0.090909,25,11,11,1.72,0,0,20,12,false,true,true,0.745,0.255
434,245,189,24.111111,13.611111,189,1482,1554,-72,1,0,0.055556,0,-22,18,18,-1.636364,0,1,3,2,true,true,true,1,0
65,71,-6,21.666667,23.666667,-6,1023,1110,-87,0,0,0,0,73,3,3,0.410959,0,1,8,9,false,true,false,0.432,0.568
300,239,61,25,19.916667,61,1305,1218,87,1,0,0.083333,0,10,12,12,3.8,0,0,17,11,false,true,true,0.987,0.013
172,116,56,17.2,12.888889,56,1069,1040,29,0,0,0,0,34,10,9,1.294118,0,2,14,5,false,true,true,0.872,0.128
375,303,72,22.058824,18.9375,72,1109,1065,44,0,0,0,0,-28,17,16,-1.178571,0,0,1,1,true,true,true,1,0
339,254,85,24.214286,18.142857,85,769,527,242,1,0,0.071429,0,-5,14,14,-7.2,0,0,18,12,false,true,true,1,0
108,104,4,13.5,13,4,218,86,132,0,0,0,0,44,8,8,0.909091,0,0,19,12,false,true,true,0.826,0.174
389,347,42,24.3125,21.6875,42,1093,1090,3,1,2,0.0625,0.125,-6,16,16,-5.666667,0,0,3,4,false,true,true,0.988,0.012
103,119,-16,17.166667,23.8,-16,965,1013,-48,0,0,0,0,56,6,5,0.589286,1,1,8,13,false,true,false,0.241,0.759
246,223,23,24.6,24.777778,23,974,995,-21,0,1,0,0.111111,30,10,9,1.1,0,0,17,10,false,true,true,0.797,0.203
22,0,22,22,0,22,808,812,-4,0,0,0,0,95,1,0,0.389474,0,0,10,0,false,true,true,0.565,0.435
346,246,100,21.625,16.4,100,859,811,48,0,0,0,0,-6,16,15,-6,0,1,7,11,false,true,true,1,0
137,85,52,22.833333,17,52,1127,1075,52,1,0,0.166667,0,60,6,5,0.516667,0,0,17,22,false,true,true,0.785,0.215
293,286,7,19.533333,20.428571,7,758,952,-194,0,0,0,0,-6,15,14,-6.666667,0,0,7,7,false,true,false,0.161,0.839
324,260,64,24.923077,21.666667,64,1127,1075,52,1,1,0.076923,0.083333,7,13,12,4.428571,0,1,15,6,false,true,true,0.876,0.124
307,267,40,17.055556,14.833333,40,609,620,-11,0,0,0,0,-21,18,18,-1.761905,0,1,2,2,false,true,true,1,0
223,223,0,18.583333,20.272727,0,942,976,-34,0,0,0,0,18,12,11,2.222222,0,0,11,7,false,true,false,0.278,0.722
101,79,22,20.2,19.75,22,784,758,26,0,0,0,0,65,5,4,0.538462,0,0,7,19,false,true,true,0.643,0.357
70,70,0,17.5,17.5,0,628,658,-30,0,0,0,0,71,4,4,0.647887,0,0,27,13,false,true,true,0.598,0.402
271,253,18,16.9375,16.866667,18,334,446,-112,0,0,0,0,-7,16,15,-5.714286,1,1,9,11,false,true,true,0.627,0.373
18,0,18,18,0,18,1482,1554,-72,0,0,0,0,97,1,0,0.371134,1,0,9,0,false,true,true,0.705,0.295
368,291,77,18.4,15.315789,77,939,913,26,0,1,0,0.052632,-26,20,19,-1.538462,1,0,0,1,false,true,true,1,0
131,128,3,18.714286,21.333333,3,995,912,83,1,0,0.142857,0,62,7,6,0.709677,1,0,16,18,false,true,true,0.562,0.438
121,100,21,24.2,20,21,1127,1176,-49,0,0,0,0,61,5,5,0.688525,0,0,11,16,false,true,true,0.564,0.436
284,243,41,25.818182,24.3,41,1762,1582,180,2,2,0.181818,0.2,19,11,10,1.684211,0,0,7,18,false,true,true,0.988,0.012
96,62,34,19.2,15.5,34,1164,1201,-37,0,0,0,0,69,5,4,0.608696,0,1,13,10,false,true,true,0.563,0.437
356,191,165,23.733333,12.733333,165,1033,1037,-4,0,1,0,0.066667,3,15,15,15,0,1,14,12,false,true,true,1,0
352,270,82,19.555556,15.882353,82,580,620,-40,1,0,0.055556,0,-14,18,17,-3.071429,0,0,9,20,false,true,true,1,0
392,313,79,21.777778,17.388889,79,1075,1152,-77,0,1,0,0.055556,-16,18,18,-2.5,0,0,11,6,false,true,true,1,0
387,215,172,29.769231,17.916667,172,986,856,130,1,0,0.076923,0,-4,13,12,-7.75,0,0,11,14,false,true,true,1,0
88,102,-14,14.666667,17,-14,540,518,22,0,0,0,0,61,6,6,0.655738,0,0,10,13,false,true,true,0.529,0.471
175,109,66,29.166667,18.166667,66,1439,1294,145,1,0,0.166667,0,56,6,6,0.642857,0,0,8,17,false,true,true,0.933,0.067
239,184,55,26.555556,23,55,1394,1424,-30,0,1,0,0.125,40,9,8,0.8,1,0,8,19,false,true,true,0.941,0.059
222,209,13,18.5,19,13,1572,1550,22,1,0,0.083333,0,26,12,11,1.5,1,1,15,9,false,true,false,0.299,0.701
148,109,39,24.666667,21.8,39,1302,1082,220,0,0,0,0,50,6,5,0.6,0,0,17,12,false,true,true,0.658,0.342
307,261,46,15.35,13.05,46,1016,1037,-21,0,0,0,0,-9,20,20,-5.333333,0,0,7,15,false,true,true,1,0
272,190,82,27.2,21.111111,82,1388,1506,-118,2,1,0.2,0.111111,33,10,9,1.030303,0,0,7,27,false,true,true,0.947,0.053
141,94,47,35.25,23.5,47,795,830,-35,1,1,0.25,0.25,60,4,4,0.7,2,0,5,11,false,true,true,0.963,0.037
69,31,38,23,15.5,38,415,518,-103,0,0,0,0,80,3,2,0.475,0,0,14,19,false,true,true,0.542,0.458
276,212,64,21.230769,16.307692,64,1170,1156,14,1,0,0.076923,0,10,13,13,3.8,0,0,11,10,false,true,true,0.988,0.012
165,69,96,33,17.25,96,1334,1256,78,1,0,0.2,0,68,5,4,0.455882,0,0,13,9,false,true,true,0.968,0.032
73,67,6,18.25,16.75,6,1266,1247,19,0,0,0,0,71,4,4,0.450704,0,0,11,7,false,true,false,0.499,0.501
296,269,27,18.5,17.933333,27,1214,1176,38,0,0,0,0,6,16,15,6,0,0,13,10,false,true,true,0.815,0.185
170,118,52,24.285714,19.666667,52,1029,1227,-198,1,0,0.142857,0,46,7,6,0.695652,0,0,21,18,false,true,true,0.735,0.265
95,72,23,15.833333,14.4,23,1047,1094,-47,0,0,0,0,63,6,5,0.571429,0,1,8,11,false,true,false,0.407,0.593
143,137,6,20.428571,22.833333,6,1302,1234,68,0,0,0,0,52,7,6,0.596154,1,0,11,8,false,true,false,0.481,0.519
186,184,2,16.909091,18.4,2,361,493,-132,1,0,0.090909,0,21,11,10,1.952381,0,0,14,20,false,true,true,0.51,0.49
216,124,92,21.6,12.4,92,421,306,115,0,1,0,0.1,23,10,10,1.913043,0,0,42,10,false,true,true,0.991,0.009
190,115,75,19,12.777778,75,954,1078,-124,0,1,0,0.111111,35,10,9,1.085714,1,0,12,21,false,true,true,0.987,0.013
37,70,-33,12.333333,23.333333,-33,1102,1245,-143,0,0,0,0,73,3,3,0.383562,0,0,8,8,false,true,false,0.142,0.858
29,44,-15,9.666667,22,-15,1554,1622,-68,1,0,0.333333,0,81,3,2,0.382716,0,0,13,15,false,true,true,0.724,0.276
358,242,116,21.058824,15.125,116,1227,1060,167,0,1,0,0.0625,-9,17,16,-4.444444,0,1,13,8,false,true,true,1,0
378,350,28,23.625,21.875,28,1014,948,66,1,0,0.0625,0,-13,16,16,-2.538462,0,0,6,1,false,true,true,1,0
27,14,13,13.5,14,13,1073,1177,-104,0,0,0,0,90,2,1,0.355556,0,1,11,25,false,true,false,0.125,0.875
149,69,80,24.833333,13.8,80,1270,1348,-78,0,0,0,0,65,6,5,0.584615,0,0,10,16,false,true,true,0.902,0.098
287,272,15,22.076923,22.666667,15,1210,1252,-42,1,0,0.076923,0,10,13,12,3.2,0,0,7,11,false,true,false,0.248,0.752
143,121,22,17.875,17.285714,22,872,818,54,0,1,0,0.142857,51,8,7,0.803922,0,0,7,11,false,true,true,0.74,0.26
117,97,20,23.4,24.25,20,1539,1537,2,0,0,0,0,73,5,4,0.438356,1,0,7,9,false,true,true,0.638,0.362
101,113,-12,25.25,28.25,-12,1636,1576,60,0,1,0,0.25,62,4,4,0.548387,0,1,10,13,false,true,false,0.274,0.726
18,48,-30,9,24,-30,831,830,1,0,0,0,0,85,2,2,0.435294,0,0,10,10,false,true,false,0.277,0.723
51,21,30,17,10.5,30,310,359,-49,0,0,0,0,83,3,2,0.590361,0,0,7,14,false,true,false,0.457,0.543
164,136,28,18.222222,17,28,704,691,13,0,0,0,0,45,9,8,0.844444,1,0,9,9,false,true,true,0.831,0.169
149,144,5,24.833333,28.8,5,1227,1060,167,0,1,0,0.2,60,6,5,0.666667,0,0,16,9,false,true,false,0.304,0.696
36,38,-2,18,19,-2,1670,1770,-100,1,0,0.5,0,82,2,2,0.390244,0,0,19,9,false,true,true,0.869,0.131
134,158,-24,22.333333,26.333333,-24,1177,1214,-37,0,0,0,0,57,6,6,0.614035,0,0,19,13,false,true,false,0.286,0.714
183,179,4,20.333333,19.888889,4,1572,1550,22,1,0,0.111111,0,39,9,9,1,0,1,16,8,false,true,false,0.437,0.563
283,263,20,18.866667,17.533333,20,942,976,-34,0,0,0,0,-2,15,15,-20,0,0,9,10,false,true,true,0.882,0.118
374,275,99,26.714286,19.642857,99,1550,1466,84,1,0,0.071429,0,2,14,14,18.5,0,0,10,11,false,true,true,1,0
351,219,132,23.4,14.6,132,554,342,212,0,0,0,0,-11,15,15,-3.272727,0,0,4,8,false,true,true,1,0
344,307,37,18.105263,17.055556,37,921,1072,-151,1,0,0.052632,0,-15,19,18,-2.533333,0,0,2,4,false,true,true,1,0
18,29,-11,9,14.5,-11,1154,1062,92,0,0,0,0,88,2,2,0.397727,0,0,7,33,false,true,false,0.485,0.515
42,12,30,21,12,30,1266,1247,19,0,0,0,0,91,2,1,0.351648,0,0,8,12,false,true,true,0.557,0.443
219,223,-4,16.846154,17.153846,-4,808,812,-4,0,0,0,0,13,13,13,2.846154,1,0,15,10,false,true,true,0.582,0.418
112,110,2,37.333333,36.666667,2,1302,1349,-47,0,0,0,0,69,3,3,0.405797,0,0,15,7,false,true,true,0.723,0.277
306,200,106,30.6,20,106,1167,1216,-49,1,0,0.1,0,27,10,10,1.518519,0,0,9,11,false,true,true,1,0
439,361,78,39.909091,32.818182,78,1770,1689,81,0,1,0,0.090909,-3,11,11,-8.666667,1,0,6,12,false,true,true,1,0
13,48,-35,6.5,48,-35,1554,1573,-19,0,0,0,0,91,2,1,0.373626,0,0,12,16,false,true,false,0.031,0.969
139,129,10,23.166667,25.8,10,1406,1454,-48,0,1,0,0.2,53,6,5,0.641509,1,0,15,10,false,true,true,0.692,0.308
66,74,-8,16.5,24.666667,-8,1826,1656,170,0,0,0,0,73,4,3,0.369863,0,0,19,11,false,true,true,0.595,0.405
347,287,60,20.411765,17.9375,60,1547,1439,108,1,0,0.058824,0,-7,17,16,-5.285714,0,0,5,5,false,true,true,1,0
281,185,96,23.416667,16.818182,96,580,620,-40,1,0,0.083333,0,28,12,11,1.535714,0,0,12,7,false,true,true,0.953,0.047
144,127,17,16,15.875,17,691,675,16,0,0,0,0,41,9,8,0.926829,0,0,14,12,false,true,true,0.6,0.4
337,240,97,25.923077,20,97,1510,1583,-73,1,0,0.076923,0,8,13,12,4,0,0,7,8,false,true,true,1,0
295,263,32,26.818182,26.3,32,1885,1846,39,1,1,0.090909,0.1,15,11,10,1.933333,1,0,18,7,false,true,true,0.882,0.118
206,183,23,17.166667,16.636364,23,1583,1422,161,0,0,0,0,39,12,11,1.307692,1,0,7,14,false,true,true,0.853,0.147
62,27,35,20.666667,13.5,35,1439,1294,145,0,0,0,0,80,3,2,0.45,0,0,14,7,false,true,true,0.587,0.413
335,307,28,22.333333,20.466667,28,1022,1095,-73,0,1,0,0.066667,-11,15,15,-3,0,0,7,4,false,true,true,0.966,0.034
168,235,-67,21,33.571429,-67,1419,1488,-69,0,1,0,0.142857,33,8,7,0.848485,1,0,15,10,false,true,false,0.246,0.754
113,76,37,28.25,25.333333,37,1305,1242,63,1,0,0.25,0,75,4,3,0.453333,0,1,9,13,false,true,true,0.561,0.439
194,177,17,21.555556,19.666667,17,1452,1469,-17,0,1,0,0.111111,37,9,9,1.027027,1,0,6,21,false,true,true,0.804,0.196
161,171,-10,12.384615,14.25,-10,611,584,27,0,0,0,0,29,13,12,1.517241,0,0,10,19,false,true,false,0.262,0.738
282,261,21,21.692308,21.75,21,926,854,72,0,0,0,0,14,13,12,2.428571,1,0,9,12,false,true,true,0.575,0.425
20,70,-50,6.666667,23.333333,-50,844,821,23,0,0,0,0,83,3,3,0.506024,0,0,27,17,false,true,false,0.272,0.728
197,146,51,17.909091,14.6,51,1164,1201,-37,0,0,0,0,33,11,10,1.272727,0,1,18,15,false,true,true,0.696,0.304
200,244,-44,13.333333,16.266667,-44,699,448,251,0,0,0,0,11,15,15,3.636364,0,0,16,12,false,true,false,0.084,0.916
120,160,-40,20,26.666667,-40,1125,1227,-102,0,0,0,0,49,6,6,0.612245,1,0,9,12,false,true,false,0.287,0.713
278,190,88,23.166667,17.272727,88,847,952,-105,0,0,0,0,29,12,11,1.241379,0,0,12,13,false,true,true,0.958,0.042
146,135,11,29.2,27,11,1344,1209,135,1,1,0.2,0.2,56,5,5,0.607143,0,0,15,21,false,true,true,0.587,0.413
183,166,17,22.875,20.75,17,1572,1550,22,1,0,0.125,0,42,8,8,0.928571,0,0,23,7,false,true,true,0.578,0.422
55,44,11,13.75,11,11,859,719,140,0,1,0,0.25,67,4,4,0.791045,0,2,12,5,false,true,true,0.721,0.279
63,56,7,21,28,7,1093,1197,-104,0,0,0,0,84,3,2,0.369048,0,0,8,7,false,true,false,0.36,0.64
8,37,-29,8,37,-29,1030,998,32,0,0,0,0,93,1,1,0.408602,1,0,14,12,false,true,false,0.352,0.648
339,261,78,19.941176,16.3125,78,880,952,-72,0,0,0,0,-11,17,16,-3.727273,0,1,4,7,false,true,true,1,0
280,210,70,21.538462,17.5,70,1394,1230,164,0,1,0,0.083333,12,13,12,3.166667,0,1,10,18,false,true,true,0.862,0.138
302,221,81,23.230769,18.416667,81,1036,1181,-145,0,0,0,0,19,13,12,1.789474,1,0,14,10,false,true,true,0.966,0.034
52,53,-1,13,17.666667,-1,1547,1439,108,0,0,0,0,79,4,3,0.468354,2,0,5,9,false,true,true,0.64,0.36
315,292,23,21,20.857143,23,1710,1636,74,1,1,0.066667,0.071429,4,15,14,9,1,0,10,14,false,true,true,0.841,0.159
253,266,-13,15.8125,17.733333,-13,1043,1055,-12,0,0,0,0,-2,16,15,-18.5,1,0,18,8,false,true,false,0.391,0.609
189,147,42,15.75,12.25,42,777,830,-53,0,0,0,0,29,12,12,1.413793,0,0,14,12,false,true,true,0.969,0.031
223,115,108,31.857143,16.428571,108,1408,1454,-46,1,0,0.142857,0,50,7,7,0.64,0,0,9,19,false,true,true,0.988,0.012
37,38,-1,12.333333,19,-1,416,374,42,0,0,0,0,85,3,2,0.541176,1,0,6,18,false,true,true,0.707,0.293
305,197,108,38.125,28.142857,108,1890,2020,-130,1,1,0.125,0.142857,32,8,7,0.90625,0,0,10,7,false,true,true,0.991,0.009
236,190,46,19.666667,17.272727,46,1334,1270,64,1,0,0.083333,0,31,12,11,1.193548,1,0,16,13,false,true,true,0.943,0.057
157,94,63,39.25,31.333333,63,1197,1127,70,0,0,0,0,69,4,3,0.434783,0,0,24,14,false,true,true,0.945,0.055
233,175,58,21.181818,15.909091,58,1270,1315,-45,0,0,0,0,24,11,11,1.5,1,0,9,26,false,true,true,0.991,0.009
86,63,23,17.2,12.6,23,303,342,-39,0,0,0,0,67,5,5,0.567164,1,0,16,17,false,true,true,0.525,0.475
194,148,46,27.714286,24.666667,46,1670,1770,-100,1,1,0.142857,0.166667,52,7,6,0.615385,0,0,15,9,false,true,true,0.946,0.054
238,173,65,21.636364,17.3,65,691,675,16,0,0,0,0,26,11,10,1.423077,0,1,24,13,false,true,true,0.948,0.052
187,109,78,23.375,15.571429,78,1022,1095,-73,0,0,0,0,50,8,7,0.66,0,0,16,11,false,true,true,0.905,0.095
68,27,41,22.666667,13.5,41,859,786,73,0,0,0,0,82,3,2,0.463415,0,1,7,6,false,true,true,0.596,0.404
172,79,93,15.636364,7.181818,93,1428,1302,126,0,0,0,0,36,11,11,1.472222,0,1,17,18,false,true,true,0.936,0.064
334,263,71,37.111111,32.875,71,1770,1689,81,0,1,0,0.125,21,9,8,1.238095,0,0,10,22,false,true,true,1,0
72,85,-13,12,14.166667,-13,539,632,-93,0,0,0,0,66,6,6,0.69697,0,1,8,7,false,true,false,0.151,0.849
123,91,32,20.5,15.166667,32,1397,1422,-25,1,0,0.166667,0,62,6,6,0.580645,0,1,17,11,false,true,true,0.647,0.353
402,342,60,22.333333,20.117647,60,1142,1176,-34,1,0,0.055556,0,-17,18,17,-2.117647,0,0,1,1,false,true,true,1,0
214,181,33,21.4,18.1,33,941,926,15,1,0,0.1,0,34,10,10,1.117647,1,0,20,10,false,true,true,0.959,0.041
10,18,-8,5,18,-8,791,774,17,0,0,0,0,95,2,1,0.431579,0,0,12,15,false,true,false,0.274,0.726
142,209,-67,17.75,26.125,-67,1539,1537,2,0,1,0,0.125,50,8,8,0.64,1,0,7,10,false,true,false,0.147,0.853
100,105,-5,16.666667,17.5,-5,1011,921,90,0,0,0,0,62,6,6,0.790323,0,0,10,22,false,true,true,0.512,0.488
91,58,33,18.2,14.5,33,491,398,93,0,0,0,0,70,5,4,0.514286,0,1,8,14,false,true,true,0.821,0.179
252,227,25,16.8,15.133333,25,299,315,-16,0,0,0,0,-5,15,15,-8.4,0,0,10,12,false,true,true,0.955,0.045
42,32,10,14,16,10,1547,1439,108,0,0,0,0,85,3,2,0.435294,1,0,6,11,false,true,false,0.35,0.65
78,105,-27,15.6,21,-27,1011,921,90,0,0,0,0,65,5,5,0.753846,0,0,10,10,false,true,false,0.334,0.666
133,152,-19,12.090909,15.2,-19,480,518,-38,0,0,0,0,42,11,10,1.095238,0,1,19,9,false,true,false,0.128,0.872
208,121,87,29.714286,17.285714,87,539,500,39,0,0,0,0,42,7,7,0.952381,0,0,7,10,false,true,true,0.976,0.024
44,0,44,44,0,44,2219,2106,113,0,0,0,0,95,1,1,0.284211,0,1,16,22,false,true,true,0.876,0.124
374,370,4,17.809524,17.619048,4,1265,1045,220,0,1,0,0.047619,-35,21,21,-1.2,0,0,1,2,true,true,true,0.915,0.085
306,336,-30,25.5,28,-30,1125,1227,-102,2,1,0.166667,0.083333,0,12,12,0,1,0,6,7,false,true,true,0.547,0.453
298,224,74,18.625,14.933333,74,1606,1544,62,0,0,0,0,13,16,15,3.461538,0,0,20,10,false,true,true,0.994,0.006
415,345,70,20.75,17.25,70,1227,1060,167,0,2,0,0.1,-32,20,20,-1.25,0,0,1,1,true,true,true,1,0
288,197,91,48,32.833333,91,1348,1331,17,2,0,0.333333,0,42,6,6,0.571429,0,0,12,12,false,true,true,1,0
283,219,64,17.6875,13.6875,64,758,750,8,0,0,0,0,-7,16,16,-5.285714,0,1,15,7,false,true,true,1,0
364,314,50,15.826087,14.272727,50,725,771,-46,0,1,0,0.045455,-35,23,22,-1.314286,0,0,1,1,false,true,true,1,0
436,374,62,21.8,19.684211,62,1220,1261,-41,2,0,0.1,0,-18,20,19,-2.5,0,0,3,3,false,true,true,1,0
118,87,31,19.666667,14.5,31,739,480,259,1,0,0.166667,0,56,6,6,0.642857,0,0,10,10,false,true,true,0.894,0.106
112,160,-48,14,20,-48,725,771,-46,0,1,0,0.125,45,8,8,1.022222,0,0,11,11,false,true,false,0.271,0.729
158,158,0,22.571429,26.333333,0,1431,802,629,0,0,0,0,44,7,6,0.727273,0,0,12,14,false,true,true,0.999,0.001
317,258,59,17.611111,14.333333,59,1091,1078,13,0,0,0,0,-6,18,18,-7.166667,0,0,10,8,false,true,true,1,0
391,317,74,23,19.8125,74,1556,1591,-35,2,0,0.117647,0,-21,17,16,-1.714286,0,0,1,3,false,true,true,1,0
0,16,-16,0,16,-16,416,374,42,0,0,0,0,97,1,1,0.474227,0,0,0,9,false,true,true,0.547,0.453
141,177,-36,17.625,22.125,-36,491,398,93,0,0,0,0,45,8,8,0.8,0,0,18,19,false,true,false,0.495,0.505
188,122,66,37.6,24.4,66,971,621,350,2,0,0.4,0,57,5,5,0.561404,0,0,10,11,false,true,true,0.925,0.075
292,269,23,15.368421,14.157895,23,613,502,111,0,0,0,0,-24,19,19,-2.041667,0,0,6,15,false,true,true,0.978,0.022
40,0,40,40,0,40,859,811,48,0,0,0,0,95,1,0,0.378947,0,0,7,0,false,true,true,0.746,0.254
199,171,28,24.875,21.375,28,1344,1209,135,1,1,0.125,0.125,37,8,8,0.918919,0,0,10,16,false,true,true,0.95,0.05
256,167,89,17.066667,11.928571,89,1128,889,239,0,1,0,0.071429,17,15,14,2.764706,0,0,18,19,false,true,true,0.987,0.013
251,115,136,22.818182,10.454545,136,1067,95,972,0,0,0,0,32,11,11,1.0625,0,0,18,9,false,true,true,1,0
378,289,89,37.8,32.111111,89,1348,1331,17,3,0,0.3,0,10,10,9,2.4,0,0,8,8,false,true,true,1,0
280,154,126,35,22,126,1302,1349,-47,0,0,0,0,37,8,7,0.756757,0,1,13,6,false,true,true,0.997,0.003
317,249,68,22.642857,17.785714,68,1439,1413,26,0,0,0,0,9,14,14,4,1,1,12,6,false,true,true,0.998,0.002
326,256,70,40.75,36.571429,70,1885,1793,92,0,0,0,0,29,8,7,0.931034,1,0,8,18,false,true,true,1,0
89,41,48,17.8,10.25,48,1091,1078,13,0,0,0,0,71,5,4,0.605634,0,0,16,22,false,true,true,0.776,0.224
232,227,5,15.466667,16.214286,5,361,493,-132,1,0,0.066667,0,-9,15,14,-4.555556,0,0,10,23,false,true,true,0.796,0.204
363,295,68,18.15,15.526316,68,505,95,410,0,1,0,0.052632,-16,20,19,-2.75,0,0,3,9,false,true,true,0.92,0.08
307,224,83,21.928571,17.230769,83,691,473,218,0,0,0,0,3,14,13,12,1,1,9,7,false,true,true,0.999,0.001
301,250,51,20.066667,17.857143,51,1548,1493,55,1,0,0.066667,0,4,15,14,10.25,0,0,7,18,false,true,true,0.959,0.041
322,283,39,16.947368,15.722222,39,719,614,105,0,1,0,0.055556,-21,19,18,-2.047619,0,0,7,11,false,true,true,0.984,0.016
558,193,365,34.875,12.0625,365,1431,825,606,2,1,0.125,0.0625,-5,16,16,-6.8,0,0,2,16,false,true,true,1,0
285,263,22,15,13.842105,22,826,771,55,0,0,0,0,-7,19,19,-6.428571,0,0,7,7,false,true,true,0.987,0.013
115,39,76,38.333333,19.5,76,1770,1689,81,0,0,0,0,75,3,2,0.346667,0,1,16,17,false,true,true,0.729,0.271
65,39,26,16.25,13,26,1045,1009,36,0,0,0,0,80,4,3,0.475,0,0,10,14,false,true,true,0.519,0.481
22,19,3,22,19,3,1983,2020,-37,0,0,0,0,90,1,1,0.288889,0,0,8,13,false,true,false,0.379,0.621
49,47,2,12.25,11.75,2,658,817,-159,0,0,0,0,80,4,4,0.475,0,1,22,10,false,true,false,0.356,0.644
79,81,-2,19.75,20.25,-2,1266,1144,122,0,0,0,0,67,4,4,0.507463,1,0,6,10,false,true,true,0.68,0.32
243,206,37,15.1875,12.875,37,416,374,42,0,0,0,0,13,16,16,3.538462,0,0,16,7,false,true,true,0.969,0.031
291,173,118,26.454545,15.727273,118,801,925,-124,1,0,0.090909,0,21,11,11,1.666667,1,0,16,9,false,true,true,0.98,0.02
239,178,61,17.071429,13.692308,61,1048,1000,48,0,0,0,0,22,14,13,1.818182,0,1,18,13,false,true,true,0.869,0.131
374,305,69,19.684211,16.052632,69,948,933,15,1,0,0.052632,0,-8,19,19,-4.75,0,0,2,3,true,true,true,1,0
176,160,16,25.142857,22.857143,16,1394,1424,-30,0,1,0,0.142857,50,7,7,0.64,0,0,18,19,false,true,true,0.703,0.297
318,300,18,13.826087,13.043478,18,871,999,-128,0,0,0,0,-36,23,23,-1.333333,0,0,1,1,false,true,true,1,0
52,78,-26,17.333333,26,-26,1142,1095,47,0,0,0,0,78,3,3,0.448718,1,0,6,14,false,true,false,0.308,0.692
177,188,-11,22.125,23.5,-11,1189,1266,-77,0,0,0,0,43,8,8,0.790698,1,0,6,10,false,true,false,0.425,0.575
327,237,90,18.166667,13.941176,90,758,750,8,0,0,0,0,-21,18,17,-1.761905,0,0,4,1,false,true,true,1,0
88,81,7,14.666667,16.2,7,971,761,210,0,0,0,0,60,6,5,0.5,1,1,9,12,false,true,true,0.542,0.458
213,152,61,19.363636,15.2,61,1181,1069,112,0,0,0,0,32,11,10,1.15625,1,0,6,9,false,true,true,0.973,0.027
107,38,69,35.666667,19,69,1270,1322,-52,1,0,0.333333,0,83,3,2,0.457831,1,0,18,16,false,true,true,0.951,0.049
102,73,29,25.5,18.25,29,939,907,32,0,0,0,0,74,4,4,0.540541,0,0,20,10,false,true,true,0.833,0.167
263,227,36,26.3,25.222222,36,1320,1339,-19,2,1,0.2,0.111111,28,10,9,1.392857,0,0,19,13,false,true,true,0.979,0.021
95,78,17,23.75,26,17,505,95,410,0,1,0,0.333333,80,4,3,0.55,0,0,10,9,false,true,true,0.549,0.451
63,37,26,21,18.5,26,948,933,15,0,0,0,0,83,3,2,0.457831,1,1,10,14,false,true,true,0.563,0.437
122,60,62,40.666667,30,62,1210,1252,-42,1,0,0.333333,0,81,3,2,0.395062,0,0,9,7,false,true,true,0.63,0.37
245,102,143,22.272727,10.2,143,993,897,96,1,0,0.090909,0,26,11,10,1.807692,0,0,10,16,false,true,true,0.996,0.004
364,314,50,21.411765,18.470588,50,1452,1469,-17,1,1,0.058824,0.058824,-17,17,17,-2.235294,0,0,3,3,false,true,true,0.998,0.002
342,266,76,20.117647,16.625,76,539,500,39,0,0,0,0,-15,17,16,-2.666667,0,0,18,11,false,true,true,1,0
299,269,30,14.95,13.45,30,613,502,111,0,0,0,0,-26,20,20,-1.884615,0,0,5,15,false,true,true,0.999,0.001
396,299,97,39.6,33.222222,97,1770,1689,81,0,1,0,0.111111,10,10,9,2.6,0,0,13,19,false,true,true,1,0
313,296,17,24.076923,22.769231,17,971,1180,-209,1,1,0.076923,0.076923,7,13,13,4.571429,0,0,20,7,false,true,true,0.67,0.33
138,87,51,27.6,21.75,51,1109,1065,44,0,0,0,0,68,5,4,0.485294,1,0,15,8,false,true,true,0.839,0.161
416,368,48,21.894737,20.444444,48,1220,1261,-41,2,0,0.105263,0,-13,19,18,-3.461538,0,0,11,5,false,true,true,1,0
103,73,30,25.75,18.25,30,1550,1624,-74,0,0,0,0,73,4,4,0.410959,0,0,24,14,false,true,true,0.76,0.24
66,63,3,16.5,15.75,3,527,514,13,0,0,0,0,75,4,4,0.52,0,0,10,10,false,true,true,0.766,0.234
305,224,81,23.461538,17.230769,81,371,336,35,2,0,0.153846,0,-7,13,13,-5.428571,0,0,8,18,false,true,true,1,0
403,380,23,19.190476,18.095238,23,1096,1009,87,2,0,0.095238,0,-21,21,21,-2.095238,0,0,1,1,false,true,true,1,0
55,52,3,13.75,13,3,856,897,-41,0,0,0,0,71,4,4,0.492958,1,0,11,10,false,true,true,0.596,0.404
87,79,8,17.4,19.75,8,1261,1349,-88,0,0,0,0,67,5,4,0.19403,1,0,10,19,false,true,false,0.384,0.616
167,150,17,18.555556,18.75,17,1266,1247,19,0,0,0,0,40,9,8,0.8,0,0,13,16,false,true,false,0.288,0.712
325,309,16,18.055556,17.166667,16,758,952,-194,0,0,0,0,-22,18,18,-1.818182,0,0,2,1,false,true,true,1,0
42,29,13,14,14.5,13,1154,1062,92,0,0,0,0,83,3,2,0.421687,0,0,11,33,false,true,true,0.503,0.497
349,264,85,20.529412,15.529412,85,711,876,-165,0,0,0,0,-9,17,17,-4.777778,0,0,5,3,false,true,true,1,0
207,198,9,20.7,19.8,9,1782,1512,270,1,1,0.1,0.1,35,10,10,1.2,0,0,18,10,false,true,true,1,0
354,282,72,16.857143,14.1,72,416,374,42,0,0,0,0,-16,21,20,-2.875,0,0,2,4,false,true,true,1,0
87,66,21,21.75,22,21,1075,1009,66,0,0,0,0,72,4,3,0.444444,0,1,8,18,false,true,false,0.336,0.664
291,160,131,36.375,22.857143,131,1396,1454,-58,2,0,0.25,0,41,8,7,0.804878,0,0,12,10,false,true,true,1,0
344,254,90,20.235294,15.875,90,620,658,-38,0,0,0,0,-13,17,16,-2.769231,0,0,7,6,false,true,true,1,0
20,14,6,20,14,6,695,523,172,0,0,0,0,89,1,1,0.41573,0,1,9,12,false,true,true,0.78,0.22
86,63,23,17.2,15.75,23,371,435,-64,0,0,0,0,64,5,4,0.6875,0,0,12,11,false,true,false,0.432,0.568
51,61,-10,17,20.333333,-10,954,1078,-124,0,0,0,0,77,3,3,0.493506,1,0,27,11,false,true,false,0.431,0.569
24,43,-19,12,21.5,-19,1334,1270,64,0,0,0,0,85,2,2,0.435294,0,0,11,9,false,true,false,0.275,0.725
401,274,127,28.642857,21.076923,127,1334,1477,-143,2,1,0.142857,0.076923,-9,14,13,-3.333333,0,0,2,9,false,true,true,1,0
247,210,37,24.7,21,37,695,671,24,0,0,0,0,21,10,10,1.571429,0,0,17,8,false,true,true,0.947,0.053
32,0,32,32,0,32,1295,1281,14,0,0,0,0,95,1,0,0.4,0,0,20,0,false,true,true,0.73,0.27
20,14,6,20,14,6,725,771,-46,0,0,0,0,91,1,1,0.505495,0,1,9,16,false,true,false,0.229,0.771
138,210,-72,27.6,42,-72,1554,1716,-162,1,1,0.2,0.2,52,5,5,0.673077,0,0,20,7,false,true,false,0.37,0.63
336,255,81,21,15.9375,81,1055,1050,5,0,0,0,0,-5,16,16,-6.8,1,0,2,1,false,true,true,1,0
195,169,26,15,13,26,584,565,19,0,0,0,0,18,13,13,2.555556,0,0,7,14,false,true,true,0.975,0.025
0,0,0,0,0,0,1710,1636,74,0,0,0,0,100,1,0,0.36,0,0,14,0,false,true,false,0.4,0.6
21,14,7,10.5,14,7,1127,1075,52,0,0,0,0,92,2,1,0.336957,0,0,9,16,false,true,false,0.294,0.706
351,330,21,19.5,19.411765,21,869,820,49,0,1,0,0.058824,-23,18,17,-1.608696,0,0,1,2,false,true,true,0.881,0.119
239,171,68,26.555556,21.375,68,834,758,76,0,1,0,0.125,39,9,8,0.923077,0,1,7,17,false,true,true,0.938,0.062
332,235,97,20.75,15.666667,97,844,821,23,0,0,0,0,14,16,15,3,0,0,9,7,false,true,true,1,0
100,132,-32,16.666667,22,-32,725,771,-46,0,1,0,0.166667,54,6,6,0.851852,0,0,17,15,false,true,false,0.297,0.703
228,234,-6,20.727273,23.4,-6,971,761,210,0,0,0,0,22,11,10,1.363636,0,0,8,13,false,true,false,0.153,0.847
20,8,12,20,8,12,310,359,-49,0,0,0,0,93,1,1,0.526882,0,0,10,16,false,true,false,0.435,0.565
313,252,61,20.866667,18,61,719,785,-66,0,1,0,0.071429,4,15,14,9,0,0,13,8,false,true,true,0.991,0.009
51,32,19,17,16,19,1452,1469,-17,0,0,0,0,83,3,2,0.457831,0,0,7,10,false,true,false,0.42,0.58
85,62,23,21.25,20.666667,23,691,473,218,0,0,0,0,72,4,3,0.5,0,0,13,12,false,true,true,0.682,0.318
96,78,18,19.2,19.5,18,349,315,34,0,0,0,0,64,5,4,0.53125,0,0,9,10,false,true,true,0.785,0.215
89,63,26,22.25,15.75,26,1048,1000,48,0,0,0,0,73,4,4,0.547945,0,1,10,9,false,true,true,0.587,0.413
249,247,2,17.785714,17.642857,2,448,598,-150,0,0,0,0,-1,14,14,-36,0,0,16,11,false,true,true,0.565,0.435
76,71,5,38,71,5,1370,1431,-61,0,1,0,1,88,2,1,0.261364,1,0,11,9,false,true,false,0.468,0.532
42,29,13,21,14.5,13,303,342,-39,0,0,0,0,89,2,2,0.426966,0,0,20,16,false,true,true,0.619,0.381
397,273,124,23.352941,16.058824,124,1110,1039,71,0,0,0,0,-20,17,17,-1.8,0,0,2,5,false,true,true,1,0
160,107,53,22.857143,15.285714,53,1270,1348,-78,0,0,0,0,54,7,7,0.703704,0,0,16,16,false,true,true,0.868,0.132
324,226,98,27,18.833333,98,1144,1014,130,0,0,0,0,19,12,12,1.894737,0,1,14,9,false,true,true,1,0
318,235,83,31.8,26.111111,83,1454,1531,-77,1,1,0.1,0.111111,20,10,9,1.5,0,0,10,12,false,true,true,0.988,0.012
264,194,70,26.4,19.4,70,1216,1228,-12,1,0,0.1,0,33,10,10,1,0,0,10,13,false,true,true,0.985,0.015
413,323,90,21.736842,17.944444,90,995,912,83,2,0,0.105263,0,-15,19,18,-2.933333,0,0,2,12,false,true,true,1,0
378,274,104,18,13.047619,104,539,632,-93,0,0,0,0,-20,21,21,-2.3,0,0,3,5,false,true,true,1,0
213,116,97,30.428571,16.571429,97,1216,1217,-1,1,0,0.142857,0,46,7,7,0.73913,0,0,10,31,false,true,true,0.987,0.013
354,309,45,18.631579,17.166667,45,795,830,-35,1,1,0.052632,0.055556,-19,19,18,-2.210526,0,0,1,6,false,true,true,0.984,0.016
51,45,6,17,15,6,1261,1349,-88,0,0,0,0,78,3,3,0.166667,0,0,13,28,false,true,false,0.112,0.888
28,2,26,28,2,26,1115,1078,37,0,0,0,0,92,1,1,0.369565,0,0,26,15,false,true,true,0.816,0.184
254,192,62,23.090909,17.454545,62,859,811,48,0,0,0,0,25,11,11,1.44,0,1,8,13,false,true,true,0.951,0.049
199,144,55,22.111111,16,55,1091,1078,13,0,0,0,0,45,9,9,0.955556,0,0,17,8,false,true,true,0.949,0.051
223,97,126,27.875,12.125,126,1014,1303,-289,1,0,0.125,0,43,8,8,0.883721,0,1,9,13,false,true,true,0.998,0.002
360,276,84,24,19.714286,84,1127,1075,52,1,1,0.066667,0.071429,-7,15,14,-4.428571,0,1,6,2,false,true,true,1,0
142,102,40,20.285714,14.571429,40,1651,1691,-40,0,0,0,0,58,7,7,0.586207,1,0,8,10,false,true,true,0.903,0.097
50,15,35,25,15,35,498,43,455,0,0,0,0,90,2,1,0.411111,1,0,7,8,false,true,true,0.814,0.186
473,257,216,27.823529,16.0625,216,918,619,299,2,0,0.117647,0,-17,17,16,-2.058824,0,0,3,1,false,true,true,1,0
205,142,63,20.5,14.2,63,609,620,-11,0,0,0,0,35,10,10,1.057143,0,1,9,6,false,true,true,0.947,0.053
405,358,47,33.75,29.833333,47,1880,1777,103,1,1,0.083333,0.083333,0,12,12,0,0,0,9,8,false,true,true,1,0
184,71,113,20.444444,8.875,113,1413,1422,-9,0,0,0,0,49,9,8,1.163265,2,0,16,18,false,true,true,0.996,0.004
237,207,30,21.545455,18.818182,30,1094,1030,64,0,0,0,0,22,11,11,1.636364,0,0,9,11,false,true,true,0.769,0.231
60,64,-4,15,21.333333,-4,1154,1062,92,0,0,0,0,78,4,3,0.448718,0,0,9,27,false,true,false,0.429,0.571
171,136,35,21.375,17,35,505,95,410,0,1,0,0.125,55,8,8,0.8,0,1,7,15,false,true,true,0.861,0.139
360,237,123,27.692308,19.75,123,1556,1591,-35,1,0,0.076923,0,12,13,12,3,0,0,7,10,false,true,true,1,0
67,43,24,16.75,14.333333,24,1651,1691,-40,0,0,0,0,80,4,3,0.425,0,0,17,22,false,true,false,0.287,0.713
12,16,-4,12,16,-4,1344,1325,19,0,0,0,0,91,1,1,0.340659,0,0,20,8,false,true,false,0.498,0.502
168,135,33,16.8,15,33,691,675,16,0,0,0,0,34,10,9,1.117647,0,0,12,24,false,true,true,0.796,0.204
338,279,59,16.9,13.95,59,1091,1078,13,0,0,0,0,-18,20,20,-2.388889,1,0,4,2,false,true,true,1,0
200,199,1,16.666667,18.090909,1,361,493,-132,1,0,0.083333,0,13,12,11,3.153846,0,0,11,23,false,true,false,0.472,0.528
298,262,36,21.285714,18.714286,36,1094,1030,64,0,0,0,0,2,14,14,18,0,0,11,16,false,true,true,0.876,0.124
396,336,60,23.294118,21,60,1142,1176,-34,1,0,0.058824,0,-12,17,16,-3,0,0,1,3,false,true,true,1,0
18,21,-3,18,21,-3,1489,1405,84,0,0,0,0,94,1,1,0.297872,1,0,16,12,false,true,true,0.682,0.318
332,165,167,33.2,18.333333,167,1439,1353,86,1,0,0.1,0,29,10,9,1.034483,0,0,7,16,false,true,true,1,0
49,31,18,24.5,15.5,18,1078,1130,-52,0,0,0,0,86,2,2,0.453488,0,1,17,12,false,true,true,0.52,0.48
454,283,171,32.428571,21.769231,171,1571,1554,17,2,1,0.142857,0.076923,-9,14,13,-3.666667,1,0,2,9,false,true,true,1,0
304,213,91,17.882353,12.529412,91,272,288,-16,0,0,0,0,10,17,17,5.2,0,0,10,14,false,true,true,0.997,0.003
315,263,52,18.529412,15.470588,52,1270,1315,-45,0,0,0,0,-13,17,17,-2.769231,0,0,1,18,false,true,true,1,0
160,107,53,26.666667,17.833333,53,778,758,20,0,0,0,0,56,6,6,0.696429,0,0,19,7,false,true,true,0.95,0.05
217,230,-13,14.466667,15.333333,-13,480,518,-38,0,0,0,0,12,15,15,3.833333,1,0,10,16,false,true,false,0.431,0.569
196,185,11,21.777778,23.125,11,1897,1793,104,1,1,0.111111,0.125,53,9,8,0.603774,0,0,10,9,false,true,true,1,0
380,282,98,27.142857,20.142857,98,1397,1361,36,1,0,0.071429,0,-10,14,14,-2.9,0,0,1,1,false,true,true,1,0
290,267,23,16.111111,15.705882,23,500,567,-67,0,0,0,0,-1,18,17,-44,0,0,8,12,false,true,true,0.94,0.06
333,273,60,33.3,30.333333,60,1302,1349,-47,0,1,0,0.111111,20,10,9,1.4,0,1,13,9,false,true,true,0.906,0.094
173,59,114,28.833333,11.8,114,1014,1303,-289,1,0,0.166667,0,59,6,5,0.644068,0,1,18,7,false,true,true,0.594,0.406
120,81,39,24,20.25,39,1036,1181,-145,0,0,0,0,69,5,4,0.492754,0,1,18,15,false,true,false,0.453,0.547
340,261,79,34,26.1,79,1684,1320,364,1,0,0.1,0,13,10,10,2.307692,0,0,7,14,false,true,true,1,0
157,120,37,19.625,17.142857,37,786,847,-61,0,0,0,0,49,8,7,0.693878,0,0,7,7,false,true,true,0.69,0.31
108,59,49,21.6,14.75,49,834,758,76,0,0,0,0,69,5,4,0.521739,0,1,11,9,false,true,true,0.817,0.183
66,65,1,16.5,16.25,1,540,518,22,0,0,0,0,75,4,4,0.533333,0,0,13,18,false,true,true,0.674,0.326
46,20,26,23,10,26,1428,1302,126,0,0,0,0,87,2,2,0.609195,0,0,7,16,false,true,true,0.713,0.287
315,258,57,15,12.285714,57,299,315,-16,0,0,0,0,-37,21,21,-1.135135,0,0,2,4,true,true,true,1,0
367,364,3,19.315789,19.157895,3,1265,1045,220,0,1,0,0.052632,-28,19,19,-1.5,0,0,2,4,false,true,true,0.57,0.43
175,153,22,13.461538,12.75,22,416,374,42,0,0,0,0,38,13,12,1.210526,0,1,11,9,false,true,true,0.562,0.438
14,27,-13,14,27,-13,1334,1477,-143,0,0,0,0,91,1,1,0.32967,0,0,22,16,false,true,false,0.176,0.824
305,270,35,23.461538,20.769231,35,1109,1065,44,0,0,0,0,-6,13,13,-5.5,0,0,19,6,false,true,true,0.962,0.038
129,162,-33,18.428571,23.142857,-33,1077,1094,-17,0,0,0,0,53,7,7,0.792453,0,0,18,13,false,true,false,0.264,0.736
415,416,-1,29.642857,29.714286,-1,1897,1793,104,2,3,0.142857,0.214286,4,14,14,8,0,0,10,3,false,true,true,1,0
53,31,22,17.666667,15.5,22,1047,1094,-47,0,0,0,0,83,3,2,0.433735,0,0,7,17,false,true,false,0.459,0.541
195,225,-30,16.25,18.75,-30,1043,1055,-12,0,0,0,0,21,12,12,1.761905,1,0,21,10,false,true,true,0.508,0.492
361,236,125,30.083333,21.454545,125,1519,1782,-263,2,0,0.166667,0,16,12,11,2.0625,0,0,24,13,false,true,true,1,0
365,283,82,21.470588,16.647059,82,904,668,236,0,0,0,0,-28,17,17,-1.214286,0,0,2,1,true,true,true,1,0
42,30,12,21,15,12,1075,1009,66,0,0,0,0,86,2,2,0.372093,1,0,13,23,false,true,true,0.881,0.119
377,334,43,34.272727,30.363636,43,1880,1777,103,1,1,0.090909,0.090909,7,11,11,4,0,0,13,14,false,true,true,1,0
119,126,-7,14.875,18,-7,95,378,-283,0,0,0,0,48,8,7,0.729167,0,0,14,10,false,true,false,0.391,0.609
46,67,-21,11.5,16.75,-21,1221,1438,-217,0,0,0,0,76,4,4,0.592105,0,1,19,9,false,true,false,0.119,0.881
201,207,-6,22.333333,23,-6,1047,1094,-47,1,1,0.111111,0.111111,35,9,9,1.028571,0,0,28,8,false,true,true,0.865,0.135
215,124,91,23.888889,13.777778,91,1075,1152,-77,0,0,0,0,42,9,9,0.952381,0,1,11,10,false,true,true,0.856,0.144
113,92,21,37.666667,30.666667,21,1983,2020,-37,1,0,0.333333,0,74,3,3,0.351351,0,1,15,7,false,true,true,0.562,0.438
104,74,30,14.857143,10.571429,30,584,565,19,0,0,0,0,55,7,7,0.836364,0,0,15,19,false,true,true,0.944,0.056
257,239,18,18.357143,17.071429,18,671,725,-54,0,0,0,0,3,14,14,12.333333,0,0,14,8,false,true,true,0.868,0.132
0,0,0,0,0,0,1030,1144,-114,0,0,0,0,100,1,0,0.35,0,0,8,0,false,true,false,0.293,0.707
206,217,-11,14.714286,15.5,-11,540,518,22,0,0,0,0,8,14,14,5,0,0,7,16,false,true,true,0.672,0.328
320,207,113,24.615385,17.25,113,1029,1227,-198,1,0,0.076923,0,-2,13,12,-16,1,0,6,8,false,true,true,1,0
202,150,52,25.25,18.75,52,306,169,137,0,0,0,0,36,8,8,0.944444,0,0,16,11,false,true,true,0.951,0.049
394,339,55,23.176471,21.1875,55,1203,1221,-18,2,0,0.117647,0,-10,17,16,-3.5,0,0,4,2,false,true,true,1,0
417,326,91,27.8,21.733333,91,1093,1100,-7,3,3,0.2,0.2,-13,15,15,-2.461538,0,0,1,1,false,true,true,0.988,0.012
41,51,-10,20.5,25.5,-10,613,569,44,0,0,0,0,81,2,2,0.481481,2,0,11,15,false,true,true,0.887,0.113
391,270,121,18.619048,13.5,121,746,796,-50,0,1,0,0.05,-24,21,20,-2,0,0,1,3,false,true,true,1,0
177,90,87,29.5,15,87,1216,1230,-14,1,0,0.166667,0,56,6,6,0.571429,1,0,18,13,false,true,true,0.993,0.007
130,96,34,32.5,32,34,1428,1606,-178,1,0,0.25,0,67,4,3,0.477612,1,0,15,21,false,true,true,0.577,0.423
98,128,-30,24.5,42.666667,-30,1454,1531,-77,0,1,0,0.333333,73,4,3,0.410959,2,0,9,8,false,true,false,0.455,0.545
332,304,28,23.714286,23.384615,28,1344,1325,19,1,0,0.071429,0,-3,14,13,-10.333333,0,1,6,6,false,true,true,0.968,0.032
344,294,50,19.111111,16.333333,50,1572,1550,22,1,0,0.055556,0,-17,18,18,-2.294118,0,0,8,1,false,true,true,1,0
12,0,12,12,0,12,758,750,8,0,0,0,0,96,1,0,0.385417,0,0,10,0,false,true,true,0.564,0.436
107,51,56,53.5,25.5,56,1762,1616,146,1,0,0.5,0,83,2,2,0.361446,0,0,10,10,false,true,true,0.596,0.404
237,193,44,21.545455,19.3,44,1094,1030,64,0,0,0,0,25,11,10,1.44,0,0,9,14,false,true,true,0.694,0.306
331,212,119,30.090909,21.2,119,1803,1552,251,1,1,0.090909,0.1,19,11,10,1.473684,0,0,9,9,false,true,true,1,0
155,66,89,25.833333,13.2,89,1022,1095,-73,0,0,0,0,65,6,5,0.507692,0,0,14,7,false,true,true,0.903,0.097
14,41,-27,14,41,-27,416,306,110,0,0,0,0,94,1,1,0.446809,0,0,23,12,false,true,false,0.495,0.505
202,125,77,28.857143,17.857143,77,742,696,46,0,0,0,0,44,7,7,0.727273,0,0,10,10,false,true,true,0.96,0.04
323,178,145,24.846154,14.833333,145,1482,1554,-72,1,0,0.076923,0,14,13,12,2.571429,0,0,7,10,false,true,true,1,0
332,291,41,30.181818,29.1,41,1148,1164,-16,1,2,0.090909,0.2,8,11,10,3.125,0,0,7,7,false,true,true,0.977,0.023
216,128,88,24,16,88,1220,1261,-41,2,0,0.222222,0,47,9,8,0.957447,0,0,22,11,false,true,true,0.969,0.031
157,125,32,22.428571,17.857143,32,1036,1181,-145,0,0,0,0,59,7,7,0.576271,0,0,25,12,false,true,true,0.659,0.341
187,173,14,15.583333,15.727273,14,871,999,-128,0,0,0,0,26,12,11,1.846154,0,0,7,10,false,true,false,0.171,0.829
337,281,56,19.823529,17.5625,56,1572,1550,22,1,0,0.058824,0,-7,17,16,-5.571429,0,0,11,5,false,true,true,0.996,0.004
66,87,-21,16.5,21.75,-21,1826,1656,170,0,0,0,0,69,4,4,0.391304,0,0,19,11,false,true,true,0.519,0.481
177,210,-33,29.5,35,-33,2219,2029,190,0,0,0,0,41,6,6,0.634146,0,1,33,6,false,true,true,0.981,0.019
205,220,-15,25.625,27.5,-15,1102,1245,-143,1,0,0.125,0,25,8,8,1.12,0,0,13,12,false,true,false,0.213,0.787
42,14,28,14,4.666667,28,1033,1037,-4,0,0,0,0,79,3,3,0.56962,0,0,19,7,false,true,true,0.581,0.419
0,10,-10,0,10,-10,1507,1554,-47,0,0,0,0,97,1,1,0.298969,0,0,10,19,false,true,false,0.276,0.724
48,47,1,24,23.5,1,306,169,137,0,0,0,0,86,2,2,0.395349,0,0,15,10,false,true,true,0.786,0.214
396,233,163,22,13.705882,163,777,830,-53,1,0,0.055556,0,-12,18,17,-3.416667,0,0,7,11,false,true,true,1,0
306,237,69,27.818182,23.7,69,1203,1221,-18,2,0,0.181818,0,30,11,10,1.166667,0,0,19,7,false,true,true,0.959,0.041
370,351,19,16.818182,15.954545,19,1181,1149,32,0,1,0,0.045455,-29,22,22,-1.551724,0,0,3,1,false,true,true,1,0
0,12,-12,0,12,-12,299,315,-16,0,0,0,0,97,1,1,0.43299,0,1,7,10,false,true,false,0.133,0.867
118,69,49,23.6,17.25,49,1065,1030,35,0,0,0,0,71,5,4,0.478873,0,1,18,9,false,true,true,0.743,0.257
222,90,132,37,15,132,918,619,299,2,0,0.333333,0,55,6,6,0.636364,1,0,16,17,false,true,true,0.999,0.001
88,154,-66,17.6,30.8,-66,594,605,-11,0,0,0,0,67,5,5,0.552239,1,0,8,7,false,true,false,0.072,0.928
323,156,167,29.363636,14.181818,167,918,619,299,2,0,0.181818,0,21,11,11,1.666667,2,0,8,14,false,true,true,1,0
220,212,8,20,19.272727,8,518,448,70,0,0,0,0,24,11,11,1.416667,0,0,12,17,false,true,true,0.768,0.232
181,107,74,22.625,15.285714,74,561,526,35,0,0,0,0,39,8,7,0.897436,0,0,16,11,false,true,true,0.962,0.038
372,326,46,24.8,23.285714,46,1014,948,66,1,0,0.066667,0,-6,15,14,-5.5,0,0,9,5,false,true,true,1,0
326,284,42,25.076923,23.666667,42,1636,1576,60,0,2,0,0.166667,9,13,12,3.777778,0,0,11,14,false,true,true,0.838,0.162
127,139,-12,14.111111,17.375,-12,699,448,251,0,0,0,0,52,9,8,0.769231,0,0,13,12,false,true,false,0.491,0.509
98,145,-47,19.6,29,-47,1554,1573,-19,0,0,0,0,65,5,5,0.523077,0,0,9,12,false,true,false,0.213,0.787
189,199,-10,12.6,13.266667,-10,611,584,27,0,0,0,0,15,15,15,2.933333,0,0,10,15,false,true,true,0.763,0.237
183,76,107,45.75,19,107,1349,1302,47,0,0,0,0,64,4,4,0.453125,0,0,14,7,false,true,true,0.972,0.028
297,268,29,16.5,15.764706,29,1583,1422,161,1,0,0.055556,0,11,18,17,4.636364,0,0,11,17,false,true,true,1,0
205,167,38,22.777778,20.875,38,1493,1513,-20,1,0,0.111111,0,42,9,8,0.785714,0,1,20,17,false,true,true,0.71,0.29
114,100,14,22.8,25,14,1406,1454,-48,0,1,0,0.25,60,5,4,0.566667,1,0,7,11,false,true,true,0.611,0.389
112,75,37,37.333333,37.5,37,1030,998,32,0,0,0,0,78,3,2,0.487179,0,0,8,13,false,true,true,0.593,0.407
369,281,88,20.5,16.529412,88,613,569,44,0,0,0,0,-17,18,17,-2.294118,0,0,1,2,false,true,true,1,0
321,227,94,21.4,16.214286,94,371,336,35,2,0,0.133333,0,-15,15,14,-2.533333,0,0,5,16,false,true,true,1,0
223,164,59,20.272727,16.4,59,691,473,218,0,0,0,0,27,11,10,1.333333,0,0,14,19,false,true,true,0.883,0.117
234,216,18,16.714286,16.615385,18,527,581,-54,0,0,0,0,10,14,13,4.2,0,0,20,16,false,true,true,0.546,0.454
245,208,37,15.3125,13.866667,37,613,502,111,0,0,0,0,0,16,15,0,1,1,7,22,false,true,true,0.784,0.216
277,229,48,18.466667,16.357143,48,808,639,169,0,0,0,0,7,15,14,5.857143,0,1,11,8,false,true,true,0.859,0.141
366,280,86,22.875,18.666667,86,416,282,134,1,0,0.0625,0,-12,16,15,-2.833333,0,0,3,6,false,true,true,1,0
156,131,25,19.5,16.375,25,859,786,73,0,0,0,0,46,8,8,0.826087,0,0,23,16,false,true,true,0.892,0.108
93,157,-64,23.25,39.25,-64,1431,825,606,0,1,0,0.25,63,4,4,0.539683,1,0,6,16,false,true,true,1,0
46,14,32,23,14,32,1691,1692,-1,0,0,0,0,87,2,1,0.344828,0,0,8,9,false,true,true,0.554,0.446
157,88,69,39.25,22,69,1245,1241,4,1,1,0.25,0.25,68,4,4,0.426471,0,0,13,21,false,true,true,0.982,0.018
357,327,30,18.789474,17.210526,30,1075,989,86,1,0,0.052632,0,-17,19,19,-2.294118,0,0,8,6,false,true,true,0.999,0.001
367,279,88,33.363636,25.363636,88,1645,1777,-132,2,0,0.181818,0,-2,11,11,-12.5,0,0,10,1,false,true,true,1,0
252,190,62,18,14.615385,62,1164,1201,-37,0,0,0,0,14,14,13,3,0,1,23,9,false,true,true,0.912,0.088
298,239,59,22.923077,19.916667,59,948,933,15,1,0,0.076923,0,23,13,12,1.652174,0,0,7,14,false,true,true,0.944,0.056
331,248,83,33.1,24.8,83,1489,1405,84,2,0,0.2,0,20,10,10,1.4,0,0,8,19,false,true,true,1,0
216,146,70,24,16.222222,70,1220,1261,-41,2,0,0.222222,0,42,9,9,1.071429,0,0,22,15,false,true,true,0.96,0.04
155,212,-57,19.375,26.5,-57,1305,1218,87,0,0,0,0,38,8,8,1,1,0,7,8,false,true,false,0.051,0.949
88,64,24,22,16,24,739,480,259,1,0,0.25,0,67,4,4,0.537313,0,0,10,14,false,true,true,0.841,0.159
292,229,63,16.222222,13.470588,63,698,742,-44,1,0,0.055556,0,0,18,17,0,0,0,11,13,false,true,true,0.939,0.061
157,129,28,22.428571,21.5,28,613,569,44,0,0,0,0,53,7,6,0.735849,2,0,6,10,false,true,true,0.937,0.063
49,22,27,24.5,22,27,1148,1164,-16,0,0,0,0,88,2,1,0.284091,0,0,14,12,false,true,true,0.557,0.443
347,275,72,18.263158,14.473684,72,1170,1156,14,1,0,0.052632,0,-26,19,19,-1.461538,0,0,1,2,true,true,true,1,0
260,188,72,14.444444,11.058824,72,947,909,38,0,0,0,0,-13,18,17,-3.538462,0,0,10,34,false,true,true,1,0
120,185,-65,15,23.125,-65,1897,1793,104,0,1,0,0.125,60,8,8,0.533333,1,0,7,9,false,true,true,0.999,0.001
135,101,34,22.5,16.833333,34,859,811,48,0,0,0,0,57,6,6,0.631579,0,1,12,7,false,true,true,0.834,0.166
204,122,82,25.5,15.25,82,1065,1030,35,0,0,0,0,45,8,8,0.755556,1,0,8,8,false,true,true,0.995,0.005
288,144,144,36,20.571429,144,1093,1197,-104,2,0,0.25,0,43,8,7,0.72093,0,0,7,18,false,true,true,1,0
223,196,27,20.272727,19.6,27,1266,1247,19,0,0,0,0,28,11,10,1.142857,1,0,12,9,false,true,true,0.55,0.45
159,227,-68,19.875,28.375,-68,1501,1473,28,0,0,0,0,39,8,8,0.923077,0,0,16,20,false,true,false,0.041,0.959
87,101,-14,21.75,25.25,-14,1125,1227,-102,0,0,0,0,64,4,4,0.46875,0,0,10,24,false,true,false,0.087,0.913
350,235,115,25,18.076923,115,1220,1261,-41,2,0,0.142857,0,17,14,13,2.647059,1,0,15,11,false,true,true,1,0
67,51,16,22.333333,25.5,16,613,569,44,0,0,0,0,78,3,2,0.5,2,0,11,15,false,true,true,0.891,0.109
35,58,-23,8.75,19.333333,-23,1214,1176,38,0,0,0,0,75,4,3,0.48,1,0,18,9,false,true,false,0.407,0.593
404,226,178,19.238095,11.3,178,1033,1037,-4,0,1,0,0.05,-20,21,20,-2.25,0,1,2,2,false,true,true,1,0
27,32,-5,13.5,32,-5,1040,925,115,0,0,0,0,89,2,1,0.483146,0,0,16,8,false,true,false,0.275,0.725
309,306,3,19.3125,20.4,3,1439,1294,145,1,0,0.0625,0,-8,16,15,-4.5,1,0,3,18,false,true,true,0.822,0.178
210,253,-43,17.5,21.083333,-43,613,611,2,0,0,0,0,11,12,12,3.454545,0,0,19,8,false,true,false,0.429,0.571
235,282,-47,19.583333,25.636364,-47,1265,1045,220,0,1,0,0.090909,14,12,11,3,0,0,20,9,false,true,false,0.055,0.945
188,132,56,37.6,33,56,1302,1349,-47,0,0,0,0,58,5,4,0.482759,0,0,13,7,false,true,true,0.767,0.233
318,289,29,18.705882,17,29,1176,1127,49,0,0,0,0,-15,17,17,-2.466667,0,0,2,1,false,true,true,0.996,0.004
304,230,74,20.266667,15.333333,74,830,907,-77,1,0,0.066667,0,5,15,15,7.8,0,1,18,6,false,true,true,0.995,0.005
75,104,-29,25,34.666667,-29,1394,1424,-30,0,1,0,0.333333,73,3,3,0.438356,0,0,22,7,false,true,false,0.385,0.615
171,192,-21,21.375,24,-21,1047,1094,-47,1,1,0.125,0.125,41,8,8,0.878049,0,0,17,9,false,true,true,0.627,0.373
352,295,57,22,18.4375,57,1434,1493,-59,1,0,0.0625,0,-10,16,16,-3.7,0,0,6,2,false,true,true,1,0
84,15,69,28,7.5,69,830,907,-77,1,0,0.333333,0,80,3,2,0.4875,0,0,10,14,false,true,true,0.746,0.254
289,280,9,22.230769,21.538462,9,1406,1454,-48,0,2,0,0.153846,0,13,13,0,1,0,19,11,false,true,true,0.971,0.029
97,108,-11,19.4,21.6,-11,892,819,73,0,1,0,0.2,62,5,5,0.548387,1,0,23,11,false,true,true,0.774,0.226
191,194,-3,19.1,21.555556,-3,1077,1094,-17,0,0,0,0,37,10,9,1.135135,0,0,7,7,false,true,false,0.267,0.733
310,190,120,34.444444,23.75,120,1245,1241,4,1,1,0.111111,0.125,30,9,8,0.966667,0,0,15,11,false,true,true,0.99,0.01
398,288,110,26.533333,20.571429,110,1334,1256,78,2,0,0.133333,0,-6,15,14,-5.166667,0,0,2,2,false,true,true,1,0
210,234,-24,17.5,21.272727,-24,613,611,2,0,0,0,0,16,12,11,2.375,0,0,19,7,false,true,false,0.442,0.558
271,240,31,24.636364,24,31,1023,1110,-87,1,1,0.090909,0.1,14,11,10,2.142857,1,0,11,9,false,true,true,0.97,0.03
219,182,37,24.333333,20.222222,37,596,595,1,1,0,0.111111,0,37,9,9,1.081081,0,0,15,12,false,true,true,0.78,0.22
154,134,20,17.111111,14.888889,20,801,807,-6,0,0,0,0,34,9,9,1.029412,0,0,16,15,false,true,true,0.884,0.116
27,44,-17,13.5,22,-17,1265,1237,28,0,0,0,0,83,2,2,0.361446,0,0,10,14,false,true,false,0.277,0.723
96,89,7,19.2,17.8,7,1211,1173,38,0,0,0,0,69,5,5,0.507246,0,1,14,6,false,true,false,0.455,0.545
383,313,70,25.533333,20.866667,70,1762,1582,180,2,3,0.133333,0.2,-8,15,15,-4,0,0,1,24,false,true,true,0.992,0.008
106,47,59,26.5,11.75,59,1295,1477,-182,1,0,0.25,0,74,4,4,0.621622,1,0,8,7,false,true,true,0.772,0.228
109,122,-13,15.571429,17.428571,-13,1244,1361,-117,0,0,0,0,65,7,7,0.584615,0,1,11,6,false,true,false,0.076,0.924
150,210,-60,25,42,-60,1636,1576,60,0,2,0,0.4,48,6,5,0.708333,0,0,10,12,false,true,false,0.198,0.802
339,322,17,19.941176,20.125,17,1493,1513,-20,1,0,0.058824,0,-8,17,16,-4.125,0,1,5,4,true,true,true,0.963,0.037
85,103,-18,17,20.6,-18,1482,1394,88,0,0,0,0,70,5,5,0.514286,1,0,6,17,false,true,false,0.332,0.668
346,313,33,20.352941,19.5625,33,1304,1040,264,1,0,0.058824,0,-9,17,16,-3.666667,0,1,2,2,true,true,true,0.792,0.208
334,229,105,20.875,15.266667,105,691,675,16,0,0,0,0,-4,16,15,-9.25,0,1,5,9,false,true,true,1,0
327,239,88,17.210526,13.277778,88,758,750,8,0,0,0,0,-23,19,18,-1.608696,0,0,4,1,true,true,true,1,0
357,288,69,25.5,20.571429,69,1245,1232,13,1,0,0.071429,0,-23,14,14,-1.26087,0,0,2,2,false,true,true,1,0
282,278,4,14.842105,15.444444,4,576,494,82,0,0,0,0,-11,19,18,-4,0,1,8,6,false,true,true,0.753,0.247
179,162,17,19.888889,20.25,17,1547,1439,108,1,0,0.111111,0,44,9,8,0.840909,0,0,17,7,false,true,false,0.321,0.679
321,262,59,22.928571,20.153846,59,995,912,83,2,0,0.142857,0,17,14,13,2.588235,0,0,14,10,false,true,true,0.988,0.012
346,326,20,19.222222,18.111111,20,1334,1270,64,1,0,0.055556,0,-12,18,18,-3.083333,0,0,2,2,false,true,true,0.974,0.026
349,329,20,26.846154,27.416667,20,1265,1237,28,1,0,0.076923,0,1,13,12,30,0,1,6,19,false,true,true,0.988,0.012
8,11,-3,8,11,-3,539,632,-93,0,0,0,0,93,1,1,0.494624,0,1,11,16,false,true,false,0.205,0.795
16,29,-13,16,29,-13,704,691,13,0,0,0,0,91,1,1,0.417582,1,0,18,10,false,true,true,0.738,0.262
126,125,1,11.454545,11.363636,1,892,768,124,0,0,0,0,44,11,11,0.977273,1,0,6,16,false,true,true,0.874,0.126
146,91,55,48.666667,30.333333,55,1633,1580,53,1,0,0.333333,0,74,3,3,0.378378,0,0,17,18,false,true,true,0.719,0.281
290,238,52,26.363636,23.8,52,965,1013,-48,1,0,0.090909,0,16,11,10,2.0625,0,1,11,9,false,true,true,0.712,0.288
176,124,52,22,15.5,52,1691,1692,-1,0,0,0,0,39,8,8,0.769231,0,0,20,12,false,true,true,0.785,0.215
135,197,-62,15,24.625,-62,613,611,2,0,0,0,0,34,9,8,1.117647,0,0,8,13,false,true,false,0.025,0.975
200,108,92,22.222222,13.5,92,421,306,115,0,1,0,0.125,30,9,8,1.466667,0,0,44,7,false,true,true,0.979,0.021
249,204,45,20.75,17,45,1548,1493,55,1,0,0.083333,0,18,12,12,2.277778,0,0,7,27,false,true,true,0.959,0.041
223,191,32,24.777778,21.222222,32,902,866,36,0,0,0,0,27,9,9,1.185185,0,0,8,8,false,true,true,0.853,0.147
0,34,-34,0,34,-34,1606,1544,62,0,0,0,0,95,1,1,0.473684,1,0,19,7,false,true,false,0.439,0.561
235,166,69,18.076923,13.833333,69,880,952,-72,0,0,0,0,13,13,12,3.153846,0,0,16,23,false,true,true,0.972,0.028
269,242,27,17.933333,17.285714,27,1214,1176,38,0,0,0,0,14,15,14,2.571429,0,0,9,11,false,true,true,0.788,0.212
206,193,13,14.714286,14.846154,13,540,518,22,0,0,0,0,11,14,13,3.636364,0,0,7,20,false,true,true,0.802,0.198
323,301,22,17,15.842105,22,908,859,49,0,0,0,0,-20,19,19,-1.95,0,0,1,2,false,true,true,0.999,0.001
302,254,48,16.777778,14.111111,48,804,683,121,0,0,0,0,-6,18,18,-7.5,0,1,16,11,false,true,true,1,0
116,80,36,14.5,10,36,584,565,19,0,0,0,0,49,8,8,0.938776,0,0,16,21,false,true,true,0.96,0.04
276,243,33,13.8,12.15,33,947,909,38,0,0,0,0,-26,20,20,-1.769231,0,1,7,26,false,true,true,1,0
271,183,88,30.111111,22.875,88,1431,825,606,1,1,0.111111,0.125,29,9,8,1.172414,0,0,17,19,false,true,true,1,0
279,159,120,25.363636,15.9,120,904,668,236,0,0,0,0,15,11,10,2.266667,0,2,9,7,false,true,true,1,0
330,275,55,19.411765,17.1875,55,866,949,-83,0,0,0,0,-9,17,16,-4.444444,1,0,3,10,false,true,true,0.999,0.001
70,100,-30,17.5,25,-30,1304,1040,264,0,0,0,0,72,4,4,0.458333,1,0,6,19,false,true,false,0.431,0.569
126,166,-40,21,33.2,-40,834,844,-10,0,1,0,0.2,53,6,5,0.679245,0,0,12,10,false,true,false,0.266,0.734
78,72,6,19.5,24,6,1244,1361,-117,0,0,0,0,79,4,3,0.481013,0,0,11,10,false,true,false,0.154,0.846
201,143,58,16.75,13,58,498,43,455,0,0,0,0,19,12,11,1.947368,0,0,14,17,false,true,true,0.898,0.102
67,27,40,22.333333,9,40,777,830,-53,0,0,0,0,76,3,3,0.539474,0,0,14,10,false,true,true,0.768,0.232
392,275,117,24.5,18.333333,117,1069,917,152,1,1,0.0625,0.066667,-9,16,15,-3.777778,0,0,2,7,false,true,true,1,0
338,258,80,21.125,16.125,80,916,837,79,1,0,0.0625,0,-2,16,16,-20,0,0,8,12,false,true,true,1,0
213,182,31,21.3,18.2,31,1388,1477,-89,1,0,0.1,0,30,10,10,1.6,0,0,14,11,false,true,true,0.93,0.07
337,299,38,19.823529,18.6875,38,1090,1244,-154,0,0,0,0,-14,17,16,-2.642857,0,0,7,2,false,true,true,1,0
156,198,-42,19.5,24.75,-42,947,810,137,0,1,0,0.125,43,8,8,0.976744,0,0,29,13,false,true,false,0.38,0.62
90,127,-37,12.857143,21.166667,-37,1156,1184,-28,0,0,0,0,52,7,6,0.538462,1,0,9,10,false,true,false,0.267,0.733
32,46,-14,10.666667,23,-14,218,86,132,0,0,0,0,80,3,2,0.5,0,0,17,10,false,true,true,0.541,0.459
447,297,150,29.8,19.8,150,1550,1546,4,0,1,0,0.066667,-6,15,15,-5,1,0,7,7,true,true,true,1,0
413,345,68,21.736842,18.157895,68,1227,1060,167,0,2,0,0.105263,-30,19,19,-1.333333,0,0,1,1,false,true,true,1,0
102,23,79,34,11.5,79,993,897,96,1,0,0.333333,0,78,3,2,0.602564,0,0,10,7,false,true,true,0.882,0.118
321,198,123,32.1,22,123,971,621,350,2,0,0.2,0,25,10,9,1.28,1,0,14,7,false,true,true,1,0
363,224,139,21.352941,13.176471,139,554,342,212,0,0,0,0,-17,17,17,-2.117647,0,0,1,4,false,true,true,1,0
164,67,97,27.333333,13.4,97,1586,1782,-196,0,0,0,0,59,6,5,0.677966,1,0,9,7,false,true,true,0.98,0.02
251,226,25,20.916667,18.833333,25,1439,1294,145,1,0,0.083333,0,19,12,12,1.894737,0,0,9,25,false,true,true,0.732,0.268
0,0,0,0,0,0,1144,1014,130,0,0,0,0,100,1,0,0.36,0,0,10,0,false,true,false,0.494,0.506
385,312,73,32.083333,28.363636,73,1890,2020,-130,1,2,0.083333,0.181818,0,12,11,0,0,1,9,15,false,true,true,0.998,0.002
289,230,59,22.230769,17.692308,59,1516,1397,119,0,1,0,0.076923,3,13,13,11,0,1,24,9,false,true,true,0.855,0.145
311,220,91,18.294118,13.75,91,1091,1078,13,0,0,0,0,3,17,16,14.333333,0,0,10,11,false,true,true,1,0
305,241,64,16.052632,13.388889,64,416,374,42,0,0,0,0,-3,19,18,-15.333333,0,0,13,7,false,true,true,0.999,0.001
384,280,104,21.333333,16.470588,104,1030,998,32,1,0,0.055556,0,-20,18,17,-1.9,0,0,1,2,false,true,true,1,0
116,146,-30,23.2,29.2,-30,1030,1144,-114,0,1,0,0.2,63,5,5,0.555556,0,0,22,7,false,true,false,0.363,0.637
197,90,107,28.142857,15,107,1216,1230,-14,1,0,0.142857,0,54,7,6,0.592593,1,0,15,13,false,true,true,0.992,0.008
87,70,17,29,23.333333,17,1153,1065,88,0,1,0,0.333333,72,3,3,0.388889,0,0,16,16,false,true,true,0.736,0.264
381,242,139,23.8125,16.133333,139,1110,1039,71,0,0,0,0,-10,16,15,-3.6,1,0,5,13,false,true,true,1,0
175,94,81,25,15.666667,81,1334,1256,78,1,0,0.142857,0,54,7,6,0.574074,0,0,13,9,false,true,true,0.981,0.019
262,190,72,23.818182,19,72,1731,1691,40,1,0,0.090909,0,19,11,10,1.789474,0,0,10,11,false,true,true,0.982,0.018
22,12,10,11,12,10,1161,1166,-5,0,0,0,0,89,2,1,0.393258,0,0,9,10,false,true,false,0.476,0.524
353,233,120,27.153846,17.923077,120,1211,1173,38,0,0,0,0,14,13,13,2.5,0,0,9,10,false,true,true,1,0
235,179,56,26.111111,19.888889,56,971,1180,-209,1,0,0.111111,0,39,9,9,0.820513,0,0,7,12,false,true,true,0.93,0.07
14,0,14,14,0,14,1245,1232,13,0,0,0,0,94,1,0,0.308511,0,0,10,0,false,true,true,0.562,0.438
185,183,2,16.818182,16.636364,2,448,598,-150,0,0,0,0,23,11,11,1.565217,1,0,12,11,false,true,true,0.52,0.48
112,62,50,28,20.666667,50,554,342,212,0,0,0,0,72,4,3,0.5,0,1,10,7,false,true,true,0.859,0.141
94,106,-12,15.666667,17.666667,-12,95,378,-283,0,0,0,0,56,6,6,0.625,0,0,16,8,false,true,false,0.464,0.536
148,113,35,24.666667,22.6,35,1501,1622,-121,0,0,0,0,61,6,5,0.508197,0,0,11,16,false,true,false,0.337,0.663
257,285,-28,19.769231,21.923077,-28,1096,1009,87,1,0,0.076923,0,29,13,13,1.517241,0,0,8,10,false,true,false,0.047,0.953
333,311,22,19.588235,19.4375,22,1334,1270,64,1,0,0.058824,0,-1,17,16,-37,0,1,6,5,false,true,true,0.993,0.007
339,295,44,18.833333,17.352941,44,448,598,-150,0,0,0,0,-18,18,17,-2,0,0,4,8,false,true,true,1,0
190,167,23,17.272727,15.181818,23,1029,1075,-46,0,0,0,0,35,11,11,1.371429,2,0,5,14,false,true,true,0.985,0.015
73,34,39,18.25,8.5,39,1428,1302,126,0,0,0,0,74,4,4,0.716216,0,1,7,15,false,true,true,0.576,0.424
329,316,13,18.277778,18.588235,13,885,719,166,0,0,0,0,-16,18,17,-2.375,0,0,3,8,false,true,false,0.233,0.767
29,39,-10,9.666667,13,-10,698,742,-44,0,0,0,0,86,3,3,0.476744,0,0,24,13,false,true,false,0.207,0.793
374,258,116,18.7,12.9,116,596,595,1,1,0,0.05,0,-22,20,20,-1.818182,0,0,1,11,true,true,true,1,0
85,34,51,42.5,17,51,986,856,130,1,0,0.5,0,82,2,2,0.378049,0,0,18,15,false,true,true,0.609,0.391
310,290,20,19.375,19.333333,20,1295,1281,14,0,0,0,0,8,16,15,4.75,0,0,17,8,false,true,true,0.676,0.324
242,166,76,22,15.090909,76,1551,1550,1,0,0,0,0,24,11,11,1.75,0,1,13,19,false,true,true,0.929,0.071
189,197,-8,12.6,14.071429,-8,611,584,27,0,0,0,0,17,15,14,2.588235,0,0,10,15,false,true,false,0.475,0.525
100,53,47,20,13.25,47,1551,1550,1,0,0,0,0,70,5,4,0.6,0,1,16,24,false,true,false,0.418,0.582
182,131,51,20.222222,16.375,51,971,658,313,0,0,0,0,40,9,8,0.9,0,0,10,22,false,true,true,0.574,0.426
57,75,-18,14.25,18.75,-18,1156,1184,-28,0,0,0,0,66,4,4,0.424242,1,0,13,19,false,true,false,0.476,0.524
79,49,30,19.75,16.333333,30,1029,1075,-46,0,0,0,0,78,4,3,0.615385,0,0,17,10,false,true,true,0.561,0.439
145,113,32,20.714286,16.142857,32,1216,1228,-12,0,0,0,0,56,7,7,0.589286,0,0,9,11,false,true,true,0.644,0.356
108,45,63,21.6,11.25,63,1067,95,972,0,0,0,0,73,5,4,0.465753,0,0,21,7,false,true,true,1,0
194,184,10,19.4,18.4,10,1572,1550,22,1,0,0.1,0,33,10,10,1.181818,0,1,21,9,false,true,false,0.49,0.51
346,205,141,31.454545,18.636364,141,1439,1353,86,1,0,0.090909,0,20,11,11,1.5,0,0,7,22,false,true,true,1,0
39,31,8,19.5,31,8,908,859,49,0,0,0,0,89,2,1,0.438202,0,0,11,8,false,true,false,0.339,0.661
440,217,223,55,31,223,991,996,-5,3,0,0.375,0,35,8,7,0.857143,0,0,7,11,false,true,true,1,0
222,184,38,18.5,15.333333,38,831,830,1,0,0,0,0,21,12,12,1.761905,1,0,22,9,false,true,true,0.99,0.01
184,143,41,16.727273,14.3,41,691,675,16,0,0,0,0,27,11,10,1.407407,0,0,13,24,false,true,true,0.903,0.097
198,171,27,22,21.375,27,1127,1134,-7,0,0,0,0,34,9,8,0.882353,0,1,14,6,false,true,false,0.494,0.506
298,266,32,19.866667,19,32,1127,1176,-49,0,0,0,0,7,15,14,6,0,0,10,8,false,true,true,0.665,0.335
226,235,-9,20.545455,21.363636,-9,1277,1166,111,0,1,0,0.090909,21,11,11,1.714286,0,0,12,17,false,true,false,0.36,0.64
155,173,-18,11.923077,14.416667,-18,826,771,55,0,0,0,0,34,13,12,1.323529,1,1,24,9,false,true,false,0.485,0.515
335,237,98,23.928571,16.928571,98,1110,1039,71,0,0,0,0,-2,14,14,-18,0,0,8,7,false,true,true,1,0
208,199,9,18.909091,18.090909,9,921,1072,-151,1,0,0.090909,0,32,11,11,1.1875,0,1,17,7,false,true,true,0.529,0.471
341,219,122,21.3125,13.6875,122,777,830,-53,1,0,0.0625,0,-2,16,16,-20.5,0,0,16,12,false,true,true,1,0
339,319,20,16.95,16.789474,20,1159,1051,108,0,0,0,0,-25,20,19,-1.6,0,0,3,1,false,true,true,0.999,0.001
379,323,56,22.294118,20.1875,56,1530,1550,-20,1,1,0.058824,0.0625,-18,17,16,-1.888889,0,0,2,3,false,true,true,1,0
105,79,26,21,15.8,26,272,288,-16,0,0,0,0,65,5,5,0.8,1,0,9,20,false,true,true,0.512,0.488
185,77,108,30.833333,15.4,108,986,856,130,1,0,0.166667,0,55,6,5,0.563636,1,0,6,22,false,true,true,0.991,0.009
41,13,28,20.5,13,28,620,513,107,0,0,0,0,88,2,1,0.511364,0,0,8,11,false,true,true,0.784,0.216
38,21,17,19,21,17,999,1011,-12,0,0,0,0,88,2,1,0.522727,0,0,7,15,false,true,false,0.485,0.515
455,334,121,41.363636,33.4,121,1885,1793,92,0,0,0,0,8,11,10,3.375,0,0,7,13,false,true,true,1,0
0,0,0,0,0,0,1266,1247,19,0,0,0,0,100,1,0,0.32,0,0,16,0,false,true,true,0.542,0.458
162,72,90,27,12,90,1004,653,351,0,0,0,0,54,6,6,0.648148,0,0,12,14,false,true,true,0.962,0.038
221,220,1,20.090909,22,1,1270,1348,-78,0,0,0,0,32,11,10,1.1875,0,0,17,7,false,true,false,0.208,0.792
49,43,6,24.5,21.5,6,1148,1164,-16,0,0,0,0,83,2,2,0.301205,0,0,14,11,false,true,true,0.558,0.442
351,269,82,25.071429,20.692308,82,1302,1234,68,1,1,0.071429,0.076923,-2,14,13,-15.5,0,0,6,12,false,true,true,0.994,0.006
233,174,59,29.125,24.857143,59,1142,1095,47,1,0,0.125,0,40,8,7,0.875,0,1,16,15,false,true,true,0.852,0.148
291,298,-7,13.227273,13.545455,-7,1029,1075,-46,0,0,0,0,-20,22,22,-2.4,1,0,4,1,false,true,true,0.948,0.052
350,179,171,16.666667,8.95,171,859,719,140,0,1,0,0.05,-29,21,20,-1.827586,0,1,17,9,false,true,true,1,0
251,273,-22,25.1,27.3,-22,1636,1576,60,0,2,0,0.2,20,10,10,1.7,0,0,9,9,false,true,false,0.265,0.735
245,144,101,35,24,101,1245,1241,4,1,1,0.142857,0.166667,48,7,6,0.604167,0,0,17,12,false,true,true,0.986,0.014
217,238,-21,19.727273,21.636364,-21,1027,856,171,1,1,0.090909,0.090909,11,11,11,3,1,0,21,10,false,true,false,0.498,0.502
151,157,-6,18.875,19.625,-6,1394,1230,164,0,1,0,0.125,42,8,8,0.904762,0,0,10,18,false,true,false,0.395,0.605
208,160,48,23.111111,17.777778,48,1270,1315,-45,0,0,0,0,37,9,9,0.972973,0,0,10,20,false,true,true,0.878,0.122
168,158,10,24,26.333333,10,1102,1245,-143,1,0,0.142857,0,37,7,6,0.756757,0,0,16,11,false,true,false,0.229,0.771
186,190,-4,18.6,19,-4,1073,1177,-104,0,0,0,0,29,10,10,1.103448,0,0,7,20,false,true,false,0.078,0.922
149,89,60,29.8,17.8,60,742,696,46,0,0,0,0,58,5,5,0.551724,0,0,16,10,false,true,true,0.95,0.05
357,232,125,23.8,16.571429,125,1651,1691,-40,1,0,0.066667,0,-3,15,14,-11.333333,1,0,6,10,false,true,true,1,0
47,18,29,23.5,18,29,1735,1770,-35,0,0,0,0,83,2,1,0.337349,0,0,8,11,false,true,true,0.543,0.457
284,225,59,20.285714,17.307692,59,561,526,35,0,0,0,0,-3,14,13,-11.666667,0,0,13,15,false,true,true,0.987,0.013
274,137,137,21.076923,10.538462,137,993,897,96,1,0,0.076923,0,10,13,13,4.7,0,1,22,19,false,true,true,1,0
127,100,27,21.166667,16.666667,27,1803,1552,251,0,0,0,0,60,6,6,0.466667,0,1,10,6,false,true,true,0.999,0.001
239,209,30,23.9,20.9,30,1295,1281,14,0,0,0,0,38,10,10,1,0,1,7,9,false,true,true,0.584,0.416
29,32,-3,14.5,16,-3,1547,1439,108,0,0,0,0,88,2,2,0.420455,1,0,6,11,false,true,false,0.465,0.535
342,317,25,20.117647,18.647059,25,1344,1209,135,1,1,0.058824,0.058824,-21,17,17,-1.619048,0,0,3,1,true,true,true,0.972,0.028
459,313,146,24.157895,16.473684,146,1270,1322,-52,1,0,0.052632,0,-22,19,19,-1.727273,0,0,2,2,true,true,true,1,0
382,207,175,17.363636,9.857143,175,1176,1076,100,0,0,0,0,4,22,21,14.75,0,0,10,16,false,true,true,1,0
93,22,71,46.5,22,71,1245,1241,4,1,1,0.5,1,83,2,1,0.349398,0,0,7,17,false,true,true,0.942,0.058
185,136,49,15.416667,12.363636,49,698,742,-44,0,0,0,0,39,12,11,1.051282,0,0,7,16,false,true,true,0.906,0.094
34,44,-10,17,22,-10,1245,1232,13,1,0,0.5,0,78,2,2,0.371795,0,0,10,8,false,true,true,0.897,0.103
132,57,75,16.5,8.142857,75,1428,1302,126,0,0,0,0,53,8,7,1,0,1,10,15,false,true,true,0.9,0.1
339,287,52,30.818182,28.7,52,1875,1793,82,2,1,0.181818,0.1,17,11,10,1.764706,0,0,8,9,false,true,true,0.991,0.009
178,149,29,17.8,16.555556,29,613,461,152,0,0,0,0,31,10,9,1.193548,0,0,12,9,false,true,true,0.653,0.347
197,139,58,24.625,17.375,58,960,1070,-110,1,0,0.125,0,45,8,8,0.777778,0,0,12,16,false,true,true,0.928,0.072
362,378,-16,21.294118,23.625,-16,834,844,-10,1,2,0.058824,0.125,-18,17,16,-2,0,0,1,9,false,true,false,0.375,0.625
265,210,55,24.090909,19.090909,55,1075,1152,-77,0,1,0,0.090909,24,11,11,1.666667,0,0,10,11,false,true,true,0.978,0.022
387,213,174,32.25,19.363636,174,1501,1622,-121,2,0,0.166667,0,13,12,11,2.384615,0,0,16,12,false,true,true,1,0
72,78,-6,12,15.6,-6,539,632,-93,0,0,0,0,69,6,5,0.666667,0,1,8,7,false,true,false,0.101,0.899
221,180,41,24.555556,20,41,1093,1090,3,1,1,0.111111,0.111111,41,9,9,0.829268,0,1,11,11,false,true,true,0.873,0.127
356,259,97,29.666667,23.545455,97,1189,1266,-77,1,0,0.083333,0,10,12,11,3.4,0,0,22,7,false,true,true,1,0
244,201,43,20.333333,16.75,43,844,821,23,0,0,0,0,37,12,12,1.135135,0,0,19,7,false,true,true,0.917,0.083
256,247,9,17.066667,16.466667,9,527,581,-54,0,0,0,0,0,15,15,0,1,0,16,12,false,true,true,0.813,0.187
138,78,60,27.6,19.5,60,1220,1261,-41,1,0,0.2,0,69,5,4,0.652174,0,0,12,13,false,true,true,0.795,0.205
166,275,-109,16.6,27.5,-109,1265,1045,220,0,1,0,0.1,23,10,10,1.826087,0,0,20,10,false,true,false,0.001,0.999
350,306,44,19.444444,18,44,795,830,-35,1,1,0.055556,0.058824,-14,18,17,-3,0,0,2,7,false,true,true,0.972,0.028
409,274,135,25.5625,18.266667,135,986,856,130,1,0,0.0625,0,-18,16,15,-1.722222,0,0,3,2,true,true,true,1,0
118,126,-8,16.857143,21,-8,1100,1008,92,0,0,0,0,62,7,6,0.580645,2,0,9,11,false,true,true,0.729,0.271
123,77,46,30.75,25.666667,46,1109,1065,44,0,0,0,0,78,4,3,0.423077,0,0,17,8,false,true,true,0.736,0.264
385,237,148,20.263158,12.473684,148,1586,1782,-196,0,0,0,0,-24,19,19,-1.666667,1,0,0,2,false,true,true,1,0
291,296,-5,15.315789,16.444444,-5,316,306,10,0,2,0,0.111111,-20,19,18,-1.9,0,0,1,5,false,true,true,0.844,0.156
77,46,31,38.5,23,31,1397,1195,202,0,0,0,0,84,2,2,0.416667,0,0,12,23,false,true,true,0.867,0.133
97,64,33,24.25,21.333333,33,804,988,-184,1,0,0.25,0,71,4,3,0.464789,0,0,11,29,false,true,false,0.456,0.544
135,114,21,16.875,16.285714,21,540,518,22,0,0,0,0,49,8,7,0.816327,0,0,11,13,false,true,true,0.7,0.3
451,371,80,37.583333,30.916667,80,1770,1689,81,1,1,0.083333,0.083333,-13,12,12,-2,0,0,1,8,false,true,true,1,0
18,16,2,18,16,2,1244,1361,-117,0,0,0,0,93,1,1,0.408602,0,0,15,17,false,true,false,0.246,0.754
205,113,92,25.625,16.142857,92,1216,1230,-14,1,0,0.125,0,49,8,7,0.653061,1,0,15,9,false,true,true,0.988,0.012
223,251,-28,20.272727,22.818182,-28,1554,1573,-19,0,0,0,0,30,11,11,1.133333,0,1,7,8,false,true,false,0.075,0.925
174,168,6,29,28,6,1890,2020,-130,0,1,0,0.166667,46,6,6,0.630435,1,0,9,12,false,true,true,0.734,0.266
318,223,95,21.2,15.928571,95,691,675,16,0,0,0,0,4,15,14,9.25,0,1,11,7,false,true,true,1,0
284,266,18,23.666667,22.166667,18,1554,1622,-68,2,0,0.166667,0,6,12,12,5.166667,1,0,9,8,false,true,true,0.959,0.041
106,12,94,35.333333,6,94,918,619,299,1,0,0.333333,0,81,3,2,0.432099,0,0,10,18,false,true,true,0.957,0.043
273,204,69,34.125,25.5,69,1826,1656,170,2,0,0.25,0,33,8,8,0.818182,0,0,7,10,false,true,true,1,0
327,297,30,19.235294,17.470588,30,1075,989,86,1,0,0.058824,0,-2,17,17,-19.5,0,0,15,13,false,true,true,0.962,0.038
348,319,29,24.857143,24.538462,29,1636,1576,60,0,2,0,0.153846,1,14,13,34,0,0,10,25,false,true,true,0.694,0.306
387,290,97,25.8,19.333333,97,1550,1466,84,1,0,0.066667,0,-6,15,15,-6.166667,0,0,10,14,false,true,true,1,0
156,120,36,19.5,17.142857,36,613,461,152,0,0,0,0,43,8,7,0.860465,0,0,10,8,false,true,true,0.782,0.218
374,327,47,19.684211,18.166667,47,1452,1469,-17,1,1,0.052632,0.055556,-27,19,18,-1.407407,0,0,1,1,false,true,true,1,0
323,340,-17,24.846154,26.153846,-17,1030,1144,-114,0,2,0,0.153846,11,13,13,3.181818,1,0,15,7,false,true,true,0.787,0.213
327,264,63,15.571429,12.571429,63,416,306,110,0,0,0,0,-26,21,21,-1.615385,1,0,1,1,true,true,true,1,0
229,242,-13,25.444444,26.888889,-13,1075,1009,66,1,0,0.111111,0,31,9,9,1.032258,0,0,11,16,false,true,false,0.265,0.735
332,305,27,23.714286,21.785714,27,834,758,76,0,1,0,0.071429,-3,14,14,-12,0,0,9,10,false,true,true,0.942,0.058
148,110,38,18.5,15.714286,38,1048,1000,48,0,0,0,0,49,8,7,0.816327,0,1,9,16,false,true,false,0.475,0.525
269,175,94,19.214286,13.461538,94,1091,1078,13,0,0,0,0,22,14,13,1.954545,0,0,7,15,false,true,true,0.994,0.006
264,171,93,26.4,19,93,758,796,-38,0,0,0,0,28,10,9,1.357143,0,0,11,23,false,true,true,0.979,0.021
129,99,30,18.428571,14.142857,30,500,567,-67,0,0,0,0,57,7,7,0.77193,0,0,9,22,false,true,true,0.804,0.196
372,265,107,26.571429,20.384615,107,1156,1114,42,1,0,0.071429,0,-4,14,13,-8,0,0,6,15,false,true,true,1,0
239,159,80,23.9,17.666667,80,526,370,156,0,0,0,0,27,10,9,1.296296,1,0,6,7,false,true,true,0.99,0.01
188,170,18,26.857143,24.285714,18,1331,1399,-68,0,0,0,0,49,7,7,0.714286,0,0,7,16,false,true,false,0.429,0.571
226,264,-38,15.066667,17.6,-38,576,494,82,0,0,0,0,9,15,15,4.888889,0,1,9,6,false,true,false,0.087,0.913
134,72,62,33.5,18,62,791,885,-94,1,0,0.25,0,67,4,4,0.567164,0,0,21,12,false,true,true,0.67,0.33
370,289,81,33.636364,26.272727,81,1633,1580,53,3,0,0.272727,0,8,11,11,3.5,0,1,11,9,false,true,true,0.969,0.031
395,237,158,30.384615,19.75,158,971,621,350,2,0,0.153846,0,-1,13,12,-32,1,0,12,8,false,true,true,1,0
162,176,-14,23.142857,25.142857,-14,1355,1210,145,0,0,0,0,50,7,7,0.6,1,0,15,10,false,true,true,0.656,0.344
165,116,49,20.625,16.571429,49,830,907,-77,1,0,0.125,0,47,8,7,0.829787,0,0,16,18,false,true,true,0.855,0.145
233,198,35,21.181818,19.8,35,1782,1512,270,1,1,0.090909,0.1,32,11,10,1.3125,0,0,13,10,false,true,true,1,0
186,142,44,23.25,17.75,44,971,906,65,0,0,0,0,38,8,8,0.842105,0,0,7,18,false,true,true,0.918,0.082
278,213,65,23.166667,17.75,65,859,811,48,0,0,0,0,18,12,12,2,1,1,9,13,false,true,true,0.959,0.041
19,27,-8,9.5,13.5,-8,1159,1031,128,0,0,0,0,84,2,2,0.464286,1,0,14,17,false,true,true,0.739,0.261
337,336,1,16.85,17.684211,1,1782,1512,270,1,1,0.05,0.052632,-23,20,19,-1.826087,0,0,1,1,false,true,true,1,0
47,56,-9,15.666667,28,-9,1731,1691,40,0,0,0,0,82,3,2,0.414634,1,0,9,12,false,true,false,0.426,0.574
227,145,82,22.7,14.5,82,1606,1544,62,0,0,0,0,41,10,10,1.097561,0,0,10,8,false,true,true,0.992,0.008
229,180,49,28.625,25.714286,49,1101,1078,23,0,0,0,0,45,8,7,0.733333,0,1,8,7,false,true,true,0.705,0.295
169,198,-29,15.363636,19.8,-29,262,306,-44,0,0,0,0,35,11,10,1.314286,0,0,9,11,false,true,false,0.149,0.851
214,145,69,19.454545,14.5,69,620,658,-38,0,0,0,0,31,11,10,1.16129,0,0,28,7,false,true,true,0.955,0.045
273,274,-1,27.3,30.444444,-1,1125,1227,-102,1,1,0.1,0.111111,17,10,9,1.764706,1,0,8,10,false,true,true,0.619,0.381
257,191,66,19.769231,14.692308,66,831,830,1,0,0,0,0,15,13,13,2.466667,1,0,15,10,false,true,true,0.996,0.004
356,331,25,22.25,20.6875,25,1177,1214,-37,0,0,0,0,-16,16,16,-2.1875,0,0,2,2,false,true,true,1,0
251,255,-4,25.1,28.333333,-4,1636,1576,60,0,2,0,0.222222,24,10,9,1.416667,0,0,9,9,false,true,false,0.283,0.717
284,283,1,21.846154,23.583333,1,1431,802,629,0,0,0,0,4,13,12,8,0,0,11,8,false,true,true,1,0
171,132,39,15.545455,13.2,39,1030,1045,-15,0,0,0,0,42,11,10,1.095238,0,0,7,23,false,true,true,0.836,0.164
495,271,224,29.117647,15.941176,224,1054,917,137,2,0,0.117647,0,-34,17,17,-1.029412,0,0,15,6,false,true,true,1,0
155,100,55,17.222222,11.111111,55,415,518,-103,0,0,0,0,47,9,9,0.808511,1,0,13,27,false,true,true,0.98,0.02
104,135,-31,20.8,27,-31,1364,1093,271,0,1,0,0.2,64,5,5,0.59375,0,0,11,9,false,true,true,0.57,0.43
210,181,29,21,20.111111,29,1127,1134,-7,0,0,0,0,28,10,9,1.071429,0,1,21,7,false,true,true,0.558,0.442
310,271,39,23.846154,22.583333,39,791,885,-94,1,1,0.076923,0.083333,12,13,12,3.166667,0,0,9,10,false,true,true,0.92,0.08
168,208,-40,18.666667,26,-40,594,605,-11,0,0,0,0,41,9,8,0.902439,0,0,12,7,false,true,false,0.089,0.911
234,198,36,16.714286,15.230769,36,859,822,37,0,0,0,0,8,14,13,4.75,0,0,9,16,false,true,true,0.946,0.054
339,333,6,18.833333,19.588235,6,1277,1166,111,0,1,0,0.058824,-21,18,17,-1.714286,0,0,2,1,false,true,false,0.176,0.824
372,287,85,21.882353,17.9375,85,1731,1691,40,1,0,0.058824,0,-15,17,16,-2.266667,0,0,2,12,false,true,true,1,0
164,150,14,18.222222,16.666667,14,416,306,110,0,0,0,0,39,9,9,1.076923,0,0,8,8,false,true,true,0.84,0.16
341,330,11,20.058824,19.411765,11,869,820,49,0,1,0,0.058824,-19,17,17,-1.947368,0,0,4,2,false,true,true,0.892,0.108
265,131,134,24.090909,13.1,134,1075,1152,-77,0,0,0,0,31,11,10,1.290323,0,1,10,8,false,true,true,1,0
381,297,84,20.052632,16.5,84,941,926,15,1,0,0.052632,0,-20,19,18,-1.9,0,0,4,1,false,true,true,1,0
294,216,78,19.6,15.428571,78,746,796,-50,0,1,0,0.071429,8,15,14,6,0,1,16,7,false,true,true,0.997,0.003
347,353,-6,26.692308,29.416667,-6,1256,1232,24,1,0,0.076923,0,3,13,12,10,1,0,9,14,false,true,true,0.996,0.004
356,248,108,18.736842,13.777778,108,925,801,124,1,0,0.052632,0,-16,19,18,-2.5,0,0,2,8,false,true,true,1,0
87,72,15,17.4,18,15,518,533,-15,1,0,0.2,0,64,5,4,0.546875,1,0,21,19,false,true,false,0.41,0.59
186,169,17,26.571429,28.166667,17,974,995,-21,0,1,0,0.166667,48,7,6,0.6875,1,0,23,11,false,true,true,0.742,0.258
389,223,166,20.473684,12.388889,166,942,1003,-61,0,0,0,0,-16,19,18,-2.8125,1,1,11,13,false,true,true,1,0
252,219,33,21,19.909091,33,901,889,12,0,1,0,0.090909,27,12,11,1.592593,0,0,14,11,false,true,true,0.785,0.215
341,302,39,17.947368,15.894737,39,658,817,-159,0,0,0,0,-14,19,19,-2.714286,0,0,2,5,true,true,true,1,0
447,271,176,27.9375,18.066667,176,1513,1482,31,1,0,0.0625,0,-13,16,15,-2.538462,0,0,1,9,false,true,true,1,0
363,318,45,25.928571,22.714286,45,1144,1014,130,0,0,0,0,2,14,14,18,0,0,7,9,false,true,true,1,0
76,129,-53,38,64.5,-53,1370,1431,-61,0,1,0,0.5,80,2,2,0.2875,1,0,11,11,false,true,false,0.44,0.56
29,15,14,14.5,15,14,448,598,-150,0,0,0,0,90,2,1,0.4,0,0,7,9,false,true,false,0.213,0.787
0,0,0,0,0,0,1176,1076,100,0,0,0,0,100,1,0,0.59,1,0,15,0,false,true,true,0.574,0.426
320,247,73,22.857143,19,73,1065,1030,35,0,1,0,0.076923,1,14,13,34,0,0,10,7,false,true,true,0.994,0.006
46,47,-1,15.333333,23.5,-1,1554,1716,-162,0,0,0,0,82,3,2,0.426829,1,0,8,9,false,true,false,0.47,0.53
286,261,25,20.428571,18.642857,25,784,758,26,0,0,0,0,0,14,14,0,1,0,6,12,false,true,true,0.963,0.037
20,10,10,20,10,10,913,871,42,0,0,0,0,93,1,1,0.462366,0,0,7,16,false,true,true,0.705,0.295
210,149,61,19.090909,14.9,61,1281,1339,-58,0,0,0,0,41,11,10,1,0,0,13,7,false,true,true,0.906,0.094
103,157,-54,14.714286,26.166667,-54,613,611,2,0,0,0,0,50,7,6,0.76,0,0,7,17,false,true,false,0.021,0.979
94,26,68,31.333333,13,68,1144,1014,130,0,0,0,0,82,3,2,0.439024,1,0,10,9,false,true,true,0.889,0.111
250,364,-114,22.727273,33.090909,-114,1897,1793,104,1,3,0.090909,0.272727,30,11,11,1.066667,0,0,10,15,false,true,false,0.275,0.725
79,67,12,19.75,22.333333,12,1355,1210,145,0,0,0,0,73,4,3,0.410959,1,0,11,13,false,true,true,0.676,0.324
204,122,82,20.4,13.555556,82,576,532,44,0,0,0,0,35,10,9,1.314286,0,0,15,16,false,true,true,0.99,0.01
84,39,45,28,13,45,1507,1554,-47,0,0,0,0,78,3,3,0.371795,1,0,6,7,false,true,true,0.759,0.241
171,72,99,42.75,18,99,918,619,299,2,0,0.5,0,66,4,4,0.530303,0,0,9,11,false,true,true,0.96,0.04
313,209,104,26.083333,19,104,1014,948,66,1,0,0.083333,0,18,12,11,1.833333,0,0,10,18,false,true,true,1,0
37,81,-44,7.4,16.2,-44,1214,1176,38,0,0,0,0,67,5,5,0.537313,1,1,21,6,false,true,false,0.276,0.724
195,143,52,24.375,20.428571,52,901,889,12,0,1,0,0.142857,55,8,7,0.781818,0,0,13,8,false,true,true,0.891,0.109
234,273,-39,16.714286,19.5,-39,316,306,10,0,2,0,0.142857,5,14,14,7.6,0,0,13,15,false,true,true,0.626,0.374
116,102,14,16.571429,17,14,721,689,32,0,0,0,0,46,7,6,0.73913,0,0,16,15,false,true,true,0.62,0.38
39,24,15,19.5,24,15,1431,825,606,0,0,0,0,89,2,1,0.382022,0,0,11,14,false,true,true,1,0
241,194,47,18.538462,16.166667,47,609,620,-11,0,0,0,0,15,13,12,2.466667,0,0,8,9,false,true,true,0.971,0.029
272,224,48,20.923077,17.230769,48,1159,1031,128,1,0,0.076923,0,5,13,13,7.8,0,0,7,10,false,true,true,0.99,0.01
168,102,66,33.6,20.4,66,695,671,24,0,0,0,0,62,5,5,0.532258,0,0,10,13,false,true,true,0.951,0.049
245,219,26,22.272727,19.909091,26,1069,917,152,0,1,0,0.090909,26,11,11,1.307692,0,0,12,9,false,true,true,0.879,0.121
264,232,32,22,19.333333,32,892,819,73,0,1,0,0.083333,15,12,12,2.266667,0,0,16,13,false,true,true,0.936,0.064
310,272,38,15.5,14.315789,38,804,683,121,0,0,0,0,-15,20,19,-3,0,1,14,6,false,true,true,1,0
188,164,24,17.090909,14.909091,24,1221,1438,-217,0,0,0,0,36,11,11,1.25,0,1,14,16,false,true,false,0.339,0.661
114,89,25,16.285714,12.714286,25,1281,1339,-58,0,0,0,0,61,7,7,0.672131,1,1,15,9,false,true,true,0.552,0.448
205,141,64,20.5,14.1,64,566,542,24,0,0,0,0,32,10,10,1.28125,0,1,21,7,false,true,true,0.951,0.049
362,224,138,30.166667,18.666667,138,1101,1078,23,1,0,0.083333,0,14,12,12,2.357143,0,1,11,15,false,true,true,1,0
192,137,55,27.428571,19.571429,55,795,830,-35,1,1,0.142857,0.142857,42,7,7,1,1,0,17,16,false,true,true,0.988,0.012
96,85,11,16,14.166667,11,303,342,-39,0,0,0,0,61,6,6,0.622951,1,0,18,11,false,true,true,0.526,0.474
157,145,12,17.444444,18.125,12,613,549,64,0,0,0,0,39,9,8,1.128205,0,0,17,20,false,true,true,0.551,0.449
196,198,-2,19.6,19.8,-2,491,398,93,0,0,0,0,31,10,10,1.16129,0,0,7,20,false,true,true,0.54,0.46
148,95,53,29.6,19,53,769,527,242,1,0,0.2,0,58,5,5,0.62069,1,0,21,9,false,true,true,0.939,0.061
119,66,53,23.8,16.5,53,719,651,68,0,0,0,0,75,5,4,0.6,0,0,28,8,false,true,true,0.971,0.029
266,277,-11,17.733333,18.466667,-11,892,788,104,2,0,0.133333,0,6,15,15,7.166667,1,0,8,10,false,true,true,0.749,0.251
43,70,-27,10.75,23.333333,-27,844,821,23,0,0,0,0,80,4,3,0.525,0,0,23,17,false,true,false,0.269,0.731
296,298,-2,16.444444,17.529412,-2,1388,1477,-89,1,0,0.055556,0,-7,18,17,-6.857143,1,0,9,18,false,true,false,0.394,0.606
228,198,30,28.5,24.75,30,965,1013,-48,1,0,0.125,0,35,8,8,0.942857,0,1,10,9,false,true,false,0.412,0.588
122,82,40,24.4,20.5,40,1153,1065,88,0,1,0,0.25,61,5,4,0.459016,0,0,21,18,false,true,true,0.852,0.148
286,285,1,20.428571,20.357143,1,1277,1166,111,0,1,0,0.071429,1,14,14,36,0,0,13,11,false,true,true,0.729,0.271
56,47,9,18.666667,15.666667,9,620,513,107,0,0,0,0,79,3,3,0.56962,0,0,10,18,false,true,true,0.755,0.245
359,291,68,15.608696,12.652174,68,416,374,42,0,0,0,0,-25,23,23,-1.84,0,0,1,1,true,true,true,1,0
137,116,21,17.125,16.571429,21,947,909,38,0,0,0,0,51,8,7,0.901961,1,0,12,36,false,true,true,0.507,0.493
30,43,-13,15,21.5,-13,804,988,-184,0,0,0,0,85,2,2,0.388235,0,0,7,19,false,true,false,0.164,0.836
314,287,27,16.526316,15.944444,27,859,822,37,0,0,0,0,-22,19,18,-1.727273,2,0,2,4,false,true,true,0.987,0.013
234,212,22,16.714286,15.142857,22,613,461,152,0,1,0,0.071429,-5,14,14,-7.4,0,0,25,15,false,true,true,0.943,0.057
93,110,-17,11.625,13.75,-17,1214,1176,38,0,0,0,0,52,8,8,0.692308,1,1,16,22,false,true,false,0.286,0.714
262,230,32,21.833333,19.166667,32,1069,917,152,0,1,0,0.083333,18,12,12,1.888889,0,0,10,11,false,true,true,0.907,0.093
203,157,46,22.555556,17.444444,46,1516,1397,119,0,1,0,0.111111,31,9,9,1.064516,0,0,18,8,false,true,true,0.908,0.092
343,290,53,19.055556,16.111111,53,1548,1493,55,1,0,0.055556,0,-15,18,18,-2.733333,0,0,4,5,false,true,true,1,0
102,91,11,17,18.2,11,272,238,34,0,0,0,0,56,6,5,0.714286,0,0,14,12,false,true,true,0.768,0.232
317,281,36,19.8125,18.733333,36,901,889,12,0,1,0,0.066667,1,16,15,43,0,0,14,8,false,true,true,0.893,0.107
390,304,86,20.526316,16,86,1305,1218,87,1,1,0.052632,0.052632,-36,19,19,-1.055556,0,0,1,1,true,true,true,1,0
30,15,15,15,15,15,613,549,64,0,0,0,0,87,2,1,0.505747,0,0,15,17,false,true,true,0.76,0.24
156,132,24,26,26.4,24,1793,1897,-104,1,0,0.166667,0,61,6,5,0.491803,0,0,10,12,false,true,true,0.545,0.455
199,156,43,22.111111,19.5,43,1227,1060,167,0,1,0,0.125,44,9,8,0.909091,0,0,12,9,false,true,true,0.855,0.145
205,166,39,17.083333,13.833333,39,1048,1000,48,0,0,0,0,31,12,12,1.290323,0,1,17,6,false,true,true,0.858,0.142
310,267,43,18.235294,15.705882,43,671,725,-54,0,0,0,0,-15,17,17,-2.466667,0,0,8,1,false,true,true,1,0
186,177,9,23.25,22.125,9,902,866,36,0,0,0,0,33,8,8,0.969697,0,0,9,11,false,true,true,0.681,0.319
33,33,0,11,11,0,299,315,-16,0,0,0,0,84,3,3,0.5,0,0,7,24,false,true,false,0.375,0.625
272,276,-4,30.222222,30.666667,-4,1265,1237,28,1,0,0.111111,0,21,9,9,1.428571,0,1,11,12,false,true,false,0.308,0.692
121,118,3,20.166667,23.6,3,995,912,83,1,0,0.166667,0,68,6,5,0.647059,1,0,16,8,false,true,true,0.585,0.415
426,312,114,25.058824,19.5,114,1396,1454,-58,2,0,0.117647,0,-10,17,16,-3.3,0,0,1,1,true,true,true,1,0
147,63,84,29.4,12.6,84,942,1003,-61,0,0,0,0,62,5,5,0.725806,0,0,13,19,false,true,true,0.954,0.046
319,272,47,24.538462,20.923077,47,834,758,76,0,1,0,0.076923,5,13,13,7.2,0,0,9,9,false,true,true,0.977,0.023
97,52,45,48.5,26,45,1793,1897,-104,1,0,0.5,0,83,2,2,0.361446,0,0,14,11,false,true,true,0.607,0.393
284,254,30,17.75,15.875,30,95,360,-265,0,1,0,0.0625,-10,16,16,-4,0,0,13,8,false,true,true,0.947,0.053
104,58,46,34.666667,19.333333,46,1334,1256,78,1,0,0.333333,0,76,3,3,0.407895,0,0,18,11,false,true,true,0.594,0.406
125,78,47,31.25,26,47,1142,1095,47,1,0,0.25,0,71,4,3,0.492958,0,0,15,14,false,true,true,0.582,0.418
438,288,150,15.103448,10.285714,150,1176,1076,100,0,0,0,0,-32,29,28,-1.84375,0,0,1,3,false,true,true,1,0
364,236,128,26,16.857143,128,1221,1266,-45,1,0,0.071429,0,-5,14,14,-7,0,0,24,12,false,true,true,1,0
298,247,51,21.285714,17.642857,51,791,774,17,1,0,0.071429,0,16,14,14,2.5625,0,0,16,14,false,true,true,0.953,0.047
12,12,0,12,12,0,595,543,52,0,0,0,0,94,1,1,0.5,0,0,10,8,false,true,true,0.749,0.251
231,190,41,25.666667,23.75,41,1089,1063,26,1,0,0.111111,0,44,9,8,0.863636,0,0,11,10,false,true,true,0.767,0.233
78,107,-29,11.142857,15.285714,-29,539,632,-93,0,0,0,0,59,7,7,0.779661,0,1,18,13,false,true,false,0.079,0.921
232,173,59,23.2,17.3,59,825,907,-82,1,0,0.1,0,31,10,10,1.290323,0,0,24,20,false,true,true,0.868,0.132
341,310,31,17.947368,16.315789,31,859,786,73,0,0,0,0,-27,19,19,-1.407407,0,0,3,1,true,true,true,1,0
257,180,77,32.125,25.714286,77,1320,1339,-19,2,1,0.25,0.142857,38,8,7,1.026316,0,0,8,22,false,true,true,0.988,0.012
329,254,75,20.5625,15.875,75,620,658,-38,0,0,0,0,-9,16,16,-4,0,0,15,6,false,true,true,1,0
349,283,66,13.423077,11.32,66,272,288,-16,0,0,0,0,-28,26,25,-1.857143,0,0,1,1,false,true,true,1,0
74,70,4,18.5,23.333333,4,1482,1394,88,0,0,0,0,79,4,3,0.455696,1,0,6,19,false,true,false,0.369,0.631
78,136,-58,15.6,27.2,-58,1077,1094,-17,0,0,0,0,65,5,5,0.646154,0,0,28,14,false,true,false,0.395,0.605
305,263,42,16.052632,13.842105,42,416,374,42,0,0,0,0,-6,19,19,-7.666667,0,0,13,7,false,true,true,0.987,0.013
358,342,16,22.375,22.8,16,1554,1716,-162,1,1,0.0625,0.066667,-14,16,15,-2.5,0,0,4,3,false,true,true,0.947,0.053
76,70,6,12.666667,11.666667,6,904,857,47,0,0,0,0,61,6,6,0.672131,0,1,25,15,false,true,false,0.47,0.53
39,56,-17,19.5,28,-17,1731,1691,40,0,0,0,0,85,2,2,0.4,1,0,6,12,false,true,false,0.445,0.555
248,168,80,20.666667,15.272727,80,808,639,169,0,0,0,0,24,12,11,1.708333,0,0,16,17,false,true,true,0.976,0.024
137,106,31,22.833333,17.666667,31,1127,1075,52,1,0,0.166667,0,56,6,6,0.553571,0,1,17,21,false,true,true,0.677,0.323
75,69,6,15,17.25,6,566,542,24,0,0,0,0,69,5,4,0.594203,0,1,8,11,false,true,false,0.403,0.597
278,253,25,23.166667,23,25,1142,1095,47,1,0,0.083333,0,13,12,11,2.692308,0,0,14,14,false,true,false,0.471,0.529
227,184,43,17.461538,15.333333,43,904,857,47,0,0,0,0,17,13,12,2.411765,1,0,13,10,false,true,true,0.959,0.041
20,17,3,20,17,3,1037,950,87,0,0,0,0,93,1,1,0.333333,1,0,7,14,false,true,true,0.812,0.188
0,0,0,0,0,0,1089,1063,26,0,0,0,0,100,1,0,0.38,0,0,15,0,false,true,true,0.552,0.448
373,329,44,23.3125,21.933333,44,1142,1176,-34,1,0,0.0625,0,-4,16,15,-9,1,0,3,9,false,true,true,1,0
255,224,31,25.5,22.4,31,1519,1782,-263,1,0,0.1,0,28,10,10,1.178571,0,0,8,11,false,true,true,0.757,0.243
80,42,38,20,14,38,498,43,455,0,0,0,0,76,4,3,0.486842,1,0,8,13,false,true,true,0.776,0.224
137,161,-24,19.571429,23,-24,1530,1550,-20,0,1,0,0.142857,42,7,7,0.809524,0,0,25,12,false,true,false,0.28,0.72
80,76,4,16,15.2,4,699,448,251,0,0,0,0,71,5,5,0.56338,0,0,18,8,false,true,true,0.572,0.428
62,45,17,15.5,15,17,1176,1127,49,0,0,0,0,75,4,3,0.493333,0,0,14,9,false,true,false,0.417,0.583
129,159,-30,18.428571,22.714286,-30,1554,1573,-19,0,0,0,0,54,7,7,0.62963,0,0,17,14,false,true,false,0.273,0.727
223,131,92,27.875,18.714286,92,1245,1232,13,1,0,0.125,0,34,8,7,0.852941,0,0,19,12,false,true,true,0.984,0.016
319,262,57,17.722222,15.411765,57,468,542,-74,0,0,0,0,-12,18,17,-3.25,0,0,3,3,false,true,true,1,0
158,111,47,22.571429,18.5,47,1439,1397,42,0,1,0,0.166667,52,7,6,0.653846,0,0,8,12,false,true,true,0.82,0.18
198,179,19,19.8,17.9,19,885,719,166,0,0,0,0,33,10,10,1.151515,1,0,8,12,false,true,true,0.695,0.305
129,80,49,25.8,16,49,801,925,-124,1,0,0.2,0,58,5,5,0.603448,0,0,10,10,false,true,true,0.882,0.118
157,122,35,19.625,17.428571,35,804,683,121,0,0,0,0,51,8,7,0.882353,0,1,19,6,false,true,true,0.86,0.14
153,150,3,21.857143,21.428571,3,902,866,36,0,0,0,0,43,7,7,0.744186,0,0,8,9,false,true,true,0.595,0.405
278,307,-29,13.9,16.157895,-29,999,1011,-12,0,0,0,0,-21,20,19,-2.190476,1,0,9,7,false,true,false,0.07,0.93
18,66,-48,18,66,-48,1571,1554,17,0,1,0,1,90,1,1,0.366667,0,0,12,13,false,true,false,0.378,0.622
315,165,150,35,18.333333,150,1439,1353,86,1,0,0.111111,0,31,9,9,0.967742,0,0,7,16,false,true,true,1,0
400,268,132,16,11.166667,132,1011,921,90,1,0,0.04,0,-23,25,24,-2.130435,0,0,1,11,true,true,true,1,0
241,146,95,24.1,16.222222,95,1045,1009,36,1,0,0.1,0,36,10,9,1.055556,0,0,9,19,false,true,true,0.989,0.011
222,189,33,22.2,18.9,33,1221,1266,-45,0,0,0,0,26,10,10,1.346154,1,0,15,10,false,true,true,0.82,0.18
447,290,157,27.9375,18.125,157,1513,1482,31,1,0,0.0625,0,-16,16,16,-2.0625,0,0,1,9,false,true,true,1,0
146,147,-1,16.222222,16.333333,-1,523,480,43,1,0,0.111111,0,37,9,9,0.891892,0,0,9,10,false,true,true,0.751,0.249
142,111,31,23.666667,18.5,31,1439,1397,42,0,1,0,0.166667,56,6,6,0.607143,0,0,8,12,false,true,true,0.786,0.214
354,314,40,17.7,15.7,40,795,830,-35,1,1,0.05,0.05,-23,20,20,-1.826087,0,0,1,4,false,true,true,0.998,0.002
23,20,3,11.5,20,3,491,398,93,0,0,0,0,92,2,1,0.391304,0,1,16,17,false,true,true,0.52,0.48
279,179,100,25.363636,16.272727,100,904,668,236,0,0,0,0,11,11,11,3.090909,0,2,9,5,false,true,true,1,0
38,88,-50,19,44,-50,719,785,-66,0,1,0,0.5,82,2,2,0.439024,0,0,13,15,false,true,false,0.272,0.728
48,22,26,16,11,26,808,812,-4,0,0,0,0,83,3,2,0.445783,0,1,9,8,false,true,true,0.557,0.443
332,255,77,20.75,15.9375,77,580,620,-40,1,0,0.0625,0,-2,16,16,-21.5,0,0,14,11,false,true,true,0.995,0.005
72,27,45,24,13.5,45,1216,1228,-12,0,0,0,0,82,3,2,0.402439,0,0,7,16,false,true,true,0.567,0.433
87,83,4,17.4,16.6,4,913,871,42,0,0,0,0,64,5,5,0.671875,0,0,8,12,false,true,true,0.596,0.404
201,205,-4,20.1,20.5,-4,971,658,313,0,0,0,0,30,10,10,1.2,0,0,14,12,false,true,false,0.46,0.54
182,80,102,45.5,26.666667,102,1684,1320,364,1,0,0.25,0,66,4,3,0.454545,0,0,12,13,false,true,true,0.999,0.001
291,235,56,20.785714,18.076923,56,1548,1493,55,1,0,0.071429,0,8,14,13,5.125,0,0,7,21,false,true,true,0.959,0.041
70,87,-17,23.333333,29,-17,1203,1221,-18,0,0,0,0,81,3,3,0.432099,1,0,10,12,false,true,true,0.61,0.39
69,70,-1,23,23.333333,-1,363,668,-305,0,0,0,0,83,3,3,0.518072,0,0,7,12,false,true,false,0.372,0.628
302,254,48,20.133333,18.142857,48,721,689,32,0,0,0,0,-18,15,14,-1.888889,0,1,9,6,false,true,true,1,0
159,98,61,31.8,24.5,61,1344,1325,19,1,0,0.2,0,61,5,4,0.508197,0,0,13,14,false,true,true,0.649,0.351
397,303,94,28.357143,23.307692,94,1349,1302,47,0,0,0,0,-7,14,13,-4.142857,0,0,11,2,false,true,true,1,0
401,268,133,21.105263,14.105263,133,939,907,32,1,0,0.052632,0,-16,19,19,-2.5,0,0,1,1,false,true,true,1,0
26,15,11,26,15,11,971,906,65,0,0,0,0,93,1,1,0.344086,0,1,10,12,false,true,true,0.566,0.434
71,53,18,14.2,13.25,18,786,847,-61,0,0,0,0,72,5,4,0.472222,0,1,14,6,false,true,false,0.301,0.699
14,24,-10,14,24,-10,1302,1349,-47,0,0,0,0,91,1,1,0.307692,0,0,10,7,false,true,false,0.401,0.599
366,249,117,19.263158,13.105263,117,1281,1339,-58,0,0,0,0,-10,19,19,-4.1,0,0,4,1,false,true,true,1,0
288,264,24,15.157895,14.666667,24,808,812,-4,0,0,0,0,-19,19,18,-1.947368,1,0,6,1,true,true,true,0.984,0.016
226,147,79,22.6,16.333333,79,1115,1078,37,0,0,0,0,34,10,9,1,1,0,13,9,false,true,true,0.992,0.008
182,150,32,16.545455,15,32,416,306,110,0,0,0,0,36,11,10,1.166667,0,0,14,13,false,true,true,0.854,0.146
141,87,54,28.2,21.75,54,907,752,155,0,0,0,0,71,5,4,0.464789,0,0,12,12,false,true,true,0.848,0.152
176,108,68,25.142857,18,68,1210,1253,-43,0,1,0,0.166667,49,7,6,0.714286,0,1,12,9,false,true,true,0.873,0.127
139,91,48,23.166667,15.166667,48,1489,1445,44,0,0,0,0,57,6,6,0.561404,0,0,14,8,false,true,true,0.648,0.352
70,23,47,70,23,47,992,1100,-108,1,0,1,0,90,1,1,0.377778,1,0,8,12,false,true,true,0.775,0.225
206,178,28,34.333333,35.6,28,1265,1237,28,1,0,0.166667,0,47,6,5,0.638298,0,0,8,19,false,true,true,0.535,0.465
123,72,51,24.6,18,51,526,370,156,0,0,0,0,68,5,4,0.514706,0,0,16,23,false,true,true,0.92,0.08
174,132,42,24.857143,18.857143,42,971,906,65,0,0,0,0,45,7,7,0.711111,0,0,9,13,false,true,true,0.888,0.112
319,283,36,22.785714,20.214286,36,1216,1228,-12,1,0,0.071429,0,7,14,14,4.714286,0,1,16,8,false,true,true,0.844,0.156
121,141,-20,12.1,14.1,-20,539,632,-93,0,0,0,0,42,10,10,1.095238,0,0,18,7,false,true,false,0.176,0.824
46,0,46,46,0,46,1054,917,137,0,0,0,0,94,1,0,0.37234,1,0,14,0,false,true,true,0.886,0.114
300,261,39,20,18.642857,39,784,758,26,0,0,0,0,-4,15,14,-8.75,1,0,6,12,false,true,true,0.981,0.019
93,42,51,46.5,21,51,908,1070,-162,1,0,0.5,0,82,2,2,0.365854,1,0,9,8,false,true,true,0.733,0.267
0,0,0,0,0,0,1397,1195,202,0,0,0,0,100,1,0,0.35,1,0,6,0,false,true,true,0.577,0.423
262,120,142,26.2,12,142,1295,1477,-182,2,0,0.2,0,36,10,10,1.277778,0,0,22,10,false,true,true,0.951,0.049
24,43,-19,8,21.5,-19,1334,1270,64,0,0,0,0,85,3,2,0.435294,0,0,11,9,false,true,false,0.271,0.729
0,0,0,0,0,0,1127,1075,52,0,0,0,0,100,1,0,0.31,0,0,14,0,false,true,true,0.543,0.457
172,129,43,19.111111,14.333333,43,303,342,-39,0,0,0,0,43,9,9,0.883721,1,0,17,14,false,true,true,0.94,0.06
270,159,111,27,15.9,111,742,696,46,0,0,0,0,28,10,10,1.142857,0,0,10,16,false,true,true,0.996,0.004
25,7,18,12.5,7,18,1093,1090,3,0,0,0,0,91,2,1,0.373626,0,0,15,15,false,true,true,0.541,0.459
364,311,53,22.75,20.733333,53,1388,1506,-118,2,1,0.125,0.066667,-4,16,15,-8.5,0,0,1,12,false,true,true,0.951,0.049
376,358,18,25.066667,23.866667,18,1125,1227,-102,2,1,0.133333,0.066667,-19,15,15,-1.578947,0,0,1,4,true,true,true,0.956,0.044
389,335,54,21.611111,19.705882,54,630,786,-156,1,0,0.055556,0,-11,18,17,-3.181818,0,0,1,2,true,true,true,1,0
10,0,10,10,0,10,1154,1062,92,0,0,0,0,98,1,0,0.357143,0,0,7,0,false,true,true,0.562,0.438
171,133,38,19,16.625,38,804,683,121,0,0,0,0,44,9,8,1.022727,0,1,27,8,false,true,true,0.915,0.085
179,162,17,16.272727,16.2,17,871,999,-128,0,0,0,0,31,11,10,1.548387,0,0,8,19,false,true,false,0.161,0.839
229,219,10,22.9,21.9,10,1047,1094,-47,1,1,0.1,0.1,31,10,10,1.16129,0,0,21,11,false,true,true,0.881,0.119
194,162,32,14.923077,12.461538,32,1016,1037,-21,0,0,0,0,24,13,13,2,1,0,18,29,false,true,true,0.95,0.05
276,216,60,25.090909,19.636364,60,1051,1030,21,0,0,0,0,17,11,11,1.764706,1,0,8,17,false,true,true,0.997,0.003
250,256,-6,31.25,32,-6,1265,1237,28,1,0,0.125,0,27,8,8,1.111111,0,1,16,12,false,true,false,0.373,0.627
55,32,23,27.5,32,23,1431,802,629,0,0,0,0,85,2,1,0.376471,0,1,18,12,false,true,true,1,0
60,20,40,20,10,40,1266,1144,122,0,0,0,0,76,3,2,0.447368,1,1,9,12,false,true,true,0.605,0.395
282,250,32,23.5,20.833333,32,1244,1361,-117,2,1,0.166667,0.083333,26,12,12,1.461538,0,0,18,13,false,true,true,0.943,0.057
316,200,116,31.6,22.222222,116,1334,1477,-143,2,1,0.2,0.111111,19,10,9,1.578947,0,0,9,16,false,true,true,0.986,0.014
368,290,78,20.444444,17.058824,78,948,933,15,1,0,0.055556,0,-3,18,17,-12.666667,0,0,2,5,false,true,true,1,0
42,21,21,21,21,21,1029,1227,-198,0,0,0,0,86,2,1,0.372093,0,0,17,12,false,true,false,0.214,0.786
333,283,50,22.2,20.214286,50,1075,1152,-77,0,1,0,0.071429,2,15,14,20,0,0,14,11,false,true,true,0.88,0.12
149,86,63,29.8,21.5,63,1762,1616,146,1,0,0.2,0,61,5,4,0.491803,0,0,7,18,false,true,true,0.811,0.189
46,22,24,15.333333,11,24,859,719,140,0,0,0,0,82,3,2,0.646341,0,1,13,6,false,true,true,0.695,0.305
314,269,45,13.083333,11.208333,45,310,359,-49,0,0,0,0,-54,24,24,-0.907407,0,0,3,2,false,true,true,1,0
415,345,70,20.75,18.157895,70,1227,1060,167,0,2,0,0.105263,-32,20,19,-1.25,0,0,1,1,false,true,true,1,0
178,134,44,19.777778,14.888889,44,711,876,-165,0,0,0,0,42,9,9,1.02381,0,1,8,18,false,true,true,0.587,0.413
85,99,-14,14.166667,16.5,-14,699,448,251,0,0,0,0,63,6,6,0.634921,0,1,17,9,false,true,true,0.513,0.487
315,292,23,19.6875,19.466667,23,786,847,-61,0,0,0,0,-5,16,15,-6.8,0,0,2,8,false,true,true,0.534,0.466
151,159,-8,16.777778,17.666667,-8,628,658,-30,0,0,0,0,42,9,9,1.095238,0,1,19,9,false,true,false,0.211,0.789
138,95,43,23,19,43,691,473,218,0,0,0,0,57,6,5,0.631579,0,0,16,7,false,true,true,0.802,0.198
192,203,-11,21.333333,22.555556,-11,1127,1075,52,1,1,0.111111,0.111111,32,9,9,0.96875,0,1,12,18,false,true,true,0.537,0.463
275,239,36,22.916667,19.916667,36,948,933,15,1,0,0.083333,0,25,12,12,1.52,0,0,9,14,false,true,true,0.883,0.117
309,279,30,20.6,18.6,30,1270,1348,-78,0,0,0,0,4,15,15,9.5,0,0,9,16,false,true,true,0.597,0.403
219,188,31,21.9,20.888889,31,315,294,21,0,1,0,0.111111,22,10,9,1.590909,0,0,15,21,false,true,true,0.949,0.051
340,281,59,24.285714,20.071429,59,1530,1550,-20,1,1,0.071429,0.071429,-4,14,14,-8.5,0,0,11,10,false,true,true,0.989,0.011
86,98,-12,21.5,24.5,-12,758,796,-38,0,0,0,0,70,4,4,0.542857,0,0,10,10,false,true,false,0.451,0.549
273,298,-25,22.75,24.833333,-25,1539,1537,2,0,1,0,0.083333,17,12,12,1.882353,0,0,7,13,false,true,false,0.12,0.88
117,135,-18,16.714286,19.285714,-18,1142,1176,-34,0,0,0,0,49,7,7,0.734694,1,0,7,15,false,true,false,0.307,0.693
241,189,52,24.1,21,52,1156,1184,-28,1,0,0.1,0,28,10,9,1,1,0,10,8,false,true,true,0.937,0.063
148,92,56,16.444444,11.5,56,346,231,115,0,0,0,0,35,9,8,1.171429,0,0,13,11,false,true,true,0.977,0.023
522,193,329,37.285714,14.846154,329,1431,825,606,2,1,0.142857,0.076923,5,14,13,6.8,0,0,9,16,false,true,true,1,0
297,237,60,21.214286,16.928571,60,1394,1230,164,0,1,0,0.071429,3,14,14,12.666667,0,0,20,22,false,true,true,0.979,0.021
81,74,7,20.25,24.666667,7,965,1013,-48,0,0,0,0,73,4,3,0.452055,1,0,7,15,false,true,true,0.528,0.472
293,217,76,13.952381,10.333333,76,310,359,-49,0,0,0,0,-37,21,21,-1.324324,0,0,14,17,false,true,true,1,0
92,40,52,23,13.333333,52,1094,1030,64,0,0,0,0,76,4,3,0.473684,0,0,9,14,false,true,true,0.772,0.228
338,291,47,16.095238,14.55,47,1221,1438,-217,0,0,0,0,-14,21,20,-3.214286,0,0,4,3,false,true,true,1,0
256,189,67,19.692308,14.538462,67,1227,1060,167,0,1,0,0.076923,16,13,13,2.5,0,0,12,16,false,true,true,0.989,0.011
340,259,81,24.285714,19.923077,81,804,988,-184,2,0,0.142857,0,1,14,13,33,0,0,11,12,false,true,true,0.989,0.011
16,13,3,16,13,3,960,1070,-110,0,0,0,0,92,1,1,0.380435,0,0,12,15,false,true,false,0.22,0.78
279,227,52,17.4375,15.133333,52,299,315,-16,0,0,0,0,-8,16,15,-5.25,0,0,10,12,false,true,true,0.982,0.018
177,189,-12,19.666667,23.625,-12,1554,1573,-19,0,0,0,0,46,9,8,0.73913,0,0,9,14,false,true,false,0.26,0.74
26,17,9,13,17,9,1548,1493,55,0,0,0,0,88,2,1,0.465909,1,0,8,13,false,true,false,0.461,0.539
316,247,69,21.066667,17.642857,69,791,774,17,1,0,0.066667,0,13,15,14,3.153846,0,0,13,14,false,true,true,0.966,0.034
333,200,133,25.615385,16.666667,133,1651,1691,-40,1,0,0.076923,0,18,13,12,1.888889,1,0,6,10,false,true,true,1,0
49,20,29,12.25,5,29,1394,1230,164,0,0,0,0,72,4,4,0.527778,0,0,15,16,false,true,true,0.692,0.308
119,102,17,23.8,20.4,17,1334,1270,64,1,0,0.2,0,69,5,5,0.536232,0,0,24,12,false,true,true,0.568,0.432
12,0,12,12,0,12,719,614,105,0,0,0,0,95,1,0,0.452632,0,0,13,0,false,true,true,0.753,0.247
206,162,44,14.714286,12.461538,44,1016,1037,-21,0,0,0,0,21,14,13,2.285714,1,0,17,29,false,true,true,0.938,0.062
267,321,-54,20.538462,24.692308,-54,1501,1473,28,0,0,0,0,9,13,13,4,0,0,10,7,false,true,false,0.014,0.986
158,103,55,22.571429,14.714286,55,834,758,76,0,0,0,0,53,7,7,0.679245,0,1,16,10,false,true,true,0.95,0.05
97,101,-4,19.4,25.25,-4,1125,1227,-102,0,0,0,0,61,5,4,0.491803,1,0,6,24,false,true,false,0.103,0.897
246,115,131,27.333333,14.375,131,1144,1014,130,0,0,0,0,41,9,8,0.878049,0,1,14,9,false,true,true,0.962,0.038
367,344,23,30.583333,28.666667,23,1302,1349,-47,0,1,0,0.083333,4,12,12,7,0,1,10,21,false,true,true,0.992,0.008
395,289,106,32.916667,26.272727,106,1633,1580,53,3,0,0.25,0,6,12,11,4.666667,0,1,9,9,false,true,true,0.998,0.002
275,256,19,22.916667,21.333333,19,1710,1636,74,1,1,0.083333,0.083333,17,12,12,2.117647,1,0,16,14,false,true,true,0.921,0.079
187,164,23,20.777778,18.222222,23,468,542,-74,0,0,0,0,43,9,9,0.906977,0,1,9,11,false,true,true,0.622,0.378
220,204,16,18.333333,18.545455,16,786,976,-190,0,0,0,0,22,12,11,1.454545,1,0,16,10,false,true,false,0.251,0.749
94,70,24,23.5,17.5,24,363,668,-305,0,0,0,0,78,4,4,0.551282,1,0,6,12,false,true,false,0.334,0.666
22,25,-3,22,25,-3,786,976,-190,0,0,0,0,94,1,1,0.340426,0,0,8,10,false,true,false,0.212,0.788
324,306,18,21.6,21.857143,18,1493,1513,-20,1,0,0.066667,0,2,15,14,16.5,0,1,10,6,false,true,false,0.419,0.581
351,262,89,20.647059,16.375,89,527,581,-54,0,0,0,0,-11,17,16,-3.818182,0,0,8,14,false,true,true,1,0
67,131,-64,13.4,26.2,-64,1897,1793,104,0,1,0,0.2,73,5,5,0.438356,0,0,8,14,false,true,true,0.999,0.001
210,166,44,23.333333,18.444444,44,1221,1266,-45,0,0,0,0,31,9,9,1.129032,1,0,11,8,false,true,true,0.878,0.122
252,154,98,36,22,98,1302,1349,-47,0,0,0,0,41,7,7,0.682927,0,1,13,6,false,true,true,0.903,0.097
225,239,-14,22.5,26.555556,-14,758,952,-194,0,0,0,0,27,10,9,1.481481,1,0,6,7,false,true,false,0.176,0.824
258,143,115,25.8,15.888889,115,1691,1692,-1,0,0,0,0,30,10,9,1,0,0,16,9,false,true,true,0.987,0.013
263,177,86,32.875,22.125,86,1397,1361,36,1,0,0.125,0,32,8,8,0.90625,0,0,8,12,false,true,true,0.997,0.003
67,16,51,22.333333,8,51,777,830,-53,0,0,0,0,80,3,2,0.5125,0,0,14,12,false,true,true,0.616,0.384
33,42,-9,11,21,-9,611,584,27,0,0,0,0,84,3,2,0.52381,0,0,22,16,false,true,false,0.377,0.623
22,0,22,22,0,22,630,786,-156,0,0,0,0,95,1,0,0.368421,0,0,10,0,false,true,false,0.211,0.789
136,166,-30,11.333333,15.090909,-30,480,518,-38,0,0,0,0,35,12,11,1.314286,0,1,27,7,false,true,false,0.126,0.874
270,251,19,18,16.733333,19,671,725,-54,0,0,0,0,-5,15,15,-7.4,0,0,23,5,false,true,true,0.902,0.098
302,232,70,25.166667,21.090909,70,834,758,76,0,1,0,0.090909,14,12,11,2.571429,0,0,11,12,false,true,true,0.985,0.015
29,27,2,9.666667,9,2,561,526,35,0,0,0,0,74,3,3,0.472973,2,0,15,17,false,true,true,0.948,0.052
73,104,-31,14.6,20.8,-31,95,360,-265,0,1,0,0.2,58,5,5,0.689655,0,0,9,14,false,true,false,0.47,0.53
128,155,-27,16,19.375,-27,856,897,-41,0,0,0,0,39,8,8,0.897436,1,1,6,17,false,true,false,0.12,0.88
38,39,-1,19,19.5,-1,999,1011,-12,0,0,0,0,84,2,2,0.547619,0,0,7,14,false,true,true,0.509,0.491
74,37,37,18.5,12.333333,37,1551,1550,1,0,0,0,0,79,4,3,0.531646,0,1,19,22,false,true,false,0.385,0.615
153,118,35,21.857143,16.857143,35,1513,1479,34,0,0,0,0,53,7,7,0.641509,1,0,12,15,false,true,true,0.815,0.185
158,130,28,19.75,16.25,28,1397,1422,-25,1,0,0.125,0,53,8,8,0.679245,0,2,7,18,false,true,false,0.432,0.568
161,135,26,32.2,27,26,2219,2106,113,0,0,0,0,57,5,5,0.473684,0,0,8,12,false,true,true,1,0
271,246,25,20.846154,20.5,25,1277,1166,111,0,1,0,0.083333,11,13,12,3.272727,0,0,17,17,false,true,true,0.786,0.214
75,109,-34,15,27.25,-34,1096,1009,87,0,0,0,0,79,5,4,0.556962,1,0,15,10,false,true,false,0.439,0.561
115,87,28,23,21.75,28,1297,1606,-309,0,0,0,0,69,5,4,0.434783,1,0,7,20,false,true,false,0.322,0.678
282,245,37,13.428571,12.25,37,611,584,27,0,0,0,0,-19,21,20,-2.315789,0,0,1,11,false,true,true,1,0
402,355,47,26.8,23.666667,47,1093,1197,-104,4,0,0.266667,0,-16,15,15,-1.9375,0,0,1,6,false,true,true,0.966,0.034
123,59,64,41,19.666667,64,1935,2020,-85,0,0,0,0,75,3,3,0.413333,0,0,13,20,false,true,true,0.842,0.158
12,0,12,12,0,12,859,822,37,0,0,0,0,97,1,0,0.391753,0,0,13,0,false,true,true,0.566,0.434
23,27,-4,11.5,13.5,-4,1176,1076,100,0,0,0,0,91,2,2,0.648352,1,0,10,7,false,true,true,0.628,0.372
316,238,78,17.555556,13.222222,78,539,632,-93,0,0,0,0,-4,18,18,-11.5,0,0,11,10,false,true,true,1,0
292,291,1,29.2,32.333333,1,1935,2020,-85,0,1,0,0.111111,25,10,9,1.24,1,0,8,9,false,true,false,0.47,0.53
249,186,63,17.785714,14.307692,63,758,750,8,0,0,0,0,10,14,13,3.7,0,1,12,8,false,true,true,0.974,0.026
343,144,199,34.3,16,199,1054,917,137,2,0,0.2,0,19,10,9,1.842105,0,0,14,12,false,true,true,1,0
263,195,68,29.222222,21.666667,68,1550,1466,84,1,0,0.111111,0,37,9,9,1,0,0,8,11,false,true,true,0.969,0.031
374,265,109,31.166667,22.083333,109,1334,1477,-143,2,1,0.166667,0.083333,2,12,12,15,0,0,7,9,false,true,true,1,0
287,248,39,31.888889,27.555556,39,1826,1656,170,2,0,0.222222,0,22,9,9,1.227273,1,0,11,15,false,true,true,1,0
41,31,10,20.5,15.5,10,415,518,-103,0,0,0,0,84,2,2,0.452381,0,0,13,19,false,true,false,0.297,0.703
10,0,10,10,0,10,1304,1040,264,0,0,0,0,95,1,0,0.347368,0,0,9,0,false,true,true,0.761,0.239
426,281,145,17.04,11.24,145,1176,1076,100,0,0,0,0,-19,25,25,-3.105263,0,0,6,7,false,true,true,1,0
305,259,46,23.461538,19.923077,46,1302,1082,220,0,0,0,0,-3,13,13,-10,1,0,7,13,false,true,true,1,0
339,287,52,30.818182,26.090909,52,1875,1793,82,2,1,0.181818,0.090909,17,11,11,1.764706,0,0,8,11,false,true,true,0.994,0.006
292,198,94,32.444444,22,94,971,621,350,2,0,0.222222,0,28,9,9,1.142857,0,0,22,7,false,true,true,1,0
299,317,-18,23,24.384615,-18,1320,1339,-19,2,1,0.153846,0.076923,11,13,13,3.545455,0,0,24,11,false,true,true,0.647,0.353
263,231,32,26.3,25.666667,32,1554,1622,-68,2,0,0.2,0,26,10,9,1.192308,1,0,9,7,false,true,true,0.934,0.066
148,156,-8,29.6,31.2,-8,1890,2020,-130,0,1,0,0.2,56,5,5,0.517857,0,0,14,9,false,true,false,0.356,0.644
239,100,139,26.555556,12.5,139,801,925,-124,1,0,0.111111,0,39,9,8,0.897436,1,0,15,16,false,true,true,0.948,0.052
116,151,-35,16.571429,21.571429,-35,856,897,-41,0,0,0,0,46,7,7,0.76087,1,0,7,14,false,true,false,0.268,0.732
338,179,159,16.9,8.95,159,859,719,140,0,1,0,0.05,-26,20,20,-2.038462,0,1,24,9,false,true,true,1,0
73,67,6,14.6,16.75,6,859,822,37,0,0,0,0,63,5,4,0.603175,0,0,30,12,false,true,true,0.51,0.49
56,58,-2,14,19.333333,-2,1027,856,171,1,0,0.25,0,67,4,3,0.492537,0,1,20,8,false,true,true,0.561,0.439
290,294,-4,18.125,18.375,-4,1782,1512,270,1,1,0.0625,0.0625,-7,16,16,-6,0,0,10,12,false,true,true,1,0
332,254,78,27.666667,21.166667,78,630,786,-156,1,0,0.083333,0,14,12,12,2.5,0,0,7,12,false,true,true,1,0
12,24,-12,12,24,-12,784,758,26,0,0,0,0,92,1,1,0.380435,0,0,19,11,false,true,false,0.418,0.582
111,75,36,37,25,36,795,830,-35,1,1,0.333333,0.333333,68,3,3,0.617647,1,0,15,8,false,true,true,0.935,0.065
71,12,59,35.5,12,59,1075,1027,48,1,0,0.5,0,86,2,1,0.430233,0,0,8,12,false,true,true,0.905,0.095
175,116,59,21.875,16.571429,59,885,719,166,0,0,0,0,52,8,7,0.730769,0,1,12,9,false,true,true,0.935,0.065
318,260,58,18.705882,16.25,58,363,668,-305,0,0,0,0,0,17,16,0,0,1,12,12,false,true,true,1,0
241,198,43,18.538462,15.230769,43,916,837,79,0,0,0,0,20,13,13,2,1,0,15,11,false,true,true,0.99,0.01
353,256,97,23.533333,18.285714,97,1073,1177,-104,1,0,0.066667,0,-7,15,14,-4.571429,0,0,2,5,false,true,true,1,0
113,49,64,22.6,12.25,64,1572,1550,22,1,0,0.2,0,71,5,4,0.549296,0,0,18,12,false,true,true,0.87,0.13
191,183,8,17.363636,16.636364,8,1583,1422,161,0,0,0,0,41,11,11,1.243902,1,0,7,14,false,true,true,0.755,0.245
143,169,-26,15.888889,18.777778,-26,916,876,40,0,0,0,0,32,9,9,1.0625,1,0,13,7,false,true,false,0.49,0.51
252,190,62,18,13.571429,62,1164,1201,-37,0,0,0,0,14,14,14,3,0,1,23,10,false,true,true,0.972,0.028
39,56,-17,13,18.666667,-17,421,306,115,0,1,0,0.333333,70,3,3,0.628571,1,0,14,8,false,true,true,0.785,0.215
83,77,6,27.666667,25.666667,6,1428,1452,-24,0,0,0,0,79,3,3,0.392405,0,0,16,11,false,true,true,0.61,0.39
291,164,127,41.571429,27.333333,127,1824,1793,31,1,0,0.142857,0,46,7,6,0.608696,1,0,15,14,false,true,true,1,0
257,266,-9,17.133333,19,-9,491,398,93,0,0,0,0,6,15,14,6,0,0,7,13,false,true,false,0.141,0.859
118,97,21,16.857143,16.166667,21,1094,1030,64,0,0,0,0,61,7,6,0.590164,1,0,13,11,false,true,true,0.722,0.278
38,56,-18,19,28,-18,1203,1221,-18,0,0,0,0,87,2,2,0.402299,1,0,9,14,false,true,true,0.533,0.467
398,279,119,33.166667,25.363636,119,1645,1777,-132,2,0,0.166667,0,-6,12,11,-4.166667,0,0,3,1,false,true,true,1,0
339,330,9,22.6,22,9,1076,1176,-100,0,1,0,0.066667,-8,15,15,-4,0,0,2,3,false,true,true,0.818,0.182
411,294,117,27.4,19.6,117,1189,1266,-77,1,0,0.066667,0,-12,15,15,-2.833333,0,0,4,1,false,true,true,1,0
155,171,-16,12.916667,14.25,-16,611,584,27,0,0,0,0,31,12,12,1.419355,0,0,7,19,false,true,false,0.358,0.642
30,14,16,30,14,16,1004,653,351,0,0,0,0,89,1,1,0.393258,1,0,11,12,false,true,true,0.886,0.114
403,346,57,18.318182,16.47619,57,892,788,104,3,0,0.136364,0,-24,22,21,-1.791667,0,0,1,1,true,true,true,1,0
373,310,63,21.941176,18.235294,63,1075,1152,-77,0,1,0,0.058824,-11,17,17,-3.636364,0,0,20,8,false,true,true,1,0
265,226,39,18.928571,16.142857,39,880,952,-72,0,0,0,0,5,14,14,8.2,0,0,16,10,false,true,true,0.954,0.046
74,54,20,37,27,20,1256,1232,24,1,0,0.5,0,81,2,2,0.37037,0,1,19,11,false,true,true,0.56,0.44
391,281,110,24.4375,17.5625,110,695,671,24,0,0,0,0,-11,16,16,-3,0,1,4,4,false,true,true,1,0
218,168,50,24.222222,21,50,986,856,130,1,0,0.111111,0,33,9,8,0.939394,1,0,6,9,false,true,true,0.937,0.063
226,168,58,22.6,18.666667,58,1110,1039,71,0,0,0,0,32,10,9,1.125,0,0,17,13,false,true,true,0.922,0.078
137,65,72,22.833333,13,72,1093,1100,-7,1,0,0.166667,0,73,6,5,0.438356,0,1,10,6,false,true,true,0.844,0.156
266,156,110,14,8.666667,110,310,359,-49,0,0,0,0,-23,19,18,-2.130435,0,0,13,22,false,true,true,1,0
378,346,32,22.235294,21.625,32,1305,1242,63,2,1,0.117647,0.0625,-16,17,16,-2.125,0,0,2,2,false,true,true,0.969,0.031
176,147,29,19.555556,16.333333,29,613,502,111,0,0,0,0,40,9,9,1.225,0,0,7,27,false,true,true,0.838,0.162
112,59,53,28,14.75,53,859,811,48,0,0,0,0,70,4,4,0.514286,0,0,10,8,false,true,true,0.928,0.072
65,37,28,21.666667,18.5,28,1691,1692,-1,0,0,0,0,77,3,2,0.38961,0,0,15,7,false,true,true,0.539,0.461
0,0,0,0,0,0,1606,1544,62,0,0,0,0,100,1,0,0.45,1,0,19,0,false,true,true,0.716,0.284
185,71,114,37,17.75,114,1054,917,137,0,0,0,0,61,5,4,0.57377,0,0,7,9,false,true,true,0.957,0.043
146,176,-30,16.222222,19.555556,-30,334,446,-112,0,0,0,0,32,9,9,1.25,0,1,8,6,false,true,false,0.016,0.984
368,357,11,20.444444,21,11,1554,1716,-162,1,1,0.055556,0.058824,-21,18,17,-1.666667,0,0,2,2,true,true,true,0.587,0.413
191,182,9,19.1,20.222222,9,1090,1244,-154,0,0,0,0,33,10,9,1.121212,0,1,9,9,false,true,false,0.089,0.911
356,317,39,22.25,21.133333,39,1177,1214,-37,0,0,0,0,-11,16,15,-3.181818,0,0,2,3,false,true,true,1,0
38,0,38,38,0,38,1364,1093,271,0,0,0,0,95,1,0,0.4,0,0,14,0,false,true,true,0.886,0.114
372,338,34,21.882353,19.882353,34,1014,1303,-289,1,0,0.058824,0,-22,17,17,-1.727273,0,0,2,4,false,true,true,1,0
286,249,37,17.875,16.6,37,864,808,56,1,0,0.0625,0,-16,16,15,-2.125,0,1,10,12,false,true,true,0.887,0.113
293,198,95,19.533333,14.142857,95,1091,1078,13,0,0,0,0,17,15,14,2.529412,0,0,10,8,false,true,true,0.999,0.001
291,231,60,26.454545,23.1,60,1355,1210,145,1,0,0.090909,0,24,11,10,1.25,1,0,6,15,false,true,true,1,0
44,42,2,22,21,2,871,999,-128,0,0,0,0,84,2,2,0.571429,0,0,10,14,false,true,false,0.213,0.787
172,104,68,24.571429,17.333333,68,1045,1009,36,1,0,0.142857,0,56,7,6,0.678571,0,1,7,21,false,true,true,0.845,0.155
76,96,-20,15.2,19.2,-20,977,976,1,0,0,0,0,69,5,5,0.492754,0,0,19,11,false,true,false,0.282,0.718
155,94,61,31,23.5,61,795,830,-35,1,1,0.2,0.25,57,5,4,0.736842,2,0,17,11,false,true,true,0.972,0.028
318,176,142,19.875,11.733333,142,421,306,115,0,1,0,0.066667,-4,16,15,-11,0,0,16,9,false,true,true,1,0
30,0,30,30,0,30,904,668,236,0,0,0,0,95,1,0,0.357895,0,0,20,0,false,true,true,0.867,0.133
145,79,66,20.714286,13.166667,66,904,783,121,0,0,0,0,61,7,6,0.688525,0,0,14,27,false,true,true,0.927,0.073
168,184,-16,15.272727,16.727273,-16,1214,1176,38,0,0,0,0,36,11,11,1,0,0,14,12,false,true,false,0.379,0.621
537,505,32,44.75,45.909091,32,1370,1431,-61,3,1,0.25,0.090909,-5,12,11,-4.6,0,0,10,4,true,true,false,0.223,0.777
342,297,45,19,17.470588,45,1075,989,86,1,0,0.055556,0,-6,18,17,-6.5,0,0,13,13,false,true,true,0.986,0.014
347,364,-17,26.692308,28,-17,1256,1232,24,1,0,0.076923,0,-2,13,13,-15,1,0,9,9,false,true,true,0.998,0.002
303,253,50,30.3,28.111111,50,1659,1782,-123,1,0,0.1,0,16,10,9,1.8125,0,1,14,9,false,true,true,0.943,0.057
291,221,70,22.384615,18.416667,70,1221,1266,-45,0,0,0,0,10,13,12,3.5,2,0,9,7,false,true,true,0.997,0.003
266,197,69,22.166667,17.909091,69,719,651,68,0,1,0,0.090909,33,12,11,1.363636,0,0,9,9,false,true,true,0.991,0.009
360,378,-18,22.5,23.625,-18,834,844,-10,1,2,0.0625,0.125,-16,16,16,-2.25,0,0,2,9,false,true,false,0.451,0.549
45,47,-2,22.5,23.5,-2,334,446,-112,0,0,0,0,87,2,2,0.45977,0,0,12,12,false,true,false,0.244,0.756
318,285,33,31.8,31.666667,33,1489,1558,-69,0,1,0,0.111111,23,10,9,1.217391,0,1,10,9,false,true,true,0.771,0.229
337,224,113,33.7,24.888889,113,1507,1554,-47,1,2,0.1,0.222222,18,10,9,1.611111,0,0,11,8,false,true,true,0.989,0.011
304,240,64,30.4,24,64,1735,1770,-35,2,1,0.2,0.1,17,10,10,1.647059,0,1,15,11,false,true,true,0.875,0.125
300,248,52,21.428571,19.076923,52,941,926,15,1,0,0.071429,0,13,14,13,2.923077,1,0,18,13,false,true,true,0.986,0.014
387,392,-5,27.642857,28,-5,1489,1558,-69,0,1,0,0.071429,-8,14,14,-3.5,0,0,6,6,true,true,false,0.281,0.719
117,45,72,29.25,11.25,72,1004,653,351,0,0,0,0,65,4,4,0.538462,0,0,12,12,false,true,true,0.88,0.12
218,221,-3,21.8,22.1,-3,1530,1550,-20,0,1,0,0.1,25,10,10,1.36,0,0,7,13,false,true,false,0.293,0.707
33,33,0,16.5,16.5,0,658,817,-159,0,0,0,0,91,2,2,0.417582,0,0,19,7,false,true,false,0.223,0.777
168,155,13,18.666667,17.222222,13,904,783,121,0,0,0,0,43,9,9,0.976744,0,0,15,22,false,true,true,0.611,0.389
304,292,12,17.882353,17.176471,12,95,378,-283,0,0,0,0,-20,17,17,-1.75,0,0,3,1,false,true,true,0.973,0.027
320,244,76,16.842105,12.842105,76,576,532,44,0,0,0,0,-19,19,19,-2.421053,0,0,9,17,false,true,true,1,0
243,92,151,27,11.5,151,925,801,124,1,0,0.111111,0,47,9,8,0.851064,1,1,6,16,false,true,true,0.995,0.005
137,153,-16,19.571429,25.5,-16,1530,1550,-20,0,1,0,0.166667,46,7,6,0.73913,0,1,25,10,false,true,false,0.272,0.728
329,238,91,20.5625,14.875,91,371,336,35,2,0,0.125,0,-22,16,16,-1.727273,0,0,3,13,false,true,true,1,0
356,315,41,20.941176,19.6875,41,1710,1636,74,1,1,0.058824,0.0625,-12,17,16,-3,0,0,1,12,false,true,true,0.946,0.054
371,241,130,19.526316,12.684211,130,872,818,54,0,1,0,0.052632,-16,19,19,-2.5625,0,0,6,1,false,true,true,1,0
391,303,88,24.4375,18.9375,88,1050,1144,-94,0,1,0,0.0625,-13,16,16,-2.923077,0,0,7,7,false,true,true,1,0
184,88,96,26.285714,14.666667,96,554,342,212,0,0,0,0,53,7,6,0.679245,0,0,9,7,false,true,true,0.967,0.033
169,92,77,21.125,13.142857,77,1033,1037,-4,0,1,0,0.142857,51,8,7,0.882353,0,0,20,12,false,true,true,0.98,0.02
255,246,9,21.25,20.5,9,1277,1166,111,0,1,0,0.083333,14,12,12,2.571429,0,0,17,17,false,true,true,0.763,0.237
142,178,-36,28.4,35.6,-36,1265,1237,28,0,0,0,0,54,5,5,0.555556,1,0,7,19,false,true,false,0.141,0.859
191,155,36,23.875,22.142857,36,1493,1513,-20,1,0,0.125,0,49,8,7,0.673469,0,1,17,16,false,true,true,0.597,0.403
27,120,-93,9,40,-93,947,810,137,0,1,0,0.333333,74,3,3,0.567568,0,0,11,16,false,true,false,0.094,0.906
253,180,73,31.625,22.5,73,1349,1302,47,0,0,0,0,37,8,8,0.783784,0,0,9,17,false,true,true,0.963,0.037
208,110,98,34.666667,22,98,1762,1582,180,2,1,0.333333,0.2,57,6,5,0.561404,0,0,10,12,false,true,true,0.99,0.01
114,82,32,19,16.4,32,916,876,40,0,0,0,0,58,6,5,0.586207,1,0,12,9,false,true,true,0.807,0.193
248,153,95,35.428571,25.5,95,1735,1770,-35,2,1,0.285714,0.166667,36,7,6,0.777778,0,1,18,10,false,true,true,0.878,0.122
383,391,-8,29.461538,32.583333,-8,2219,2029,190,0,0,0,0,-13,13,12,-2,0,0,2,11,false,true,true,1,0
346,330,16,21.625,22,16,1076,1176,-100,0,1,0,0.066667,-11,16,15,-2.909091,0,0,2,3,false,true,true,0.732,0.268
402,309,93,40.2,34.333333,93,1983,2020,-37,2,1,0.2,0.111111,17,10,9,1.529412,0,0,11,12,false,true,true,1,0
502,286,216,45.636364,28.6,216,991,996,-5,3,0,0.272727,0,13,11,10,2.307692,0,0,9,9,false,true,true,1,0
357,220,137,18.789474,12.222222,137,595,543,52,0,0,0,0,-15,19,18,-3.133333,0,0,10,7,false,true,true,1,0
43,60,-17,10.75,15,-17,613,502,111,0,0,0,0,71,4,4,0.690141,0,0,12,16,false,true,true,0.525,0.475
16,22,-6,16,22,-6,1885,1846,39,0,1,0,1,88,1,1,0.329545,1,0,8,16,false,true,true,0.778,0.222
112,89,23,22.4,22.25,23,1040,925,115,0,0,0,0,68,5,4,0.632353,1,0,11,10,false,true,true,0.863,0.137
87,41,46,29,20.5,46,746,796,-50,0,1,0,0.5,75,3,2,0.64,0,0,7,14,false,true,true,0.897,0.103
351,296,55,25.071429,22.769231,55,630,786,-156,1,0,0.071429,0,7,14,13,5,0,0,10,8,false,true,true,0.986,0.014
164,182,-18,20.5,26,-18,1125,1227,-102,0,0,0,0,39,8,7,0.769231,1,0,12,12,false,true,false,0.284,0.716
284,275,9,23.666667,22.916667,9,971,1180,-209,1,1,0.083333,0.083333,12,12,12,2.666667,0,0,16,8,false,true,true,0.683,0.317
198,234,-36,18,23.4,-36,594,605,-11,0,0,0,0,26,11,10,1.423077,0,0,25,8,false,true,false,0.197,0.803
264,228,36,15.529412,14.25,36,613,502,111,0,0,0,0,-6,17,16,-8.166667,1,0,10,19,false,true,true,0.981,0.019
224,151,73,22.4,15.1,73,1551,1550,1,0,0,0,0,32,10,10,1.3125,0,1,8,18,false,true,true,0.876,0.124
19,15,4,9.5,15,4,613,461,152,0,0,0,0,89,2,1,0.41573,1,0,6,20,false,true,true,0.673,0.327
352,298,54,19.555556,17.529412,54,1434,1493,-59,1,0,0.055556,0,-12,18,17,-3.083333,0,0,6,1,false,true,true,1,0
312,326,-14,18.352941,20.375,-14,1439,1294,145,1,0,0.058824,0,-18,17,16,-2,1,0,2,15,false,true,true,0.68,0.32
318,277,41,19.875,17.3125,41,838,786,52,0,1,0,0.0625,-9,16,16,-3.555556,0,0,4,3,true,true,true,0.995,0.005
163,119,44,20.375,17,44,349,315,34,0,0,0,0,40,8,7,0.85,0,0,8,9,false,true,true,0.936,0.064
278,263,15,14.631579,14.611111,15,361,493,-132,1,0,0.052632,0,-31,19,18,-1.322581,0,0,2,4,false,true,true,0.892,0.108
420,294,126,24.705882,18.375,126,1189,1266,-77,1,0,0.058824,0,-19,17,16,-1.789474,0,0,1,1,false,true,true,1,0
63,15,48,21,7.5,48,1270,1348,-78,0,0,0,0,86,3,2,0.44186,1,0,16,9,false,true,true,0.74,0.26
305,232,73,21.785714,17.846154,73,825,907,-82,1,0,0.071429,0,13,14,13,3.076923,0,0,20,15,false,true,true,0.935,0.065
395,318,77,28.214286,22.714286,77,1093,1100,-7,3,3,0.214286,0.214286,-5,14,14,-6.4,0,1,7,4,false,true,true,0.988,0.012
40,14,26,20,14,26,1419,1488,-69,0,0,0,0,87,2,1,0.321839,0,0,8,17,false,true,true,0.539,0.461
345,313,32,26.538462,24.076923,32,1075,1009,66,2,0,0.153846,0,2,13,13,16,0,0,9,11,false,true,true,1,0
128,89,39,25.6,17.8,39,1388,1477,-89,1,0,0.2,0,63,5,5,0.761905,0,0,11,8,false,true,true,0.807,0.193
197,219,-22,19.7,24.333333,-22,1181,1149,32,0,1,0,0.111111,42,10,9,1.071429,0,0,10,19,false,true,false,0.232,0.768
40,41,-1,13.333333,13.666667,-1,1091,1078,13,0,0,0,0,81,3,3,0.530864,0,0,13,8,false,true,false,0.493,0.507
278,208,70,25.272727,18.909091,70,306,169,137,0,0,0,0,13,11,11,2.615385,0,1,10,7,false,true,true,0.963,0.037
286,265,21,22,20.384615,21,786,976,-190,0,0,0,0,7,13,13,4.571429,0,0,18,14,false,true,true,0.54,0.46
274,194,80,22.833333,17.636364,80,1022,1095,-73,0,0,0,0,15,12,11,2.2,0,1,11,9,false,true,true,0.996,0.004
282,250,32,23.5,22.727273,32,1244,1361,-117,2,1,0.166667,0.090909,26,12,11,1.461538,0,0,18,12,false,true,true,0.93,0.07
86,24,62,28.666667,12,62,1075,1027,48,1,0,0.333333,0,78,3,2,0.474359,0,0,17,13,false,true,true,0.8,0.2
292,250,42,19.466667,16.666667,42,1159,1031,128,1,0,0.066667,0,-8,15,15,-4.875,0,0,14,10,false,true,true,0.984,0.016
431,273,158,30.785714,19.5,158,1501,1622,-121,2,0,0.142857,0,-3,14,14,-10.333333,0,0,16,5,false,true,true,1,0
81,110,-29,27,36.666667,-29,1571,1554,17,1,1,0.333333,0.333333,72,3,3,0.458333,0,0,9,11,false,true,true,0.585,0.415
93,72,21,23.25,18,21,1388,1477,-89,1,0,0.25,0,69,4,4,0.695652,0,0,13,9,false,true,true,0.692,0.308
339,238,101,21.1875,14.875,101,527,503,24,0,0,0,0,4,16,16,10.25,0,0,9,14,false,true,true,1,0
218,194,24,24.222222,21.555556,24,1344,1209,135,1,1,0.111111,0.111111,27,9,9,1.259259,0,0,7,20,false,true,true,0.956,0.044
33,46,-13,11,15.333333,-13,628,658,-30,0,0,0,0,79,3,3,0.582278,1,0,35,14,false,true,true,0.74,0.26
10,32,-22,10,32,-22,218,86,132,0,0,0,0,93,1,1,0.430108,0,1,11,12,false,true,false,0.269,0.731
343,244,99,18.052632,12.842105,99,620,513,107,0,0,0,0,-14,19,19,-3.214286,0,0,3,4,false,true,true,1,0
325,306,19,25,23.538462,19,1154,1062,92,2,0,0.153846,0,11,13,13,3.181818,0,0,15,7,false,true,true,0.978,0.022
365,353,12,26.071429,25.214286,12,1397,1195,202,1,0,0.071429,0,0,14,14,0,0,0,14,9,false,true,true,0.998,0.002
332,291,41,22.133333,19.4,41,1302,1082,220,0,0,0,0,-16,15,15,-1.875,0,0,2,6,true,true,true,0.998,0.002
343,211,132,15.590909,9.590909,132,1069,1040,29,0,0,0,0,-35,22,22,-1.257143,0,0,1,1,true,true,true,1,0
0,26,-26,0,26,-26,1142,1095,47,0,0,0,0,95,1,1,0.368421,1,0,8,11,false,true,false,0.287,0.713
12,7,5,12,7,5,1093,1090,3,0,0,0,0,94,1,1,0.361702,0,0,11,15,false,true,true,0.554,0.446
305,110,195,38.125,13.75,195,1513,1482,31,1,0,0.125,0,34,8,8,0.970588,0,0,10,16,false,true,true,1,0
295,227,68,22.692308,17.461538,68,1216,1217,-1,1,0,0.076923,0,11,13,13,3.090909,0,0,11,8,false,true,true,0.989,0.011
290,254,36,26.363636,23.090909,36,416,282,134,1,0,0.090909,0,17,11,11,2,0,0,17,10,false,true,true,0.973,0.027
45,16,29,22.5,8,29,777,830,-53,0,0,0,0,82,2,2,0.5,0,0,14,12,false,true,true,0.569,0.431
365,329,36,26.071429,25.307692,36,1397,1195,202,1,0,0.071429,0,2,14,13,17.5,0,0,14,9,false,true,true,0.999,0.001
44,9,35,22,4.5,35,1067,95,972,0,0,0,0,88,2,2,0.386364,0,0,14,14,false,true,true,1,0
293,205,88,19.533333,13.666667,88,1091,1078,13,0,0,0,0,13,15,15,3.307692,0,0,10,11,false,true,true,0.999,0.001
31,65,-34,15.5,32.5,-34,416,306,110,0,0,0,0,88,2,2,0.477273,0,0,25,10,false,true,true,0.521,0.479
218,113,105,24.222222,12.555556,105,1159,1031,128,1,0,0.111111,0,34,9,9,1.147059,1,0,17,13,false,true,true,0.996,0.004
28,43,-15,14,21.5,-15,1388,1477,-89,0,0,0,0,85,2,2,0.564706,1,0,6,9,false,true,true,0.531,0.469
174,166,8,21.75,20.75,8,1302,1082,220,0,0,0,0,31,8,8,0.967742,0,0,22,7,false,true,true,0.569,0.431
302,256,46,16.777778,14.222222,46,416,306,110,0,0,0,0,-13,18,18,-3.230769,1,0,5,4,false,true,true,0.994,0.006
382,265,117,19.1,13.947368,117,746,796,-50,0,1,0,0.052632,-17,20,19,-2.823529,0,0,2,6,false,true,true,1,0
262,230,32,23.818182,23,32,856,897,-41,0,1,0,0.1,15,11,10,2.333333,0,0,17,11,false,true,true,0.866,0.134
98,53,45,19.6,13.25,45,971,658,313,0,0,0,0,68,5,4,0.529412,0,0,23,10,false,true,true,0.748,0.252
231,125,106,28.875,17.857143,106,742,696,46,0,0,0,0,40,8,7,0.8,0,0,10,10,false,true,true,0.984,0.016
320,261,59,22.857143,18.642857,59,1065,1030,35,0,1,0,0.071429,-2,14,14,-17,0,0,10,11,false,true,true,0.994,0.006
14,0,14,14,0,14,1489,1555,-66,0,0,0,0,96,1,0,0.302083,1,0,9,0,false,true,true,0.64,0.36
410,335,75,29.285714,25.769231,75,1826,1656,170,2,0,0.142857,0,-6,14,13,-4.5,0,0,4,1,true,true,true,1,0
288,239,49,22.153846,19.916667,49,1161,1166,-5,1,0,0.076923,0,7,13,12,5,0,1,10,15,false,true,true,0.843,0.157
100,89,11,12.5,11.125,11,892,768,124,0,0,0,0,57,8,8,0.754386,0,0,8,18,false,true,true,0.58,0.42
68,41,27,17,10.25,27,561,526,35,0,0,0,0,67,4,4,0.522388,1,0,7,19,false,true,true,0.883,0.117
189,98,91,37.8,19.6,91,1824,1793,31,1,0,0.2,0,65,5,5,0.430769,1,0,16,7,false,true,true,0.97,0.03
257,271,-14,21.416667,22.583333,-14,1096,1009,87,1,0,0.083333,0,31,12,12,1.419355,0,0,7,12,false,true,false,0.114,0.886
266,179,87,14,9.421053,87,310,359,-49,0,0,0,0,-26,19,19,-1.884615,0,0,13,22,false,true,true,1,0
229,134,95,32.714286,22.333333,95,1030,998,32,1,0,0.142857,0,46,7,6,0.826087,0,0,17,15,false,true,true,0.958,0.042
70,30,40,23.333333,15,40,1075,1009,66,0,0,0,0,82,3,2,0.390244,1,0,8,23,false,true,true,0.871,0.129
231,236,-5,14.4375,14.75,-5,480,518,-38,0,0,0,0,5,16,16,9.2,1,0,7,16,false,true,true,0.809,0.191
139,164,-25,17.375,23.428571,-25,971,761,210,0,0,0,0,43,8,7,0.697674,0,0,9,19,false,true,false,0.148,0.852
171,107,64,21.375,15.285714,64,1047,1094,-47,1,0,0.125,0,48,8,7,0.75,0,1,17,7,false,true,true,0.829,0.171
260,90,170,37.142857,15,170,918,619,299,2,0,0.285714,0,52,7,6,0.673077,1,0,12,17,false,true,true,1,0
115,87,28,19.166667,17.4,28,1127,1134,-7,0,0,0,0,58,6,5,0.517241,1,0,13,17,false,true,true,0.727,0.273
163,139,24,20.375,17.375,24,1216,1228,-12,0,0,0,0,50,8,8,0.66,0,0,16,11,false,true,true,0.576,0.424
368,277,91,18.4,14.578947,91,719,651,68,0,1,0,0.052632,-18,20,19,-2.5,0,0,4,5,false,true,true,1,0
119,128,-9,23.8,25.6,-9,1431,802,629,0,0,0,0,58,5,5,0.551724,0,0,14,13,false,true,true,1,0
196,139,57,28,19.857143,57,1167,1216,-49,1,0,0.142857,0,50,7,7,0.82,1,0,15,17,false,true,true,0.968,0.032
260,249,11,23.636364,24.9,11,1434,1493,-59,1,0,0.090909,0,16,11,10,2.3125,0,1,13,6,false,true,false,0.463,0.537
51,74,-23,10.2,14.8,-23,523,480,43,0,0,0,0,69,5,5,0.478261,0,0,20,8,false,true,true,0.549,0.451
165,95,70,20.625,13.571429,70,871,867,4,0,0,0,0,53,8,7,0.811321,0,0,10,11,false,true,true,0.974,0.026
118,111,7,16.857143,18.5,7,758,750,8,0,0,0,0,47,7,6,0.787234,0,1,13,6,false,true,false,0.448,0.552
154,80,74,30.8,20,74,1331,1399,-68,0,0,0,0,61,5,4,0.57377,0,0,7,21,false,true,true,0.798,0.202
50,6,44,25,6,44,1004,840,164,0,0,0,0,85,2,1,0.352941,1,0,9,22,false,true,true,0.882,0.118
280,218,62,21.538462,16.769231,62,1394,1230,164,0,1,0,0.076923,10,13,13,3.8,0,0,10,20,false,true,true,0.986,0.014
174,195,-21,14.5,17.727273,-21,916,876,40,0,0,0,0,14,12,11,2.428571,1,0,24,16,false,true,true,0.665,0.335
379,304,75,34.454545,30.4,75,1890,2020,-130,1,2,0.090909,0.2,6,11,10,4.833333,0,1,10,15,false,true,true,0.966,0.034
202,131,71,20.2,14.555556,71,1037,950,87,1,0,0.1,0,39,10,9,0.794872,0,0,11,12,false,true,true,0.988,0.012
212,146,66,19.272727,14.6,66,804,683,121,0,0,0,0,32,11,10,1.40625,0,1,20,13,false,true,true,0.935,0.065
264,252,12,17.6,18,12,859,786,73,0,0,0,0,3,15,14,12.666667,0,0,20,10,false,true,true,0.732,0.268
114,87,27,22.8,21.75,27,926,854,72,0,0,0,0,73,5,4,0.465753,0,0,20,10,false,true,true,0.716,0.284
271,257,14,24.636364,23.363636,14,1023,1110,-87,1,1,0.090909,0.090909,10,11,11,3,1,0,11,10,false,true,true,0.968,0.032
117,177,-60,14.625,22.125,-60,316,306,10,0,2,0,0.25,46,8,8,0.826087,0,0,23,17,false,true,true,0.623,0.377
284,317,-33,13.52381,15.095238,-33,999,1011,-12,0,0,0,0,-27,21,21,-1.703704,1,0,8,5,false,true,false,0.021,0.979
76,89,-13,19,22.25,-13,1040,925,115,0,0,0,0,70,4,4,0.614286,1,0,18,10,false,true,true,0.82,0.18
189,79,110,37.8,19.75,110,1489,1405,84,1,0,0.2,0,69,5,4,0.405797,1,0,9,10,false,true,true,0.974,0.026
48,75,-27,24,37.5,-27,1030,998,32,0,0,0,0,86,2,2,0.44186,1,0,7,13,false,true,false,0.391,0.609
36,72,-36,9,18,-36,977,976,1,0,0,0,0,76,4,4,0.447368,0,0,25,9,false,true,false,0.273,0.727
114,42,72,38,21,72,1220,1261,-41,1,0,0.333333,0,82,3,2,0.54878,0,0,11,10,false,true,true,0.757,0.243
334,312,22,15.904762,15.6,22,947,810,137,0,1,0,0.05,-27,21,20,-1.555556,0,0,2,7,false,true,true,0.971,0.029
221,246,-25,18.416667,22.363636,-25,1181,1149,32,0,1,0,0.090909,33,12,11,1.363636,1,0,9,18,false,true,false,0.18,0.82
170,138,32,28.333333,23,32,1493,1513,-20,1,0,0.166667,0,58,6,6,0.568966,0,1,8,9,false,true,true,0.579,0.421
223,171,52,31.857143,28.5,52,908,1070,-162,1,0,0.142857,0,48,7,6,0.625,0,0,12,10,false,true,true,0.565,0.435
135,215,-80,15,23.888889,-80,613,611,2,0,0,0,0,31,9,9,1.225806,0,0,8,7,false,true,false,0.03,0.97
289,210,79,32.111111,26.25,79,1237,1277,-40,0,0,0,0,27,9,8,1.074074,1,0,6,9,false,true,true,1,0
292,168,124,26.545455,15.272727,124,778,758,20,0,1,0,0.090909,14,11,11,2.785714,1,0,9,17,false,true,true,0.996,0.004
217,272,-55,19.727273,27.2,-55,1501,1473,28,0,0,0,0,23,11,10,1.565217,0,1,13,6,false,true,false,0.014,0.986
148,168,-20,18.5,24,-20,1519,1782,-263,0,0,0,0,47,8,7,0.702128,1,0,7,10,false,true,false,0.082,0.918
312,193,119,31.2,21.444444,119,1431,825,606,1,1,0.1,0.111111,23,10,9,1.478261,0,0,9,16,false,true,true,1,0
54,44,10,18,22,10,1245,1232,13,1,0,0.333333,0,74,3,2,0.391892,0,0,21,8,false,true,true,0.6,0.4
273,283,-10,16.058824,16.647059,-10,1043,1055,-12,0,0,0,0,-12,17,17,-3.083333,0,0,6,3,false,true,false,0.465,0.535
66,18,48,33,18,48,1489,1558,-69,0,0,0,0,86,2,1,0.325581,0,0,18,15,false,true,true,0.738,0.262
385,153,232,32.083333,13.909091,232,1054,917,137,2,0,0.166667,0,9,12,11,3.888889,0,0,13,11,false,true,true,1,0
203,234,-31,15.615385,19.5,-31,95,360,-265,0,1,0,0.083333,7,13,12,5.714286,2,0,12,7,false,true,true,0.576,0.424
317,293,24,17.611111,17.235294,24,784,758,26,0,0,0,0,-18,18,17,-1.944444,1,0,1,2,true,true,true,0.905,0.095
190,123,67,23.75,17.571429,67,691,675,16,0,0,0,0,49,8,7,0.755102,0,1,12,15,false,true,true,0.943,0.057
274,214,60,17.125,13.375,60,539,632,-93,0,0,0,0,8,16,16,5.75,0,0,11,9,false,true,true,0.975,0.025
142,81,61,20.285714,13.5,61,1651,1691,-40,0,0,0,0,61,7,6,0.557377,1,0,8,11,false,true,true,0.936,0.064
258,205,53,18.428571,15.769231,53,786,788,-2,0,0,0,0,1,14,13,34,1,0,6,11,false,true,true,0.985,0.015
46,14,32,23,14,32,1428,1302,126,0,0,0,0,89,2,1,0.595506,0,0,7,16,false,true,true,0.552,0.448
316,289,27,22.571429,22.230769,27,791,885,-94,1,1,0.071429,0.076923,6,14,13,6.333333,0,0,9,8,false,true,true,0.882,0.118
117,72,45,16.714286,10.285714,45,1253,1166,87,0,0,0,0,61,7,7,0.704918,1,0,6,32,false,true,true,0.947,0.053
376,303,73,22.117647,17.823529,73,416,282,134,1,0,0.058824,0,-18,17,17,-1.888889,0,0,3,4,true,true,true,1,0
87,79,8,17.4,19.75,8,1023,1070,-47,0,0,0,0,70,5,4,0.457143,1,0,15,10,false,true,true,0.684,0.316
159,77,82,31.8,15.4,82,371,336,35,2,0,0.4,0,51,5,5,0.745098,0,0,19,14,false,true,true,0.984,0.016
378,303,75,17.181818,13.772727,75,505,95,410,0,1,0,0.045455,-26,22,22,-1.692308,0,0,2,4,true,true,true,1,0
144,107,37,20.571429,17.833333,37,1027,856,171,1,0,0.142857,0,47,7,6,0.702128,0,1,9,10,false,true,true,0.568,0.432
261,223,38,16.3125,13.9375,38,416,306,110,0,0,0,0,3,16,16,14,1,0,8,9,false,true,true,0.988,0.012
59,37,22,19.666667,12.333333,22,804,683,121,0,0,0,0,75,3,3,0.6,0,1,20,6,false,true,true,0.757,0.243
172,122,50,17.2,12.2,50,346,231,115,0,0,0,0,22,10,10,1.863636,0,0,10,10,false,true,true,0.992,0.008
282,215,67,21.692308,16.538462,67,1022,1095,-73,0,0,0,0,5,13,13,6.6,0,1,16,8,false,true,true,0.999,0.001
358,232,126,19.888889,12.888889,126,1586,1782,-196,0,0,0,0,-18,18,18,-2.222222,1,0,4,3,false,true,true,1,0
371,339,32,23.1875,22.6,32,1154,1062,92,2,0,0.125,0,-4,16,15,-8.75,0,0,3,3,false,true,true,1,0
137,116,21,27.4,29,21,1078,1130,-52,0,1,0,0.25,66,5,4,0.590909,0,0,12,11,false,true,true,0.698,0.302
364,339,25,28,26.076923,25,1659,1782,-123,1,0,0.076923,0,-5,13,13,-5.8,0,0,8,4,false,true,true,1,0
255,191,64,19.615385,15.916667,64,711,876,-165,0,0,0,0,17,13,12,2.529412,0,1,7,12,false,true,true,0.957,0.043
311,285,26,13.521739,12.391304,26,262,306,-44,1,0,0.043478,0,-40,23,23,-1.15,0,0,1,4,true,true,true,1,0
235,134,101,26.111111,14.888889,101,1014,1303,-289,1,0,0.111111,0,35,9,9,1.085714,0,1,8,19,false,true,true,0.925,0.075
24,20,4,24,20,4,719,651,68,0,0,0,0,94,1,1,0.478723,1,0,24,13,false,true,true,0.885,0.115
267,238,29,19.071429,18.307692,29,1547,1439,108,1,0,0.071429,0,9,14,13,4.111111,0,0,19,16,false,true,true,0.607,0.393
343,305,38,28.583333,25.416667,38,1762,1616,146,2,0,0.166667,0,2,12,12,15,1,0,7,11,false,true,true,1,0
300,200,100,16.666667,11.764706,100,1069,1040,29,0,0,0,0,-14,18,17,-3.142857,0,1,12,4,false,true,true,1,0
158,235,-77,22.571429,33.571429,-77,1419,1488,-69,0,1,0,0.142857,36,7,7,0.777778,1,0,17,10,false,true,false,0.377,0.623
69,69,0,13.8,13.8,0,1159,1031,128,0,0,0,0,61,5,5,0.639344,1,0,8,14,false,true,true,0.684,0.316
83,89,-6,11.857143,12.714286,-6,892,768,124,0,0,0,0,61,7,7,0.704918,0,0,11,18,false,true,true,0.516,0.484
329,286,43,20.5625,19.066667,43,1094,1030,64,0,0,0,0,-8,16,15,-4.5,0,0,4,5,false,true,true,0.976,0.024
174,94,80,34.8,18.8,80,820,783,37,0,0,0,0,61,5,5,0.540984,0,0,7,10,false,true,true,0.952,0.048
103,53,50,25.75,17.666667,50,1550,1624,-74,0,0,0,0,77,4,3,0.38961,0,0,24,17,false,true,true,0.77,0.23
210,130,80,30,18.571429,80,1156,1114,42,1,0,0.142857,0,39,7,7,0.820513,0,1,15,23,false,true,true,0.873,0.127
72,77,-5,24,25.666667,-5,1109,1065,44,0,0,0,0,82,3,3,0.402439,0,0,21,8,false,true,true,0.56,0.44
10,0,10,10,0,10,1651,1691,-40,0,0,0,0,97,1,0,0.350515,0,0,31,0,false,true,true,0.731,0.269
241,146,95,24.1,14.6,95,1045,1009,36,1,0,0.1,0,36,10,10,1.055556,0,0,9,16,false,true,true,0.99,0.01
324,230,94,20.25,15.333333,94,719,651,68,0,1,0,0.066667,10,16,15,4.5,0,0,8,11,false,true,true,0.996,0.004
144,89,55,20.571429,14.833333,55,786,788,-2,0,0,0,0,46,7,6,0.73913,0,0,11,16,false,true,true,0.933,0.067
69,55,14,23,18.333333,14,786,757,29,0,0,0,0,76,3,3,0.513158,0,0,8,10,false,true,true,0.713,0.287
187,89,98,31.166667,17.8,98,742,696,46,0,0,0,0,54,6,5,0.592593,0,0,8,10,false,true,true,0.962,0.038
121,144,-23,24.2,28.8,-23,1227,1060,167,0,1,0,0.2,63,5,5,0.634921,0,0,20,9,false,true,false,0.289,0.711
170,142,28,34,28.4,28,1203,1221,-18,1,0,0.2,0,63,5,5,0.555556,1,0,6,9,false,true,true,0.67,0.33
109,33,76,36.333333,16.5,76,1348,1331,17,0,0,0,0,78,3,2,0.307692,1,0,12,9,false,true,true,0.758,0.242
263,202,61,26.3,22.444444,61,1034,1040,-6,1,0,0.1,0,27,10,9,1.296296,1,0,13,15,false,true,true,0.963,0.037
82,104,-22,16.4,20.8,-22,1548,1493,55,0,0,0,0,63,5,5,0.650794,2,0,8,16,false,true,true,0.511,0.489
90,95,-5,15,19,-5,1244,1361,-117,0,0,0,0,70,6,5,0.542857,0,1,11,15,false,true,false,0.072,0.928
343,131,212,34.3,14.555556,212,1513,1482,31,1,0,0.1,0,24,10,9,1.375,0,0,10,19,false,true,true,1,0
149,132,17,21.285714,22,17,1040,925,115,0,0,0,0,53,7,6,0.811321,0,0,21,9,false,true,true,0.542,0.458
311,261,50,19.4375,16.3125,50,880,952,-72,0,0,0,0,-7,16,16,-5.857143,0,1,16,7,false,true,true,1,0
173,154,19,24.714286,25.666667,19,1406,1454,-48,0,1,0,0.166667,44,7,6,0.772727,1,0,6,9,false,true,true,0.635,0.365
195,175,20,16.25,15.909091,20,523,480,43,1,0,0.083333,0,16,12,11,2.0625,0,0,20,12,false,true,true,0.904,0.096
371,271,100,28.538462,22.583333,100,1093,1100,-7,3,3,0.230769,0.25,7,13,12,4.571429,0,1,14,11,false,true,true,0.988,0.012
344,261,83,20.235294,15.352941,83,916,837,79,1,0,0.058824,0,-10,17,17,-4,0,0,8,11,false,true,true,1,0
103,52,51,25.75,17.333333,51,1022,1095,-73,0,0,0,0,75,4,3,0.44,1,0,21,9,false,true,true,0.736,0.264
52,0,52,26,0,52,1803,1552,251,0,0,0,0,92,2,1,0.304348,0,0,19,0,false,true,true,1,0
20,50,-30,10,25,-30,1142,1095,47,0,0,0,0,85,2,2,0.411765,1,0,15,15,false,true,false,0.424,0.576
134,80,54,33.5,20,54,1331,1399,-68,0,0,0,0,64,4,4,0.546875,0,0,8,21,false,true,true,0.756,0.244
247,233,14,24.7,23.3,14,1189,1266,-77,1,0,0.1,0,23,10,10,1.478261,0,0,14,9,false,true,true,0.578,0.422
294,265,29,14.7,13.947368,29,371,435,-64,0,0,0,0,-27,20,19,-1.62963,0,0,2,2,false,true,true,1,0
369,249,120,21.705882,14.647059,120,526,370,156,0,0,0,0,-19,17,17,-1.842105,0,0,1,3,false,true,true,1,0
203,234,-31,15.615385,18,-31,95,360,-265,0,1,0,0.076923,7,13,13,5.714286,2,0,12,10,false,true,true,0.739,0.261
361,249,112,24.066667,16.6,112,1029,1227,-198,1,0,0.066667,0,-23,15,15,-1.391304,0,0,1,3,false,true,true,1,0
326,228,98,17.157895,12.666667,98,913,871,42,0,0,0,0,-15,19,18,-2.866667,0,0,3,7,false,true,true,1,0
243,149,94,30.375,18.625,94,769,527,242,1,0,0.125,0,34,8,8,1.058824,0,0,15,16,false,true,true,0.995,0.005
233,153,80,29.125,21.857143,80,1731,1691,40,1,0,0.125,0,39,8,7,0.871795,0,0,8,9,false,true,true,0.951,0.049
173,123,50,21.625,17.571429,50,1516,1397,119,0,1,0,0.142857,42,8,7,0.785714,0,0,11,13,false,true,true,0.777,0.223
10,17,-7,10,17,-7,1261,1349,-88,0,0,0,0,94,1,1,0.138298,0,0,8,18,false,true,false,0.232,0.768
52,35,17,17.333333,11.666667,17,1482,1554,-72,0,0,0,0,85,3,3,0.423529,1,0,15,22,false,true,true,0.7,0.3
36,9,27,18,9,27,1516,1397,119,0,0,0,0,88,2,1,0.375,0,1,12,7,false,true,true,0.543,0.457
270,102,168,18,7.285714,168,859,719,140,0,1,0,0.071429,7,15,14,7.571429,0,1,10,16,false,true,true,1,0
368,270,98,19.368421,15,98,916,837,79,1,0,0.052632,0,-21,19,18,-1.904762,0,0,1,7,false,true,true,1,0
190,181,9,15.833333,16.454545,9,500,567,-67,0,0,0,0,34,12,11,1.294118,0,0,9,27,false,true,false,0.499,0.501
283,212,71,21.769231,17.666667,71,866,949,-83,0,0,0,0,14,13,12,2.857143,1,0,8,17,false,true,true,0.984,0.016
242,174,68,26.888889,21.75,68,1023,1070,-47,1,0,0.111111,0,35,9,8,0.914286,1,0,14,20,false,true,true,0.947,0.053
336,285,51,19.764706,16.764706,51,306,169,137,0,0,0,0,-28,17,17,-1.214286,0,0,1,1,true,true,true,1,0
367,275,92,17.47619,13.095238,92,1606,1544,62,0,0,0,0,-16,21,21,-2.8125,0,0,2,2,false,true,true,1,0
348,346,2,23.2,24.714286,2,1297,1606,-309,1,1,0.066667,0.071429,-11,15,14,-2.727273,0,0,3,4,false,true,true,0.767,0.233
379,324,55,27.071429,23.142857,55,1885,1846,39,1,1,0.071429,0.071429,-10,14,14,-2.9,0,0,3,2,false,true,true,1,0
185,117,68,30.833333,19.5,68,695,671,24,0,0,0,0,54,6,6,0.611111,0,1,7,11,false,true,true,0.948,0.052
364,304,60,21.411765,17.882353,60,892,788,104,3,0,0.176471,0,-9,17,17,-4.777778,0,0,14,9,false,true,true,1,0
355,189,166,32.272727,18.9,166,1501,1622,-121,2,0,0.181818,0,21,11,10,1.47619,0,0,21,9,false,true,true,1,0
303,212,91,23.307692,17.666667,91,1110,1039,71,0,0,0,0,9,13,12,4,0,0,11,13,false,true,true,0.997,0.003
254,172,82,36.285714,24.571429,82,1880,1777,103,1,0,0.142857,0,42,7,7,0.666667,0,1,19,12,false,true,true,0.938,0.062
238,162,76,23.8,16.2,76,1439,1413,26,0,0,0,0,37,10,10,0.972973,1,0,16,12,false,true,true,0.997,0.003
69,51,18,34.5,25.5,18,866,949,-83,0,0,0,0,83,2,2,0.481928,0,0,13,9,false,true,true,0.552,0.448
115,114,1,23,22.8,1,505,95,410,0,1,0,0.2,72,5,5,0.611111,0,0,8,8,false,true,true,0.56,0.44
320,334,-14,22.857143,25.692308,-14,1762,1538,224,1,2,0.071429,0.153846,4,14,13,8.5,0,0,16,10,false,true,true,0.985,0.015
135,121,14,22.5,20.166667,14,1189,1266,-77,0,0,0,0,57,6,6,0.596491,1,0,6,15,false,true,true,0.585,0.415
329,310,19,16.45,16.315789,19,942,976,-34,0,0,0,0,-26,20,19,-1.538462,0,0,1,5,false,true,true,1,0
189,118,71,31.5,23.6,71,1101,1078,23,0,0,0,0,57,6,5,0.578947,0,1,7,17,false,true,true,0.858,0.142
314,240,74,24.153846,20,74,1089,1063,26,1,0,0.076923,0,13,13,12,2.923077,0,0,8,19,false,true,true,0.997,0.003
400,234,166,17.391304,10.173913,166,1176,1076,100,0,0,0,0,-7,23,23,-8.428571,0,0,10,18,false,true,true,1,0
261,222,39,23.727273,20.181818,39,1305,1390,-85,0,1,0,0.090909,16,11,11,2.25,0,1,10,19,false,true,true,0.856,0.144
300,285,15,25,23.75,15,1305,1242,63,2,1,0.166667,0.083333,14,12,12,2.428571,0,0,17,8,false,true,true,0.96,0.04
327,281,46,16.35,14.789474,46,699,448,251,0,0,0,0,-17,20,19,-2.352941,0,0,2,7,false,true,true,0.992,0.008
226,183,43,22.6,18.3,43,1110,1039,71,0,0,0,0,28,10,10,1.285714,0,0,17,13,false,true,true,0.93,0.07
211,279,-68,21.1,27.9,-68,1419,1488,-69,0,1,0,0.1,17,10,10,1.647059,1,0,13,10,false,true,false,0.139,0.861
56,11,45,28,11,45,262,306,-44,0,0,0,0,91,2,1,0.505495,0,0,23,7,false,true,true,0.792,0.208
263,172,91,32.875,24.571429,91,1510,1583,-73,1,0,0.125,0,35,8,7,0.914286,0,0,7,11,false,true,true,0.99,0.01
330,286,44,19.411765,16.823529,44,866,949,-83,0,0,0,0,-11,17,17,-3.636364,1,0,3,7,false,true,true,0.999,0.001
250,277,-27,17.857143,19.785714,-27,613,611,2,0,0,0,0,-3,14,14,-12.666667,0,0,12,10,false,true,false,0.339,0.661
72,43,29,18,10.75,29,1482,1554,-72,0,0,0,0,77,4,4,0.467532,1,0,18,20,false,true,true,0.755,0.245
138,38,100,34.5,12.666667,100,1014,1303,-289,1,0,0.25,0,71,4,3,0.535211,0,1,12,6,false,true,true,0.575,0.425
47,46,1,23.5,46,1,758,796,-38,0,0,0,0,88,2,1,0.431818,1,0,9,12,false,true,false,0.447,0.553
305,279,26,30.5,27.9,26,1826,1656,170,2,0,0.2,0,16,10,10,1.6875,1,0,13,13,false,true,true,1,0
205,104,101,29.285714,17.333333,101,769,527,242,1,0,0.142857,0,48,7,6,0.75,0,0,11,8,false,true,true,0.994,0.006
129,156,-27,18.428571,26,-27,1077,1094,-17,0,0,0,0,56,7,6,0.75,0,0,18,14,false,true,false,0.255,0.745
24,0,24,24,0,24,872,818,54,0,0,0,0,95,1,0,0.431579,0,0,12,0,false,true,true,0.614,0.386
111,91,20,18.5,15.166667,20,698,742,-44,0,0,0,0,67,6,6,0.61194,0,0,10,11,false,true,true,0.645,0.355
240,180,60,18.461538,15,60,523,480,43,1,0,0.076923,0,8,13,12,4.125,0,1,23,14,false,true,true,0.887,0.113
171,121,50,17.1,13.444444,50,1030,1045,-15,0,0,0,0,45,10,9,1.022222,0,0,7,24,false,true,true,0.902,0.098
264,158,106,26.4,17.555556,106,1216,1228,-12,1,0,0.1,0,37,10,9,0.891892,0,0,10,12,false,true,true,0.988,0.012
78,58,20,15.6,11.6,20,859,719,140,0,1,0,0.2,60,5,5,0.883333,0,2,18,5,false,true,true,0.86,0.14
312,162,150,31.2,18,150,1270,1322,-52,1,0,0.1,0,36,10,9,1.055556,0,0,8,20,false,true,true,1,0
372,241,131,18.6,12.05,131,595,543,52,0,0,0,0,-22,20,20,-2.136364,0,0,9,6,false,true,true,1,0
231,162,69,23.1,18,69,1036,1181,-145,0,0,0,0,41,10,9,0.829268,0,0,16,7,false,true,true,0.639,0.361
311,173,138,19.4375,10.8125,138,595,543,52,0,0,0,0,3,16,16,15.666667,0,1,8,17,false,true,true,1,0
188,146,42,23.5,18.25,42,1439,1294,145,1,0,0.125,0,43,8,8,0.837209,0,0,10,33,false,true,true,0.847,0.153
12,23,-11,12,23,-11,885,719,166,0,0,0,0,94,1,1,0.404255,0,1,22,9,false,true,false,0.344,0.656
257,275,-18,14.277778,15.277778,-18,540,518,22,0,0,0,0,-16,18,18,-2.5,0,0,5,2,false,true,true,0.506,0.494
37,22,15,18.5,11,15,1875,1793,82,0,0,0,0,91,2,2,0.32967,0,0,14,16,false,true,false,0.412,0.588
343,256,87,16.333333,12.8,87,272,288,-16,0,0,0,0,-14,21,20,-3.714286,0,0,4,6,false,true,true,1,0
211,119,92,26.375,17,92,1051,1030,21,0,0,0,0,43,8,7,0.697674,0,0,16,13,false,true,true,0.966,0.034
443,322,121,36.916667,29.272727,121,1983,2020,-37,2,1,0.166667,0.090909,5,12,11,5.2,0,0,3,22,false,true,true,1,0
315,276,39,24.230769,23,39,1331,1399,-68,0,0,0,0,3,13,12,11.666667,0,0,9,7,false,true,true,0.565,0.435
67,76,-9,22.333333,25.333333,-9,262,306,-44,0,0,0,0,84,3,3,0.547619,0,0,14,8,false,true,false,0.36,0.64
310,315,-5,17.222222,17.5,-5,1164,1201,-37,0,0,0,0,-15,18,18,-2.8,0,0,15,5,false,true,false,0.004,0.996
201,165,36,15.461538,12.692308,36,218,86,132,0,0,0,0,10,13,13,4,0,0,22,9,false,true,true,0.96,0.04
299,253,46,23,19.461538,46,1489,1445,44,0,0,0,0,10,13,13,3.2,1,0,8,10,false,true,true,0.99,0.01
121,138,-17,24.2,34.5,-17,1227,1060,167,0,1,0,0.25,66,5,4,0.606061,0,0,20,9,false,true,false,0.283,0.717
250,153,97,22.727273,13.909091,97,1045,1009,36,1,0,0.090909,0,32,11,11,1.1875,1,0,8,19,false,true,true,0.995,0.005
38,17,21,19,17,21,1127,1134,-7,0,0,0,0,89,2,1,0.337079,0,0,14,8,false,true,true,0.555,0.445
107,41,66,26.75,13.666667,66,830,907,-77,1,0,0.25,0,74,4,3,0.527027,0,0,7,12,false,true,true,0.778,0.222
123,76,47,41,25.333333,47,1004,840,164,1,0,0.333333,0,72,3,3,0.416667,1,0,13,19,false,true,true,0.851,0.149
193,87,106,24.125,12.428571,106,786,757,29,1,0,0.125,0,52,8,7,0.75,0,0,8,20,false,true,true,0.993,0.007
409,377,32,31.461538,31.416667,32,2219,2106,113,2,0,0.153846,0,-14,13,12,-1.928571,0,0,7,3,false,true,true,0.999,0.001
292,288,4,19.466667,19.2,4,1181,1149,32,0,1,0,0.066667,11,15,15,4.090909,1,0,9,14,false,true,true,0.881,0.119
87,144,-57,21.75,36,-57,1023,1110,-87,0,1,0,0.25,63,4,4,0.47619,0,0,13,12,false,true,false,0.27,0.73
171,130,41,15.545455,13,41,698,742,-44,0,0,0,0,46,11,10,0.891304,0,0,9,16,false,true,true,0.738,0.262
258,253,5,15.176471,15.8125,5,699,448,251,0,0,0,0,0,17,16,0,0,0,20,7,false,true,true,0.721,0.279
292,209,83,32.444444,26.125,83,1762,1616,146,2,0,0.222222,0,27,9,8,1.111111,0,0,7,19,false,true,true,1,0
339,333,6,18.833333,18.5,6,1277,1166,111,0,1,0,0.055556,-21,18,18,-1.714286,0,0,2,1,true,true,true,0.666,0.334
40,14,26,13.333333,7,26,1519,1782,-263,0,0,0,0,87,3,2,0.37931,0,1,12,8,false,true,false,0.211,0.789
0,0,0,0,0,0,995,912,83,0,0,0,0,100,1,0,0.44,0,0,14,0,false,true,true,0.547,0.453
55,39,16,13.75,13,16,698,742,-44,0,0,0,0,83,4,3,0.493976,0,0,20,13,false,true,false,0.24,0.76
265,290,-25,24.090909,26.363636,-25,1102,1245,-143,2,0,0.181818,0,-4,11,11,-7,0,0,15,12,false,true,false,0.11,0.89
79,12,67,39.5,12,67,918,619,299,1,0,0.5,0,86,2,1,0.406977,0,0,13,18,false,true,true,0.86,0.14
28,0,28,28,0,28,939,907,32,0,0,0,0,96,1,0,0.416667,0,0,24,0,false,true,true,0.736,0.264
213,172,41,17.75,14.333333,41,1164,1201,-37,0,0,0,0,24,12,12,1.75,0,1,18,13,false,true,true,0.734,0.266
194,223,-29,14.923077,17.153846,-29,500,567,-67,0,0,0,0,29,13,13,1.517241,0,2,9,14,false,true,false,0,1
110,121,-11,27.5,30.25,-11,1428,1452,-24,0,0,0,0,73,4,4,0.424658,0,0,15,9,false,true,false,0.379,0.621
277,217,60,30.777778,24.111111,60,1349,1302,47,0,0,0,0,27,9,9,1.074074,0,0,9,11,false,true,true,0.98,0.02
344,188,156,21.5,12.533333,156,1413,1422,-9,0,0,0,0,8,16,15,7.125,0,0,9,20,false,true,true,1,0
133,119,14,19,17,14,695,523,172,0,0,0,0,46,7,7,0.804348,0,1,9,7,false,true,true,0.743,0.257
82,131,-49,27.333333,43.666667,-49,834,844,-10,0,1,0,0.333333,71,3,3,0.507042,0,0,10,10,false,true,false,0.27,0.73
10,0,10,10,0,10,1551,1550,1,0,0,0,0,96,1,0,0.4375,0,0,22,0,false,true,true,0.571,0.429
305,203,102,16.052632,10.684211,102,1128,889,239,0,1,0,0.052632,-10,19,19,-4.7,0,1,12,15,false,true,true,1,0
41,14,27,20.5,14,27,859,822,37,0,0,0,0,86,2,1,0.44186,0,0,22,7,false,true,true,0.607,0.393
128,178,-50,21.333333,29.666667,-50,1431,825,606,0,1,0,0.166667,49,6,6,0.693878,1,0,18,13,false,true,true,1,0
6,18,-12,6,18,-12,844,821,23,0,0,0,0,95,1,1,0.442105,0,0,23,9,false,true,false,0.435,0.565
268,225,43,22.333333,18.75,43,941,926,15,1,0,0.083333,0,20,12,12,1.9,1,0,13,12,false,true,true,0.986,0.014
69,114,-45,17.25,38,-45,1076,1176,-100,0,1,0,0.333333,69,4,3,0.463768,0,0,9,15,false,true,false,0.27,0.73
144,52,92,72,26,92,1054,917,137,0,0,0,0,79,2,2,0.443038,0,0,7,12,false,true,true,1,0
116,89,27,19.333333,14.833333,27,1164,1201,-37,0,0,0,0,59,6,6,0.711864,0,1,20,9,false,true,true,0.749,0.251
251,189,62,22.818182,18.9,62,1221,1266,-45,0,0,0,0,24,11,10,1.458333,1,0,9,10,false,true,true,0.939,0.061
396,289,107,28.285714,22.230769,107,1735,1770,-35,2,1,0.142857,0.076923,-9,14,13,-3.111111,0,1,11,3,false,true,true,1,0
391,321,70,23,18.882353,70,1556,1591,-35,2,0,0.117647,0,-24,17,17,-1.5,0,0,1,1,false,true,true,1,0
116,120,-4,16.571429,17.142857,-4,620,513,107,0,0,0,0,51,7,7,0.882353,0,0,8,9,false,true,true,0.566,0.434
142,150,-8,12.909091,15,-8,611,584,27,0,0,0,0,38,11,10,1.157895,0,0,16,12,false,true,false,0.497,0.503
106,39,67,26.5,13,67,1295,1477,-182,1,0,0.25,0,77,4,3,0.597403,1,0,8,10,false,true,true,0.769,0.231
301,300,1,18.8125,18.75,1,1181,1149,32,0,1,0,0.0625,4,16,16,11.25,1,0,13,15,false,true,true,0.903,0.097
230,122,108,38.333333,20.333333,108,1349,1302,47,0,0,0,0,49,6,6,0.591837,0,0,10,9,false,true,true,0.973,0.027
312,295,17,18.352941,17.352941,17,859,786,73,0,0,0,0,-15,17,17,-2.533333,0,0,6,8,false,true,true,0.908,0.092
255,150,105,36.428571,25,105,1645,1777,-132,2,0,0.285714,0,37,7,6,0.675676,0,0,12,18,false,true,true,0.991,0.009
235,187,48,18.076923,14.384615,48,880,952,-72,0,0,0,0,10,13,13,4.1,0,0,16,19,false,true,true,0.977,0.023
226,196,30,13.294118,11.529412,30,584,565,19,0,0,0,0,-7,17,17,-6.571429,0,0,29,15,false,true,true,0.975,0.025
357,179,178,14.875,7.782609,178,859,719,140,0,1,0,0.043478,-33,24,23,-1.606061,0,1,12,9,false,true,true,1,0
392,254,138,30.153846,21.166667,138,1826,1803,23,1,0,0.076923,0,4,13,12,7.5,1,0,5,11,false,true,true,1,0
400,268,132,17.391304,11.652174,132,1011,921,90,1,0,0.043478,0,-23,23,23,-2.130435,0,0,1,11,false,true,true,1,0
91,79,12,15.166667,15.8,12,908,859,49,0,0,0,0,61,6,5,0.639344,0,0,12,18,false,true,true,0.5,0.5
401,287,114,26.733333,19.133333,114,1270,1322,-52,1,0,0.066667,0,-4,15,15,-9.5,0,0,10,7,false,true,true,1,0
20,6,14,10,6,14,1016,1037,-21,0,0,0,0,93,2,1,0.516129,0,0,15,12,false,true,true,0.539,0.461
353,333,20,32.090909,30.272727,20,1935,2020,-85,0,1,0,0.090909,11,11,11,2.818182,0,0,15,14,false,true,true,0.801,0.199
76,49,27,25.333333,16.333333,27,1127,1176,-49,0,0,0,0,77,3,3,0.545455,0,0,18,12,false,true,true,0.615,0.385
328,301,27,14.909091,13.681818,27,480,518,-38,0,0,0,0,-30,22,22,-1.533333,0,0,1,2,false,true,true,1,0
201,71,130,28.714286,11.833333,130,925,801,124,1,0,0.142857,0,60,7,6,0.666667,1,0,13,13,false,true,true,0.996,0.004
53,68,-15,17.666667,22.666667,-15,1659,1782,-123,0,0,0,0,79,3,3,0.367089,0,0,9,17,false,true,false,0.233,0.767
276,167,109,23,15.181818,109,1065,1030,35,0,0,0,0,20,12,11,1.7,1,0,11,10,false,true,true,0.997,0.003
283,161,122,21.769231,12.384615,122,925,801,124,1,0,0.076923,0,20,13,13,2,1,0,9,19,false,true,true,0.998,0.002
361,287,74,20.055556,15.944444,74,1364,1093,271,0,1,0,0.055556,-15,18,18,-2.533333,0,0,5,1,false,true,true,1,0
332,238,94,19.529412,14.875,94,371,336,35,2,0,0.117647,0,-24,17,16,-1.583333,0,0,2,13,false,true,true,1,0
208,157,51,17.333333,14.272727,51,272,288,-16,0,0,0,0,40,12,11,1.3,0,1,12,13,false,true,true,0.703,0.297
204,89,115,34,17.8,115,1075,1027,48,2,0,0.333333,0,57,6,5,0.649123,0,0,9,16,false,true,true,0.988,0.012
186,199,-13,16.909091,18.090909,-13,361,493,-132,1,0,0.090909,0,17,11,11,2.411765,0,0,14,23,false,true,false,0.489,0.511
297,223,74,17.470588,13.117647,74,415,518,-103,0,0,0,0,-12,17,17,-3.166667,0,0,3,15,false,true,true,1,0
299,259,40,23,19.923077,40,1075,1152,-77,0,1,0,0.076923,10,13,13,4,0,0,7,14,false,true,true,0.968,0.032
59,15,44,29.5,15,44,1295,1281,14,0,0,0,0,88,2,1,0.431818,0,0,17,10,false,true,true,0.673,0.327
300,198,102,21.428571,14.142857,102,831,830,1,0,0,0,0,7,14,14,5.285714,0,0,7,9,false,true,true,1,0
115,64,51,16.428571,10.666667,51,1394,1230,164,0,0,0,0,55,7,6,0.690909,0,0,17,7,false,true,true,0.719,0.281
284,250,34,23.666667,22.727273,34,1554,1622,-68,2,0,0.166667,0,12,12,11,2.583333,1,0,9,7,false,true,true,0.948,0.052
159,130,29,22.714286,21.666667,29,926,854,72,0,0,0,0,58,7,6,0.586207,0,0,8,9,false,true,true,0.646,0.354
335,249,86,18.611111,14.647059,86,518,533,-15,1,0,0.055556,0,-20,18,17,-1.75,0,0,3,1,true,true,true,1,0
292,240,52,19.466667,17.142857,52,1159,1031,128,1,0,0.066667,0,-6,15,14,-6.5,0,0,14,7,false,true,true,0.976,0.024
451,280,171,28.1875,18.666667,171,1501,1622,-121,2,0,0.125,0,-12,16,15,-2.583333,0,0,12,5,true,true,true,1,0
0,0,0,0,0,0,791,774,17,0,0,0,0,100,1,0,0.41,0,0,14,0,false,true,true,0.56,0.44
354,305,49,22.125,20.333333,49,1397,1422,-25,3,1,0.1875,0.066667,5,16,15,7.2,0,0,11,23,false,true,true,0.896,0.104
363,221,142,33,20.090909,142,971,621,350,2,0,0.181818,0,10,11,11,3.2,1,0,16,8,false,true,true,1,0
289,188,101,18.0625,11.75,101,272,288,-16,0,0,0,0,16,16,16,3.25,0,0,10,17,false,true,true,0.994,0.006
301,279,22,18.8125,17.4375,22,349,315,34,0,0,0,0,-24,16,16,-1.416667,0,0,1,4,false,true,true,0.988,0.012
132,98,34,22,16.333333,34,808,812,-4,0,0,0,0,52,6,6,0.711538,0,0,15,26,false,true,true,0.916,0.084
20,26,-6,20,26,-6,1454,1531,-77,0,0,0,0,94,1,1,0.319149,1,0,9,7,false,true,true,0.721,0.279
372,277,95,18.6,13.85,95,527,503,24,0,0,0,0,-22,20,20,-1.863636,0,0,1,2,false,true,true,1,0
301,290,11,20.066667,19.333333,11,561,526,35,0,0,0,0,-12,15,15,-2.916667,0,0,13,10,false,true,true,0.861,0.139
132,79,53,22,15.8,53,1245,1232,13,1,0,0.166667,0,54,6,5,0.537037,0,0,20,19,false,true,true,0.815,0.185
386,238,148,24.125,15.866667,148,939,907,32,1,0,0.0625,0,-1,16,15,-40,0,0,5,9,false,true,true,1,0
76,9,67,25.333333,3,67,1067,95,972,0,0,0,0,83,3,3,0.409639,0,0,16,14,false,true,true,1,0
342,330,12,24.428571,23.571429,12,1023,1110,-87,1,1,0.071429,0.071429,-15,14,14,-2,0,0,3,1,false,true,true,0.976,0.024
137,56,81,34.25,18.666667,81,908,1070,-162,1,0,0.25,0,72,4,3,0.416667,1,0,22,11,false,true,true,0.875,0.125
91,99,-8,15.166667,16.5,-8,908,859,49,0,0,0,0,58,6,6,0.672414,0,0,12,15,false,true,false,0.484,0.516
156,139,17,19.5,17.375,17,1305,1390,-85,0,0,0,0,45,8,8,0.8,0,0,10,20,false,true,false,0.216,0.784
205,187,18,17.083333,17,18,725,771,-46,0,1,0,0.090909,28,12,11,1.642857,1,0,6,18,false,true,true,0.961,0.039
148,103,45,24.666667,20.6,45,1295,1281,14,0,0,0,0,64,6,5,0.59375,0,0,16,7,false,true,true,0.591,0.409
304,266,38,16.888889,15.647059,38,808,639,169,0,0,0,0,-10,18,17,-4.1,0,1,5,3,false,true,true,1,0
311,165,146,20.733333,11,146,942,1003,-61,0,0,0,0,2,15,15,22.5,1,1,21,15,false,true,true,1,0
348,351,-3,24.857143,25.071429,-3,1636,1576,60,0,2,0,0.142857,-2,14,14,-17,0,0,10,19,false,true,false,0.429,0.571
81,12,69,20.25,4,69,896,818,78,0,0,0,0,82,4,3,0.536585,0,0,17,10,false,true,true,0.925,0.075
206,209,-3,12.875,13.0625,-3,1030,1045,-15,0,0,0,0,10,16,16,4.6,1,0,6,8,false,true,true,0.93,0.07
346,193,153,31.454545,19.3,153,1439,1353,86,1,0,0.090909,0,23,11,10,1.304348,0,0,7,22,false,true,true,1,0
134,49,85,44.666667,24.5,85,416,282,134,1,0,0.333333,0,78,3,2,0.435897,0,0,22,14,false,true,true,0.934,0.066
348,297,51,20.470588,18.5625,51,795,830,-35,1,1,0.058824,0.0625,-10,17,16,-4.2,0,0,3,11,false,true,true,0.98,0.02
310,236,74,28.181818,21.454545,74,1156,1114,42,1,0,0.090909,0,10,11,11,3.2,0,0,18,16,false,true,true,1,0
227,177,50,16.214286,13.615385,50,698,742,-44,1,0,0.071429,0,23,14,13,1.782609,0,0,7,11,false,true,true,0.904,0.096
315,304,11,15.75,16,11,527,514,13,0,0,0,0,-18,20,19,-2.166667,0,0,3,1,true,true,true,0.582,0.418
317,193,124,26.416667,17.545455,124,1651,1691,-40,1,0,0.083333,0,25,12,11,1.36,1,0,6,10,false,true,true,1,0
138,150,-12,13.8,16.666667,-12,611,584,27,0,0,0,0,42,10,9,1.047619,0,0,7,7,false,true,false,0.497,0.503
272,303,-31,15.111111,17.823529,-31,999,1011,-12,0,0,0,0,-13,18,17,-3.538462,1,0,9,7,false,true,false,0.088,0.912
125,136,-11,20.833333,22.666667,-11,771,754,17,0,0,0,0,53,6,6,0.603774,0,0,11,21,false,true,false,0.485,0.515
227,191,36,22.7,19.1,36,1302,1082,220,0,0,0,0,18,10,10,1.666667,0,0,16,9,false,true,true,0.646,0.354
221,248,-27,17,20.666667,-27,999,1011,-12,0,0,0,0,16,13,12,2.875,1,0,7,25,false,true,false,0.04,0.96
308,269,39,14,12.809524,39,613,502,111,0,0,0,0,-28,22,21,-1.75,0,0,4,15,false,true,true,1,0
169,133,36,21.125,19,36,784,758,26,0,0,0,0,41,8,7,0.853659,0,0,15,7,false,true,true,0.822,0.178
95,74,21,15.833333,12.333333,21,1128,889,239,0,1,0,0.166667,61,6,6,0.770492,1,0,11,7,false,true,true,0.936,0.064
331,301,30,19.470588,18.8125,30,758,796,-38,0,0,0,0,-12,17,16,-3.166667,0,0,2,7,false,true,true,0.953,0.047
323,110,213,35.888889,13.75,213,1513,1482,31,1,0,0.111111,0,31,9,8,1.064516,0,0,10,16,false,true,true,1,0
126,72,54,15.75,10.285714,54,1253,1166,87,0,0,0,0,58,8,7,0.741379,2,0,6,32,false,true,true,0.984,0.016
120,98,22,24,24.5,22,1075,1152,-77,0,0,0,0,67,5,4,0.597015,0,1,19,7,false,true,false,0.49,0.51
309,291,18,25.75,24.25,18,1554,1716,-162,1,1,0.083333,0.083333,7,12,12,5,0,0,15,12,false,true,true,0.903,0.097
12,22,-10,12,22,-10,1572,1550,22,0,0,0,0,93,1,1,0.419355,0,0,10,10,false,true,false,0.28,0.72
378,309,69,37.8,30.9,69,1348,1331,17,3,1,0.3,0.1,3,10,10,8,0,0,8,9,false,true,true,1,0
47,6,41,23.5,6,41,699,448,251,0,0,0,0,92,2,1,0.434783,0,0,11,7,false,true,true,0.785,0.215
70,71,-1,17.5,23.666667,-1,1304,1040,264,0,0,0,0,74,4,3,0.445946,1,0,6,19,false,true,true,0.545,0.455
99,106,-7,16.5,21.2,-7,416,306,110,0,0,0,0,66,6,5,0.636364,0,1,17,6,false,true,true,0.531,0.469
68,0,68,68,0,68,795,830,-35,1,0,1,0,93,1,0,0.451613,1,0,8,0,false,true,true,0.922,0.078
236,215,21,19.666667,19.545455,21,892,788,104,2,0,0.166667,0,23,12,11,1.869565,0,0,12,19,false,true,true,0.932,0.068
64,28,36,21.333333,14,36,1305,1390,-85,0,0,0,0,81,3,2,0.444444,0,0,26,10,false,true,true,0.725,0.275
109,41,68,27.25,13.666667,68,1156,1114,42,1,0,0.25,0,65,4,3,0.492308,0,0,23,7,false,true,true,0.736,0.264
281,241,40,16.529412,14.176471,40,416,306,110,0,0,0,0,-8,17,17,-5.25,1,0,15,6,false,true,true,0.993,0.007
187,121,66,20.777778,15.125,66,620,658,-38,0,0,0,0,43,9,8,0.837209,0,0,31,9,false,true,true,0.951,0.049
183,88,95,36.6,22,95,1245,1241,4,1,1,0.2,0.25,62,5,4,0.467742,0,0,19,21,false,true,true,0.986,0.014
158,136,22,17.555556,15.111111,22,620,513,107,0,0,0,0,42,9,9,1.071429,0,0,10,15,false,true,true,0.828,0.172
296,222,74,24.666667,20.181818,74,613,569,44,0,0,0,0,17,12,11,2.294118,1,0,12,10,false,true,true,0.998,0.002
185,102,83,30.833333,20.4,83,695,671,24,0,0,0,0,59,6,5,0.559322,0,0,7,13,false,true,true,0.953,0.047
394,321,73,23.176471,20.0625,73,901,1159,-258,2,0,0.117647,0,-16,17,16,-2.1875,0,0,10,4,false,true,true,1,0
29,8,21,14.5,8,21,834,758,76,0,0,0,0,87,2,1,0.413793,0,1,14,7,false,true,true,0.567,0.433
70,37,33,23.333333,18.5,33,739,480,259,0,0,0,0,81,3,2,0.444444,0,0,9,16,false,true,true,0.717,0.283
362,200,162,30.166667,18.181818,162,1270,1322,-52,1,0,0.083333,0,20,12,11,1.9,0,0,12,19,false,true,true,1,0
391,267,124,24.4375,16.6875,124,1510,1583,-73,1,0,0.0625,0,-13,16,16,-2.461538,0,0,7,5,true,true,true,1,0
16,0,16,16,0,16,993,897,96,0,0,0,0,97,1,0,0.484536,1,0,7,0,false,true,true,0.695,0.305
270,165,105,20.769231,13.75,105,1253,1166,87,1,0,0.076923,0,25,13,12,1.72,0,0,10,19,false,true,true,0.995,0.005
289,247,42,16.055556,13.722222,42,346,231,115,0,0,0,0,-33,18,18,-1.242424,0,1,18,2,false,true,true,1,0
300,257,43,21.428571,18.357143,43,866,949,-83,0,0,0,0,5,14,14,8,1,0,11,13,false,true,true,0.986,0.014
73,70,3,14.6,14,3,416,222,194,0,0,0,0,64,5,5,0.859375,1,0,9,9,false,true,true,0.786,0.214
216,213,3,24,23.666667,3,1153,1065,88,0,1,0,0.111111,21,9,9,1.333333,0,0,15,17,false,true,false,0.394,0.606
129,105,24,21.5,21,24,613,569,44,0,0,0,0,58,6,5,0.672414,2,0,9,13,false,true,true,0.919,0.081
260,145,115,20,12.083333,115,421,306,115,0,1,0,0.083333,10,13,12,4.4,0,0,24,11,false,true,true,0.996,0.004
49,65,-16,12.25,21.666667,-16,1554,1622,-68,1,0,0.25,0,71,4,3,0.43662,0,1,10,13,false,true,true,0.516,0.484
279,148,131,31,18.5,131,1270,1322,-52,1,0,0.111111,0,41,9,8,0.926829,0,0,14,23,false,true,true,0.986,0.014
380,280,100,27.142857,21.538462,100,1397,1361,36,1,0,0.071429,0,-8,14,13,-3.625,0,0,1,1,false,true,true,1,0
314,242,72,17.444444,13.444444,72,620,513,107,0,0,0,0,-9,18,18,-5,0,0,15,5,false,true,true,1,0
348,262,86,34.8,26.2,86,1197,1127,70,0,0,0,0,18,10,10,1.666667,1,0,9,9,false,true,true,1,0
276,295,-19,25.090909,26.818182,-19,908,1070,-162,1,0,0.090909,0,17,11,11,1.764706,0,0,10,9,false,true,false,0.173,0.827
212,166,46,17.666667,13.833333,46,880,952,-72,0,0,0,0,16,12,12,2.5625,0,0,16,23,false,true,true,0.958,0.042
343,191,152,16.333333,9.55,152,421,306,115,0,1,0,0.05,-18,21,20,-2.444444,0,0,8,5,false,true,true,1,0
325,264,61,16.25,13.2,61,416,306,110,0,0,0,0,-23,20,20,-1.826087,1,0,1,1,false,true,true,1,0
376,272,104,25.066667,18.133333,104,695,671,24,0,0,0,0,-4,15,15,-8.25,0,1,9,4,false,true,true,1,0
261,197,64,21.75,17.909091,64,1513,1479,34,0,0,0,0,19,12,11,1.789474,1,0,15,16,false,true,true,0.977,0.023
93,65,28,23.25,21.666667,28,1501,1622,-121,0,0,0,0,74,4,3,0.418919,1,0,10,28,false,true,false,0.356,0.644
191,150,41,19.1,16.666667,41,1127,1176,-49,0,0,0,0,34,10,9,1.235294,0,0,11,12,false,true,true,0.647,0.353
276,261,15,23,23.727273,15,795,830,-35,1,1,0.083333,0.090909,14,12,11,3,0,0,17,11,false,true,true,0.87,0.13
6,0,6,6,0,6,1075,1152,-77,0,0,0,0,97,1,0,0.412371,1,0,7,0,false,true,true,0.564,0.436
212,154,58,17.666667,14,58,880,952,-72,0,0,0,0,19,12,11,2.157895,0,0,16,15,false,true,true,0.983,0.017
230,153,77,19.166667,13.909091,77,1037,950,87,1,0,0.083333,0,25,12,11,1.24,0,0,8,12,false,true,true,0.992,0.008
309,246,63,30.9,24.6,63,1349,1302,47,0,0,0,0,21,10,10,1.380952,0,0,11,8,false,true,true,1,0
69,65,4,17.25,16.25,4,361,493,-132,0,0,0,0,69,4,4,0.594203,0,1,14,9,false,true,false,0.285,0.715
60,90,-30,15,22.5,-30,1154,1062,92,0,0,0,0,75,4,4,0.466667,0,0,9,23,false,true,false,0.346,0.654
226,150,76,18.833333,12.5,76,415,518,-103,0,0,0,0,27,12,12,1.407407,1,0,9,21,false,true,true,0.981,0.019
350,297,53,23.333333,21.214286,53,1397,1422,-25,3,1,0.2,0.071429,12,15,14,3,0,0,8,23,false,true,true,0.936,0.064
97,97,0,19.4,24.25,0,1102,1245,-143,0,0,0,0,58,5,4,0.482759,1,1,11,15,false,true,false,0.203,0.797
30,60,-30,10,20,-30,1388,1477,-89,0,0,0,0,81,3,3,0.592593,1,0,6,9,false,true,false,0.31,0.69
6,0,6,6,0,6,1045,1009,36,0,0,0,0,97,1,0,0.391753,0,0,15,0,false,true,true,0.561,0.439
224,232,-8,22.4,25.777778,-8,1539,1537,2,0,1,0,0.111111,34,10,9,0.941176,0,0,13,8,false,true,false,0.271,0.729
12,16,-4,12,16,-4,518,533,-15,0,0,0,0,93,1,1,0.376344,0,0,11,26,false,true,false,0.325,0.675
148,157,-9,29.6,31.4,-9,1428,1606,-178,1,0,0.2,0,57,5,5,0.561404,1,0,12,11,false,true,false,0.332,0.668
204,176,28,22.666667,19.555556,28,901,1159,-258,2,0,0.222222,0,34,9,9,1.029412,0,0,13,9,false,true,true,0.914,0.086
55,56,-1,18.333333,18.666667,-1,1189,1266,-77,0,0,0,0,80,3,3,0.425,1,0,19,9,false,true,true,0.731,0.269
35,16,19,11.666667,5.333333,19,1394,1230,164,0,0,0,0,78,3,3,0.487179,0,0,13,7,false,true,true,0.706,0.294
283,286,-3,21.769231,22,-3,1513,1479,34,0,0,0,0,10,13,13,3.4,1,0,13,8,false,true,false,0.465,0.535
338,295,43,28.166667,24.583333,43,1394,1424,-30,1,1,0.083333,0.083333,14,12,12,2.285714,1,0,6,15,false,true,true,0.994,0.006
14,0,14,14,0,14,1128,889,239,0,0,0,0,97,1,0,0.484536,1,0,8,0,false,true,true,0.799,0.201
148,151,-3,16.444444,18.875,-3,527,514,13,0,0,0,0,40,9,8,0.975,0,1,8,14,false,true,false,0.208,0.792
261,188,73,21.75,15.666667,73,830,907,-77,1,0,0.083333,0,23,12,12,1.695652,0,0,9,10,false,true,true,0.949,0.051
341,334,7,17.947368,17.578947,7,885,719,166,0,0,0,0,-21,19,19,-1.809524,0,0,3,3,true,true,false,0.433,0.567
22,0,22,22,0,22,880,952,-72,0,0,0,0,95,1,0,0.431579,0,0,9,0,false,true,true,0.501,0.499
330,244,86,16.5,12.2,86,576,532,44,0,0,0,0,-21,20,20,-2.190476,1,0,8,17,false,true,true,1,0
360,246,114,24,16.4,114,1482,1394,88,2,0,0.133333,0,-1,15,15,-36,0,0,10,15,false,true,true,1,0
291,253,38,16.166667,14.882353,38,272,238,34,0,1,0,0.058824,-23,18,17,-1.73913,0,1,7,3,false,true,true,1,0
270,237,33,22.5,21.545455,33,809,868,-59,1,0,0.083333,0,18,12,11,1.777778,0,0,11,8,false,true,true,0.656,0.344
212,90,122,30.285714,15,122,1439,1353,86,1,0,0.142857,0,51,7,6,0.588235,1,0,18,13,false,true,true,0.994,0.006
61,30,31,20.333333,15,31,916,837,79,0,0,0,0,84,3,2,0.47619,0,1,14,12,false,true,true,0.585,0.415
440,344,96,29.333333,22.933333,96,1216,1230,-14,1,0,0.066667,0,-6,15,15,-5.333333,0,0,3,5,false,true,true,1,0
164,202,-38,16.4,22.444444,-38,999,1011,-12,0,0,0,0,36,10,9,1.277778,0,0,15,10,false,true,false,0.225,0.775
292,206,86,36.5,25.75,86,1735,1770,-35,2,1,0.25,0.125,27,8,8,1.037037,0,1,15,11,false,true,true,0.882,0.118
50,51,-1,16.666667,17,-1,769,527,242,0,0,0,0,74,3,3,0.486486,0,0,11,7,false,true,true,0.681,0.319
337,197,140,24.071429,15.153846,140,742,696,46,0,0,0,0,-2,14,13,-16,0,0,14,16,false,true,true,1,0
86,58,28,21.5,19.333333,28,1245,1232,13,1,0,0.25,0,69,4,3,0.42029,0,0,18,8,false,true,true,0.607,0.393
419,326,93,26.1875,20.375,93,1093,1100,-7,3,3,0.1875,0.1875,-15,16,16,-2.133333,0,0,1,1,true,true,true,0.989,0.011
164,230,-66,20.5,28.75,-66,1076,1176,-100,0,1,0,0.125,39,8,8,0.820513,0,1,22,12,false,true,false,0.093,0.907
78,76,2,19.5,19,2,1606,1544,62,0,0,0,0,79,4,4,0.56962,1,0,7,7,false,true,true,0.588,0.412
343,266,77,16.333333,12.666667,77,272,288,-16,0,0,0,0,-17,21,21,-3.058824,0,0,4,4,false,true,true,1,0
144,18,126,72,18,126,1054,917,137,0,0,0,0,82,2,1,0.426829,0,0,7,15,false,true,true,1,0
288,226,62,16.941176,14.125,62,786,788,-2,0,0,0,0,-20,17,16,-1.7,1,0,2,14,false,true,true,0.999,0.001
386,381,5,29.692308,29.307692,5,1428,1452,-24,1,2,0.076923,0.153846,1,13,13,31,0,0,8,7,false,true,true,0.836,0.164
278,177,101,30.888889,22.125,101,1397,1361,36,1,0,0.111111,0,27,9,8,1.074074,0,0,15,12,false,true,true,0.996,0.004
248,219,29,22.545455,19.909091,29,1047,1094,-47,1,1,0.090909,0.090909,28,11,11,1.285714,0,0,21,11,false,true,true,0.946,0.054
203,126,77,20.3,14,77,939,913,26,0,0,0,0,39,10,9,1.025641,0,1,10,10,false,true,true,0.943,0.057
335,174,161,19.705882,10.875,161,942,1003,-61,0,0,0,0,-6,17,16,-7.5,1,1,20,18,false,true,true,1,0
382,191,191,31.833333,17.363636,191,820,783,37,1,0,0.083333,0,15,12,11,2.2,0,0,7,12,false,true,true,1,0
313,238,75,20.866667,15.866667,75,527,503,24,0,0,0,0,8,15,15,5.125,0,0,7,7,false,true,true,0.996,0.004
50,40,10,16.666667,20,10,1583,1422,161,0,0,0,0,84,3,2,0.607143,0,0,17,9,false,true,false,0.295,0.705
301,196,105,27.363636,17.818182,105,1550,1546,4,0,0,0,0,28,11,11,1.071429,1,1,15,11,false,true,true,0.998,0.002
120,85,35,30,21.25,35,1880,1777,103,1,0,0.25,0,67,4,4,0.41791,0,1,11,11,false,true,true,0.563,0.437
195,114,81,27.857143,19,81,1388,1506,-118,2,1,0.285714,0.166667,54,7,6,0.62963,0,0,12,20,false,true,true,0.965,0.035
298,183,115,29.8,18.3,115,996,1063,-67,1,1,0.1,0.1,19,10,10,1.684211,1,0,8,15,false,true,true,0.99,0.01
371,249,122,20.611111,14.647059,122,596,595,1,1,0,0.055556,0,-15,18,17,-2.666667,0,0,1,18,false,true,true,1,0
182,151,31,22.75,21.571429,31,1266,1144,122,0,0,0,0,46,8,7,0.73913,1,0,8,11,false,true,true,0.76,0.24
92,103,-11,13.142857,14.714286,-11,299,315,-16,0,0,0,0,54,7,7,0.777778,1,0,16,17,false,true,false,0.422,0.578
390,293,97,21.666667,17.235294,97,1394,1118,276,0,1,0,0.058824,-15,18,17,-2.466667,0,0,11,1,false,true,true,1,0
403,344,59,20.15,17.2,59,892,788,104,3,0,0.15,0,-22,20,20,-1.954545,0,0,1,1,false,true,true,1,0
240,170,70,24,17,70,859,811,48,0,0,0,0,30,10,10,1.2,0,1,8,9,false,true,true,0.951,0.049
259,282,-23,17.266667,20.142857,-23,999,1011,-12,0,0,0,0,4,15,14,11.5,1,0,9,16,false,true,false,0.144,0.856
341,251,90,18.944444,14.764706,90,830,907,-77,1,0,0.055556,0,-9,18,17,-4.333333,0,1,14,4,false,true,true,1,0
82,67,15,20.5,22.333333,15,2219,2029,190,0,0,0,0,72,4,3,0.361111,1,0,11,7,false,true,true,1,0
323,246,77,20.1875,16.4,77,939,913,26,0,1,0,0.066667,-2,16,15,-20,1,0,6,13,false,true,true,0.997,0.003
320,200,120,29.090909,20,120,1167,1216,-49,1,0,0.090909,0,24,11,10,1.708333,0,0,7,11,false,true,true,1,0
362,273,89,25.857143,21,89,1203,1221,-18,2,0,0.142857,0,11,14,13,3.181818,0,0,7,9,false,true,true,1,0
221,190,31,22.1,19,31,1334,1270,64,1,0,0.1,0,37,10,10,1,0,0,14,9,false,true,true,0.855,0.145
151,171,-20,15.1,17.1,-20,576,494,82,0,0,0,0,38,10,10,1.157895,0,0,12,19,false,true,true,0.51,0.49
146,98,48,20.857143,14,48,1091,1078,13,0,0,0,0,60,7,7,0.716667,0,0,9,15,false,true,true,0.946,0.054
129,170,-41,16.125,21.25,-41,334,446,-112,0,0,0,0,41,8,8,0.97561,0,0,8,8,false,true,false,0.08,0.92
343,266,77,34.3,26.6,77,1633,1580,53,3,0,0.3,0,19,10,10,1.473684,0,0,9,13,false,true,true,1,0
374,323,51,23.375,20.1875,51,630,786,-156,1,0,0.0625,0,-7,16,16,-5,0,0,6,2,false,true,true,1,0
409,280,129,15.148148,10.769231,129,1413,1422,-9,0,0,0,0,-30,27,26,-1.9,0,0,3,1,false,true,true,1,0
136,74,62,22.666667,12.333333,62,1439,1413,26,0,0,0,0,63,6,6,0.571429,0,0,25,7,false,true,true,0.929,0.071
330,311,19,17.368421,16.368421,19,1078,1130,-52,0,1,0,0.052632,-30,19,19,-1.3,0,0,1,1,false,true,true,1,0
227,145,82,37.833333,24.166667,82,1762,1616,146,2,0,0.333333,0,45,6,6,0.666667,0,0,14,12,false,true,true,0.974,0.026
376,304,72,28.923077,25.333333,72,1333,1331,2,1,0,0.076923,0,-5,13,12,-6,0,0,5,12,false,true,true,1,0
352,241,111,29.333333,21.909091,111,1397,1361,36,1,0,0.083333,0,6,12,11,4.833333,0,0,5,19,false,true,true,1,0
30,7,23,30,7,23,942,1003,-61,0,0,0,0,91,1,1,0.494505,0,0,11,14,false,true,false,0.393,0.607
198,125,73,18,12.5,73,1069,1040,29,0,0,0,0,25,11,10,1.76,0,2,8,5,false,true,true,1,0
12,0,12,12,0,12,1161,1166,-5,0,0,0,0,96,1,0,0.364583,0,0,12,0,false,true,true,0.562,0.438
297,170,127,22.846154,14.166667,127,303,342,-39,0,0,0,0,20,13,12,1.9,0,0,14,12,false,true,true,0.992,0.008
272,212,60,16,13.25,60,698,742,-44,1,0,0.058824,0,7,17,16,5.857143,0,0,10,15,false,true,true,0.917,0.083
197,160,37,21.888889,17.777778,37,916,837,79,0,0,0,0,44,9,9,0.909091,0,0,12,10,false,true,true,0.926,0.074
174,182,-8,19.333333,20.222222,-8,1090,1244,-154,0,0,0,0,35,9,9,1.057143,0,1,9,9,false,true,false,0.1,0.9
348,289,59,38.666667,32.111111,59,1348,1331,17,3,0,0.333333,0,16,9,9,1.5,0,0,10,8,false,true,true,0.998,0.002
299,255,44,27.181818,25.5,44,791,885,-94,1,1,0.090909,0.1,23,11,10,1.652174,0,0,12,9,false,true,true,0.819,0.181
332,309,23,20.75,19.3125,23,315,294,21,0,1,0,0.0625,-22,16,16,-1.590909,0,0,6,1,false,true,true,0.99,0.01
267,204,63,29.666667,22.666667,63,1355,1210,145,1,0,0.111111,0,32,9,9,0.9375,0,0,9,13,false,true,true,0.962,0.038
326,290,36,19.176471,17.058824,36,921,1072,-151,1,0,0.058824,0,-7,17,17,-5.428571,0,0,6,6,false,true,true,0.964,0.036
75,96,-21,25,48,-21,1394,1424,-30,0,1,0,0.5,76,3,2,0.421053,0,0,22,8,false,true,false,0.428,0.572
277,228,49,23.083333,19,49,1731,1691,40,1,0,0.083333,0,12,12,12,2.833333,0,0,10,9,false,true,true,0.978,0.022
226,179,47,16.142857,12.785714,47,871,999,-128,0,0,0,0,19,14,14,2.526316,0,0,7,15,false,true,true,0.94,0.06
110,145,-35,11,14.5,-35,826,771,55,0,0,0,0,49,10,10,0.918367,0,1,12,11,false,true,false,0.32,0.68
164,139,25,16.4,13.9,25,947,909,38,0,0,0,0,34,10,10,1.352941,1,0,9,35,false,true,true,0.909,0.091
10,0,10,10,0,10,1043,1055,-12,0,0,0,0,97,1,0,0.381443,0,0,10,0,false,true,true,0.562,0.438
31,16,15,15.5,16,15,1051,1030,21,0,0,0,0,88,2,1,0.340909,0,0,11,10,false,true,true,0.524,0.476
10,0,10,10,0,10,1211,1173,38,0,0,0,0,96,1,0,0.364583,0,0,17,0,false,true,true,0.562,0.438
158,191,-33,15.8,21.222222,-33,95,360,-265,0,1,0,0.111111,29,10,9,1.37931,0,0,14,10,false,true,false,0.343,0.657
330,211,119,17.368421,11.105263,119,218,86,132,0,0,0,0,-27,19,19,-1.481481,0,0,2,6,false,true,true,1,0
270,220,50,20.769231,16.923077,50,921,1072,-151,1,0,0.076923,0,21,13,13,1.809524,0,1,13,11,false,true,true,0.6,0.4
57,33,24,14.25,11,24,1176,1076,100,0,0,0,0,81,4,3,0.728395,0,0,17,7,false,true,true,0.539,0.461
451,280,171,30.066667,18.666667,171,1501,1622,-121,2,0,0.133333,0,-12,15,15,-2.583333,0,0,12,5,false,true,true,1,0
203,144,59,16.916667,12,59,872,818,54,0,1,0,0.083333,34,12,12,1.205882,0,0,9,8,false,true,true,0.995,0.005
87,83,4,21.75,20.75,4,613,569,44,0,0,0,0,68,4,4,0.573529,2,0,7,13,false,true,true,0.898,0.102
345,286,59,19.166667,16.823529,59,1221,1258,-37,1,0,0.055556,0,-8,18,17,-4.875,1,0,3,7,false,true,true,1,0
301,251,50,15.05,13.210526,50,346,231,115,0,0,0,0,-38,20,19,-1.078947,0,1,13,1,false,true,true,1,0
457,371,86,35.153846,28.538462,86,1770,1689,81,1,1,0.076923,0.076923,-16,13,13,-1.625,0,0,1,8,true,true,true,1,0
217,102,115,27.125,14.571429,115,1211,1173,38,0,0,0,0,51,8,7,0.686275,0,1,15,9,false,true,true,0.917,0.083
394,211,183,35.818182,19.181818,183,1550,1624,-74,2,0,0.181818,0,19,11,11,1.578947,0,0,9,9,false,true,true,1,0
397,347,50,23.352941,20.411765,50,1093,1090,3,1,2,0.058824,0.117647,-10,17,17,-3.4,0,0,3,4,true,true,true,0.992,0.008
186,177,9,26.571429,25.285714,9,974,995,-21,0,1,0,0.142857,44,7,7,0.75,1,0,23,15,false,true,true,0.768,0.232
163,121,42,23.285714,20.166667,42,1302,1082,220,0,0,0,0,43,7,6,0.697674,0,0,17,9,false,true,true,0.678,0.322
185,145,40,30.833333,24.166667,40,992,1100,-108,2,0,0.333333,0,51,6,6,0.666667,0,0,15,10,false,true,true,0.845,0.155
209,116,93,41.8,29,93,1197,1127,70,0,0,0,0,61,5,4,0.491803,0,0,20,11,false,true,true,0.977,0.023
258,179,79,17.2,11.933333,79,498,43,455,0,0,0,0,2,15,15,18.5,0,0,7,10,false,true,true,0.986,0.014
224,133,91,22.4,14.777778,91,1551,1550,1,0,0,0,0,37,10,9,1.135135,0,1,8,17,false,true,true,0.901,0.099
57,26,31,28.5,13,31,786,757,29,0,0,0,0,83,2,2,0.46988,0,0,10,17,false,true,true,0.803,0.197
204,255,-51,20.4,25.5,-51,1076,1176,-100,0,1,0,0.1,27,10,10,1.185185,0,1,26,6,false,true,false,0.006,0.994
295,220,75,22.692308,18.333333,75,960,1070,-110,1,0,0.076923,0,17,13,12,2.058824,1,1,19,6,false,true,true,0.606,0.394
262,78,184,43.666667,15.6,184,1513,1482,31,1,0,0.166667,0,52,6,5,0.634615,0,0,14,19,false,true,true,1,0
234,155,79,33.428571,22.142857,79,1762,1582,180,2,1,0.285714,0.142857,48,7,7,0.666667,0,0,7,10,false,true,true,0.992,0.008
357,179,178,14.875,7.458333,178,859,719,140,0,1,0,0.041667,-33,24,24,-1.606061,0,1,12,9,false,true,true,1,0
18,0,18,18,0,18,346,231,115,0,0,0,0,95,1,0,0.431579,0,0,17,0,false,true,true,0.784,0.216
129,129,0,21.5,21.5,0,613,569,44,0,0,0,0,56,6,6,0.696429,2,0,9,10,false,true,true,0.894,0.106
131,168,-37,18.714286,24,-37,1519,1782,-263,0,0,0,0,51,7,7,0.647059,0,0,7,10,false,true,false,0.072,0.928
301,247,54,15.842105,13.722222,54,346,231,115,0,0,0,0,-36,19,18,-1.138889,0,1,13,2,false,true,true,1,0
90,122,-32,15,20.333333,-32,1244,1361,-117,0,0,0,0,67,6,6,0.567164,0,1,11,15,false,true,false,0.072,0.928
46,36,10,23,36,10,1302,1234,68,0,0,0,0,88,2,1,0.352273,0,0,12,18,false,true,false,0.271,0.729
360,261,99,25.714286,20.076923,99,880,952,-72,0,0,0,0,6,14,13,5.833333,0,0,7,8,false,true,true,1,0
18,0,18,18,0,18,272,288,-16,0,0,0,0,96,1,0,0.541667,1,0,7,0,false,true,true,0.68,0.32
41,86,-45,13.666667,28.666667,-45,902,866,36,0,0,0,0,71,3,3,0.450704,0,0,16,12,false,true,false,0.267,0.733
12,6,6,12,6,6,1253,1166,87,0,0,0,0,93,1,1,0.462366,0,0,8,21,false,true,true,0.517,0.483
8,8,0,8,8,0,415,518,-103,0,0,0,0,91,1,1,0.417582,1,0,19,26,false,true,false,0.402,0.598
334,200,134,18.555556,11.111111,134,896,818,78,0,1,0,0.055556,-2,18,18,-22,1,0,13,8,false,true,true,1,0
0,14,-14,0,14,-14,1388,1506,-118,0,0,0,0,96,1,1,0.354167,1,0,6,28,false,true,false,0.145,0.855
31,31,0,15.5,15.5,0,1261,1349,-88,0,0,0,0,83,2,2,0.156627,0,0,16,25,false,true,false,0.179,0.821
270,145,125,30,16.111111,125,1482,1554,-72,1,0,0.111111,0,35,9,9,1.028571,0,0,19,8,false,true,true,0.989,0.011
189,199,-10,21,24.875,-10,771,754,17,0,0,0,0,38,9,8,0.842105,0,0,16,10,false,true,false,0.346,0.654
75,136,-61,15,27.2,-61,1096,1009,87,0,0,0,0,76,5,5,0.578947,1,0,15,13,false,true,false,0.39,0.61
260,227,33,18.571429,17.461538,33,859,786,73,0,0,0,0,8,14,13,4.75,0,0,20,10,false,true,true,0.839,0.161
400,365,35,23.529412,21.470588,35,1144,1014,130,0,0,0,0,-20,17,17,-1.8,0,0,1,1,false,true,true,1,0
432,249,183,20.571429,12.45,183,1295,1477,-182,3,0,0.142857,0,-20,21,20,-2.3,0,0,2,1,false,true,true,1,0
424,245,179,24.941176,14.411765,179,1482,1554,-72,1,0,0.058824,0,-17,17,17,-2.117647,0,1,3,2,false,true,true,1,0
184,127,57,30.666667,25.4,57,1710,1636,74,1,0,0.166667,0,60,6,5,0.6,1,0,20,7,false,true,true,0.797,0.203
115,43,72,23,10.75,72,1270,1348,-78,0,0,0,0,72,5,4,0.527778,2,0,10,18,false,true,true,0.972,0.028
181,62,119,20.111111,7.75,119,1176,1076,100,0,0,0,0,58,9,8,1.017241,0,1,15,15,false,true,true,0.952,0.048
34,21,13,11.333333,10.5,13,580,620,-40,0,0,0,0,84,3,2,0.511905,1,0,11,9,false,true,true,0.537,0.463
196,186,10,19.6,20.666667,10,491,398,93,0,0,0,0,34,10,9,1.058824,0,0,7,20,false,true,true,0.514,0.486
120,96,24,20,19.2,24,977,976,1,0,0,0,0,66,6,5,0.515152,0,0,13,11,false,true,false,0.453,0.547
357,294,63,27.461538,22.615385,63,1428,1606,-178,1,0,0.076923,0,-2,13,13,-16,1,0,7,4,false,true,true,1,0
273,197,76,21,15.153846,76,620,658,-38,0,0,0,0,12,13,13,3,0,0,17,9,false,true,true,0.994,0.006
364,273,91,19.157895,14.368421,91,527,503,24,0,0,0,0,-17,19,19,-2.411765,0,0,3,2,false,true,true,1,0
373,306,67,23.3125,20.4,67,880,952,-72,0,0,0,0,-7,16,15,-5,0,0,3,6,false,true,true,1,0
104,47,57,17.333333,9.4,57,1394,1230,164,0,0,0,0,61,6,5,0.622951,0,0,7,11,false,true,true,0.813,0.187
218,105,113,24.222222,11.666667,113,942,1003,-61,0,0,0,0,35,9,9,1.285714,0,1,21,17,false,true,true,0.95,0.05
40,15,25,20,15,25,1489,1445,44,0,0,0,0,87,2,1,0.367816,0,0,16,13,false,true,true,0.518,0.482
156,127,29,19.5,15.875,29,786,788,-2,0,0,0,0,38,8,8,0.894737,0,0,11,7,false,true,true,0.898,0.102
47,24,23,23.5,24,23,1205,1216,-11,0,0,0,0,91,2,1,0.362637,0,0,13,19,false,false,false,0.3,0.7
52,67,-15,13,16.75,-15,775,786,-11,0,0,0,0,72,4,4,0.597222,0,0,9,16,false,false,false,0.154,0.846
12,19,-7,12,19,-7,952,870,82,0,0,0,0,93,1,1,0.397849,0,0,10,8,false,false,true,0.507,0.493
173,120,53,19.222222,15,53,742,594,148,0,0,0,0,42,9,8,0.928571,0,1,24,12,false,false,true,0.98,0.02
135,315,-180,8.4375,19.6875,-180,651,996,-345,0,2,0,0.125,-2,16,16,-22.5,0,0,28,10,false,false,false,0.005,0.995
340,371,-31,22.666667,26.5,-31,1495,1597,-102,0,1,0,0.071429,-5,15,14,-6.4,0,0,6,6,false,false,false,0.027,0.973
57,111,-54,28.5,55.5,-54,907,910,-3,0,1,0,0.5,85,2,2,0.505882,0,0,9,15,false,false,false,0.209,0.791
112,140,-28,14,20,-28,450,427,23,0,1,0,0.142857,45,8,7,0.822222,0,0,15,7,false,false,false,0.469,0.531
208,300,-92,18.909091,27.272727,-92,1656,1649,7,0,0,0,0,18,11,11,1.777778,0,0,10,18,false,false,false,0.013,0.987
189,261,-72,18.9,29,-72,874,868,6,0,0,0,0,27,10,9,1.222222,0,0,10,28,false,false,false,0.006,0.994
10,0,10,10,0,10,691,695,-4,0,0,0,0,97,1,0,0.329897,1,0,9,0,false,false,true,0.535,0.465
70,14,56,70,14,56,801,679,122,1,0,1,0,89,1,1,0.325843,0,0,9,18,false,false,false,0.424,0.576
257,197,60,28.555556,24.625,60,1373,1334,39,1,1,0.111111,0.125,39,9,8,0.820513,0,0,10,18,false,false,true,0.904,0.096
324,282,42,23.142857,20.142857,42,1093,1173,-80,1,0,0.071429,0,10,14,14,4.3,0,0,11,9,false,false,true,0.925,0.075
90,23,67,45,23,67,714,820,-106,1,0,0.5,0,86,2,1,0.360465,0,1,14,16,false,false,false,0.001,0.999
176,412,-236,22,51.5,-236,1632,2020,-388,0,2,0,0.25,27,8,8,1.148148,0,0,10,14,false,false,false,0.005,0.995
116,144,-28,19.333333,28.8,-28,452,698,-246,0,1,0,0.2,61,6,5,0.672131,0,0,16,9,false,false,false,0.17,0.83
133,155,-22,33.25,38.75,-22,1689,1777,-88,1,0,0.25,0,58,4,4,0.517241,0,1,11,15,false,false,false,0.117,0.883
100,69,31,25,17.25,31,991,1063,-72,0,0,0,0,76,4,4,0.5,0,0,7,21,false,false,true,0.644,0.356
166,172,-6,23.714286,24.571429,-6,1110,1123,-13,0,1,0,0.142857,43,7,7,0.767442,0,0,8,19,false,false,true,0.658,0.342
176,217,-41,25.142857,36.166667,-41,1388,1455,-67,0,0,0,0,41,7,6,0.682927,1,1,14,14,false,false,false,0.106,0.894
52,68,-16,17.333333,22.666667,-16,1000,960,40,0,0,0,0,79,3,3,0.56962,0,0,10,12,false,false,false,0.23,0.77
136,165,-29,17,20.625,-29,727,820,-93,0,1,0,0.125,41,8,8,0.853659,0,0,12,8,false,false,false,0.298,0.702
95,94,1,15.833333,18.8,1,603,721,-118,0,0,0,0,68,6,5,0.632353,0,1,15,9,false,false,false,0.205,0.795
75,44,31,25,22,31,1633,1556,77,0,0,0,0,77,3,2,0.428571,0,0,23,9,false,false,true,0.525,0.475
330,302,28,30,27.454545,28,820,718,102,0,2,0,0.181818,7,11,11,4,0,0,13,9,false,false,true,0.55,0.45
232,249,-17,19.333333,22.636364,-17,1633,1620,13,0,0,0,0,14,12,11,2.571429,0,1,13,15,false,false,false,0.055,0.945
147,219,-72,14.7,24.333333,-72,1699,1803,-104,1,0,0.1,0,51,10,9,0.686275,0,0,19,8,false,false,false,0.048,0.952
80,69,11,26.666667,34.5,11,1126,1277,-151,0,0,0,0,76,3,2,0.460526,0,0,14,15,false,false,false,0.239,0.761
260,294,-34,20,22.615385,-34,967,856,111,0,0,0,0,13,13,13,2.538462,0,1,16,6,false,false,false,0.018,0.982
148,319,-171,14.8,31.9,-171,1399,1210,189,0,1,0,0.1,35,10,10,1,0,0,20,7,false,false,false,0.066,0.934
259,255,4,21.583333,21.25,4,921,1045,-124,0,0,0,0,19,12,12,1.842105,0,0,10,10,false,false,false,0.484,0.516
209,257,-48,13.933333,17.133333,-48,830,787,43,0,0,0,0,1,15,15,38,0,0,10,8,false,false,false,0.028,0.972
322,354,-32,23,25.285714,-32,1373,1334,39,1,2,0.071429,0.142857,2,14,14,16,1,0,6,11,false,false,false,0.061,0.939
229,376,-147,13.470588,23.5,-147,473,683,-210,0,0,0,0,-10,17,16,-3.8,0,0,2,8,false,false,false,0.005,0.995
273,399,-126,10.92,16.625,-126,1248,1220,28,0,1,0,0.041667,-26,25,24,-2,0,0,2,4,false,false,false,0.028,0.972
126,210,-84,15.75,30,-84,1101,1115,-14,0,0,0,0,47,8,7,0.638298,0,1,16,12,false,false,false,0.017,0.983
227,333,-106,15.133333,22.2,-106,1580,1629,-49,0,1,0,0.066667,-2,15,15,-18.5,0,0,16,12,false,false,false,0.003,0.997
49,48,1,16.333333,24,1,714,892,-178,0,0,0,0,81,3,2,0.518519,1,1,9,17,false,false,false,0.025,0.975
46,80,-34,23,40,-34,1164,1161,3,0,1,0,0.5,79,2,2,0.291139,0,0,10,24,false,false,false,0.278,0.722
274,449,-175,15.222222,26.411765,-175,1399,1210,189,0,1,0,0.058824,-14,18,17,-2.5,0,0,2,2,true,false,false,0.058,0.942
127,119,8,15.875,14.875,8,1220,1185,35,0,0,0,0,54,8,8,0.87037,0,1,30,10,false,false,false,0.46,0.54
228,281,-53,17.538462,21.615385,-53,343,570,-227,0,0,0,0,2,13,13,18,0,0,13,9,false,false,false,0.007,0.993
49,75,-26,8.166667,15,-26,342,53,289,0,0,0,0,65,6,5,0.630769,0,0,9,19,false,false,false,0.234,0.766
220,278,-58,13.75,17.375,-58,278,1,277,0,0,0,0,-7,16,16,-5.285714,0,0,11,3,false,false,false,0.019,0.981
69,70,-1,13.8,17.5,-1,360,371,-11,0,0,0,0,66,5,4,0.560606,0,0,15,13,false,false,false,0.293,0.707
20,35,-15,10,17.5,-15,951,976,-25,0,0,0,0,86,2,2,0.511628,1,1,14,21,false,false,false,0.287,0.713
144,189,-45,14.4,21,-45,95,453,-358,0,0,0,0,39,10,9,1,0,0,7,19,false,false,false,0.01,0.99
18,17,1,18,17,1,1248,1220,28,0,0,0,0,94,1,1,0.553191,0,1,10,10,false,false,false,0.32,0.68
131,198,-67,18.714286,28.285714,-67,1315,1331,-16,0,0,0,0,47,7,7,0.702128,0,0,12,18,false,false,false,0.105,0.895
173,147,26,34.6,29.4,26,1167,1245,-78,1,0,0.2,0,54,5,5,0.518519,0,1,9,13,false,false,false,0.192,0.808
29,11,18,14.5,11,18,804,766,38,0,0,0,0,90,2,1,0.455556,0,1,19,6,false,false,true,0.511,0.489
98,99,-1,49,49.5,-1,1689,1777,-88,1,0,0.5,0,74,2,2,0.405405,0,0,7,19,false,false,false,0.252,0.748
164,186,-22,18.222222,20.666667,-22,615,542,73,0,0,0,0,45,9,9,0.933333,0,1,12,8,false,false,false,0.12,0.88
0,26,-26,0,26,-26,1101,1115,-14,0,0,0,0,97,1,1,0.309278,0,0,10,12,false,false,false,0.115,0.885
320,392,-72,17.777778,21.777778,-72,771,668,103,2,0,0.111111,0,-28,18,18,-1.357143,0,0,1,2,false,false,false,0.036,0.964
291,319,-28,18.1875,21.266667,-28,689,804,-115,0,1,0,0.066667,-9,16,15,-3.888889,0,1,4,5,false,false,false,0.007,0.993
24,19,5,12,19,5,952,870,82,0,0,0,0,90,2,1,0.411111,0,0,8,8,false,false,false,0.457,0.543
279,223,56,21.461538,18.583333,56,742,868,-126,0,0,0,0,17,13,12,1.941176,0,1,7,6,false,false,true,0.975,0.025
285,331,-46,15.833333,18.388889,-46,306,468,-162,1,0,0.055556,0,-11,18,18,-3.363636,0,0,7,2,false,false,false,0.036,0.964
38,20,18,19,20,18,1232,1281,-49,0,1,0,1,83,2,1,0.373494,0,0,8,12,false,false,true,0.53,0.47
69,79,-10,17.25,19.75,-10,653,820,-167,0,0,0,0,69,4,4,0.550725,0,0,10,23,false,false,false,0.131,0.869
247,226,21,16.466667,16.142857,21,480,518,-38,0,0,0,0,3,15,14,13.333333,0,0,14,19,false,false,true,0.596,0.404
16,20,-4,16,20,-4,1203,1270,-67,0,0,0,0,94,1,1,0.468085,0,0,9,18,false,false,false,0.158,0.842
119,130,-11,17,21.666667,-11,1210,1162,48,0,0,0,0,54,7,6,0.592593,0,0,9,17,false,false,false,0.109,0.891
46,35,11,23,17.5,11,621,786,-165,0,0,0,0,82,2,2,0.365854,1,1,20,6,false,false,false,0.377,0.623
147,120,27,18.375,17.142857,27,526,502,24,0,0,0,0,53,8,7,0.943396,0,0,16,7,false,false,true,0.85,0.15
161,158,3,23,22.571429,3,1269,1477,-208,1,0,0.142857,0,50,7,7,0.7,0,1,8,11,false,false,false,0.152,0.848
28,71,-43,14,35.5,-43,1407,1473,-66,0,1,0,0.5,83,2,2,0.373494,0,0,15,10,false,false,false,0.42,0.58
307,387,-80,21.928571,27.642857,-80,1422,1798,-376,0,2,0,0.142857,-1,14,14,-32,0,0,7,7,false,false,false,0.006,0.994
127,177,-50,18.142857,25.285714,-50,694,658,36,0,1,0,0.142857,51,7,7,0.72549,0,0,34,7,false,false,true,0.713,0.287
270,285,-15,16.875,19,-15,599,448,151,0,0,0,0,-1,16,15,-36,0,1,8,14,false,false,false,0.02,0.98
28,50,-22,14,25,-22,1253,1324,-71,0,0,0,0,84,2,2,0.345238,0,0,9,21,false,false,false,0.108,0.892
133,111,22,19,15.857143,22,897,996,-99,0,0,0,0,55,7,7,0.709091,0,0,10,10,false,false,true,0.73,0.27
336,337,-1,15.272727,16.047619,-1,206,346,-140,1,0,0.045455,0,-28,22,21,-1.535714,0,0,11,2,true,false,false,0.117,0.883
93,111,-18,15.5,18.5,-18,848,976,-128,0,0,0,0,62,6,6,0.645161,0,0,10,13,false,false,false,0.109,0.891
290,301,-11,26.363636,30.1,-11,1331,1432,-101,0,0,0,0,13,11,10,2.076923,0,0,18,9,false,false,false,0.171,0.829
127,133,-6,21.166667,26.6,-6,1439,1314,125,0,0,0,0,63,6,5,0.444444,0,0,22,9,false,false,false,0.271,0.729
317,321,-4,17.611111,18.882353,-4,785,892,-107,0,0,0,0,-15,18,17,-2.466667,0,0,1,2,false,false,false,0.265,0.735
87,141,-54,14.5,23.5,-54,1176,1211,-35,0,0,0,0,50,6,6,0.66,1,0,9,15,false,false,false,0.111,0.889
294,324,-30,13.363636,14.727273,-30,526,502,24,0,0,0,0,-28,22,22,-1.785714,1,0,14,14,false,false,false,0.161,0.839
334,511,-177,33.4,51.1,-177,1398,1431,-33,0,0,0,0,0,10,10,0,0,0,13,21,false,false,false,0.012,0.988
26,0,26,26,0,26,450,624,-174,0,0,0,0,96,1,0,0.34375,0,0,16,0,false,false,true,0.687,0.313
99,128,-29,19.8,32,-29,804,766,38,0,1,0,0.25,68,5,4,0.602941,0,1,11,7,false,false,false,0.08,0.92
95,140,-45,10.555556,17.5,-45,1037,1016,21,0,0,0,0,54,9,8,1.074074,0,0,8,26,false,false,false,0.106,0.894
302,452,-150,23.230769,37.666667,-150,1925,1885,40,1,2,0.076923,0.166667,-13,13,12,-1.923077,0,0,1,1,true,false,false,0,1
251,273,-22,16.733333,18.2,-22,1123,1062,61,0,0,0,0,7,15,15,6.285714,0,0,9,17,false,false,false,0.345,0.655
227,281,-54,16.214286,20.071429,-54,360,371,-11,0,0,0,0,-7,14,14,-5.285714,0,0,7,15,false,false,false,0.01,0.99
173,190,-17,17.3,21.111111,-17,356,498,-142,0,1,0,0.111111,33,10,9,1.060606,1,1,6,15,false,false,false,0.106,0.894
42,52,-10,10.5,17.333333,-10,977,1100,-123,0,0,0,0,77,4,3,0.532468,1,0,14,9,false,false,false,0.263,0.737
387,481,-94,38.7,48.1,-94,2147,2219,-72,1,2,0.1,0.2,3,10,10,8,0,0,16,4,false,false,false,0.006,0.994
182,219,-37,14,18.25,-37,830,787,43,0,0,0,0,19,13,12,2,0,0,7,8,false,false,false,0.1,0.9
177,178,-1,19.666667,22.25,-1,967,856,111,0,0,0,0,41,9,8,0.804878,0,0,18,15,false,false,true,0.52,0.48
270,230,40,18,15.333333,40,720,437,283,0,0,0,0,14,15,15,3,0,0,8,16,false,false,true,0.932,0.068
46,12,34,46,12,34,1633,1556,77,0,0,0,0,90,1,1,0.366667,0,0,23,13,false,false,true,0.905,0.095
307,397,-90,16.157895,20.894737,-90,1094,1159,-65,0,0,0,0,-26,19,19,-1.461538,0,0,1,1,true,false,false,0.005,0.995
349,388,-39,19.388889,22.823529,-39,700,820,-120,0,1,0,0.058824,-22,18,17,-1.727273,0,0,2,4,false,false,false,0.04,0.96
195,198,-3,13.928571,15.230769,-3,1040,1091,-51,0,0,0,0,21,14,13,2.238095,0,1,12,15,false,false,false,0.113,0.887
231,265,-34,16.5,18.928571,-34,907,1070,-163,0,0,0,0,15,14,14,2.333333,0,1,13,19,false,false,false,0.02,0.98
103,54,49,34.333333,27,49,1173,1256,-83,1,0,0.333333,0,79,3,2,0.392405,0,1,9,20,false,false,false,0.239,0.761
250,267,-17,17.857143,20.538462,-17,1063,1134,-71,1,0,0.071429,0,25,14,13,1.76,0,1,13,19,false,false,false,0.007,0.993
98,165,-67,10.888889,20.625,-67,651,567,84,0,0,0,0,40,9,8,1.375,0,0,7,9,false,false,false,0.094,0.906
52,36,16,17.333333,18,16,1000,960,40,0,0,0,0,82,3,2,0.54878,0,0,10,16,false,false,false,0.328,0.672
66,83,-17,13.2,20.75,-17,1606,1890,-284,0,0,0,0,69,5,4,0.405797,1,0,6,17,false,false,false,0.247,0.753
10,0,10,10,0,10,1331,1374,-43,0,0,0,0,95,1,0,0.347368,0,0,9,0,false,false,false,0.283,0.717
253,329,-76,15.8125,20.5625,-76,344,315,29,1,1,0.0625,0.0625,-19,16,16,-2.105263,0,0,13,6,false,false,false,0.045,0.955
256,351,-95,17.066667,25.071429,-95,1270,1424,-154,0,2,0,0.142857,2,15,14,17.5,0,0,16,10,false,false,false,0.006,0.994
37,93,-56,9.25,23.25,-56,1368,1452,-84,0,0,0,0,78,4,4,0.410256,1,0,11,26,false,false,false,0.152,0.848
139,236,-97,17.375,33.714286,-97,976,995,-19,0,1,0,0.142857,48,8,7,0.791667,0,0,8,14,false,false,false,0.006,0.994
194,183,11,19.4,20.333333,11,1302,1351,-49,0,0,0,0,37,10,9,1,0,0,9,15,false,false,false,0.113,0.887
237,284,-47,13.166667,16.705882,-47,278,1,277,0,0,0,0,-12,18,17,-3.083333,0,0,9,1,false,false,false,0.006,0.994
298,374,-76,12.416667,15.583333,-76,595,412,183,0,1,0,0.041667,-22,24,24,-2.363636,0,0,10,11,false,false,false,0.014,0.986
49,35,14,16.333333,11.666667,14,1101,1237,-136,0,0,0,0,79,3,3,0.43038,0,1,11,10,false,false,false,0.269,0.731
87,88,-1,17.4,22,-1,736,791,-55,0,0,0,0,68,5,4,0.558824,1,0,8,16,false,false,false,0.35,0.65
29,38,-9,9.666667,12.666667,-9,595,662,-67,0,0,0,0,77,3,3,0.571429,0,0,15,18,false,false,false,0.242,0.758
215,315,-100,9.347826,14.318182,-100,818,826,-8,0,0,0,0,-25,23,22,-2.12,0,0,11,13,false,false,false,0.005,0.995
324,357,-33,20.25,22.3125,-33,917,856,61,1,1,0.0625,0.0625,-9,16,16,-3.666667,0,0,1,2,false,false,false,0.046,0.954
314,333,-19,19.625,20.8125,-19,1257,1176,81,2,0,0.125,0,-2,16,16,-17,0,0,9,5,false,false,false,0.073,0.927
358,466,-108,22.375,31.066667,-108,2143,2219,-76,1,0,0.0625,0,-21,16,15,-1.47619,0,0,3,1,true,false,false,0.005,0.995
138,195,-57,12.545455,17.727273,-57,907,878,29,0,0,0,0,45,11,11,0.955556,1,0,11,12,false,false,false,0.119,0.881
213,222,-9,23.666667,24.666667,-9,1245,1148,97,0,0,0,0,35,9,9,1,0,0,19,10,false,false,true,0.582,0.418
259,253,6,16.1875,15.8125,6,897,996,-99,0,0,0,0,-1,16,16,-39,0,0,14,16,false,false,true,0.551,0.449
234,243,-9,21.272727,24.3,-9,786,885,-99,1,1,0.090909,0.1,29,11,10,1.172414,0,0,8,23,false,false,false,0.156,0.844
137,225,-88,13.7,22.5,-88,343,570,-227,0,0,0,0,23,10,10,1.565217,1,0,16,7,false,false,false,0.011,0.989
243,290,-47,18.692308,22.307692,-47,668,771,-103,0,0,0,0,18,13,13,2.222222,0,0,14,10,false,false,false,0.024,0.976
229,337,-108,16.357143,24.071429,-108,1193,1177,16,0,1,0,0.071429,12,14,14,2.916667,1,1,6,13,false,false,false,0,1
306,309,-3,17,18.176471,-3,720,437,283,0,0,0,0,-3,18,17,-14,0,0,8,12,false,false,false,0.005,0.995
117,117,0,16.714286,19.5,0,1439,1428,11,0,0,0,0,61,7,6,0.655738,1,0,9,17,false,false,false,0.423,0.577
277,430,-153,18.466667,28.666667,-153,976,995,-19,1,2,0.066667,0.133333,-3,15,15,-12.666667,1,0,6,8,false,false,false,0.001,0.999
249,213,36,14.647059,13.3125,36,671,638,33,0,0,0,0,0,17,16,0,0,0,12,21,false,false,true,0.787,0.213
185,266,-81,16.818182,24.181818,-81,736,791,-55,0,0,0,0,18,11,11,2.111111,0,0,12,9,false,false,false,0.006,0.994
168,190,-22,18.666667,21.111111,-22,356,498,-142,0,1,0,0.111111,36,9,9,0.972222,1,1,6,15,false,false,false,0.118,0.882
286,369,-83,16.823529,23.0625,-83,1633,1739,-106,1,0,0.058824,0,-15,17,16,-2.266667,0,0,2,6,false,false,false,0.005,0.995
354,370,-16,22.125,24.666667,-16,714,820,-106,1,0,0.0625,0,-7,16,15,-4.428571,0,0,2,2,true,false,false,0.089,0.911
185,172,13,26.428571,28.666667,13,1305,1211,94,1,0,0.142857,0,57,7,6,0.578947,1,0,6,11,false,false,true,0.848,0.152
153,204,-51,15.3,22.666667,-51,736,791,-55,0,0,0,0,31,10,9,1.225806,0,0,9,9,false,false,false,0.098,0.902
23,32,-9,11.5,32,-9,1397,1309,88,0,0,0,0,91,2,1,0.395604,1,1,15,27,false,false,false,0.156,0.844
214,300,-86,15.285714,23.076923,-86,450,427,23,1,1,0.071429,0.076923,1,14,13,37,0,0,13,13,false,false,false,0.02,0.98
200,233,-33,11.764706,14.5625,-33,391,542,-151,1,0,0.058824,0,-4,17,16,-11.5,0,0,19,22,false,false,false,0.036,0.964
26,28,-2,8.666667,9.333333,-2,797,796,1,0,0,0,0,88,3,3,0.556818,0,0,15,21,false,false,false,0.179,0.821
148,172,-24,16.444444,21.5,-24,1071,1181,-110,0,0,0,0,49,9,8,0.693878,0,1,11,6,false,false,false,0.144,0.856
72,75,-3,18,18.75,-3,1310,1477,-167,0,0,0,0,70,4,4,0.514286,0,0,11,8,false,false,false,0.263,0.737
276,343,-67,15.333333,19.055556,-67,1037,1009,28,0,0,0,0,-2,18,18,-22,1,0,7,4,false,false,false,0.006,0.994
181,168,13,16.454545,16.8,13,1312,1334,-22,0,0,0,0,25,11,10,1.56,0,0,18,10,false,false,false,0.226,0.774
288,335,-47,24,27.916667,-47,1495,1597,-102,0,1,0,0.083333,12,12,12,2.666667,0,1,8,9,false,false,false,0.006,0.994
12,25,-13,6,12.5,-13,710,758,-48,0,0,0,0,88,2,2,0.420455,0,1,19,9,false,false,false,0.302,0.698
251,285,-34,22.818182,28.5,-34,1266,1339,-73,0,1,0,0.1,30,11,10,1.166667,0,0,11,12,false,false,false,0.161,0.839
114,133,-19,14.25,19,-19,907,878,29,0,0,0,0,61,8,7,0.704918,0,0,15,12,false,false,false,0.108,0.892
270,323,-53,12.272727,14.681818,-53,595,662,-67,0,1,0,0.045455,-28,22,22,-1.571429,0,0,1,9,true,false,false,0.02,0.98
339,374,-35,16.142857,17.809524,-35,1063,1134,-71,1,0,0.047619,0,-17,21,21,-2.588235,0,0,1,1,false,false,false,0.04,0.96
135,98,37,22.5,19.6,37,1606,1593,13,0,0,0,0,63,6,5,0.460317,0,0,11,17,false,false,false,0.405,0.595
149,165,-16,29.8,33,-16,801,679,122,1,0,0.2,0,56,5,5,0.517857,0,0,9,11,false,false,false,0.358,0.642
169,248,-79,16.9,27.555556,-79,1572,1777,-205,0,1,0,0.111111,26,10,9,1.269231,0,1,16,11,false,false,false,0.082,0.918
231,220,11,19.25,20,11,206,346,-140,1,0,0.083333,0,18,12,11,2.388889,0,0,16,9,false,false,true,0.642,0.358
146,178,-32,16.222222,19.777778,-32,1248,1220,28,0,1,0,0.111111,47,9,9,1.106383,1,0,6,17,false,false,false,0.128,0.872
251,315,-64,16.733333,22.5,-64,1493,1453,40,0,0,0,0,-1,15,14,-35,0,2,8,5,false,false,false,0.004,0.996
95,178,-83,11.875,25.428571,-83,1368,1452,-84,0,0,0,0,55,8,7,0.581818,1,0,10,15,false,false,false,0.106,0.894
48,65,-17,9.6,16.25,-17,1101,1130,-29,0,0,0,0,73,5,4,0.616438,0,1,7,7,false,false,false,0.245,0.755
158,144,14,17.555556,18,14,500,532,-32,0,0,0,0,41,9,8,1,0,0,14,10,false,false,true,0.688,0.312
156,247,-91,17.333333,27.444444,-91,954,939,15,0,0,0,0,35,9,9,1.028571,1,1,21,7,false,false,false,0.019,0.981
308,314,-6,23.692308,26.166667,-6,1552,1803,-251,2,0,0.153846,0,6,13,12,5.5,0,0,7,11,false,false,false,0.054,0.946
93,72,21,15.5,14.4,21,542,390,152,0,0,0,0,74,6,5,0.675676,0,1,11,15,false,false,true,0.51,0.49
122,135,-13,17.428571,19.285714,-13,595,538,57,0,0,0,0,49,7,7,0.77551,0,0,10,19,false,false,false,0.417,0.583
278,385,-107,15.444444,21.388889,-107,595,733,-138,1,1,0.055556,0.055556,-20,18,18,-1.95,0,1,21,2,false,false,false,0.007,0.993
216,293,-77,15.428571,20.928571,-77,1101,1130,-29,1,1,0.071429,0.071429,17,14,14,2.647059,0,1,11,8,false,false,false,0.005,0.995
187,184,3,15.583333,15.333333,3,671,638,33,0,0,0,0,20,12,12,2.45,0,0,16,21,false,false,true,0.687,0.313
177,160,17,17.7,17.777778,17,306,468,-162,0,0,0,0,47,10,9,0.787234,0,0,9,10,false,false,false,0.463,0.537
100,97,3,16.666667,19.4,3,1159,1131,28,0,0,0,0,67,6,5,0.552239,0,1,10,6,false,false,false,0.248,0.752
149,192,-43,14.9,19.2,-43,306,361,-55,0,0,0,0,26,10,10,1.384615,0,1,7,6,false,false,false,0.06,0.94
301,365,-64,14.333333,18.25,-64,603,721,-118,0,0,0,0,-25,21,20,-1.72,1,0,1,1,false,false,false,0.006,0.994
69,59,10,17.25,19.666667,10,653,820,-167,0,0,0,0,72,4,3,0.527778,0,0,10,19,false,false,false,0.145,0.855
278,285,-7,19.857143,20.357143,-7,1803,1658,145,1,0,0.071429,0,-4,14,14,-8.25,0,0,10,12,false,false,false,0.299,0.701
142,144,-2,15.777778,18,-2,995,965,30,0,0,0,0,44,9,8,0.909091,0,1,26,10,false,false,false,0.187,0.813
314,333,-19,14.952381,15.857143,-19,1000,960,40,0,0,0,0,-27,21,21,-1.666667,0,0,1,1,false,false,false,0.091,0.909
29,22,7,9.666667,11,7,595,662,-67,0,0,0,0,82,3,2,0.536585,0,0,15,20,false,false,false,0.203,0.797
250,361,-111,16.666667,24.066667,-111,1193,1177,16,0,1,0,0.066667,4,15,15,8.75,1,1,8,9,false,false,false,0,1
180,180,0,22.5,25.714286,0,1606,1890,-284,0,0,0,0,43,8,7,0.651163,0,0,11,13,false,false,false,0.106,0.894
30,50,-20,10,16.666667,-20,530,683,-153,0,0,0,0,82,3,3,0.487805,0,0,8,13,false,false,false,0.111,0.889
31,39,-8,15.5,19.5,-8,1123,1062,61,0,0,0,0,86,2,2,0.511628,0,0,7,23,false,false,false,0.176,0.824
126,103,23,21,20.6,23,1428,1361,67,0,0,0,0,57,6,5,0.578947,0,1,16,15,false,false,false,0.421,0.579
98,131,-33,19.6,26.2,-33,1484,1556,-72,0,1,0,0.2,58,5,5,0.534483,1,0,20,12,false,false,true,0.824,0.176
95,21,74,31.666667,10.5,74,786,885,-99,1,0,0.333333,0,81,3,2,0.419753,0,0,7,23,false,false,true,0.815,0.185
12,0,12,12,0,12,1554,1685,-131,0,0,0,0,97,1,0,0.329897,0,0,9,0,false,false,false,0.248,0.752
16,10,6,16,10,6,388,542,-154,0,0,0,0,88,1,1,0.420455,0,0,13,17,false,false,false,0.314,0.686
224,301,-77,18.666667,25.083333,-77,1572,1777,-205,0,1,0,0.083333,7,12,12,4.714286,0,1,9,6,false,false,false,0.029,0.971
140,108,32,23.333333,21.6,32,1691,1551,140,0,0,0,0,62,6,5,0.596774,0,0,14,17,false,false,false,0.397,0.603
76,57,19,19,19,19,796,800,-4,0,0,0,0,78,4,3,0.615385,0,0,18,7,false,false,true,0.56,0.44
108,310,-202,10.8,31,-202,1422,1510,-88,0,2,0,0.2,41,10,10,0.95122,1,0,16,14,false,false,false,0.001,0.999
113,171,-58,16.142857,24.428571,-58,518,414,104,0,1,0,0.142857,53,7,7,0.716981,0,0,19,11,false,false,true,0.58,0.42
18,0,18,18,0,18,1102,1245,-143,0,0,0,0,96,1,0,0.302083,0,0,12,0,false,false,false,0.369,0.631
115,269,-154,10.454545,24.454545,-154,530,683,-153,0,1,0,0.090909,37,11,11,1.081081,0,0,19,10,false,false,false,0.005,0.995
257,358,-101,14.277778,19.888889,-101,837,844,-7,0,0,0,0,-9,18,18,-4.555556,1,0,4,2,false,false,false,0.005,0.995
251,295,-44,14.764706,18.4375,-44,615,542,73,0,0,0,0,-1,17,16,-42,0,0,11,7,false,false,false,0.032,0.968
80,42,38,80,42,38,1436,1489,-53,1,0,1,0,89,1,1,0.41573,0,0,15,21,false,false,true,0.664,0.336
227,233,-6,18.916667,19.416667,-6,387,683,-296,0,0,0,0,6,12,12,5.666667,1,0,14,19,false,false,false,0.203,0.797
38,56,-18,9.5,18.666667,-18,1270,1261,9,0,0,0,0,81,4,3,0.45679,1,0,10,16,false,false,false,0.254,0.746
137,122,15,22.833333,24.4,15,1102,1245,-143,0,0,0,0,52,6,5,0.557692,0,0,11,11,false,false,false,0.223,0.777
73,96,-23,14.6,19.2,-23,451,448,3,0,0,0,0,71,5,5,0.521127,0,1,13,12,false,false,false,0.092,0.908
14,0,14,14,0,14,948,998,-50,0,0,0,0,94,1,0,0.393617,0,0,9,0,false,false,false,0.451,0.549
135,46,89,45,15.333333,89,1373,1334,39,1,0,0.333333,0,79,3,3,0.405063,0,0,8,13,false,false,true,0.913,0.087
18,0,18,18,0,18,1094,1159,-65,0,0,0,0,94,1,0,0.404255,0,0,19,0,false,false,true,0.517,0.483
26,0,26,26,0,26,473,683,-210,0,0,0,0,95,1,0,0.4,0,0,13,0,false,false,true,0.579,0.421
200,302,-102,15.384615,25.166667,-102,342,263,79,0,0,0,0,5,13,12,6.8,1,0,10,8,false,false,false,0.005,0.995
14,0,14,14,0,14,1229,1220,9,0,0,0,0,96,1,0,0.385417,0,0,12,0,false,false,false,0.46,0.54
160,235,-75,17.777778,26.111111,-75,1055,840,215,0,1,0,0.111111,36,9,9,1,1,0,8,7,false,false,false,0.009,0.991
209,299,-90,17.416667,24.916667,-90,1305,1254,51,0,1,0,0.083333,10,12,12,3.2,0,0,7,11,false,false,false,0.001,0.999
202,355,-153,10.1,17.75,-153,651,996,-345,0,2,0,0.1,-25,20,20,-1.8,0,0,5,3,false,false,false,0.005,0.995
262,257,5,16.375,16.0625,5,796,800,-4,1,0,0.0625,0,10,16,16,4.8,0,1,10,6,false,false,false,0.309,0.691
150,156,-6,16.666667,17.333333,-6,450,503,-53,0,0,0,0,39,9,9,1,1,0,19,10,false,false,true,0.53,0.47
110,88,22,27.5,22,22,595,733,-138,1,0,0.25,0,65,4,4,0.6,0,0,16,11,false,false,true,0.577,0.423
139,201,-62,12.636364,18.272727,-62,1182,1075,107,0,1,0,0.090909,23,11,11,1.695652,0,1,24,9,false,false,false,0.007,0.993
198,214,-16,19.8,21.4,-16,758,904,-146,1,0,0.1,0,22,10,10,1.545455,0,1,9,6,false,false,false,0.001,0.999
189,262,-73,11.8125,17.466667,-73,595,662,-67,0,1,0,0.066667,3,16,15,14.666667,0,0,16,14,false,false,false,0.01,0.99
34,42,-8,17,21,-8,837,844,-7,0,0,0,0,88,2,2,0.465909,0,1,7,18,false,false,false,0.135,0.865
167,152,15,27.833333,30.4,15,1415,1361,54,0,0,0,0,62,6,5,0.5,0,1,11,6,false,false,false,0.344,0.656
92,133,-41,18.4,26.6,-41,1636,1796,-160,0,0,0,0,64,5,5,0.421875,0,0,15,9,false,false,false,0.107,0.893
186,212,-26,15.5,17.666667,-26,797,796,1,0,0,0,0,32,12,12,1.53125,1,0,11,18,false,false,false,0.11,0.89
269,257,12,22.416667,21.416667,12,1305,1194,111,1,0,0.083333,0,14,12,12,2.357143,0,0,18,7,false,false,true,0.742,0.258
90,132,-42,18,26.4,-42,1047,1127,-80,0,1,0,0.2,62,5,5,0.435484,1,0,6,19,false,false,false,0.123,0.877
88,144,-56,12.571429,20.571429,-56,1580,1629,-49,0,0,0,0,54,7,7,0.685185,0,0,22,7,false,false,false,0.108,0.892
242,226,16,26.888889,25.111111,16,691,695,-4,1,0,0.111111,0,35,9,9,0.914286,0,0,18,14,false,false,true,0.733,0.267
347,287,60,21.6875,19.133333,60,1093,1173,-80,1,0,0.0625,0,2,16,15,21.5,0,0,10,8,false,false,true,0.985,0.015
8,0,8,8,0,8,361,413,-52,0,0,0,0,96,1,0,0.427083,0,0,26,0,false,false,true,0.53,0.47
282,406,-124,13.428571,19.333333,-124,1037,1016,21,1,0,0.047619,0,-13,21,21,-4.461538,1,0,12,6,false,false,false,0.005,0.995
70,97,-27,23.333333,32.333333,-27,1554,1685,-131,0,1,0,0.333333,77,3,3,0.415584,0,0,19,9,false,false,false,0.432,0.568
209,292,-83,17.416667,26.545455,-83,1407,1473,-66,0,2,0,0.181818,13,12,11,2.384615,0,0,7,17,false,false,false,0,1
186,233,-47,15.5,19.416667,-47,1312,1334,-22,0,0,0,0,13,12,12,3,0,0,17,8,false,false,false,0.106,0.894
280,345,-65,14.736842,19.166667,-65,620,698,-78,1,0,0.052632,0,-19,19,18,-2.157895,1,0,13,3,false,false,false,0.006,0.994
169,279,-110,21.125,34.875,-110,1334,1486,-152,1,1,0.125,0.125,46,8,8,0.630435,0,0,9,17,false,false,false,0.005,0.995
289,344,-55,20.642857,26.461538,-55,1176,1133,43,1,0,0.071429,0,16,14,13,2.125,0,0,9,11,false,false,false,0.011,0.989
92,68,24,23,22.666667,24,1159,1131,28,0,0,0,0,77,4,3,0.480519,0,1,7,6,false,false,false,0.396,0.604
115,108,7,19.166667,21.6,7,1003,1018,-15,0,0,0,0,61,6,5,0.606557,0,1,14,13,false,false,false,0.17,0.83
215,233,-18,17.916667,21.181818,-18,1123,1062,61,0,0,0,0,25,12,11,1.76,0,0,11,12,false,false,false,0.116,0.884
199,260,-61,22.111111,28.888889,-61,1266,1339,-73,0,1,0,0.111111,41,9,9,0.853659,0,1,13,14,false,false,false,0.043,0.957
297,236,61,33,29.5,61,169,306,-137,2,1,0.222222,0.125,20,9,8,1.55,0,0,14,8,false,false,false,0.333,0.667
133,199,-66,19,33.166667,-66,1397,1309,88,1,0,0.142857,0,61,7,6,0.590164,0,1,7,10,false,false,false,0.011,0.989
69,60,9,17.25,15,9,651,700,-49,0,0,0,0,75,4,4,0.746667,0,0,7,16,false,false,false,0.325,0.675
331,368,-37,19.470588,23,-37,1656,1580,76,1,1,0.058824,0.0625,-9,17,16,-3.666667,0,0,6,2,true,false,false,0,1
148,209,-61,18.5,29.857143,-61,1408,1539,-131,0,1,0,0.142857,42,8,7,0.809524,0,0,11,9,false,false,false,0.106,0.894
116,260,-144,19.333333,52,-144,1219,1216,3,0,3,0,0.6,50,6,5,0.54,0,0,9,8,false,false,false,0.001,0.999
100,133,-33,12.5,16.625,-33,568,570,-2,0,0,0,0,49,8,8,0.755102,0,0,17,18,false,false,false,0.13,0.87
277,284,-7,17.3125,18.933333,-7,704,523,181,0,0,0,0,-16,16,15,-2.1875,0,0,4,6,false,false,false,0.486,0.514
149,187,-38,13.545455,18.7,-38,613,525,88,0,0,0,0,36,11,10,1.166667,0,1,10,9,false,false,false,0.091,0.909
139,221,-82,9.928571,17,-82,818,826,-8,0,0,0,0,31,14,13,1.709677,1,0,6,16,false,false,false,0.007,0.993
208,265,-57,18.909091,26.5,-57,1656,1649,7,0,0,0,0,23,11,10,1.391304,0,0,10,11,false,false,false,0.104,0.896
183,256,-73,20.333333,32,-73,1606,1593,13,0,1,0,0.125,34,9,8,0.852941,0,0,10,15,false,false,false,0.021,0.979
108,123,-15,18,20.5,-15,306,468,-162,0,0,0,0,66,6,6,0.560606,1,0,9,11,false,false,false,0.307,0.693
241,268,-27,11.47619,12.761905,-27,808,749,59,0,0,0,0,-29,21,21,-1.448276,0,0,5,5,true,false,false,0.02,0.98
42,51,-9,14,17,-9,360,371,-11,0,0,0,0,80,3,3,0.4625,0,1,17,12,false,false,false,0.255,0.745
118,169,-51,19.666667,28.166667,-51,1167,1245,-78,0,0,0,0,44,6,6,0.522727,0,0,11,14,false,false,false,0.108,0.892
42,29,13,14,14.5,13,1484,1556,-72,0,0,0,0,78,3,2,0.397436,0,0,11,7,false,false,false,0.288,0.712
181,245,-64,15.083333,22.272727,-64,642,952,-310,0,0,0,0,24,12,11,1.833333,0,0,8,14,false,false,false,0.007,0.993
223,279,-56,24.777778,31,-56,1770,1745,25,1,0,0.111111,0,36,9,9,0.916667,0,0,7,11,false,false,false,0.079,0.921
171,255,-84,19,31.875,-84,1232,1281,-49,0,2,0,0.25,30,9,8,1.033333,1,0,9,11,false,false,false,0.011,0.989
28,24,4,28,24,4,985,1062,-77,0,0,0,0,94,1,1,0.393617,0,0,10,14,false,false,false,0.417,0.583
243,289,-46,17.357143,20.642857,-46,1422,1583,-161,0,1,0,0.071429,11,14,14,3.727273,1,0,8,16,false,false,false,0.1,0.9
234,311,-77,18,23.923077,-77,527,954,-427,0,1,0,0.076923,14,13,13,2.5,0,0,23,19,false,false,false,0.025,0.975
165,265,-100,15,26.5,-100,595,412,183,0,1,0,0.1,30,11,10,1.733333,0,0,8,9,false,false,false,0,1
243,284,-41,18.692308,21.846154,-41,1110,1123,-13,0,1,0,0.076923,11,13,13,3,1,1,9,9,false,false,false,0.015,0.985
36,45,-9,12,22.5,-9,1572,1777,-205,0,0,0,0,79,3,2,0.417722,0,1,13,7,false,false,false,0.245,0.755
264,277,-13,17.6,19.785714,-13,1161,1030,131,0,1,0,0.071429,-5,15,14,-7.6,0,1,18,6,false,false,false,0.013,0.987
14,35,-21,14,35,-21,1229,1220,9,0,0,0,0,90,1,1,0.411111,0,1,12,15,false,false,false,0.127,0.873
245,282,-37,11.666667,14.1,-37,668,363,305,0,0,0,0,-18,21,20,-2.611111,0,0,11,4,false,false,false,0.004,0.996
14,50,-36,7,25,-36,980,965,15,0,0,0,0,90,2,2,0.422222,0,1,11,13,false,false,false,0.116,0.884
91,36,55,30.333333,18,55,1563,1539,24,0,0,0,0,80,3,2,0.4375,0,0,11,8,false,false,true,0.542,0.458
122,87,35,24.4,17.4,35,691,704,-13,0,0,0,0,68,5,5,0.558824,0,0,7,9,false,false,true,0.88,0.12
146,104,42,18.25,14.857143,42,691,704,-13,0,0,0,0,56,8,7,0.678571,0,0,9,9,false,false,true,0.874,0.126
51,24,27,17,12,27,306,302,4,0,0,0,0,83,3,2,0.493976,0,0,11,16,false,false,true,0.684,0.316
255,456,-201,18.214286,35.076923,-201,1219,1216,3,1,4,0.071429,0.307692,-16,14,13,-1.6875,0,0,1,5,true,false,false,0,1
337,428,-91,24.071429,30.571429,-91,1689,1777,-88,1,1,0.071429,0.071429,-13,14,14,-2.307692,0,0,5,2,false,false,false,0.005,0.995
272,281,-9,14.315789,15.611111,-9,797,796,1,0,0,0,0,-5,19,18,-9.8,0,0,10,14,false,false,false,0.095,0.905
32,53,-21,10.666667,17.666667,-21,948,998,-50,0,0,0,0,75,3,3,0.493333,1,1,10,16,false,false,false,0.258,0.742
74,99,-25,24.666667,49.5,-25,1633,1680,-47,0,1,0,0.5,72,3,2,0.388889,0,0,13,8,false,false,false,0.299,0.701
256,330,-74,15.058824,19.411765,-74,1101,1130,-29,1,1,0.058824,0.058824,-1,17,17,-45,0,1,11,9,false,false,false,0.001,0.999
76,56,20,15.2,14,20,526,502,24,0,0,0,0,72,5,4,0.694444,0,0,19,17,false,false,true,0.654,0.346
238,154,84,21.636364,15.4,84,1168,1216,-48,0,0,0,0,43,11,10,0.767442,0,0,10,17,false,false,true,0.966,0.034
76,102,-26,15.2,20.4,-26,1040,1364,-324,0,0,0,0,63,5,5,0.571429,0,1,16,14,false,false,false,0.113,0.887
255,314,-59,11.590909,14.952381,-59,391,542,-151,1,0,0.045455,0,-33,22,21,-1.393939,0,0,1,7,false,false,false,0.03,0.97
22,83,-61,7.333333,27.666667,-61,343,570,-227,0,0,0,0,74,3,3,0.486486,0,0,12,9,false,false,false,0.106,0.894
294,352,-58,22.615385,27.076923,-58,801,679,122,1,0,0.076923,0,-8,13,13,-3.625,0,0,6,1,false,false,false,0.047,0.953
46,0,46,46,0,46,1633,1556,77,0,0,0,0,95,1,0,0.347368,0,0,23,0,false,false,true,0.83,0.17
217,383,-166,14.466667,25.533333,-166,1422,1510,-88,0,2,0,0.133333,12,15,15,3.25,0,0,14,10,false,false,false,0.002,0.998
191,190,1,31.833333,31.666667,1,1354,1210,144,0,1,0,0.166667,54,6,6,0.611111,0,0,13,11,false,false,false,0.196,0.804
12,28,-16,12,28,-16,1078,1095,-17,0,0,0,0,93,1,1,0.397849,0,0,7,15,false,false,false,0.134,0.866
62,72,-10,12.4,18,-10,530,683,-153,0,0,0,0,72,5,4,0.555556,0,1,9,7,false,false,false,0.164,0.836
50,60,-10,12.5,20,-10,1075,878,197,0,0,0,0,77,4,3,0.428571,0,0,17,12,false,false,false,0.278,0.722
184,132,52,18.4,14.666667,52,1168,1216,-48,0,0,0,0,48,10,9,0.6875,0,0,17,17,false,false,true,0.815,0.185
379,414,-35,27.071429,31.846154,-35,820,718,102,0,2,0,0.153846,-15,14,13,-1.866667,0,0,6,3,false,false,false,0.007,0.993
333,356,-23,22.2,23.733333,-23,1436,1489,-53,1,1,0.066667,0.066667,4,15,15,9.25,0,0,15,7,false,false,false,0.044,0.956
134,146,-12,19.142857,24.333333,-12,1127,995,132,0,1,0,0.166667,53,7,6,0.622642,0,1,17,10,false,false,false,0.019,0.981
180,366,-186,20,40.666667,-186,786,848,-62,0,2,0,0.222222,34,9,9,0.911765,1,0,15,7,false,false,false,0.003,0.997
220,269,-49,16.923077,22.416667,-49,1037,1016,21,1,0,0.076923,0,29,13,12,2,1,0,16,10,false,false,false,0.007,0.993
45,45,0,15,22.5,0,1312,1334,-22,0,0,0,0,81,3,2,0.481481,0,0,12,21,false,false,false,0.116,0.884
10,27,-17,10,27,-17,226,361,-135,0,0,0,0,93,1,1,0.473118,0,1,14,6,false,false,false,0.001,0.999
240,244,-4,24,24.4,-4,1422,1798,-376,0,1,0,0.1,30,10,10,1.066667,0,1,8,8,false,false,false,0.12,0.88
235,383,-148,14.6875,25.533333,-148,1422,1510,-88,0,2,0,0.133333,8,16,15,4.875,0,0,10,10,false,false,false,0.001,0.999
86,107,-21,17.2,21.4,-21,1493,1453,40,0,0,0,0,65,5,5,0.538462,0,0,10,19,false,false,false,0.11,0.89
160,161,-1,16,16.1,-1,720,437,283,0,0,0,0,44,10,10,0.954545,0,0,10,9,false,false,true,0.753,0.247
208,300,-92,18.909091,27.272727,-92,1315,1334,-19,0,1,0,0.090909,23,11,11,1.565217,0,1,11,15,false,false,false,0,1
103,106,-3,20.6,26.5,-3,1439,1314,125,0,0,0,0,70,5,4,0.4,0,0,19,11,false,false,false,0.263,0.737
88,108,-20,14.666667,21.6,-20,710,758,-48,0,0,0,0,65,6,5,0.569231,0,2,11,14,false,false,false,0,1
190,259,-69,14.615385,19.923077,-69,642,952,-310,0,0,0,0,18,13,13,2.444444,0,0,14,10,false,false,false,0.006,0.994
282,350,-68,15.666667,19.444444,-68,1078,1095,-17,1,1,0.055556,0.055556,-17,18,18,-2.176471,0,0,6,4,false,false,false,0.035,0.965
211,176,35,21.1,19.555556,35,1422,1583,-161,0,1,0,0.111111,36,10,9,1.138889,1,0,6,28,false,false,true,0.562,0.438
204,273,-69,12.75,17.0625,-69,595,540,55,0,0,0,0,0,16,16,0,0,0,8,17,false,false,false,0.007,0.993
114,151,-37,12.666667,18.875,-37,907,878,29,0,0,0,0,58,9,8,0.741379,0,0,15,9,false,false,false,0.106,0.894
20,0,20,20,0,20,651,700,-49,0,0,0,0,97,1,0,0.57732,0,0,14,0,false,false,true,0.531,0.469
219,192,27,21.9,21.333333,27,1493,1413,80,0,0,0,0,34,10,9,1.058824,0,1,10,13,false,false,false,0.165,0.835
186,158,28,18.6,15.8,28,1281,1268,13,0,0,0,0,37,10,10,1.135135,0,0,10,16,false,false,true,0.727,0.273
168,182,-14,18.666667,22.75,-14,356,498,-142,0,1,0,0.125,40,9,8,0.875,1,1,6,16,false,false,false,0.095,0.905
147,197,-50,16.333333,24.625,-50,452,698,-246,0,1,0,0.125,45,9,8,0.911111,0,0,20,9,false,false,false,0.092,0.908
208,221,-13,18.909091,22.1,-13,1210,1162,48,0,0,0,0,29,11,10,1.103448,1,1,9,18,false,false,false,0.118,0.882
284,362,-78,14.947368,20.111111,-78,1159,1131,28,0,2,0,0.111111,-17,19,18,-2.176471,0,0,1,2,true,false,false,0,1
111,223,-112,12.333333,27.875,-112,760,976,-216,0,1,0,0.125,38,9,8,0.947368,0,0,10,12,false,false,false,0.005,0.995
115,117,-2,16.428571,19.5,-2,306,361,-55,0,0,0,0,52,7,6,0.692308,0,2,9,7,false,false,false,0.007,0.993
162,227,-65,11.571429,17.461538,-65,1182,1075,107,0,1,0,0.076923,8,14,13,4.875,0,1,24,6,false,false,false,0.002,0.998
26,142,-116,8.666667,47.333333,-116,2143,2219,-76,0,0,0,0,77,3,3,0.402597,0,0,7,15,false,false,false,0.107,0.893
261,280,-19,18.642857,21.538462,-19,450,624,-174,0,0,0,0,-1,14,13,-33,1,0,6,11,false,false,false,0.17,0.83
295,321,-26,16.388889,18.882353,-26,1161,1030,131,0,1,0,0.058824,-22,18,17,-1.727273,0,0,2,1,false,false,false,0.008,0.992
144,125,19,18,15.625,19,952,870,82,0,0,0,0,41,8,8,0.902439,1,0,12,35,false,false,false,0.319,0.681
105,140,-35,17.5,23.333333,-35,1493,1453,40,0,0,0,0,57,6,6,0.614035,0,0,15,25,false,false,false,0.107,0.893
208,224,-16,18.909091,20.363636,-16,1331,1374,-43,0,0,0,0,20,11,11,1.65,1,0,15,7,false,false,false,0.354,0.646
206,252,-46,10.3,13.263158,-46,542,390,152,0,0,0,0,2,20,19,25,1,0,6,13,false,false,false,0.028,0.972
36,53,-17,12,17.666667,-17,1439,1428,11,0,0,0,0,81,3,3,0.493827,0,0,9,14,false,false,false,0.184,0.816
251,163,88,22.818182,16.3,88,1652,1473,179,1,0,0.090909,0,24,11,10,1.25,0,2,9,16,false,false,true,1,0
91,178,-87,15.166667,29.666667,-87,1656,1580,76,0,1,0,0.166667,56,6,6,0.589286,0,0,13,9,false,false,false,0.102,0.898
298,322,-24,16.555556,18.941176,-24,1245,1148,97,0,0,0,0,-19,18,17,-1.842105,0,0,10,2,true,false,false,0.06,0.94
155,272,-117,15.5,30.222222,-117,473,683,-210,0,0,0,0,34,10,9,1.117647,0,0,8,7,false,false,false,0.005,0.995
178,238,-60,16.181818,21.636364,-60,727,820,-93,0,1,0,0.090909,20,11,11,1.75,0,0,8,13,false,false,false,0.03,0.97
116,293,-177,19.333333,48.833333,-177,1219,1216,3,0,3,0,0.5,44,6,6,0.613636,0,0,9,16,false,false,false,0,1
61,87,-26,12.2,17.4,-26,595,540,55,0,0,0,0,64,5,5,0.671875,0,1,13,17,false,false,false,0.122,0.878
179,198,-19,16.272727,18,-19,797,796,1,0,0,0,0,37,11,11,1.324324,1,0,6,19,false,false,false,0.112,0.888
36,35,1,18,17.5,1,561,633,-72,0,0,0,0,84,2,2,0.416667,1,1,8,16,false,false,false,0.029,0.971
156,191,-35,19.5,23.875,-35,1305,1194,111,0,0,0,0,43,8,8,0.767442,0,0,13,10,false,false,false,0.129,0.871
26,32,-6,8.666667,16,-6,632,603,29,0,0,0,0,82,3,2,0.463415,1,0,9,21,false,false,false,0.329,0.671
90,115,-25,11.25,14.375,-25,970,1030,-60,0,0,0,0,48,8,8,0.833333,0,0,22,10,false,false,false,0.128,0.872
277,298,-21,23.083333,27.090909,-21,801,679,122,1,0,0.083333,0,5,12,11,5.8,1,0,12,11,false,false,false,0.097,0.903
94,244,-150,15.666667,40.666667,-150,1539,1891,-352,0,1,0,0.166667,49,6,6,0.510204,1,0,18,7,false,false,false,0.012,0.988
259,309,-50,17.266667,20.6,-50,758,791,-33,0,0,0,0,-6,15,15,-6.5,0,0,7,10,false,false,false,0.009,0.991
248,271,-23,17.714286,20.846154,-23,576,602,-26,0,0,0,0,11,14,13,3.818182,0,1,10,8,false,false,false,0.012,0.988
120,563,-443,5.454545,25.590909,-443,1164,1149,15,0,3,0,0.136364,1,22,22,47,0,1,12,13,false,false,false,0.066,0.934
16,48,-32,5.333333,16,-32,95,453,-358,0,0,0,0,88,3,3,0.443182,0,0,10,13,false,false,false,0.094,0.906
308,329,-21,14.666667,15.666667,-21,1203,1270,-67,1,0,0.047619,0,-25,21,21,-1.76,0,0,1,2,false,false,false,0.072,0.928
65,106,-41,16.25,26.5,-41,1093,1173,-80,0,0,0,0,76,4,4,0.565789,0,0,19,7,false,false,false,0.111,0.889
184,234,-50,18.4,26,-50,892,856,36,0,1,0,0.111111,31,10,9,1.129032,1,0,7,10,false,false,false,0.104,0.896
265,250,15,24.090909,22.727273,15,1305,1194,111,1,0,0.090909,0,18,11,11,1.833333,0,0,16,7,false,false,true,0.738,0.262
117,131,-14,19.5,21.833333,-14,1331,1374,-43,0,0,0,0,52,6,6,0.634615,0,0,21,7,false,false,false,0.331,0.669
175,265,-90,17.5,26.5,-90,1583,1403,180,0,0,0,0,28,10,10,1.142857,0,1,14,15,false,false,false,0.003,0.997
174,257,-83,15.818182,25.7,-83,700,820,-120,0,1,0,0.1,27,11,10,1.407407,1,0,22,10,false,false,false,0.006,0.994
122,141,-19,15.25,17.625,-19,1312,1334,-22,0,0,0,0,44,8,8,0.886364,0,0,23,7,false,false,false,0.244,0.756
65,75,-10,21.666667,37.5,-10,1334,1486,-152,0,0,0,0,85,3,2,0.341176,0,1,11,18,false,false,false,0.106,0.894
142,137,5,20.285714,22.833333,5,450,624,-174,0,0,0,0,49,7,6,0.673469,0,0,19,16,false,false,true,0.522,0.478
69,80,-11,17.25,26.666667,-11,615,542,73,0,0,0,0,78,4,3,0.538462,0,0,14,16,false,false,false,0.251,0.749
302,278,24,20.133333,19.857143,24,1197,1156,41,0,1,0,0.071429,-1,15,14,-35,0,0,6,14,false,false,true,0.963,0.037
286,353,-67,22,29.416667,-67,1422,1798,-376,0,2,0,0.166667,8,13,12,4,0,0,11,15,false,false,false,0.006,0.994
94,211,-117,13.428571,35.166667,-117,935,995,-60,0,1,0,0.166667,55,7,6,0.709091,2,0,14,22,false,false,false,0.065,0.935
233,325,-92,15.533333,21.666667,-92,837,844,-7,0,0,0,0,12,15,15,3.416667,1,0,14,7,false,false,false,0.005,0.995
302,348,-46,20.133333,23.2,-46,917,856,61,1,1,0.066667,0.066667,-2,15,15,-16.5,0,0,13,2,false,false,false,0.06,0.94
238,278,-40,23.8,27.8,-40,1439,1314,125,0,0,0,0,22,10,10,1.272727,0,0,10,7,false,false,false,0.114,0.886
302,311,-9,13.130435,14.136364,-9,671,638,33,0,0,0,0,-32,23,22,-1.53125,0,0,2,2,false,false,false,0.125,0.875
186,218,-32,16.909091,21.8,-32,758,791,-33,0,0,0,0,25,11,10,1.56,0,0,7,21,false,false,false,0.1,0.9
278,282,-4,25.272727,28.2,-4,1556,1513,43,0,0,0,0,16,11,10,1.9375,0,0,12,8,false,false,false,0.172,0.828
39,56,-17,13,28,-17,1071,1000,71,0,0,0,0,84,3,2,0.559524,0,0,9,10,false,false,false,0.124,0.876
82,84,-2,16.4,21,-2,874,868,6,0,0,0,0,64,5,4,0.515625,0,0,19,17,false,false,false,0.264,0.736
80,85,-5,20,28.333333,-5,1407,1473,-66,0,1,0,0.333333,74,4,3,0.418919,0,0,13,11,false,false,false,0.416,0.584
90,153,-63,18,30.6,-63,1110,1399,-289,0,1,0,0.2,59,5,5,0.576271,0,0,14,14,false,false,false,0.106,0.894
61,128,-67,15.25,32,-67,804,766,38,0,1,0,0.25,71,4,4,0.577465,0,1,18,7,false,false,false,0.098,0.902
284,302,-18,16.705882,17.764706,-18,1045,948,97,0,0,0,0,-31,17,17,-1.096774,0,0,6,2,true,false,false,0.269,0.731
276,291,-15,18.4,20.785714,-15,907,910,-3,0,1,0,0.071429,16,15,14,2.6875,0,0,16,7,false,false,false,0.112,0.888
230,313,-83,19.166667,28.454545,-83,1038,917,121,1,2,0.083333,0.181818,12,12,11,2.916667,0,0,13,10,false,false,false,0.002,0.998
315,408,-93,22.5,29.142857,-93,1699,1803,-104,1,1,0.071429,0.071429,11,14,14,3.181818,0,0,14,18,false,false,false,0.008,0.992
30,60,-30,7.5,15,-30,1344,1208,136,0,0,0,0,78,4,4,0.384615,0,0,21,12,false,false,false,0.189,0.811
20,14,6,20,14,6,711,746,-35,0,0,0,0,93,1,1,0.408602,0,1,23,7,false,false,true,0.522,0.478
117,122,-5,13,13.555556,-5,1278,1101,177,0,0,0,0,46,9,9,0.804348,1,1,9,6,false,false,false,0.062,0.938
294,343,-49,16.333333,19.055556,-49,344,315,29,1,1,0.055556,0.055556,-30,18,18,-1.333333,0,0,2,4,false,false,false,0.057,0.943
114,196,-82,11.4,21.777778,-82,1071,1000,71,0,0,0,0,43,10,9,1.093023,1,1,24,12,false,false,false,0.078,0.922
237,282,-45,16.928571,21.692308,-45,1432,1452,-20,0,1,0,0.076923,6,14,13,6,1,0,8,19,false,false,false,0.085,0.915
152,178,-26,15.2,19.777778,-26,1248,1220,28,0,1,0,0.111111,45,10,9,1.155556,1,0,15,17,false,false,false,0.119,0.881
43,39,4,14.333333,19.5,4,1123,1062,61,0,0,0,0,82,3,2,0.536585,0,0,7,23,false,false,false,0.134,0.866
262,194,68,20.153846,16.166667,68,1043,1003,40,0,0,0,0,18,13,12,2.111111,0,1,13,10,false,false,true,0.992,0.008
24,23,1,24,23,1,450,503,-53,0,0,0,0,92,1,1,0.423913,0,0,21,9,false,false,true,0.544,0.456
126,229,-103,9.692308,17.615385,-103,651,567,84,0,0,0,0,22,13,13,2.5,0,0,7,18,false,false,false,0.005,0.995
294,311,-17,21,23.923077,-17,1691,1510,181,0,1,0,0.076923,-2,14,13,-15,1,0,2,13,false,false,false,0.026,0.974
264,335,-71,17.6,23.928571,-71,1633,1556,77,0,0,0,0,-10,15,14,-3.3,0,1,4,4,false,false,false,0.001,0.999
101,81,20,16.833333,13.5,20,721,757,-36,0,0,0,0,60,6,6,0.633333,0,1,10,16,false,false,false,0.4,0.6
285,334,-49,21.923077,25.692308,-49,1021,897,124,0,2,0,0.153846,1,13,13,37,1,0,8,10,false,false,false,0.008,0.992
176,159,17,22,22.714286,17,921,1045,-124,0,0,0,0,45,8,7,0.777778,0,0,17,10,false,false,false,0.415,0.585
236,271,-35,21.454545,27.1,-35,1173,1256,-83,1,0,0.090909,0,26,11,10,1.192308,1,1,10,18,false,false,false,0.001,0.999
103,144,-41,14.714286,24,-41,1182,1075,107,0,1,0,0.166667,53,7,6,0.735849,0,1,22,8,false,false,false,0.009,0.991
137,106,31,22.833333,17.666667,31,664,786,-122,0,0,0,0,62,6,6,0.532258,0,0,12,18,false,false,true,0.734,0.266
316,305,11,19.75,20.333333,11,1094,1041,53,1,0,0.0625,0,-10,16,15,-3.8,0,0,9,9,false,false,true,0.656,0.344
179,186,-7,12.785714,14.307692,-7,342,53,289,0,0,0,0,10,14,13,4.1,0,0,7,19,false,false,true,0.599,0.401
240,257,-17,24,25.7,-17,1452,1388,64,0,1,0,0.1,26,10,10,1.346154,0,0,9,12,false,false,false,0.283,0.717
124,143,-19,17.714286,23.833333,-19,889,895,-6,0,1,0,0.166667,57,7,6,0.649123,0,0,8,8,false,false,false,0.139,0.861
146,118,28,20.857143,16.857143,28,206,346,-140,1,0,0.142857,0,49,7,7,0.877551,0,1,15,13,false,false,false,0.003,0.997
122,55,67,30.5,18.333333,67,1274,1394,-120,0,0,0,0,74,4,3,0.405405,0,0,16,18,false,false,true,0.868,0.132
232,312,-80,19.333333,28.363636,-80,1131,1030,101,0,0,0,0,12,12,11,2.5,0,0,10,17,false,false,false,0.005,0.995
256,333,-77,16,22.2,-77,1580,1629,-49,0,1,0,0.066667,-5,16,15,-7.4,0,0,6,12,false,false,false,0.002,0.998
59,61,-2,19.666667,20.333333,-2,926,973,-47,0,0,0,0,78,3,3,0.448718,0,0,10,7,false,false,false,0.481,0.519
258,331,-73,13.578947,18.388889,-73,642,952,-310,0,0,0,0,-15,19,18,-2.933333,0,0,1,4,false,false,false,0.005,0.995
253,357,-104,21.083333,32.454545,-104,1636,1702,-66,0,1,0,0.090909,16,12,11,1.8125,0,0,11,17,false,false,false,0.004,0.996
82,62,20,16.4,15.5,20,388,542,-154,0,0,0,0,63,5,4,0.587302,0,0,19,15,false,false,false,0.459,0.541
183,176,7,20.333333,19.555556,7,1422,1583,-161,0,1,0,0.111111,40,9,9,1.025,1,0,10,28,false,false,false,0.369,0.631
330,357,-27,22,25.5,-27,1331,1347,-16,1,1,0.066667,0.071429,-18,15,14,-1.777778,0,0,2,4,false,false,false,0.038,0.962
288,359,-71,16.941176,22.4375,-71,1633,1556,77,1,0,0.058824,0,-22,17,16,-1.5,0,1,1,2,true,false,false,0,1
261,260,1,13.05,13.684211,1,306,302,4,0,0,0,0,-26,20,19,-1.576923,0,0,3,1,false,false,true,0.503,0.497
234,262,-28,11.142857,13.1,-28,342,53,289,0,0,0,0,-31,21,20,-1.322581,0,0,2,1,true,false,false,0.007,0.993
74,113,-39,10.571429,16.142857,-39,999,1165,-166,0,0,0,0,59,7,7,0.779661,0,0,23,7,false,false,false,0.119,0.881
114,157,-43,16.285714,22.428571,-43,775,786,-11,0,0,0,0,51,7,7,0.843137,0,0,13,14,false,false,false,0.111,0.889
263,250,13,20.230769,19.230769,13,1168,1062,106,0,0,0,0,21,13,13,2.047619,1,0,11,8,false,false,true,0.852,0.148
253,253,0,15.8125,16.866667,0,840,1055,-215,0,0,0,0,-5,16,15,-7,0,0,18,8,false,false,false,0.362,0.638
43,64,-21,14.333333,32,-21,473,683,-210,0,0,0,0,82,3,2,0.463415,0,0,12,22,false,false,false,0.107,0.893
92,78,14,23,19.5,14,1159,1131,28,0,0,0,0,73,4,4,0.506849,0,1,7,11,false,false,false,0.415,0.585
92,80,12,18.4,20,12,694,658,36,0,0,0,0,69,5,4,0.536232,0,0,25,8,false,false,true,0.591,0.409
228,362,-134,19,32.909091,-134,842,926,-84,0,1,0,0.090909,3,12,11,10,0,0,16,25,false,false,false,0.005,0.995
42,83,-41,10.5,20.75,-41,1606,1890,-284,0,0,0,0,72,4,4,0.388889,1,0,6,17,false,false,false,0.242,0.758
70,0,70,70,0,70,824,830,-6,1,0,1,0,93,1,0,0.473118,0,0,15,0,false,false,true,0.545,0.455
12,27,-15,12,27,-15,1055,1019,36,0,0,0,0,91,1,1,0.362637,1,0,7,8,false,false,true,0.519,0.481
98,81,17,14,13.5,17,306,302,4,0,0,0,0,57,7,6,0.719298,0,0,9,7,false,false,true,0.776,0.224
38,34,4,19,17,4,1040,1091,-51,0,0,0,0,85,2,2,0.552941,0,0,11,18,false,false,false,0.285,0.715
90,84,6,15,16.8,6,889,855,34,0,0,0,0,67,6,5,0.597015,0,0,23,11,false,false,false,0.344,0.656
24,0,24,24,0,24,450,503,-53,0,0,0,0,95,1,0,0.410526,0,0,21,0,false,false,true,0.798,0.202
115,87,28,14.375,10.875,28,491,651,-160,0,0,0,0,54,8,8,0.555556,0,1,10,7,false,false,false,0.3,0.7
33,34,-1,8.25,11.333333,-1,940,947,-7,0,0,0,0,76,4,3,0.460526,0,0,11,11,false,false,false,0.256,0.744
221,242,-21,22.1,26.888889,-21,1473,1500,-27,0,2,0,0.222222,32,10,9,1.21875,0,0,14,19,false,false,false,0.105,0.895
190,328,-138,15.833333,27.333333,-138,1193,1177,16,0,1,0,0.083333,21,12,12,1.666667,0,0,15,10,false,false,false,0.004,0.996
175,207,-32,17.5,23,-32,450,624,-174,0,0,0,0,29,10,9,1.137931,0,0,20,7,false,false,false,0.112,0.888
231,383,-152,21,38.3,-152,786,848,-62,0,2,0,0.2,22,11,10,1.409091,0,0,20,9,false,false,false,0.003,0.997
216,193,23,27,24.125,23,1770,1745,25,1,0,0.125,0,47,8,8,0.702128,0,1,10,10,false,false,false,0.419,0.581
6,0,6,6,0,6,951,976,-25,0,0,0,0,97,1,0,0.453608,1,0,16,0,false,false,true,0.516,0.484
317,272,45,21.133333,19.428571,45,1331,1374,-43,0,0,0,0,-5,15,14,-6.6,0,0,11,6,false,false,true,0.957,0.043
230,320,-90,15.333333,22.857143,-90,736,791,-55,0,0,0,0,-3,15,14,-12.666667,0,0,13,7,false,false,false,0.005,0.995
101,117,-16,16.833333,19.5,-16,306,361,-55,0,0,0,0,56,6,6,0.642857,0,2,7,7,false,false,false,0.006,0.994
217,309,-92,15.5,23.769231,-92,503,668,-165,0,1,0,0.076923,7,14,13,5.285714,2,0,6,15,false,false,false,0.006,0.994
294,324,-30,17.294118,19.058824,-30,576,602,-26,0,0,0,0,-10,17,17,-4.2,0,0,8,4,false,false,false,0.038,0.962
258,350,-92,12.285714,16.666667,-92,642,952,-310,0,0,0,0,-23,21,21,-1.913043,0,0,1,2,false,false,false,0.005,0.995
24,0,24,24,0,24,1219,1216,3,0,0,0,0,95,1,0,0.284211,0,0,7,0,false,false,true,0.501,0.499
147,95,52,18.375,13.571429,52,671,638,33,0,0,0,0,45,8,7,1.088889,0,0,16,25,false,false,true,0.739,0.261
250,296,-46,14.705882,18.5,-46,518,414,104,0,1,0,0.0625,-4,17,16,-9.5,0,0,16,7,false,false,false,0.029,0.971
31,24,7,15.5,12,7,874,868,6,0,0,0,0,86,2,2,0.383721,1,0,21,9,false,false,true,0.554,0.446
34,23,11,34,23,11,892,856,36,0,0,0,0,93,1,1,0.376344,0,0,12,10,false,false,true,0.647,0.353
250,277,-27,13.888889,16.294118,-27,925,1000,-75,0,0,0,0,-7,18,17,-6.285714,0,1,14,6,false,false,false,0.016,0.984
145,183,-38,14.5,20.333333,-38,595,540,55,0,0,0,0,37,10,9,1.162162,0,0,14,17,false,false,false,0.105,0.895
43,93,-50,8.6,23.25,-50,1368,1452,-84,0,0,0,0,75,5,4,0.426667,1,0,14,26,false,false,false,0.123,0.877
278,279,-1,19.857143,21.461538,-1,1257,1176,81,2,0,0.142857,0,12,14,13,2.833333,0,0,12,15,false,false,false,0.148,0.852
242,302,-60,13.444444,16.777778,-60,951,976,-25,0,0,0,0,-9,18,18,-4.888889,0,0,7,7,false,false,false,0.006,0.994
180,202,-22,20,22.444444,-22,1210,1162,48,0,0,0,0,38,9,9,0.842105,0,0,10,18,false,false,false,0.117,0.883
132,206,-74,18.857143,29.428571,-74,1305,1254,51,0,1,0,0.142857,42,7,7,0.761905,0,0,11,13,false,false,false,0.074,0.926
283,210,73,35.375,30,73,169,306,-137,2,1,0.25,0.142857,28,8,7,1.107143,0,0,10,16,false,false,true,0.573,0.427
85,127,-42,21.25,42.333333,-42,1537,1539,-2,0,1,0,0.333333,69,4,3,0.492754,0,0,12,11,false,false,false,0.07,0.93
79,61,18,19.75,15.25,18,1652,1473,179,0,0,0,0,69,4,4,0.434783,0,0,20,11,false,false,true,0.543,0.457
219,324,-105,19.909091,32.4,-105,1334,1486,-152,2,1,0.181818,0.1,26,11,10,1.115385,0,0,8,7,false,false,false,0.005,0.995
181,246,-65,20.111111,27.333333,-65,1315,1334,-19,0,1,0,0.111111,35,9,9,1.028571,0,1,10,11,false,false,false,0.01,0.99
300,340,-40,23.076923,26.153846,-40,1102,1245,-143,0,1,0,0.076923,-5,13,13,-5.8,0,0,10,3,false,false,false,0.105,0.895
136,141,-5,19.428571,20.142857,-5,742,868,-126,0,0,0,0,52,7,7,0.634615,0,0,11,11,false,false,false,0.194,0.806
247,357,-110,14.529412,21,-110,342,263,79,0,0,0,0,-24,17,17,-1.416667,1,0,1,1,true,false,false,0.006,0.994
4,0,4,4,0,4,710,758,-48,0,0,0,0,98,1,0,0.377551,0,0,16,0,false,false,false,0.441,0.559
75,80,-5,15,20,-5,306,361,-55,0,0,0,0,65,5,4,0.553846,0,1,9,9,false,false,false,0.018,0.982
211,207,4,21.1,20.7,4,1803,1658,145,1,0,0.1,0,24,10,10,1.375,0,0,18,18,false,false,false,0.427,0.573
137,171,-34,17.125,24.428571,-34,518,414,104,0,1,0,0.142857,50,8,7,0.76,0,0,17,11,false,false,true,0.665,0.335
243,260,-17,17.357143,18.571429,-17,206,346,-140,1,0,0.071429,0,3,14,14,14.333333,0,0,27,13,false,false,false,0.116,0.884
338,360,-22,22.533333,24,-22,1070,814,256,1,1,0.066667,0.066667,-9,15,15,-3.666667,0,0,3,1,false,false,false,0.013,0.987
152,228,-76,21.714286,38,-76,1633,1680,-47,0,1,0,0.166667,37,7,6,0.756757,0,0,12,9,false,false,false,0.069,0.931
136,108,28,19.428571,18,28,742,594,148,0,0,0,0,54,7,6,0.722222,0,1,29,6,false,false,true,0.724,0.276
266,275,-9,16.625,17.1875,-9,670,576,94,0,0,0,0,-4,16,16,-10.25,0,0,7,7,false,false,false,0.448,0.552
369,442,-73,41,49.111111,-73,2147,2219,-72,1,2,0.111111,0.222222,8,9,9,3,0,0,10,18,false,false,false,0.006,0.994
160,162,-2,16,18,-2,603,721,-118,0,0,0,0,38,10,9,1.131579,0,0,7,22,false,false,false,0.163,0.837
16,0,16,16,0,16,1493,1453,40,0,0,0,0,97,1,0,0.360825,0,0,14,0,false,false,false,0.466,0.534
191,236,-45,17.363636,23.6,-45,795,786,9,1,0,0.090909,0,36,11,10,1.055556,0,0,8,13,false,false,false,0.007,0.993
0,0,0,0,0,0,1269,1477,-208,0,0,0,0,100,1,0,0.35,0,0,10,0,false,false,false,0.245,0.755
146,349,-203,13.272727,31.727273,-203,1422,1510,-88,0,2,0,0.181818,35,11,11,1.114286,0,0,12,7,false,false,false,0.016,0.984
207,229,-22,17.25,20.818182,-22,451,448,3,0,0,0,0,22,12,11,1.681818,0,0,14,7,false,false,false,0.344,0.656
145,162,-17,16.111111,18,-17,603,721,-118,0,0,0,0,42,9,9,1.02381,0,0,10,22,false,false,false,0.189,0.811
202,358,-156,20.2,39.777778,-156,1556,1656,-100,0,2,0,0.222222,17,10,9,1.764706,0,0,9,26,false,false,false,0,1
26,11,15,13,11,15,797,796,1,0,0,0,0,93,2,1,0.526882,0,0,7,7,false,false,false,0.426,0.574
249,355,-106,24.9,35.5,-106,1388,1455,-67,0,0,0,0,13,10,10,2.153846,1,0,8,17,false,false,false,0.029,0.971
68,0,68,68,0,68,1488,1428,60,1,0,1,0,93,1,0,0.397849,0,0,14,0,false,false,true,0.533,0.467
106,111,-5,15.142857,18.5,-5,848,976,-128,0,0,0,0,60,7,6,0.666667,0,0,16,13,false,false,false,0.109,0.891
202,256,-54,15.538462,21.333333,-54,95,453,-358,0,0,0,0,16,13,12,2.4375,0,0,10,23,false,false,false,0.006,0.994
149,114,35,18.625,16.285714,35,1344,1208,136,0,0,0,0,53,8,7,0.566038,0,0,10,8,false,false,true,0.617,0.383
63,107,-44,10.5,21.4,-44,651,996,-345,0,0,0,0,63,6,5,0.714286,0,0,12,23,false,false,false,0.106,0.894
252,305,-53,22.909091,27.727273,-53,1071,1065,6,0,0,0,0,14,11,11,2.214286,0,0,9,12,false,false,false,0.032,0.968
152,133,19,16.888889,16.625,19,797,796,1,0,0,0,0,51,9,8,0.960784,1,0,6,7,false,false,false,0.441,0.559
69,124,-55,11.5,20.666667,-55,1302,1351,-49,0,0,0,0,59,6,6,0.627119,1,0,14,8,false,false,false,0.243,0.757
122,228,-106,9.384615,17.538462,-106,651,996,-345,0,1,0,0.076923,14,13,13,3.214286,0,2,26,5,false,false,false,0.001,0.999
35,24,11,11.666667,12,11,1452,1388,64,0,0,0,0,85,3,2,0.411765,0,0,10,21,false,false,false,0.172,0.828
25,34,-9,12.5,34,-9,1102,1245,-143,0,0,0,0,87,2,1,0.333333,0,0,9,23,false,false,false,0.106,0.894
286,333,-47,22,25.615385,-47,1030,1014,16,0,1,0,0.076923,12,13,13,2.75,0,0,9,8,false,false,false,0.038,0.962
52,100,-48,8.666667,16.666667,-48,970,1030,-60,0,0,0,0,60,6,6,0.666667,0,0,25,10,false,false,false,0.109,0.891
127,157,-30,14.111111,17.444444,-30,1000,960,40,0,0,0,0,40,9,9,1.125,1,0,8,16,false,false,false,0.173,0.827
121,140,-19,20.166667,23.333333,-19,566,742,-176,0,1,0,0.166667,54,6,6,0.592593,1,0,12,18,false,false,false,0.275,0.725
18,18,0,18,18,0,1101,1237,-136,0,0,0,0,92,1,1,0.369565,0,0,12,8,false,false,false,0.406,0.594
230,192,38,20.909091,17.454545,38,675,570,105,0,0,0,0,21,11,11,1.666667,0,0,12,13,false,false,true,0.785,0.215
262,274,-12,17.466667,19.571429,-12,785,892,-107,0,0,0,0,9,15,14,4.111111,0,1,11,9,false,false,false,0.049,0.951
130,151,-21,18.571429,21.571429,-21,1484,1556,-72,0,1,0,0.142857,43,7,7,0.72093,1,0,11,9,false,false,false,0.424,0.576
24,32,-8,8,10.666667,-8,288,359,-71,0,0,0,0,84,3,3,0.321429,0,1,10,7,false,false,false,0.079,0.921
119,107,12,23.8,21.4,12,711,746,-35,0,0,0,0,66,5,5,0.575758,0,0,7,11,false,false,true,0.64,0.36
280,349,-69,15.555556,19.388889,-69,402,448,-46,0,0,0,0,-22,18,18,-1.681818,0,0,2,1,false,false,false,0.01,0.99
120,168,-48,17.142857,24,-48,971,635,336,0,0,0,0,47,7,7,0.680851,0,0,22,10,false,false,false,0.341,0.659
114,141,-27,28.5,47,-27,1699,1580,119,1,0,0.25,0,70,4,3,0.428571,0,0,9,19,false,false,false,0.089,0.911
173,158,15,15.727273,15.8,15,913,1037,-124,0,1,0,0.1,46,11,10,0.891304,0,0,16,10,false,false,true,0.544,0.456
117,200,-83,10.636364,20,-83,651,567,84,0,0,0,0,30,11,10,1.833333,0,0,10,10,false,false,false,0.009,0.991
267,412,-145,19.071429,29.428571,-145,999,1283,-284,0,2,0,0.142857,-2,14,14,-16.5,0,0,16,6,false,false,false,0.005,0.995
312,350,-38,17.333333,19.444444,-38,952,870,82,0,0,0,0,-26,18,18,-1.423077,0,0,4,3,false,false,false,0.022,0.978
387,442,-55,38.7,49.111111,-55,2147,2219,-72,1,2,0.1,0.222222,6,10,9,4,0,0,16,18,false,false,false,0.017,0.983
52,78,-26,26,39,-26,1182,1075,107,0,1,0,0.5,81,2,2,0.481481,0,0,15,9,false,false,false,0.272,0.728
41,50,-9,13.666667,16.666667,-9,1344,1314,30,0,1,0,0.333333,76,3,3,0.447368,0,0,7,11,false,false,true,0.5,0.5
107,188,-81,15.285714,31.333333,-81,595,412,183,0,1,0,0.166667,56,7,6,0.928571,0,1,8,6,false,false,false,0.001,0.999
50,108,-58,12.5,27,-58,1633,1739,-106,0,0,0,0,78,4,4,0.435897,0,0,17,9,false,false,false,0.106,0.894
218,246,-28,13.625,15.375,-28,999,1071,-72,0,0,0,0,0,16,16,0,0,0,17,18,false,false,false,0.258,0.742
127,133,-6,21.166667,22.166667,-6,1071,1181,-110,0,0,0,0,63,6,6,0.539683,0,0,8,9,false,false,false,0.141,0.859
302,315,-13,20.133333,22.5,-13,917,856,61,1,1,0.066667,0.071429,3,15,14,11,0,0,13,11,false,false,false,0.091,0.909
276,342,-66,11.5,14.869565,-66,651,700,-49,0,0,0,0,-37,24,23,-1.513514,0,0,15,11,false,false,false,0.028,0.972
335,339,-4,33.5,33.9,-4,1699,1580,119,3,1,0.3,0.1,18,10,10,1.666667,0,1,20,6,false,false,false,0.011,0.989
195,213,-18,17.727273,21.3,-18,668,771,-103,0,0,0,0,35,11,10,1.142857,1,0,15,11,false,false,false,0.114,0.886
131,290,-159,13.1,32.222222,-159,940,947,-7,0,2,0,0.222222,29,10,9,1.206897,0,0,17,16,false,false,false,0.001,0.999
243,331,-88,22.090909,33.1,-88,1633,1680,-47,0,1,0,0.1,11,11,10,2.545455,0,0,13,9,false,false,false,0.004,0.996
152,133,19,25.333333,26.6,19,1586,1633,-47,1,0,0.166667,0,66,6,5,0.515152,0,0,24,9,false,false,false,0.344,0.656
10,22,-12,10,22,-12,691,695,-4,0,0,0,0,91,1,1,0.351648,1,0,9,13,false,false,true,0.516,0.484
201,359,-158,33.5,59.833333,-158,1398,1431,-33,0,0,0,0,33,6,6,0.848485,0,1,13,11,false,false,false,0,1
300,290,10,21.428571,22.307692,10,1561,1495,66,1,0,0.071429,0,-5,14,13,-6.6,0,0,16,8,false,false,true,0.696,0.304
271,308,-37,18.066667,22,-37,1633,1620,13,0,0,0,0,-8,15,14,-4.5,0,0,9,9,false,false,false,0.101,0.899
22,73,-51,7.333333,24.333333,-51,795,786,9,0,0,0,0,89,3,3,0.426966,0,1,7,9,false,false,false,0.113,0.887
93,103,-10,13.285714,14.714286,-10,542,390,152,0,0,0,0,68,7,7,0.735294,0,0,14,16,false,false,true,0.647,0.353
46,18,28,23,18,28,1110,1123,-13,0,0,0,0,84,2,1,0.392857,0,0,15,7,false,false,true,0.524,0.476
164,156,8,16.4,15.6,8,1344,1314,30,0,1,0,0.1,35,10,10,0.971429,0,0,10,24,false,false,true,0.533,0.467
137,152,-15,19.571429,21.714286,-15,1331,1374,-43,0,0,0,0,45,7,7,0.733333,0,0,21,12,false,false,false,0.227,0.773
261,290,-29,21.75,26.363636,-29,1473,1500,-27,0,2,0,0.181818,21,12,11,1.857143,1,0,11,8,false,false,false,0.075,0.925
312,311,1,19.5,20.733333,1,1803,1658,145,1,0,0.0625,0,-12,16,15,-2.75,0,0,3,3,false,false,false,0.03,0.97
31,0,31,15.5,0,31,1495,1597,-102,0,0,0,0,93,2,1,0.344086,0,0,17,11,false,false,false,0.341,0.659
180,220,-40,15,20,-40,907,910,-3,0,1,0,0.090909,43,12,11,1,0,1,12,19,false,false,false,0.014,0.986
263,140,123,18.785714,10.769231,123,1065,948,117,0,0,0,0,25,14,13,1.56,0,0,8,10,false,false,true,1,0
273,266,7,21,20.461538,7,1227,1189,38,0,0,0,0,4,13,13,8.75,0,2,9,24,false,false,false,0.196,0.804
100,83,17,16.666667,13.833333,17,1168,1216,-48,0,0,0,0,72,6,6,0.458333,0,0,10,20,false,false,false,0.196,0.804
210,272,-62,17.5,22.666667,-62,804,1080,-276,0,0,0,0,19,12,12,1.789474,1,0,9,12,false,false,false,0.044,0.956
61,88,-27,15.25,29.333333,-27,837,844,-7,0,0,0,0,81,4,3,0.506173,0,1,13,16,false,false,false,0.105,0.895
36,49,-13,18,24.5,-13,1266,1339,-73,0,0,0,0,88,2,2,0.397727,0,0,10,18,false,false,false,0.115,0.885
19,32,-13,6.333333,16,-13,822,845,-23,0,0,0,0,88,3,2,0.397727,0,0,21,21,false,false,false,0.118,0.882
296,393,-97,18.5,26.2,-97,1583,1403,180,0,0,0,0,-11,16,15,-2.909091,0,0,2,1,false,false,false,0.046,0.954
165,272,-107,12.692308,22.666667,-107,1305,1307,-2,0,1,0,0.083333,18,13,12,2.277778,0,0,10,11,false,false,false,0.004,0.996
101,75,26,16.833333,15,26,721,757,-36,0,0,0,0,62,6,5,0.612903,0,0,10,17,false,false,false,0.379,0.621
140,99,41,35,24.75,41,1793,1957,-164,0,0,0,0,66,4,4,0.439394,0,1,11,6,false,false,false,0.486,0.514
257,343,-86,19.769231,28.583333,-86,835,786,49,0,0,0,0,-2,13,12,-17,0,0,14,7,false,false,false,0.005,0.995
261,185,76,37.285714,30.833333,76,169,306,-137,2,1,0.285714,0.166667,36,7,6,0.861111,1,0,11,18,false,false,false,0.385,0.615
205,225,-20,17.083333,18.75,-20,1094,1041,53,0,0,0,0,19,12,12,2,1,1,6,15,false,false,false,0.214,0.786
296,349,-53,15.578947,18.368421,-53,452,698,-246,0,1,0,0.052632,-18,19,19,-2.277778,0,0,4,2,false,false,false,0.037,0.963
296,367,-71,17.411765,22.9375,-71,1205,1216,-11,0,0,0,0,-10,17,16,-3.3,0,0,3,5,true,false,false,0.005,0.995
139,242,-103,12.636364,22,-103,837,844,-7,0,0,0,0,40,11,11,1.025,1,1,9,7,false,false,false,0.005,0.995
20,63,-43,20,63,-43,1388,1455,-67,0,0,0,0,88,1,1,0.318182,0,0,15,8,false,false,false,0.137,0.863
93,151,-58,18.6,30.2,-58,1164,1149,15,0,0,0,0,68,5,5,0.691176,0,1,15,6,false,false,false,0.106,0.894
114,189,-75,12.666667,21,-75,95,453,-358,0,0,0,0,45,9,9,0.866667,0,0,14,19,false,false,false,0.005,0.995
237,274,-37,15.8,18.266667,-37,561,688,-127,0,0,0,0,11,15,15,4.181818,0,0,14,12,false,false,false,0.042,0.958
191,187,4,23.875,26.714286,4,1305,1211,94,1,0,0.125,0,51,8,7,0.647059,1,0,6,11,false,false,true,0.79,0.21
159,216,-57,15.9,24,-57,642,952,-310,0,0,0,0,36,10,9,1.222222,0,0,7,12,false,false,false,0.041,0.959
40,66,-26,20,33,-26,2010,2219,-209,0,0,0,0,87,2,2,0.298851,1,1,6,9,false,false,false,0.251,0.749
133,126,7,19,21,7,727,820,-93,0,1,0,0.166667,52,7,6,0.673077,0,0,7,10,false,false,true,0.583,0.417
219,207,12,15.642857,15.923077,12,306,302,4,0,0,0,0,9,14,13,4.555556,0,0,7,19,false,false,true,0.52,0.48
173,201,-28,19.222222,22.333333,-28,1488,1428,60,1,0,0.111111,0,38,9,9,0.973684,0,0,25,14,false,false,false,0.263,0.737
167,133,34,18.555556,16.625,34,704,523,181,0,0,0,0,35,9,8,1,0,0,9,17,false,false,true,0.734,0.266
167,247,-80,15.181818,24.7,-80,1003,1018,-15,0,0,0,0,27,11,10,1.37037,0,0,17,11,false,false,false,0.009,0.991
175,283,-108,14.583333,25.727273,-108,595,412,183,0,1,0,0.090909,24,12,11,2.166667,0,0,13,10,false,false,false,0.001,0.999
150,226,-76,21.428571,32.285714,-76,1266,1339,-73,0,1,0,0.142857,52,7,7,0.673077,0,0,10,21,false,false,false,0.088,0.912
318,342,-24,21.2,24.428571,-24,1021,897,124,0,2,0,0.142857,-12,15,14,-3.083333,0,0,11,8,false,false,false,0.01,0.99
331,394,-63,18.388889,21.888889,-63,1047,1253,-206,1,1,0.055556,0.055556,-19,18,18,-1.947368,1,0,4,3,false,false,false,0.009,0.991
326,346,-20,25.076923,26.615385,-20,169,306,-137,2,1,0.153846,0.076923,-8,13,13,-3.875,0,0,6,8,false,false,false,0.001,0.999
40,71,-31,20,35.5,-31,1422,1583,-161,0,1,0,0.5,80,2,2,0.5125,0,0,16,13,false,false,false,0.47,0.53
98,118,-20,14,16.857143,-20,1040,1364,-324,0,0,0,0,49,7,7,0.734694,0,1,22,13,false,false,false,0.136,0.864
325,322,3,20.3125,21.466667,3,1561,1495,66,1,0,0.0625,0,-18,16,15,-1.833333,0,0,2,3,false,false,false,0.437,0.563
28,29,-1,14,14.5,-1,977,1100,-123,0,0,0,0,83,2,2,0.493976,0,0,9,9,false,false,false,0.361,0.639
302,319,-17,17.764706,18.764706,-17,758,904,-146,1,0,0.058824,0,-21,17,17,-1.619048,0,0,2,3,true,false,false,0.055,0.945
138,180,-42,17.25,22.5,-42,775,786,-11,0,0,0,0,44,8,8,0.977273,1,0,12,17,false,false,false,0.122,0.878
44,79,-35,14.666667,26.333333,-35,1127,995,132,0,1,0,0.333333,80,3,3,0.4125,0,0,15,15,false,false,false,0.29,0.71
67,65,2,22.333333,21.666667,2,1205,1216,-11,0,0,0,0,80,3,3,0.4125,0,0,12,16,false,false,false,0.279,0.721
284,350,-66,15.777778,20.588235,-66,1422,1583,-161,0,1,0,0.058824,-5,18,17,-8.2,1,0,3,15,false,false,false,0.006,0.994
82,98,-16,16.4,24.5,-16,915,971,-56,0,0,0,0,66,5,4,0.5,0,0,8,30,false,false,false,0.107,0.893
165,178,-13,20.625,22.25,-13,1227,1189,38,0,0,0,0,39,8,8,0.897436,0,0,11,23,false,false,false,0.166,0.834
16,16,0,16,16,0,814,830,-16,0,0,0,0,93,1,1,0.44086,0,0,10,11,false,false,false,0.493,0.507
128,170,-42,14.222222,18.888889,-42,278,1,277,0,0,0,0,32,9,9,1.15625,0,0,21,18,false,false,true,0.688,0.312
299,323,-24,13.590909,14.681818,-24,925,1000,-75,0,0,0,0,-28,22,22,-1.571429,0,0,4,1,true,false,false,0.008,0.992
229,217,12,15.266667,15.5,12,306,302,4,0,0,0,0,4,15,14,10.25,0,0,7,14,false,false,true,0.507,0.493
87,86,1,14.5,14.333333,1,999,1071,-72,0,0,0,0,56,6,6,0.714286,1,0,11,16,false,false,false,0.462,0.538
253,454,-201,16.866667,30.266667,-201,1093,1100,-7,0,2,0,0.133333,1,15,15,35,0,0,24,10,false,false,false,0.006,0.994
12,0,12,12,0,12,1281,1268,13,0,0,0,0,97,1,0,0.43299,0,0,22,0,false,false,true,0.511,0.489
122,204,-82,10.166667,18.545455,-82,818,826,-8,0,0,0,0,41,12,11,1.292683,1,0,6,18,false,false,false,0.014,0.986
71,89,-18,17.75,22.25,-18,1045,1082,-37,0,0,0,0,72,4,4,0.625,1,0,17,9,false,false,true,0.557,0.443
85,52,33,14.166667,10.4,33,491,651,-160,0,0,0,0,68,6,5,0.441176,0,1,12,11,false,false,false,0.265,0.735
314,312,2,18.470588,19.5,2,944,1095,-151,0,1,0,0.0625,-1,17,16,-39,0,2,4,15,false,false,false,0.384,0.616
241,288,-47,18.538462,24,-47,1094,1159,-65,0,0,0,0,6,13,12,6.333333,1,0,8,21,false,false,false,0.081,0.919
167,121,46,20.875,17.285714,46,1197,1156,41,0,0,0,0,51,8,7,0.686275,0,1,24,6,false,false,true,0.594,0.406
298,282,16,18.625,18.8,16,675,570,105,0,0,0,0,-15,16,15,-2.333333,0,0,19,4,false,false,true,0.751,0.249
160,182,-22,16,18.2,-22,603,721,-118,0,0,0,0,34,10,10,1.264706,0,0,7,22,false,false,false,0.154,0.846
226,269,-43,20.545455,26.9,-43,1636,1796,-160,0,0,0,0,17,11,10,1.588235,0,1,11,10,false,false,false,0.105,0.895
89,192,-103,22.25,48,-103,1093,1100,-7,0,1,0,0.25,64,4,4,0.546875,0,0,9,11,false,false,false,0.057,0.943
25,30,-5,12.5,30,-5,1110,1399,-289,0,0,0,0,90,2,1,0.377778,0,0,12,11,false,false,false,0.131,0.869
114,109,5,14.25,15.571429,5,1278,1101,177,0,0,0,0,52,8,7,0.711538,1,0,6,11,false,false,false,0.389,0.611
302,390,-88,17.764706,22.941176,-88,710,758,-48,1,1,0.058824,0.058824,-9,17,17,-4.111111,0,0,11,5,false,false,false,0.036,0.964
116,152,-36,23.2,30.4,-36,1415,1361,54,0,0,0,0,68,5,5,0.455882,0,1,12,6,false,false,false,0.123,0.877
214,307,-93,16.461538,25.583333,-93,892,856,36,0,1,0,0.083333,8,13,12,4.375,1,0,7,11,false,false,false,0.004,0.996
251,310,-59,22.818182,28.181818,-59,1266,1339,-73,0,1,0,0.090909,27,11,11,1.296296,0,0,11,14,false,false,false,0.016,0.984
297,355,-58,17.470588,20.882353,-58,1126,1277,-151,0,0,0,0,-16,17,17,-2.1875,0,0,1,8,false,false,false,0.006,0.994
300,348,-48,23.076923,26.769231,-48,1454,1479,-25,1,0,0.076923,0,3,13,13,10.333333,0,0,12,13,false,false,false,0.007,0.993
39,16,23,19.5,16,23,1312,1334,-22,0,0,0,0,85,2,1,0.458824,0,0,12,16,false,false,false,0.477,0.523
270,292,-22,15.882353,17.176471,-22,670,576,94,0,0,0,0,-11,17,17,-3.727273,0,0,4,6,false,false,false,0.129,0.871
132,178,-46,10.153846,13.692308,-46,925,1000,-75,0,0,0,0,20,13,13,2.2,0,0,16,21,false,false,false,0.105,0.895
131,247,-116,14.555556,27.444444,-116,342,263,79,0,0,0,0,31,9,9,1.096774,0,0,7,7,false,false,false,0.005,0.995
192,203,-11,19.2,22.555556,-11,1161,1030,131,0,1,0,0.111111,31,10,9,1.225806,0,0,23,11,false,false,true,0.644,0.356
152,212,-60,16.888889,23.555556,-60,907,910,-3,0,1,0,0.111111,48,9,9,0.895833,1,1,11,18,false,false,false,0.08,0.92
95,194,-99,31.666667,64.666667,-99,2147,2219,-72,0,2,0,0.666667,67,3,3,0.358209,0,0,13,19,false,false,false,0.042,0.958
272,406,-134,18.133333,27.066667,-134,874,868,6,0,0,0,0,-15,15,15,-2.2,0,0,8,1,false,false,false,0.005,0.995
133,235,-102,16.625,33.571429,-102,710,758,-48,0,1,0,0.142857,51,8,7,0.72549,0,0,8,7,false,false,false,0.005,0.995
216,205,11,19.636364,20.5,11,742,868,-126,0,0,0,0,31,11,10,1.064516,0,1,9,6,false,false,false,0.183,0.817
214,254,-40,19.454545,25.4,-40,1101,1237,-136,1,0,0.090909,0,26,11,10,1.307692,1,0,15,13,false,false,false,0.075,0.925
206,245,-39,17.166667,22.272727,-39,691,704,-13,0,1,0,0.090909,24,12,11,1.583333,0,0,10,12,false,false,false,0.113,0.887
176,246,-70,12.571429,17.571429,-70,595,662,-67,0,1,0,0.071429,13,14,14,3.384615,0,0,17,13,false,false,false,0.026,0.974
154,200,-46,15.4,20,-46,360,371,-11,0,0,0,0,23,10,10,1.608696,0,0,15,7,false,false,false,0.174,0.826
77,153,-76,9.625,19.125,-76,1078,983,95,0,0,0,0,57,8,8,0.842105,1,1,7,15,false,false,false,0.134,0.866
46,44,2,15.333333,22,2,1003,1018,-15,0,0,0,0,80,3,2,0.4625,0,0,15,8,false,false,false,0.43,0.57
228,277,-49,12.666667,16.294118,-49,226,361,-135,0,0,0,0,-21,18,17,-2.095238,0,0,15,16,false,false,false,0.018,0.982
181,166,15,25.857143,27.666667,15,1237,1265,-28,1,0,0.142857,0,44,7,6,0.818182,0,0,19,8,false,false,false,0.343,0.657
337,313,24,24.071429,24.076923,24,1563,1539,24,0,1,0,0.076923,-7,14,13,-5,0,0,2,11,false,false,true,0.893,0.107
122,194,-72,11.090909,19.4,-72,818,826,-8,0,0,0,0,43,11,10,1.232558,1,0,8,20,false,false,false,0.06,0.94
153,151,2,21.857143,21.571429,2,566,742,-176,0,1,0,0.142857,47,7,7,0.680851,0,0,11,16,false,false,true,0.722,0.278
168,229,-61,16.8,22.9,-61,1229,1220,9,0,1,0,0.1,32,10,10,1.15625,0,0,12,10,false,false,false,0.102,0.898
24,7,17,6,2.333333,17,1064,1397,-333,0,0,0,0,94,4,3,0.457447,1,0,20,7,false,false,false,0.257,0.743
250,206,44,22.727273,20.6,44,1093,1173,-80,0,0,0,0,32,11,10,1.34375,0,0,10,14,false,false,true,0.646,0.354
262,293,-31,16.375,18.3125,-31,1176,1211,-35,0,1,0,0.0625,-18,16,16,-1.833333,0,0,3,1,false,false,false,0.161,0.839
326,337,-11,17.157895,17.736842,-11,206,346,-140,1,0,0.052632,0,-26,19,19,-1.653846,0,0,12,2,false,false,false,0.114,0.886
260,344,-84,21.666667,28.666667,-84,991,1063,-72,0,1,0,0.083333,16,12,12,2.375,0,0,9,8,false,false,false,0.006,0.994
168,150,18,21,21.428571,18,1168,1062,106,0,0,0,0,52,8,7,0.826923,0,0,11,18,false,false,false,0.451,0.549
142,195,-53,17.75,27.857143,-53,1656,1580,76,0,1,0,0.142857,47,8,7,0.702128,0,0,13,8,false,false,false,0.041,0.959
216,364,-148,9.391304,16.545455,-148,651,996,-345,0,2,0,0.090909,-36,23,22,-1.25,0,0,4,2,true,false,false,0.005,0.995
240,219,21,20,18.25,21,952,870,82,0,0,0,0,16,12,12,2.3125,0,0,7,23,false,false,true,0.743,0.257
299,323,-24,13.590909,15.380952,-24,925,1000,-75,0,0,0,0,-28,22,21,-1.571429,0,0,4,1,false,false,false,0.03,0.97
317,324,-7,17.611111,18,-7,1193,1220,-27,1,0,0.055556,0,-14,18,18,-3.071429,0,0,21,6,false,false,false,0.13,0.87
38,29,9,12.666667,14.5,9,999,1071,-72,0,0,0,0,82,3,2,0.487805,0,0,8,8,false,false,false,0.285,0.715
82,94,-12,13.666667,15.666667,-12,568,570,-2,0,0,0,0,61,6,6,0.606557,0,0,10,29,false,false,false,0.178,0.822
162,136,26,20.25,19.428571,26,1131,1030,101,0,0,0,0,48,8,7,0.625,1,0,9,21,false,false,true,0.634,0.366
321,370,-49,21.4,24.666667,-49,1556,1513,43,0,0,0,0,-11,15,15,-2.818182,0,0,2,2,false,false,false,0.024,0.976
0,70,-70,0,70,-70,1576,1556,20,0,1,0,1,93,1,1,0.322581,0,0,12,15,false,false,false,0.041,0.959
94,102,-8,15.666667,20.4,-8,1203,1270,-67,0,0,0,0,67,6,5,0.656716,1,0,12,12,false,false,false,0.261,0.739
178,168,10,17.8,18.666667,10,500,532,-32,0,0,0,0,35,10,9,1.171429,0,0,8,12,false,false,true,0.542,0.458
175,139,36,29.166667,27.8,36,1305,1211,94,1,0,0.166667,0,62,6,5,0.532258,1,0,8,17,false,false,true,0.856,0.144
24,0,24,24,0,24,1341,1606,-265,0,0,0,0,95,1,0,0.347368,2,0,6,0,false,false,true,0.884,0.116
18,11,7,9,11,7,964,1003,-39,0,0,0,0,90,2,1,0.433333,0,1,18,9,false,false,false,0.28,0.72
87,118,-31,14.5,19.666667,-31,360,371,-11,0,0,0,0,55,6,6,0.672727,0,0,18,8,false,false,false,0.285,0.715
309,311,-2,22.071429,23.923077,-2,1645,1636,9,0,1,0,0.076923,-7,14,13,-4.714286,0,0,4,9,false,false,false,0.027,0.973
120,563,-443,5.217391,25.590909,-443,1164,1149,15,0,3,0,0.136364,1,23,22,47,0,1,12,13,false,false,false,0.066,0.934
253,289,-36,31.625,41.285714,-36,1431,1399,32,0,2,0,0.285714,25,8,7,1,0,0,11,9,false,false,false,0.078,0.922
231,206,25,28.875,29.428571,25,1167,1245,-78,1,0,0.125,0,35,8,7,0.8,1,0,7,10,false,false,true,0.665,0.335
296,356,-60,18.5,22.25,-60,804,1080,-276,1,0,0.0625,0,-11,16,16,-3.090909,0,0,4,2,false,false,false,0.007,0.993
262,287,-25,18.714286,20.5,-25,1344,1314,30,0,2,0,0.142857,4,14,14,8.5,0,0,10,16,false,false,false,0.055,0.945
142,158,-16,15.777778,19.75,-16,1803,1658,145,0,0,0,0,37,9,8,0.891892,2,0,8,17,false,false,true,0.554,0.446
301,415,-114,20.066667,29.642857,-114,1576,1556,20,0,1,0,0.071429,-9,15,14,-3.333333,0,0,3,4,false,false,false,0,1
266,397,-131,16.625,24.8125,-131,1408,1539,-131,0,1,0,0.0625,-18,16,16,-1.888889,0,0,2,2,false,false,false,0.005,0.995
138,119,19,13.8,11.9,19,1193,1220,-27,0,0,0,0,34,10,10,1.264706,1,1,8,21,false,false,false,0.256,0.744
168,262,-94,16.8,26.2,-94,1407,1473,-66,0,2,0,0.2,23,10,10,1.347826,0,0,12,19,false,false,false,0.002,0.998
94,80,14,15.666667,16,14,1094,1041,53,0,0,0,0,58,6,5,0.655172,1,0,16,13,false,false,true,0.526,0.474
156,167,-11,22.285714,27.833333,-11,1063,1134,-71,1,0,0.142857,0,59,7,6,0.745763,1,0,15,13,false,false,false,0.311,0.689
38,18,20,19,18,20,1270,1261,9,0,0,0,0,89,2,1,0.41573,1,1,10,9,false,false,false,0.426,0.574
161,148,13,17.888889,16.444444,13,561,688,-127,0,0,0,0,47,9,9,0.978723,0,0,17,18,false,false,true,0.649,0.351
77,36,41,19.25,12,41,1203,1270,-67,0,0,0,0,81,4,3,0.54321,1,0,6,14,false,false,true,0.558,0.442
152,181,-29,16.888889,20.111111,-29,711,746,-35,0,0,0,0,41,9,9,0.926829,0,0,7,19,false,false,false,0.118,0.882
252,312,-60,18,24,-60,700,820,-120,0,1,0,0.076923,3,14,13,12.666667,0,0,20,12,false,false,false,0.023,0.977
27,51,-24,9,25.5,-24,1257,1176,81,0,0,0,0,89,3,2,0.382022,0,0,14,9,false,false,false,0.126,0.874
254,326,-72,14.111111,18.111111,-72,1278,1101,177,0,1,0,0.055556,-11,18,18,-3.363636,0,0,10,1,false,false,false,0.149,0.851
290,324,-34,16.111111,19.058824,-34,1040,1364,-324,0,0,0,0,-20,18,17,-1.8,0,0,1,9,false,false,false,0.015,0.985
277,325,-48,13.190476,15.47619,-48,1071,1000,71,0,0,0,0,-27,21,21,-1.740741,0,0,2,1,false,false,false,0.007,0.993
269,329,-60,14.944444,19.352941,-60,620,698,-78,1,0,0.055556,0,-13,18,17,-3.153846,1,0,14,7,false,false,false,0.006,0.994
210,250,-40,19.090909,22.727273,-40,595,733,-138,1,1,0.090909,0.090909,19,11,11,2.052632,0,1,22,15,false,false,false,0.033,0.967
25,74,-49,8.333333,37,-49,1454,1479,-25,0,0,0,0,79,3,2,0.392405,1,0,14,11,false,false,false,0.234,0.766
79,80,-1,15.8,20,-1,727,820,-93,0,1,0,0.25,64,5,4,0.546875,0,0,19,21,false,false,true,0.5,0.5
276,380,-104,18.4,25.333333,-104,967,856,111,0,1,0,0.066667,-2,15,15,-16.5,0,1,13,2,false,false,false,0,1
124,188,-64,13.777778,20.888889,-64,1220,1202,18,0,0,0,0,40,9,9,1.25,0,0,25,7,false,false,false,0.106,0.894
235,291,-56,18.076923,24.25,-56,721,757,-36,0,2,0,0.166667,12,13,12,3.166667,0,0,10,19,false,false,false,0.031,0.969
278,303,-25,19.857143,21.642857,-25,1257,1176,81,2,0,0.142857,0,10,14,14,3.4,0,0,12,11,false,false,false,0.076,0.924
267,300,-33,16.6875,18.75,-33,500,509,-9,0,0,0,0,-2,16,16,-20.5,0,0,8,9,false,false,false,0.04,0.96
223,169,54,17.153846,14.083333,54,670,576,94,0,0,0,0,18,13,12,2.277778,1,1,6,18,false,false,true,0.866,0.134
166,206,-40,18.444444,25.75,-40,874,868,6,0,0,0,0,35,9,8,0.942857,0,0,10,15,false,false,false,0.105,0.895
43,47,-4,10.75,15.666667,-4,651,567,84,0,0,0,0,75,4,3,0.733333,0,0,9,22,false,false,false,0.182,0.818
336,376,-40,18.666667,20.888889,-40,721,757,-36,0,2,0,0.111111,-15,18,18,-2.533333,0,0,1,1,false,false,false,0.024,0.976
186,309,-123,8.857143,14.714286,-123,818,826,-8,0,0,0,0,-15,21,21,-3.533333,0,0,7,12,false,false,false,0.005,0.995
28,13,15,14,6.5,15,1127,995,132,0,0,0,0,92,2,2,0.358696,0,1,13,7,false,false,true,0.503,0.497
264,301,-37,13.2,15.842105,-37,1182,1075,107,0,1,0,0.052632,-27,20,19,-1.444444,0,1,12,3,true,false,false,0,1
120,148,-28,17.142857,24.666667,-28,971,635,336,0,0,0,0,51,7,6,0.627451,0,0,22,9,false,false,false,0.263,0.737
314,332,-18,14.952381,16.6,-18,576,602,-26,0,0,0,0,-24,21,20,-1.75,0,0,1,1,false,false,false,0.041,0.959
105,179,-74,17.5,35.8,-74,1777,1500,277,0,1,0,0.2,57,6,5,0.491228,1,0,8,12,false,false,true,0.897,0.103
289,375,-86,17,23.4375,-86,1315,1331,-16,0,0,0,0,-11,17,16,-3,0,0,2,2,true,false,false,0.005,0.995
345,307,38,24.642857,23.615385,38,1407,1473,-66,1,2,0.071429,0.153846,-4,14,13,-7.75,0,0,12,15,false,false,true,0.997,0.003
132,266,-134,18.857143,38,-134,1399,1210,189,0,1,0,0.142857,47,7,7,0.744681,0,0,17,17,false,false,false,0.057,0.943
322,405,-83,20.125,25.3125,-83,1176,1133,43,1,0,0.0625,0,-3,16,16,-11.333333,0,0,2,3,false,false,false,0.007,0.993
108,66,42,36,33,42,2010,2219,-209,1,0,0.333333,0,80,3,2,0.325,0,1,18,9,false,false,false,0.31,0.69
152,198,-46,16.888889,24.75,-46,907,910,-3,0,1,0,0.125,50,9,8,0.86,1,1,11,20,false,false,false,0.087,0.913
283,303,-20,15.722222,16.833333,-20,1123,1062,61,0,0,0,0,-12,18,18,-3.666667,0,0,4,12,false,false,false,0.266,0.734
236,289,-53,16.857143,22.230769,-53,795,786,9,1,0,0.071429,0,18,14,13,2.111111,0,0,12,14,false,false,false,0.022,0.978
280,327,-47,13.333333,16.35,-47,1040,1091,-51,0,0,0,0,-26,21,20,-1.807692,0,0,6,4,false,false,false,0.006,0.994
20,0,20,20,0,20,1195,1397,-202,0,0,0,0,95,1,1,0.421053,0,1,9,10,false,false,false,0.251,0.749
146,124,22,20.857143,17.714286,22,1281,1268,13,0,0,0,0,53,7,7,0.792453,0,0,12,10,false,false,true,0.633,0.367
293,344,-51,16.277778,19.111111,-51,1633,1620,13,0,0,0,0,-25,18,18,-1.44,0,0,1,1,true,false,false,0.025,0.975
75,147,-72,15,29.4,-72,1488,1403,85,0,1,0,0.2,62,5,5,0.548387,0,0,21,10,false,false,false,0.115,0.885
55,39,16,18.333333,19.5,16,1691,1551,140,0,0,0,0,82,3,2,0.45122,0,0,9,19,false,false,false,0.323,0.677
85,115,-30,14.166667,23,-30,683,859,-176,0,0,0,0,66,6,5,0.681818,1,0,15,12,false,false,false,0.136,0.864
293,316,-23,15.421053,16.631579,-23,970,1030,-60,0,1,0,0.052632,-25,19,19,-1.6,1,0,1,1,false,false,true,0.556,0.444
83,112,-29,11.857143,18.666667,-29,907,878,29,0,0,0,0,67,7,6,0.641791,0,0,13,11,false,false,false,0.106,0.894
293,302,-9,24.416667,25.166667,-9,1436,1489,-53,1,1,0.083333,0.083333,19,12,12,1.947368,0,0,8,16,false,false,false,0.445,0.555
283,300,-17,15.722222,17.647059,-17,704,523,181,0,0,0,0,-26,18,17,-1.346154,0,0,1,3,true,false,false,0.036,0.964
132,52,80,33,17.333333,80,1156,1279,-123,1,0,0.25,0,69,4,3,0.57971,1,0,9,12,false,false,true,0.92,0.08
285,392,-107,15.833333,21.777778,-107,1003,1018,-15,0,0,0,0,-37,18,18,-1,0,0,1,2,false,false,false,0.005,0.995
122,128,-6,17.428571,21.333333,-6,620,698,-78,1,0,0.142857,0,58,7,6,0.706897,0,0,28,17,false,false,true,0.638,0.362
106,194,-88,15.142857,27.714286,-88,944,1095,-151,0,1,0,0.142857,58,7,7,0.672414,0,1,9,10,false,false,false,0.034,0.966
314,318,-4,19.625,21.2,-4,1197,1156,41,0,1,0,0.066667,-7,16,15,-5,0,0,3,4,false,false,false,0.131,0.869
339,427,-88,26.076923,32.846154,-88,1253,1324,-71,0,2,0,0.153846,-1,13,13,-29,0,0,4,1,false,false,false,0.002,0.998
267,238,29,14.833333,13.222222,29,671,638,33,0,0,0,0,-8,18,18,-6.125,0,0,8,18,false,false,true,0.973,0.027
16,0,16,16,0,16,1203,1270,-67,0,0,0,0,96,1,0,0.458333,0,0,9,0,false,false,false,0.351,0.649
290,323,-33,19.333333,21.533333,-33,804,1080,-276,1,0,0.066667,0,-3,15,15,-11.333333,0,0,7,8,false,false,false,0.033,0.967
261,309,-48,26.1,30.9,-48,1164,1161,3,1,1,0.1,0.1,4,10,10,5.75,0,1,25,12,false,false,false,0.017,0.983
182,272,-90,18.2,30.222222,-90,1576,1556,20,0,1,0,0.111111,24,10,9,1.25,0,0,15,17,false,false,false,0.004,0.996
27,46,-19,9,23,-19,1210,1162,48,0,0,0,0,81,3,2,0.395062,0,0,9,14,false,false,false,0.11,0.89
171,261,-90,17.1,26.1,-90,954,939,15,0,0,0,0,29,10,10,1.241379,1,1,18,7,false,false,false,0.011,0.989
263,278,-15,21.916667,23.166667,-15,1561,1495,66,1,0,0.083333,0,5,12,12,6.6,0,0,12,8,false,false,false,0.344,0.656
108,200,-92,10.8,20,-92,651,567,84,0,0,0,0,33,10,10,1.666667,0,0,8,10,false,false,false,0.009,0.991
59,139,-80,14.75,34.75,-80,1422,1798,-376,0,1,0,0.25,66,4,4,0.484848,1,0,19,9,false,false,false,0.16,0.84
267,304,-37,15.705882,19,-37,1037,1009,28,0,0,0,0,7,17,16,6.285714,1,0,15,15,false,false,false,0.011,0.989
127,147,-20,21.166667,24.5,-20,1055,840,215,0,0,0,0,53,6,6,0.679245,0,0,7,12,false,false,false,0.27,0.73
297,355,-58,17.470588,22.1875,-58,1126,1277,-151,0,0,0,0,-16,17,16,-2.1875,0,0,1,8,false,false,false,0.006,0.994
338,371,-33,19.882353,21.823529,-33,980,965,15,0,0,0,0,-12,17,17,-3.166667,0,0,3,4,false,false,false,0.035,0.965
173,244,-71,14.416667,20.333333,-71,1195,1397,-202,0,1,0,0.083333,30,12,12,1.333333,0,0,9,8,false,false,false,0.034,0.966
244,361,-117,16.266667,25.785714,-117,915,971,-56,0,0,0,0,-5,15,14,-6.6,0,0,4,11,false,false,false,0.005,0.995
228,234,-6,15.2,16.714286,-6,430,542,-112,0,1,0,0.071429,13,15,14,3.692308,0,0,23,15,false,false,false,0.238,0.762
194,229,-35,17.636364,22.9,-35,1229,1220,9,0,1,0,0.1,28,11,10,1.321429,0,0,16,10,false,false,false,0.122,0.878
62,88,-26,20.666667,29.333333,-26,804,1080,-276,0,0,0,0,76,3,3,0.447368,1,0,8,14,false,false,false,0.186,0.814
295,376,-81,19.666667,26.857143,-81,732,868,-136,0,1,0,0.071429,-9,15,14,-3.555556,0,0,2,11,false,false,false,0.006,0.994
0,62,-62,0,62,-62,1407,1473,-66,0,1,0,1,93,1,1,0.333333,0,0,0,8,false,false,false,0.111,0.889
72,69,3,24,34.5,3,1632,2020,-388,0,0,0,0,79,3,2,0.392405,0,0,8,21,false,false,false,0.106,0.894
84,81,3,16.8,16.2,3,540,498,42,0,0,0,0,69,5,5,0.666667,0,1,9,12,false,false,false,0.404,0.596
322,360,-38,20.125,24,-38,1266,1339,-73,0,1,0,0.066667,-1,16,15,-35,0,0,2,3,false,false,false,0.024,0.976
189,333,-144,6.75,12.333333,-144,651,567,84,0,0,0,0,-23,28,27,-2.391304,0,0,4,13,true,false,false,0.001,0.999
255,328,-73,12.142857,16.4,-73,651,700,-49,0,0,0,0,-25,21,20,-2.24,0,0,12,14,false,false,false,0.007,0.993
26,23,3,26,23,3,450,624,-174,0,0,0,0,91,1,1,0.362637,0,0,16,15,false,false,false,0.35,0.65
101,162,-61,20.2,40.5,-61,1583,1403,180,0,0,0,0,56,5,4,0.571429,0,0,14,16,false,false,false,0.011,0.989
34,72,-38,5.666667,14.4,-38,1078,983,95,0,0,0,0,72,6,5,0.666667,1,0,9,16,false,false,false,0.232,0.768
126,138,-12,14,15.333333,-12,814,830,-16,0,0,0,0,41,9,9,1,0,0,20,30,false,false,false,0.33,0.67
105,123,-18,35,41,-18,1354,1210,144,0,1,0,0.333333,76,3,3,0.434211,0,1,19,13,false,false,false,0.04,0.96
259,246,13,16.1875,16.4,13,897,996,-99,0,0,0,0,3,16,15,13,0,0,14,10,false,false,false,0.457,0.543
76,138,-62,15.2,27.6,-62,1253,1324,-71,0,0,0,0,64,5,5,0.453125,0,0,16,11,false,false,false,0.106,0.894
258,304,-46,17.2,20.266667,-46,343,570,-227,0,0,0,0,-10,15,15,-3.6,0,0,8,4,false,false,false,0.011,0.989
43,70,-27,10.75,23.333333,-27,651,996,-345,0,0,0,0,75,4,3,0.6,0,0,9,18,false,false,false,0.106,0.894
105,168,-63,13.125,21,-63,500,509,-9,0,0,0,0,44,8,8,0.931818,1,0,9,10,false,false,false,0.108,0.892
212,285,-73,11.777778,16.764706,-73,595,540,55,0,0,0,0,-6,18,17,-7.166667,0,0,10,15,false,false,false,0.006,0.994
169,324,-155,12.071429,23.142857,-155,1075,1189,-114,0,0,0,0,9,14,14,4.444444,0,1,7,20,false,false,false,0.005,0.995
24,53,-29,12,26.5,-29,1770,1745,25,0,0,0,0,88,2,2,0.375,0,0,9,17,false,false,false,0.109,0.891
357,439,-82,22.3125,29.266667,-82,1415,1361,54,0,1,0,0.066667,-15,16,15,-2.066667,0,1,6,3,true,false,false,0,1
50,48,2,12.5,16,2,999,1071,-72,0,0,0,0,75,4,3,0.533333,0,0,8,10,false,false,false,0.24,0.76
322,374,-52,17.888889,22,-52,1493,1413,80,0,1,0,0.058824,-21,18,17,-1.714286,0,0,2,1,false,false,false,0.001,0.999
203,230,-27,20.3,23,-27,1488,1428,60,1,0,0.1,0,32,10,10,1.15625,0,1,19,9,false,false,false,0.115,0.885
51,15,36,17,7.5,36,1220,1185,35,0,0,0,0,82,3,2,0.573171,0,1,23,11,false,false,true,0.519,0.481
317,323,-6,21.133333,21.533333,-6,1652,1473,179,1,1,0.066667,0.066667,-11,15,15,-2.727273,0,0,2,2,true,false,false,0.056,0.944
83,150,-67,11.857143,21.428571,-67,95,453,-358,0,0,0,0,62,7,7,0.629032,0,0,9,10,false,false,false,0.015,0.985
295,323,-28,18.4375,20.1875,-28,775,786,-11,1,0,0.0625,0,-1,16,16,-43,1,0,19,18,false,false,false,0.084,0.916
219,326,-107,15.642857,25.076923,-107,342,263,79,0,0,0,0,-1,14,13,-34,1,0,12,8,false,false,false,0.005,0.995
60,66,-6,20,22,-6,1021,1094,-73,0,0,0,0,80,3,3,0.4625,0,0,8,15,false,false,false,0.153,0.847
157,200,-43,14.272727,20,-43,651,700,-49,0,0,0,0,32,11,10,1.75,1,0,6,12,false,false,false,0.105,0.895
179,252,-73,25.571429,36,-73,1925,1885,40,1,1,0.142857,0.142857,33,7,7,0.757576,1,1,15,7,false,false,false,0.008,0.992
293,419,-126,14.65,20.95,-126,530,683,-153,0,1,0,0.05,-15,20,20,-2.666667,0,0,3,3,true,false,false,0.005,0.995
180,191,-11,22.5,23.875,-11,1102,1245,-143,0,0,0,0,34,8,8,0.852941,0,0,15,19,false,false,false,0.171,0.829
318,324,-6,18.705882,19.058824,-6,1168,1062,106,0,0,0,0,-1,17,17,-43,1,0,4,5,false,false,true,0.675,0.325
340,343,-3,21.25,21.4375,-3,1428,1361,67,0,0,0,0,-14,16,16,-2.357143,1,0,1,1,false,false,true,0.635,0.365
163,160,3,18.111111,17.777778,3,803,786,17,0,0,0,0,45,9,9,0.711111,0,0,14,15,false,false,true,0.654,0.346
351,381,-30,18.473684,21.166667,-30,980,965,15,0,0,0,0,-19,19,18,-2,0,0,1,2,false,false,false,0.027,0.973
278,371,-93,13.9,19.526316,-93,595,412,183,0,1,0,0.052632,-14,20,19,-3.714286,0,0,10,11,false,false,false,0.002,0.998
268,343,-75,15.764706,20.176471,-75,402,448,-46,0,0,0,0,-16,17,17,-2.3125,0,0,7,1,false,false,false,0.008,0.992
185,209,-24,26.428571,34.833333,-24,1415,1361,54,0,0,0,0,48,7,6,0.645833,0,1,14,8,false,false,false,0.038,0.962
179,152,27,35.8,38,27,1086,926,160,0,1,0,0.25,63,5,4,0.444444,0,0,12,12,false,false,false,0.172,0.828
78,99,-21,11.142857,14.142857,-21,917,856,61,0,0,0,0,61,7,7,0.540984,0,1,21,6,false,false,false,0.256,0.744
360,362,-2,27.692308,27.846154,-2,1047,1127,-80,0,1,0,0.076923,-11,13,13,-2.454545,0,0,9,6,false,false,true,0.958,0.042
170,235,-65,13.076923,19.583333,-65,907,878,29,0,0,0,0,36,13,12,1.194444,1,0,9,11,false,false,false,0.028,0.972
293,415,-122,20.928571,29.642857,-122,1576,1556,20,0,1,0,0.071429,-6,14,14,-5,0,0,3,4,false,false,false,0,1
287,371,-84,12.478261,16.863636,-84,1101,1130,-29,1,1,0.043478,0.045455,-22,23,22,-2.045455,0,1,3,1,true,false,false,0,1
226,251,-25,14.125,16.733333,-25,526,502,24,0,0,0,0,7,16,15,7.142857,0,0,11,22,false,false,false,0.047,0.953
242,401,-159,13.444444,23.588235,-159,913,1037,-124,0,3,0,0.176471,-3,18,17,-13.666667,0,0,23,13,false,false,false,0.002,0.998
320,362,-42,16,18.1,-42,1220,1185,35,0,1,0,0.05,-18,20,20,-2.611111,0,0,10,5,false,false,false,0.006,0.994
111,116,-5,18.5,19.333333,-5,758,791,-33,0,0,0,0,56,6,6,0.696429,0,1,15,12,false,false,false,0.237,0.763
215,325,-110,9.347826,14.130435,-110,818,826,-8,0,0,0,0,-28,23,23,-1.892857,0,0,11,10,false,false,false,0.005,0.995
291,283,8,18.1875,18.866667,8,356,498,-142,0,1,0,0.066667,-2,16,15,-17.5,0,0,10,16,false,false,false,0.235,0.765
120,109,11,20,21.8,11,1168,1062,106,0,0,0,0,65,6,5,0.661538,0,1,9,13,false,false,false,0.242,0.758
53,86,-33,10.6,17.2,-33,977,1100,-123,0,0,0,0,71,5,5,0.577465,1,0,13,8,false,false,false,0.248,0.752
274,307,-33,13.7,15.35,-33,999,1165,-166,0,0,0,0,-12,20,20,-3.833333,1,1,6,7,false,false,false,0.03,0.97
203,349,-146,11.941176,20.529412,-146,977,1100,-123,0,1,0,0.058824,0,17,17,0,0,0,9,19,false,false,false,0.005,0.995
172,247,-75,17.2,27.444444,-75,1656,1649,7,0,0,0,0,31,10,9,1.032258,0,0,19,12,false,false,false,0.1,0.9
43,97,-54,8.6,19.4,-54,951,976,-25,0,0,0,0,69,5,5,0.637681,1,1,23,24,false,false,false,0.107,0.893
83,92,-9,16.6,23,-9,402,448,-46,0,0,0,0,69,5,4,0.536232,0,1,16,7,false,false,false,0.101,0.899
332,378,-46,30.181818,34.363636,-46,1167,1245,-78,2,0,0.181818,0,-9,11,11,-2.555556,0,1,10,7,false,false,false,0,1
93,163,-70,11.625,23.285714,-70,818,826,-8,0,0,0,0,63,8,7,0.84127,1,0,10,13,false,false,false,0.102,0.898
15,30,-15,5,15,-15,1422,1510,-88,0,0,0,0,92,3,2,0.423913,0,0,10,11,false,false,false,0.236,0.764
126,104,22,18,17.333333,22,892,856,36,0,0,0,0,60,7,6,0.583333,2,0,9,10,false,false,true,0.972,0.028
302,323,-21,12.08,13.458333,-21,671,638,33,0,0,0,0,-36,25,24,-1.361111,0,0,2,1,true,false,false,0.021,0.979
339,370,-31,14.73913,16.818182,-31,540,498,42,1,0,0.043478,0,-41,23,22,-1.121951,0,0,2,1,false,false,false,0.068,0.932
37,42,-5,12.333333,21,-5,683,859,-176,0,0,0,0,83,3,2,0.542169,1,1,10,20,false,false,false,0.027,0.973
349,388,-39,29.083333,32.333333,-39,820,718,102,0,2,0,0.166667,-3,12,12,-9.333333,0,0,13,8,false,false,false,0.007,0.993
20,0,20,20,0,20,1388,1455,-67,0,0,0,0,96,1,0,0.291667,0,0,15,0,false,false,false,0.458,0.542
69,108,-39,13.8,27,-39,518,414,104,0,1,0,0.25,69,5,4,0.550725,0,0,14,7,false,false,false,0.279,0.721
32,0,32,32,0,32,1495,1531,-36,0,0,0,0,95,1,0,0.389474,0,0,11,0,false,false,true,0.514,0.486
286,370,-84,19.066667,24.666667,-84,1110,1399,-289,0,1,0,0.066667,7,15,15,4.857143,1,0,6,8,false,false,false,0.005,0.995
57,99,-42,19,33,-42,620,698,-78,0,0,0,0,80,3,3,0.5125,1,0,17,8,false,false,false,0.33,0.67
230,273,-43,16.428571,19.5,-43,599,448,151,0,0,0,0,8,14,14,4.5,0,0,12,15,false,false,false,0.046,0.954
160,227,-67,17.777778,28.375,-67,1055,840,215,0,1,0,0.125,39,9,8,0.923077,1,0,8,7,false,false,false,0.008,0.992
96,82,14,16,16.4,14,388,542,-154,0,0,0,0,56,6,5,0.660714,0,0,16,15,false,false,false,0.366,0.634
214,266,-52,19.454545,26.6,-52,1030,1014,16,0,1,0,0.1,29,11,10,1.137931,0,0,18,16,false,false,false,0.034,0.966
134,129,5,22.333333,21.5,5,804,1074,-270,0,0,0,0,58,6,6,0.551724,0,0,12,12,false,false,false,0.16,0.84
86,86,0,21.5,21.5,0,450,503,-53,0,0,0,0,71,4,4,0.549296,0,0,13,12,false,false,true,0.551,0.449
99,170,-71,14.142857,24.285714,-71,726,818,-92,0,0,0,0,52,7,7,0.673077,0,1,13,9,false,false,false,0.088,0.912
319,372,-53,19.9375,24.8,-53,1071,1065,6,0,0,0,0,-15,16,15,-2.066667,0,0,1,1,true,false,false,0.006,0.994
234,251,-17,23.4,27.888889,-17,1388,1366,22,0,1,0,0.111111,25,10,9,1.28,0,0,9,13,false,false,false,0.133,0.867
91,175,-84,13,29.166667,-84,1473,1500,-27,0,2,0,0.333333,56,7,6,0.696429,0,0,20,9,false,false,false,0.038,0.962
42,64,-22,10.5,21.333333,-22,1210,1162,48,0,0,0,0,74,4,3,0.432432,0,0,10,14,false,false,false,0.108,0.892
265,332,-67,15.588235,19.529412,-67,1161,1176,-15,1,1,0.058824,0.058824,-21,17,17,-1.809524,0,0,2,9,false,false,false,0.015,0.985
192,231,-39,19.2,23.1,-39,971,635,336,0,0,0,0,28,10,10,1.142857,0,0,17,10,false,false,false,0.268,0.732
264,275,-11,13.2,14.473684,-11,999,1071,-72,0,0,0,0,-20,20,19,-2,0,0,2,3,false,false,false,0.249,0.751
188,228,-40,18.8,22.8,-40,1334,1439,-105,1,0,0.1,0,45,10,10,0.8,0,0,9,9,false,false,false,0.095,0.905
55,55,0,18.333333,18.333333,0,1045,1082,-37,0,0,0,0,80,3,3,0.5625,1,0,12,12,false,false,true,0.569,0.431
117,104,13,19.5,17.333333,13,892,856,36,0,0,0,0,65,6,6,0.538462,1,0,7,10,false,false,true,0.539,0.461
192,267,-75,19.2,29.666667,-75,1127,995,132,0,1,0,0.111111,32,10,9,1.03125,0,0,9,12,false,false,false,0.001,0.999
38,0,38,38,0,38,1793,1957,-164,0,0,0,0,95,1,0,0.305263,0,0,12,0,false,false,false,0.449,0.551
86,55,31,28.666667,18.333333,31,1274,1394,-120,0,0,0,0,79,3,3,0.379747,0,0,13,18,false,false,true,0.562,0.438
183,175,8,18.3,19.444444,8,480,518,-38,0,0,0,0,32,10,9,1.25,0,1,8,6,false,false,false,0.218,0.782
247,293,-46,19,24.416667,-46,503,527,-24,0,1,0,0.083333,4,13,12,8.25,0,0,8,14,false,false,false,0.033,0.967
225,281,-56,11.842105,15.611111,-56,391,542,-151,1,0,0.052632,0,-17,19,18,-2.705882,0,0,11,18,false,false,false,0.032,0.968
56,28,28,18.666667,14,28,1161,1176,-15,0,0,0,0,81,3,2,0.469136,0,0,10,10,false,false,false,0.499,0.501
87,122,-35,14.5,20.333333,-35,451,448,3,0,0,0,0,62,6,6,0.596774,0,1,13,6,false,false,false,0.109,0.891
84,75,9,16.8,15,9,721,757,-36,0,0,0,0,68,5,5,0.558824,0,0,7,17,false,false,false,0.294,0.706
255,306,-51,15.9375,20.4,-51,952,826,126,0,1,0,0.066667,7,16,15,6.142857,0,0,14,14,false,false,false,0.005,0.995
313,336,-23,18.411765,21,-23,727,820,-93,0,1,0,0.0625,-14,17,16,-2.5,0,1,3,2,false,false,false,0.009,0.991
324,348,-24,23.142857,26.769231,-24,1454,1479,-25,1,0,0.071429,0,0,14,13,0,0,0,14,13,false,false,false,0.025,0.975
152,142,10,25.333333,23.666667,10,1245,1148,97,0,0,0,0,55,6,6,0.636364,0,0,26,23,false,false,true,0.709,0.291
386,523,-137,22.705882,30.764706,-137,1586,1633,-47,1,1,0.058824,0.058824,-13,17,17,-2.615385,0,0,2,1,true,false,false,0.002,0.998
165,340,-175,12.692308,26.153846,-175,940,947,-7,0,2,0,0.153846,12,13,13,2.916667,1,0,18,19,false,false,false,0,1
238,367,-129,19.833333,30.583333,-129,1606,1890,-284,0,1,0,0.083333,7,12,12,4,1,0,13,13,false,false,false,0.007,0.993
369,339,30,21.705882,21.1875,30,1156,1279,-123,2,0,0.117647,0,-10,17,16,-4,0,0,2,4,false,false,true,0.959,0.041
169,230,-61,15.363636,23,-61,341,416,-75,0,0,0,0,35,11,10,1.114286,0,0,9,13,false,false,false,0.006,0.994
412,481,-69,37.454545,48.1,-69,2147,2219,-72,1,2,0.090909,0.2,0,11,10,0,0,0,7,4,false,false,false,0.003,0.997
44,76,-32,22,38,-32,576,602,-26,0,0,0,0,86,2,2,0.488372,0,0,12,17,false,false,false,0.231,0.769
64,42,22,16,14,22,897,996,-99,0,0,0,0,77,4,3,0.506494,0,0,18,10,false,false,false,0.492,0.508
54,113,-59,10.8,22.6,-59,822,845,-23,0,0,0,0,72,5,5,0.486111,1,0,24,14,false,false,false,0.117,0.883
101,158,-57,14.428571,22.571429,-57,1161,1176,-15,0,1,0,0.142857,49,7,7,0.77551,0,0,10,8,false,false,false,0.106,0.894
141,240,-99,15.666667,30,-99,726,818,-92,0,1,0,0.125,40,9,8,0.875,0,0,17,9,false,false,false,0.005,0.995
88,60,28,14.666667,12,28,1278,1101,177,0,0,0,0,65,6,5,0.569231,1,0,8,11,false,false,true,0.603,0.397
279,257,22,21.461538,19.769231,22,1197,1156,41,0,1,0,0.076923,11,13,13,3.181818,0,0,11,7,false,false,true,0.898,0.102
110,113,-3,12.222222,14.125,-3,306,302,4,0,0,0,0,45,9,8,0.911111,0,1,11,6,false,false,false,0.242,0.758
105,148,-43,17.5,24.666667,-43,971,635,336,0,0,0,0,56,6,6,0.571429,0,0,21,9,false,false,true,0.61,0.39
26,11,15,26,11,15,758,791,-33,0,0,0,0,92,1,1,0.423913,0,0,16,10,false,false,true,0.645,0.355
28,27,1,14,27,1,714,892,-178,0,0,0,0,86,2,1,0.488372,1,1,18,19,false,false,false,0.17,0.83
242,334,-92,16.133333,22.266667,-92,725,668,57,0,0,0,0,3,15,15,11.666667,1,0,8,6,false,false,false,0.005,0.995
157,141,16,22.428571,23.5,16,1093,1100,-7,1,0,0.142857,0,56,7,6,0.553571,0,0,9,23,false,false,false,0.385,0.615
106,116,-10,11.777778,12.888889,-10,342,53,289,0,0,0,0,42,9,9,0.97619,1,0,15,9,false,false,true,0.76,0.24
77,68,9,25.666667,22.666667,9,1159,1131,28,0,0,0,0,80,3,3,0.4625,0,1,9,6,false,false,false,0.481,0.519
27,82,-55,9,41,-55,518,414,104,0,1,0,0.5,80,3,2,0.475,0,0,23,7,false,false,false,0.291,0.709
121,109,12,12.1,12.111111,12,1045,948,97,0,0,0,0,34,10,9,1,0,0,9,13,false,false,false,0.271,0.729
165,249,-84,9.705882,15.5625,-84,818,826,-8,0,0,0,0,11,17,16,4.818182,0,0,7,24,false,false,false,0.005,0.995
167,207,-40,12.846154,15.923077,-40,1220,1202,18,0,0,0,0,17,13,13,2.941176,0,1,27,8,false,false,false,0.124,0.876
190,331,-141,23.75,41.375,-141,1925,1885,40,1,2,0.125,0.25,24,8,8,1.041667,1,0,8,27,false,false,false,0.002,0.998
146,163,-17,16.222222,18.111111,-17,1312,1334,-22,0,0,0,0,35,9,9,1.114286,0,0,24,7,false,false,false,0.245,0.755
8,11,-3,8,11,-3,1030,1014,16,0,0,0,0,94,1,1,0.351064,1,0,9,18,false,false,false,0.492,0.508
77,225,-148,12.833333,37.5,-148,940,947,-7,0,2,0,0.333333,53,6,6,0.660377,0,0,10,20,false,false,false,0.001,0.999
240,229,11,24,25.444444,11,1422,1798,-376,0,1,0,0.111111,33,10,9,0.969697,0,1,8,9,false,false,false,0.122,0.878
112,114,-2,14,14.25,-2,814,830,-16,0,0,0,0,49,8,8,0.836735,0,0,17,19,false,false,false,0.334,0.666
166,197,-31,18.444444,24.625,-31,653,820,-167,0,0,0,0,30,9,8,1.266667,0,0,7,13,false,false,false,0.106,0.894
155,168,-13,17.222222,18.666667,-13,1094,1041,53,0,0,0,0,35,9,9,1.085714,1,0,9,17,false,false,false,0.331,0.669
226,290,-64,16.142857,22.307692,-64,653,820,-167,0,0,0,0,0,14,13,0,0,0,7,19,false,false,false,0.006,0.994
167,170,-3,27.833333,34,-3,1071,1065,6,0,0,0,0,46,6,5,0.673913,0,0,22,7,false,false,false,0.293,0.707
33,22,11,16.5,22,11,1094,1159,-65,0,0,0,0,86,2,1,0.44186,0,0,17,13,false,false,false,0.395,0.605
158,175,-17,17.555556,21.875,-17,1417,1482,-65,0,0,0,0,49,9,8,0.673469,0,1,16,8,false,false,false,0.164,0.836
304,300,4,17.882353,18.75,4,742,594,148,0,0,0,0,-7,17,16,-5.571429,1,0,6,7,false,false,true,0.745,0.255
201,227,-26,14.357143,17.461538,-26,830,787,43,0,0,0,0,13,14,13,2.923077,0,1,7,7,false,false,false,0.099,0.901
46,53,-7,11.5,17.666667,-7,948,998,-50,0,0,0,0,71,4,3,0.521127,1,1,11,16,false,false,false,0.253,0.747
255,333,-78,13.421053,18.5,-78,714,892,-178,0,2,0,0.111111,-13,19,18,-3.230769,0,0,8,7,false,false,false,0.035,0.965
45,50,-5,7.5,10,-5,288,359,-71,0,0,0,0,73,6,5,0.369863,0,0,23,11,false,false,false,0.209,0.791
311,365,-54,31.1,40.555556,-54,1777,1500,277,1,2,0.1,0.222222,17,10,9,1.647059,0,0,13,11,false,false,true,0.802,0.198
288,332,-44,18,22.133333,-44,1063,1134,-71,1,0,0.0625,0,13,16,15,3.384615,0,0,10,10,false,false,false,0.031,0.969
279,446,-167,18.6,31.857143,-167,1003,1004,-1,0,2,0,0.142857,-2,15,14,-17.5,0,0,7,7,false,false,false,0,1
127,198,-71,14.111111,24.75,-71,837,844,-7,0,0,0,0,52,9,8,0.788462,1,1,6,8,false,false,false,0.075,0.925
186,198,-12,16.909091,19.8,-12,721,757,-36,0,1,0,0.1,32,11,10,1.1875,0,0,13,9,false,false,false,0.47,0.53
185,211,-26,14.230769,16.230769,-26,361,413,-52,0,0,0,0,15,13,13,2.733333,2,0,11,7,false,false,true,0.796,0.204
81,60,21,16.2,12,21,1278,1101,177,0,0,0,0,67,5,5,0.552239,1,0,8,11,false,false,true,0.631,0.369
169,170,-1,15.363636,17,-1,995,965,30,0,0,0,0,29,11,10,1.37931,0,0,17,12,false,false,false,0.165,0.835
165,237,-72,13.75,21.545455,-72,1101,1130,-29,1,1,0.083333,0.090909,33,12,11,1.363636,0,1,11,10,false,false,false,0.005,0.995
93,158,-65,15.5,26.333333,-65,1253,1324,-71,0,0,0,0,58,6,6,0.5,0,0,16,9,false,false,false,0.106,0.894
74,26,48,37,26,48,1431,1399,32,0,0,0,0,89,2,1,0.280899,0,1,9,8,false,false,true,0.916,0.084
274,448,-174,11.913043,19.478261,-174,1078,983,95,1,0,0.043478,0,-33,23,23,-1.454545,0,0,1,1,false,false,false,0.001,0.999
171,160,11,19,20,11,785,892,-107,0,0,0,0,41,9,8,0.902439,0,0,15,11,false,false,false,0.329,0.671
54,70,-16,10.8,14,-16,805,918,-113,0,0,0,0,65,5,5,0.553846,0,1,32,6,false,false,false,0.402,0.598
224,253,-29,20.363636,23,-29,1110,1123,-13,0,1,0,0.090909,21,11,11,1.571429,0,1,9,17,false,false,false,0.029,0.971
189,200,-11,14.538462,16.666667,-11,1580,1629,-49,0,0,0,0,20,13,12,1.85,0,0,17,10,false,false,false,0.118,0.882
295,346,-51,14.75,17.3,-51,814,830,-16,0,0,0,0,-36,20,20,-1.138889,0,0,5,2,false,false,false,0.01,0.99
314,379,-65,19.625,25.266667,-65,527,954,-427,0,1,0,0.066667,-4,16,15,-8.75,0,0,8,8,false,false,false,0.022,0.978
90,128,-38,12.857143,18.285714,-38,1000,960,40,0,0,0,0,56,7,7,0.803571,1,0,9,7,false,false,false,0.256,0.744
20,15,5,10,7.5,5,925,1000,-75,0,0,0,0,84,2,2,0.52381,0,0,9,7,false,false,false,0.439,0.561
337,365,-28,22.466667,26.071429,-28,691,695,-4,1,0,0.066667,0,-10,15,14,-3.2,0,0,2,3,false,false,false,0.046,0.954
86,91,-5,21.5,22.75,-5,500,532,-32,0,0,0,0,68,4,4,0.602941,0,0,12,10,false,false,false,0.369,0.631
187,315,-128,20.777778,39.375,-128,1556,1656,-100,0,2,0,0.25,24,9,8,1.25,0,0,16,30,false,false,false,0,1
88,211,-123,14.666667,35.166667,-123,935,995,-60,0,1,0,0.166667,58,6,6,0.672414,2,0,14,22,false,false,false,0.093,0.907
293,393,-100,19.533333,26.2,-100,1583,1403,180,0,0,0,0,-8,15,15,-4,0,0,2,1,false,false,false,0.049,0.951
58,170,-112,11.6,34,-112,1220,1202,18,0,0,0,0,66,5,5,0.757576,0,0,23,7,false,false,false,0.047,0.953
255,523,-268,18.214286,37.357143,-268,1632,2020,-388,0,3,0,0.214286,-14,14,14,-2.214286,0,0,9,2,false,false,false,0.001,0.999
199,330,-131,15.307692,27.5,-131,965,1078,-113,0,1,0,0.083333,15,13,12,2.466667,1,0,7,14,false,false,false,0.005,0.995
135,242,-107,8.4375,16.133333,-107,651,996,-345,0,1,0,0.066667,5,16,15,9,0,2,28,5,false,false,false,0.003,0.997
0,0,0,0,0,0,1586,1633,-47,0,0,0,0,100,2,1,0.34,0,0,8,0,false,false,false,0.245,0.755
365,388,-23,28.076923,32.333333,-23,820,718,102,0,2,0,0.166667,-7,13,12,-4,0,0,6,8,false,false,false,0.009,0.991
312,371,-59,18.352941,23.1875,-59,1493,1413,80,0,1,0,0.0625,-17,17,16,-2.117647,0,0,2,2,false,false,false,0,1
280,347,-67,17.5,21.6875,-67,503,527,-24,0,1,0,0.0625,-24,16,16,-1.375,0,0,1,3,false,false,false,0.024,0.976
177,223,-46,25.285714,37.166667,-46,1021,897,124,0,2,0,0.333333,43,7,6,0.860465,0,0,15,16,false,false,false,0.123,0.877
20,20,0,20,20,0,675,570,105,0,0,0,0,93,1,1,0.376344,1,0,7,20,false,false,true,0.583,0.417
229,220,9,28.625,31.428571,9,1086,926,160,0,1,0,0.142857,38,8,7,0.736842,0,0,9,12,false,false,false,0.166,0.834
250,227,23,20.833333,20.636364,23,1093,1173,-80,0,0,0,0,28,12,11,1.535714,2,0,5,14,false,false,true,0.942,0.058
241,268,-27,11.47619,13.4,-27,808,749,59,0,0,0,0,-29,21,20,-1.448276,0,0,5,5,false,false,false,0.047,0.953
140,127,13,17.5,15.875,13,720,437,283,0,0,0,0,54,8,8,0.777778,0,0,13,7,false,false,true,0.876,0.124
283,337,-54,16.647059,19.823529,-54,480,518,-38,0,0,0,0,-12,17,17,-3.333333,0,0,7,2,false,false,false,0.029,0.971
232,273,-41,19.333333,22.75,-41,1691,1551,140,0,0,0,0,23,12,12,1.608696,1,0,6,12,false,false,false,0.131,0.869
40,31,9,13.333333,15.5,9,721,757,-36,0,0,0,0,83,3,2,0.457831,0,0,14,18,false,false,false,0.232,0.768
230,257,-27,17.692308,19.769231,-27,599,448,151,0,0,0,0,12,13,13,3,0,0,12,17,false,false,false,0.378,0.622
24,0,24,24,0,24,1232,1448,-216,0,0,0,0,95,1,0,0.368421,0,0,11,0,false,false,false,0.324,0.676
166,130,36,23.714286,21.666667,36,1636,1727,-91,0,1,0,0.166667,51,7,6,0.588235,1,0,12,8,false,false,true,0.931,0.069
274,360,-86,18.266667,25.714286,-86,965,1078,-113,1,1,0.066667,0.071429,0,15,14,0,1,0,7,20,false,false,false,0.005,0.995
222,285,-63,11.1,14.25,-63,595,540,55,0,0,0,0,-10,20,20,-4.3,0,0,7,15,false,false,false,0.032,0.968
330,320,10,16.5,16.842105,10,1065,948,117,0,1,0,0.052632,-12,20,19,-3.25,0,0,8,6,true,false,false,0.044,0.956
347,365,-18,21.6875,22.8125,-18,1093,1173,-80,1,1,0.0625,0.0625,-5,16,16,-8.6,0,0,10,15,false,false,false,0.05,0.95
307,394,-87,20.466667,26.266667,-87,1176,1133,43,1,0,0.066667,0,5,15,15,6.8,0,0,9,6,false,false,false,0.007,0.993
153,148,5,17,18.5,5,1580,1629,-49,0,0,0,0,39,9,8,0.948718,0,0,18,9,false,false,false,0.216,0.784
0,0,0,0,0,0,1439,1314,125,0,0,0,0,100,1,0,0.28,0,0,13,0,false,false,false,0.302,0.698
0,40,-40,0,40,-40,1334,1439,-105,0,0,0,0,95,1,1,0.378947,2,0,12,10,false,false,true,0.654,0.346
144,101,43,28.8,25.25,43,1063,1134,-71,1,0,0.2,0,68,5,4,0.647059,0,0,7,20,false,false,true,0.551,0.449
190,317,-127,11.176471,18.647059,-127,1078,983,95,1,0,0.058824,0,5,17,17,9.6,0,1,12,6,false,false,false,0.002,0.998
300,357,-57,20,23.8,-57,1495,1531,-36,0,1,0,0.066667,2,15,15,18.5,0,0,7,10,false,false,false,0.008,0.992
77,152,-75,11,25.333333,-75,343,570,-227,0,0,0,0,45,7,6,0.8,0,0,25,7,false,false,false,0.066,0.934
162,317,-155,13.5,28.818182,-155,940,947,-7,0,2,0,0.181818,19,12,11,1.842105,1,0,15,14,false,false,false,0,1
235,333,-98,16.785714,23.785714,-98,935,995,-60,1,1,0.071429,0.071429,10,14,14,3.9,0,0,17,14,false,false,false,0.022,0.978
22,48,-26,7.333333,24,-26,795,786,9,0,0,0,0,92,3,2,0.413043,0,0,7,10,false,false,false,0.108,0.892
234,296,-62,13,17.411765,-62,1071,1000,71,0,0,0,0,-6,18,17,-7.833333,0,0,15,8,false,false,false,0.006,0.994
176,231,-55,11.733333,15.4,-55,814,830,-16,0,0,0,0,2,15,15,20.5,0,1,19,23,false,false,false,0.009,0.991
181,222,-41,20.111111,27.75,-41,1315,1334,-19,0,1,0,0.125,38,9,8,0.947368,0,1,10,14,false,false,false,0.013,0.987
276,230,46,23,20.909091,46,1691,1510,181,0,1,0,0.090909,16,12,11,1.875,1,0,6,14,false,false,true,0.775,0.225
137,228,-91,22.833333,38,-91,1633,1680,-47,0,1,0,0.166667,40,6,6,0.7,0,0,9,9,false,false,false,0.064,0.936
46,67,-21,23,33.5,-21,835,786,49,0,0,0,0,87,2,2,0.390805,0,0,9,11,false,false,false,0.263,0.737
232,307,-75,14.5,20.466667,-75,1101,1130,-29,1,1,0.0625,0.066667,11,16,15,4.090909,0,1,15,7,false,false,false,0.005,0.995
85,108,-23,14.166667,18,-23,1040,1364,-324,0,0,0,0,57,6,6,0.631579,0,1,16,11,false,false,false,0.188,0.812
234,265,-31,23.4,26.5,-31,1388,1366,22,0,1,0,0.1,22,10,10,1.454545,0,0,9,13,false,false,false,0.186,0.814
308,324,-16,16.210526,18,-16,985,1062,-77,0,0,0,0,-21,19,18,-1.761905,1,0,2,3,true,false,false,0.199,0.801
276,373,-97,19.714286,26.642857,-97,835,786,49,0,0,0,0,-17,14,14,-2,0,0,7,4,false,false,false,0.005,0.995
30,80,-50,7.5,20,-50,430,542,-112,0,0,0,0,76,4,4,0.631579,0,2,9,8,false,false,false,0,1
191,151,40,21.222222,18.875,40,1341,1606,-265,1,0,0.111111,0,32,9,8,1.03125,0,0,13,16,false,false,false,0.3,0.7
73,132,-59,10.428571,22,-59,651,996,-345,0,0,0,0,56,7,6,0.803571,0,0,10,15,false,false,false,0.105,0.895
26,10,16,26,10,16,1126,1277,-151,0,0,0,0,90,1,1,0.388889,0,0,20,7,false,false,true,0.525,0.475
147,160,-13,16.333333,20,-13,889,895,-6,0,1,0,0.125,42,9,8,0.880952,0,1,17,12,false,false,false,0.111,0.889
14,0,14,14,0,14,1305,1254,51,0,0,0,0,96,1,0,0.333333,0,0,19,0,false,false,true,0.516,0.484
67,48,19,16.75,16,19,1586,1633,-47,1,0,0.25,0,88,4,3,0.386364,0,0,17,8,false,false,false,0.28,0.72
333,341,-8,17.526316,18.944444,-8,775,786,-11,1,0,0.052632,0,-17,19,18,-2.529412,0,0,13,16,false,false,false,0.044,0.956
258,350,-92,12.9,17.5,-92,642,952,-310,0,0,0,0,-23,20,20,-1.913043,0,0,1,2,false,false,false,0.005,0.995
307,365,-58,16.157895,19.210526,-58,668,771,-103,0,0,0,0,-10,19,19,-4,0,1,1,1,false,false,false,0.006,0.994
311,454,-143,31.1,45.4,-143,1885,1908,-23,1,3,0.1,0.3,-8,10,10,-2.875,0,0,11,6,false,false,false,0.001,0.999
41,26,15,13.666667,13,15,1344,1314,30,0,1,0,0.5,78,3,2,0.435897,0,0,7,12,false,false,true,0.525,0.475
44,17,27,22,17,27,1493,1453,40,0,0,0,0,91,2,1,0.384615,0,0,10,24,false,false,false,0.261,0.739
194,213,-19,21.555556,23.666667,-19,1270,1261,9,1,0,0.111111,0,43,9,9,0.860465,0,0,10,14,false,false,false,0.188,0.812
57,111,-54,19,55.5,-54,907,910,-3,0,1,0,0.5,85,3,2,0.505882,0,0,9,15,false,false,false,0.105,0.895
264,288,-24,17.6,19.2,-24,500,509,-9,0,0,0,0,4,15,15,10.25,0,0,7,11,false,false,false,0.055,0.945
12,20,-8,12,20,-8,651,996,-345,0,0,0,0,95,1,1,0.473684,0,0,12,12,false,false,false,0.143,0.857
73,156,-83,10.428571,22.285714,-83,651,996,-345,0,1,0,0.142857,49,7,7,0.918367,0,1,10,11,false,false,false,0.087,0.913
58,41,17,14.5,13.666667,17,306,361,-55,0,0,0,0,71,4,3,0.507042,0,1,12,16,false,false,false,0.192,0.808
329,263,66,23.5,20.230769,66,1305,1194,111,1,0,0.071429,0,3,14,13,11,1,0,9,7,false,false,true,0.995,0.005
241,332,-91,9.64,13.833333,-91,818,826,-8,0,0,0,0,-37,25,24,-1.432432,0,0,3,6,false,false,false,0.005,0.995
286,371,-85,20.428571,26.5,-85,991,1063,-72,0,1,0,0.071429,2,14,14,19,0,0,11,14,false,false,false,0.009,0.991
43,33,10,14.333333,16.5,10,999,1165,-166,0,0,0,0,82,3,2,0.560976,0,0,15,11,false,false,false,0.277,0.723
241,185,56,40.166667,30.833333,56,169,306,-137,2,1,0.333333,0.166667,39,6,6,0.794872,1,0,9,18,false,false,false,0.183,0.817
214,163,51,21.4,18.111111,51,664,786,-122,0,0,0,0,35,10,9,0.942857,1,0,11,13,false,false,true,0.869,0.131
216,293,-77,19.636364,29.3,-77,1038,917,121,1,2,0.090909,0.2,20,11,10,1.75,0,0,10,16,false,false,false,0.002,0.998
0,48,-48,0,16,-48,1586,1633,-47,0,0,0,0,95,3,3,0.357895,0,0,8,8,false,false,false,0.237,0.763
14,17,-3,14,17,-3,725,668,57,0,0,0,0,94,1,1,0.37234,0,0,9,18,false,false,false,0.282,0.718
0,0,0,0,0,0,2143,2219,-76,0,0,0,0,100,1,0,0.31,0,0,14,0,false,false,false,0.249,0.751
286,297,-11,13,14.142857,-11,797,796,1,0,0,0,0,-19,22,21,-2.578947,0,0,7,5,false,false,false,0.07,0.93
122,193,-71,17.428571,27.571429,-71,700,820,-120,0,1,0,0.142857,46,7,7,0.826087,0,0,13,7,false,false,false,0.099,0.901
55,24,31,18.333333,12,31,1045,1082,-37,0,0,0,0,85,3,2,0.529412,1,1,12,15,false,false,false,0.447,0.553
205,273,-68,15.769231,22.75,-68,450,427,23,1,1,0.076923,0.083333,9,13,12,4.111111,0,0,11,12,false,false,false,0.033,0.967
180,193,-13,20,21.444444,-13,985,1062,-77,0,0,0,0,34,9,9,1.088235,0,0,7,21,false,false,false,0.12,0.88
193,330,-137,16.083333,27.5,-137,965,1078,-113,0,1,0,0.083333,18,12,12,2.055556,0,0,8,14,false,false,false,0.005,0.995
237,285,-48,19.75,25.909091,-48,1101,1237,-136,1,0,0.083333,0,22,12,11,1.545455,1,0,20,10,false,false,false,0.011,0.989
21,25,-4,10.5,25,-4,1305,1194,111,0,0,0,0,90,2,1,0.366667,0,0,16,20,false,false,false,0.193,0.807
258,258,0,23.454545,23.454545,0,1237,1265,-28,1,0,0.090909,0,11,11,11,3.272727,0,0,7,19,false,false,true,0.679,0.321
150,228,-78,18.75,28.5,-78,971,800,171,0,1,0,0.125,25,8,8,1.16,0,0,9,12,false,false,false,0.011,0.989
161,196,-35,16.1,19.6,-35,1075,878,197,0,0,0,0,39,10,10,0.846154,0,0,13,10,false,false,false,0.131,0.869
37,54,-17,9.25,13.5,-17,206,346,-140,0,0,0,0,75,4,4,0.573333,0,0,13,19,false,false,false,0.142,0.858
40,100,-60,10,25,-60,1580,1629,-49,0,0,0,0,74,4,4,0.5,0,0,14,10,false,false,false,0.106,0.894
192,203,-11,12,13.533333,-11,391,542,-151,1,0,0.0625,0,3,16,15,15.333333,0,0,16,22,false,false,false,0.061,0.939
182,163,19,18.2,18.111111,19,599,448,151,0,0,0,0,34,10,9,1.058824,0,1,10,10,false,false,true,0.885,0.115
252,267,-15,19.384615,22.25,-15,1302,1351,-49,0,0,0,0,17,13,12,2.176471,0,0,11,11,false,false,false,0.11,0.89
16,21,-5,16,21,-5,1101,1130,-29,0,0,0,0,93,1,1,0.483871,0,1,7,10,false,false,false,0.261,0.739
89,142,-53,8.090909,12.909091,-53,288,359,-71,0,0,0,0,43,11,11,0.627907,0,0,14,12,false,false,false,0.093,0.907
82,101,-19,16.4,20.2,-19,700,820,-120,0,0,0,0,64,5,5,0.59375,0,0,11,8,false,false,false,0.145,0.855
67,63,4,16.75,21,4,603,721,-118,0,0,0,0,80,4,3,0.5375,0,1,16,6,false,false,false,0.249,0.751
59,87,-28,14.75,21.75,-28,1037,1009,28,0,0,0,0,73,4,4,0.60274,0,0,28,10,false,false,false,0.276,0.724
221,305,-84,12.277778,17.941176,-84,595,662,-67,0,1,0,0.058824,-10,18,17,-4.4,0,0,6,13,false,false,false,0.007,0.993
294,261,33,18.375,17.4,33,824,830,-6,1,0,0.0625,0,9,16,15,4.888889,0,0,10,20,false,false,true,0.77,0.23
276,377,-101,16.235294,22.176471,-101,848,976,-128,0,1,0,0.058824,-1,17,17,-40,0,0,10,6,false,false,false,0.016,0.984
351,349,2,21.9375,23.266667,2,1354,1210,144,0,1,0,0.066667,-11,16,15,-3,0,0,2,4,false,false,false,0.096,0.904
264,323,-59,12.571429,15.380952,-59,595,662,-67,0,1,0,0.047619,-25,21,21,-1.76,0,0,1,9,false,false,false,0.039,0.961
14,14,0,14,14,0,1349,1203,146,0,0,0,0,91,1,1,0.351648,0,1,15,9,false,false,false,0.498,0.502
85,190,-105,9.444444,21.111111,-105,1078,983,95,0,0,0,0,51,9,9,0.941176,1,1,8,14,false,false,false,0.021,0.979
273,409,-136,17.0625,25.5625,-136,1572,1777,-205,0,2,0,0.125,-24,16,16,-1.375,0,0,15,2,false,false,false,0.003,0.997
91,94,-3,13,15.666667,-3,568,570,-2,0,0,0,0,57,7,6,0.649123,0,0,14,29,false,false,false,0.157,0.843
193,177,16,17.545455,16.090909,16,720,437,283,0,0,0,0,37,11,11,1.135135,1,0,11,9,false,false,true,0.959,0.041
171,267,-96,17.1,26.7,-96,1408,1539,-131,0,1,0,0.1,20,10,10,1.7,0,0,8,19,false,false,false,0.013,0.987
205,208,-3,17.083333,17.333333,-3,704,523,181,0,0,0,0,10,12,12,3.5,0,0,10,12,false,false,true,0.724,0.276
357,426,-69,23.8,30.428571,-69,1415,1361,54,0,1,0,0.071429,-11,15,14,-2.818182,0,1,6,3,false,false,false,0,1
40,0,40,40,0,40,1556,1513,43,0,0,0,0,95,1,0,0.326316,0,0,18,0,false,false,true,0.572,0.428
215,299,-84,14.333333,21.357143,-84,603,721,-118,0,0,0,0,15,15,14,2.866667,0,0,8,12,false,false,false,0.005,0.995
299,309,-10,23,25.75,-10,1388,1366,22,0,1,0,0.083333,8,13,12,4,0,0,23,14,false,false,true,0.636,0.364
251,335,-84,17.928571,23.928571,-84,1633,1556,77,0,0,0,0,-5,14,14,-6.6,0,1,9,4,false,false,false,0,1
168,124,44,21,17.714286,44,1281,1268,13,0,0,0,0,50,8,7,0.84,0,0,9,10,false,false,true,0.715,0.285
282,350,-68,14.842105,19.444444,-68,1078,1095,-17,1,1,0.052632,0.055556,-17,19,18,-2.176471,0,0,6,4,true,false,false,0.005,0.995
246,314,-68,12.947368,16.526316,-68,951,976,-25,0,0,0,0,-14,19,19,-3.142857,0,0,6,5,false,false,false,0.006,0.994
141,170,-29,14.1,18.888889,-29,278,1,277,0,0,0,0,30,10,9,1.233333,0,0,28,18,false,false,true,0.712,0.288
180,237,-57,15,19.75,-57,775,786,-11,0,0,0,0,24,12,12,1.791667,1,0,9,20,false,false,false,0.072,0.928
295,348,-53,19.666667,24.857143,-53,1127,995,132,0,1,0,0.071429,-1,15,14,-33,0,0,13,11,false,false,false,0.002,0.998
42,153,-111,14,76.5,-111,786,848,-62,0,1,0,0.5,81,3,2,0.382716,2,0,21,12,false,false,false,0.233,0.767
207,196,11,17.25,17.818182,11,907,1070,-163,0,0,0,0,26,12,11,1.346154,0,0,10,25,false,false,false,0.314,0.686
0,0,0,0,0,0,907,878,29,0,0,0,0,100,1,0,0.43,0,0,21,0,false,false,false,0.468,0.532
150,239,-89,15,23.9,-89,1159,1131,28,0,2,0,0.2,30,10,10,1.233333,0,0,18,19,false,false,false,0.001,0.999
179,169,10,16.272727,16.9,10,797,796,1,0,0,0,0,42,11,10,1.166667,1,1,6,10,false,false,false,0.246,0.754
56,54,2,28,27,2,450,624,-174,0,0,0,0,83,2,2,0.39759,1,0,6,14,false,false,true,0.516,0.484
135,170,-35,22.5,28.333333,-35,1606,1593,13,0,0,0,0,58,6,6,0.5,0,1,11,9,false,false,false,0.107,0.893
221,243,-22,22.1,24.3,-22,1063,1134,-71,1,0,0.1,0,40,10,10,1.1,0,0,7,17,false,false,false,0.29,0.71
198,188,10,19.8,20.888889,10,1331,1374,-43,0,0,0,0,33,10,9,1,0,0,17,10,false,false,false,0.157,0.843
119,153,-34,19.833333,30.6,-34,1422,1798,-376,0,1,0,0.2,57,6,5,0.561404,0,0,19,9,false,false,false,0.106,0.894
53,34,19,13.25,11.333333,19,542,605,-63,0,0,0,0,73,4,3,0.493151,1,1,11,9,false,false,false,0.465,0.535
270,333,-63,19.285714,23.785714,-63,980,965,15,0,0,0,0,4,14,14,9.5,0,0,19,13,false,false,false,0.008,0.992
308,293,15,28,29.3,15,1885,1842,43,0,2,0,0.2,12,11,10,2.25,0,1,9,13,false,false,false,0.049,0.951
120,100,20,17.142857,16.666667,20,952,870,82,0,0,0,0,52,7,6,0.711538,0,0,15,31,false,false,false,0.49,0.51
235,273,-38,19.583333,24.818182,-38,976,995,-19,1,1,0.083333,0.090909,23,12,11,1.652174,0,0,13,9,false,false,false,0.04,0.96
54,35,19,18,17.5,19,1188,1334,-146,0,0,0,0,79,3,2,0.379747,0,0,20,7,false,false,false,0.486,0.514
360,433,-73,27.692308,33.307692,-73,1388,1455,-67,0,0,0,0,-8,13,13,-3.5,0,0,3,3,false,false,false,0.006,0.994
299,367,-68,16.611111,21.588235,-68,954,939,15,1,0,0.055556,0,-21,18,17,-1.714286,0,0,1,1,false,false,false,0.006,0.994
248,312,-64,13.052632,17.333333,-64,1071,1000,71,0,0,0,0,-11,19,18,-4.272727,0,0,4,7,false,false,false,0.005,0.995
158,262,-104,14.363636,26.2,-104,760,976,-216,0,1,0,0.1,24,11,10,1.5,0,1,13,8,false,false,false,0.005,0.995
180,313,-133,12.857143,22.357143,-133,948,998,-50,0,0,0,0,3,14,14,12.333333,0,0,13,12,false,false,false,0.005,0.995
368,381,-13,23,23.8125,-13,1168,1216,-48,1,1,0.0625,0.0625,-6,16,16,-5.5,0,0,11,7,false,false,false,0.081,0.919
258,254,4,25.8,28.222222,4,1556,1513,43,0,0,0,0,24,10,9,1.291667,0,0,11,14,false,false,false,0.193,0.807
308,332,-24,15.4,16.6,-24,576,602,-26,0,0,0,0,-20,20,20,-2.1,0,0,1,1,false,false,false,0.041,0.959
52,13,39,26,13,39,518,461,57,0,0,0,0,90,2,1,0.4,0,0,8,16,false,false,true,0.855,0.145
59,57,2,19.666667,19,2,796,800,-4,0,0,0,0,81,3,3,0.592593,0,0,18,7,false,false,true,0.54,0.46
328,319,9,17.263158,16.789474,9,897,996,-99,0,0,0,0,-19,19,19,-2.052632,0,0,2,7,false,false,true,0.966,0.034
214,327,-113,11.263158,18.166667,-113,1078,983,95,1,0,0.052632,0,-2,19,18,-24,0,1,12,6,false,false,false,0,1
148,209,-61,9.866667,14.928571,-61,925,1000,-75,0,0,0,0,12,15,14,3.666667,0,0,17,14,false,false,false,0.042,0.958
245,370,-125,14.411765,23.125,-125,450,427,23,1,1,0.058824,0.0625,-17,17,16,-2.176471,0,0,5,7,false,false,false,0.006,0.994
110,165,-55,12.222222,18.333333,-55,226,361,-135,0,0,0,0,38,9,9,1.157895,0,0,7,11,false,false,false,0.087,0.913
300,253,47,14.285714,12.65,47,671,638,33,0,0,0,0,-22,21,20,-2.227273,0,0,3,16,false,false,true,0.997,0.003
297,327,-30,14.85,17.210526,-30,613,525,88,0,0,0,0,-24,20,19,-1.75,0,0,4,4,false,false,false,0.035,0.965
245,289,-44,15.3125,18.0625,-44,1312,1334,-22,0,0,0,0,-9,16,16,-4.333333,0,0,10,6,false,false,false,0.094,0.906
294,326,-32,16.333333,19.176471,-32,995,965,30,0,1,0,0.058824,-12,18,17,-3.333333,0,0,3,5,false,false,false,0.013,0.987
335,346,-11,16.75,18.210526,-11,775,786,-11,1,0,0.05,0,-23,20,19,-1.869565,0,0,12,15,false,false,false,0.049,0.951
74,156,-82,12.333333,26,-82,1699,1803,-104,0,0,0,0,70,6,6,0.5,0,0,7,12,false,false,false,0.106,0.894
268,310,-42,22.333333,28.181818,-42,1266,1339,-73,0,1,0,0.090909,23,12,11,1.521739,0,0,7,14,false,false,false,0.023,0.977
62,101,-39,15.5,33.666667,-39,944,1095,-151,0,1,0,0.333333,77,4,3,0.506494,0,0,10,19,false,false,false,0.106,0.894
214,229,-15,19.454545,20.818182,-15,576,602,-26,0,0,0,0,30,11,11,1.4,1,0,6,14,false,false,false,0.144,0.856
263,360,-97,18.785714,25.714286,-97,965,1078,-113,1,1,0.071429,0.071429,3,14,14,12.333333,1,0,9,20,false,false,false,0.005,0.995
183,207,-24,20.333333,23,-24,1131,1030,101,0,0,0,0,37,9,9,0.810811,1,0,12,11,false,false,false,0.43,0.57
129,171,-42,12.9,19,-42,1075,1189,-114,0,0,0,0,36,10,9,1.111111,0,0,8,17,false,false,false,0.106,0.894
111,143,-32,12.333333,15.888889,-32,977,1100,-123,0,0,0,0,52,9,9,0.788462,0,0,25,9,false,false,false,0.11,0.89
245,374,-129,22.272727,37.4,-129,2143,2219,-76,0,0,0,0,17,11,10,1.823529,1,0,8,9,false,false,false,0.028,0.972
177,182,-5,19.666667,22.75,-5,576,602,-26,0,0,0,0,50,9,8,0.84,0,0,10,13,false,false,false,0.394,0.606
196,236,-40,19.6,26.222222,-40,1205,1216,-11,0,0,0,0,33,10,9,1,0,0,8,11,false,false,false,0.105,0.895
260,265,-5,18.571429,20.384615,-5,1021,1094,-73,1,0,0.071429,0,10,14,13,3.7,1,0,15,7,false,false,false,0.363,0.637
289,328,-39,19.266667,21.866667,-39,621,786,-165,0,0,0,0,-17,15,15,-1.764706,0,0,1,2,true,false,false,0.018,0.982
215,311,-96,14.333333,20.733333,-96,603,721,-118,0,0,0,0,12,15,15,3.583333,0,0,8,9,false,false,false,0.005,0.995
256,369,-113,17.066667,24.6,-113,1270,1424,-154,0,2,0,0.133333,-3,15,15,-11.666667,0,0,16,6,false,false,false,0.005,0.995
166,182,-16,13.833333,16.545455,-16,970,1030,-60,0,0,0,0,24,12,11,1.666667,0,0,20,7,false,false,false,0.112,0.888
82,77,5,27.333333,25.666667,5,1495,1531,-36,0,0,0,0,79,3,3,0.468354,0,0,14,8,false,false,false,0.496,0.504
92,92,0,11.5,13.142857,0,342,53,289,0,0,0,0,54,8,7,0.759259,1,0,11,16,false,false,true,0.585,0.415
212,246,-34,13.25,15.375,-34,163,346,-183,0,0,0,0,-12,16,16,-3.25,0,0,21,7,false,false,false,0.07,0.93
311,371,-60,19.4375,23.1875,-60,1349,1203,146,0,1,0,0.0625,-2,16,16,-16,0,0,3,8,true,false,false,0,1
207,273,-66,14.785714,19.5,-66,1037,913,124,1,1,0.071429,0.071429,17,14,14,2.235294,1,0,10,11,false,false,false,0.007,0.993
63,26,37,21,13,37,1110,1123,-13,0,0,0,0,74,3,2,0.445946,0,0,16,10,false,false,true,0.528,0.472
74,47,27,24.666667,23.5,27,967,856,111,0,0,0,0,79,3,2,0.417722,0,0,9,19,false,false,false,0.33,0.67
346,407,-61,20.352941,23.941176,-61,921,1045,-124,0,1,0,0.058824,-11,17,17,-3.181818,0,1,1,5,false,false,false,0.005,0.995
243,280,-37,14.294118,17.5,-37,1278,1101,177,0,1,0,0.0625,-1,17,16,-37,0,0,20,12,false,false,false,0.185,0.815
285,324,-39,16.764706,19.058824,-39,306,468,-162,1,0,0.058824,0,-9,17,17,-4.111111,0,0,7,2,false,false,false,0.036,0.964
107,124,-17,17.833333,20.666667,-17,1229,1220,9,0,0,0,0,57,6,6,0.649123,0,1,19,10,false,false,false,0.223,0.777
302,335,-33,23.230769,27.916667,-33,1495,1597,-102,0,1,0,0.083333,9,13,12,3.555556,0,1,10,9,false,false,false,0.008,0.992
243,198,45,24.3,22,45,1070,814,256,1,1,0.1,0.111111,26,10,9,1.269231,0,1,11,13,false,false,false,0.357,0.643
234,318,-84,19.5,28.909091,-84,1576,1556,20,0,1,0,0.090909,10,12,11,3,1,0,9,10,false,false,false,0.003,0.997
15,39,-24,3.75,13,-24,1422,1510,-88,0,0,0,0,88,4,3,0.443182,0,1,10,9,false,false,false,0.252,0.748
219,317,-98,16.846154,24.384615,-98,1305,1254,51,0,1,0,0.076923,2,13,13,16,0,0,16,10,false,false,false,0.002,0.998
72,81,-9,14.4,20.25,-9,1270,1261,9,0,0,0,0,75,5,4,0.493333,1,0,9,7,false,false,false,0.27,0.73
276,301,-25,23,25.083333,-25,1093,1100,-7,2,0,0.166667,0,19,12,12,1.631579,0,0,14,7,false,false,false,0.106,0.894
80,186,-106,10,26.571429,-106,1699,1803,-104,0,0,0,0,65,8,7,0.538462,0,0,8,9,false,false,false,0.087,0.913
136,132,4,19.428571,18.857143,4,995,965,30,0,0,0,0,50,7,7,0.8,0,1,25,13,false,false,false,0.368,0.632
186,188,-2,18.6,20.888889,-2,1439,1428,11,0,0,0,0,42,10,9,0.952381,0,0,14,12,false,false,false,0.109,0.891
149,161,-12,14.9,17.888889,-12,714,892,-178,0,0,0,0,45,10,9,0.933333,0,1,13,9,false,false,false,0.125,0.875
253,464,-211,18.071429,35.692308,-211,1334,1486,-152,3,1,0.214286,0.076923,3,14,13,9.666667,0,0,7,9,false,false,false,0,1
181,203,-22,30.166667,33.833333,-22,1793,1957,-164,0,0,0,0,49,6,6,0.591837,0,1,7,11,false,false,false,0.107,0.893
225,246,-21,25,30.75,-21,1274,1394,-120,0,1,0,0.125,30,9,8,1,0,0,10,10,false,false,false,0.122,0.878
251,332,-81,27.888889,36.888889,-81,1770,1751,19,0,1,0,0.111111,24,9,9,1.208333,0,0,9,10,false,false,false,0.003,0.997
308,324,-16,17.111111,18,-16,985,1062,-77,0,0,0,0,-21,18,18,-1.761905,1,0,2,3,false,false,true,0.503,0.497
122,94,28,30.5,23.5,28,786,885,-99,1,0,0.25,0,72,4,4,0.472222,0,1,7,13,false,false,false,0.001,0.999
166,247,-81,13.833333,20.583333,-81,278,1,277,0,0,0,0,15,12,12,2.466667,0,0,17,7,false,false,false,0.014,0.986
329,409,-80,19.352941,24.058824,-80,527,954,-427,0,1,0,0.058824,-13,17,17,-2.692308,0,0,3,4,false,false,false,0.022,0.978
205,190,15,17.083333,17.272727,15,704,523,181,0,0,0,0,15,12,11,2.333333,0,0,10,14,false,false,true,0.726,0.274
324,450,-126,17.052632,23.684211,-126,976,995,-19,1,2,0.052632,0.105263,-20,19,19,-1.9,1,0,0,4,true,false,false,0,1
247,315,-68,19,24.230769,-68,503,527,-24,0,1,0,0.076923,0,13,13,0,0,0,8,7,false,false,false,0.028,0.972
275,313,-38,16.176471,19.5625,-38,1040,1364,-324,0,0,0,0,-15,17,16,-2.4,0,0,1,13,false,false,false,0.016,0.984
76,21,55,19,7,55,1193,1220,-27,0,0,0,0,76,4,3,0.565789,1,1,7,23,false,false,false,0.477,0.523
58,46,12,19.333333,15.333333,12,651,700,-49,0,0,0,0,81,3,3,0.691358,0,0,8,17,false,false,false,0.38,0.62
27,45,-18,9,22.5,-18,813,698,115,0,0,0,0,83,3,2,0.578313,1,0,14,9,false,false,true,0.5,0.5
156,266,-110,14.181818,26.6,-110,342,263,79,0,0,0,0,20,11,10,1.7,0,0,18,12,false,false,false,0.005,0.995
33,20,13,16.5,20,13,1331,1374,-43,0,0,0,0,88,2,1,0.375,0,1,8,8,false,false,false,0.251,0.749
296,393,-97,18.5,24.5625,-97,1583,1403,180,0,0,0,0,-11,16,16,-2.909091,0,0,2,1,true,false,false,0,1
56,70,-14,18.666667,23.333333,-14,971,635,336,0,0,0,0,77,3,3,0.415584,0,0,12,7,false,false,false,0.464,0.536
272,331,-59,17,22.066667,-59,1493,1453,40,0,0,0,0,-9,16,15,-3.888889,0,2,4,5,false,false,false,0.004,0.996
47,39,8,15.666667,19.5,8,1331,1374,-43,0,0,0,0,79,3,2,0.417722,0,0,11,7,false,false,false,0.33,0.67
277,324,-47,21.307692,24.923077,-47,561,633,-72,0,1,0,0.076923,11,13,13,3.181818,0,0,9,7,false,false,false,0.037,0.963
141,150,-9,14.1,15,-9,814,830,-16,0,0,0,0,31,10,10,1.322581,0,0,19,28,false,false,false,0.397,0.603
299,366,-67,14.95,18.3,-67,594,648,-54,1,1,0.05,0.05,-19,20,20,-2.105263,0,0,1,1,true,false,false,0.034,0.966
214,254,-40,12.588235,14.941176,-40,668,363,305,0,0,0,0,5,17,17,9.4,0,1,8,8,false,false,false,0.002,0.998
275,377,-102,16.176471,22.176471,-102,889,895,-6,0,1,0,0.058824,-10,17,17,-3.7,0,1,8,6,false,false,false,0,1
60,106,-46,12,21.2,-46,813,698,115,0,0,0,0,65,5,5,0.738462,1,1,7,9,false,false,false,0.25,0.75
51,46,5,17,15.333333,5,306,302,4,0,0,0,0,80,3,3,0.5125,0,0,11,16,false,false,true,0.604,0.396
74,59,15,24.666667,19.666667,15,1428,1361,67,0,0,0,0,75,3,3,0.44,0,0,9,11,false,false,true,0.521,0.479
74,43,31,18.5,14.333333,31,721,757,-36,0,0,0,0,77,4,3,0.493506,0,0,7,17,false,false,false,0.43,0.57
224,146,78,32,20.857143,78,1552,1803,-251,2,0,0.285714,0,49,7,7,0.673469,0,1,12,13,false,false,true,0.919,0.081
221,256,-35,12.277778,15.058824,-35,391,542,-151,1,0,0.055556,0,-10,18,17,-4.6,0,0,11,14,false,false,false,0.036,0.964
80,106,-26,16,21.2,-26,803,786,17,0,0,0,0,68,5,5,0.470588,0,0,9,10,false,false,false,0.131,0.869
174,243,-69,15.818182,24.3,-69,1493,1453,40,0,0,0,0,28,11,10,1.25,0,0,15,10,false,false,false,0.098,0.902
136,86,50,17,12.285714,50,1040,1091,-51,0,0,0,0,52,8,7,0.903846,0,1,10,17,false,false,false,0.318,0.682
38,68,-30,12.666667,22.666667,-30,1038,917,121,0,0,0,0,82,3,3,0.426829,0,1,7,8,false,false,false,0.235,0.765
198,261,-63,18,26.1,-63,1047,1253,-206,1,1,0.090909,0.1,32,11,10,1.15625,0,0,17,10,false,false,false,0.006,0.994
232,250,-18,23.2,25,-18,1237,1265,-28,1,0,0.1,0,20,10,10,1.8,0,0,7,14,false,false,false,0.249,0.751
172,247,-75,13.230769,20.583333,-75,278,1,277,0,0,0,0,12,13,12,3.083333,0,0,16,7,false,false,false,0.006,0.994
330,378,-48,22,25.2,-48,921,1045,-124,0,1,0,0.066667,-1,15,15,-35,0,1,4,9,false,false,false,0.012,0.988
22,28,-6,11,14,-6,889,895,-6,0,0,0,0,85,2,2,0.435294,0,1,12,6,false,false,false,0.332,0.668
291,254,37,22.384615,21.166667,37,1488,1428,60,1,0,0.076923,0,17,13,12,2.176471,0,1,16,7,false,false,true,0.822,0.178
34,33,1,8.5,11,1,925,1000,-75,0,0,0,0,73,4,3,0.60274,0,0,11,13,false,false,false,0.218,0.782
275,365,-90,18.333333,24.333333,-90,1315,1331,-16,0,0,0,0,-7,15,15,-4.714286,0,0,4,2,false,false,false,0.005,0.995
198,135,63,24.75,19.285714,63,1070,814,256,1,1,0.125,0.142857,38,8,7,0.868421,0,0,17,25,false,false,true,0.91,0.09
331,375,-44,23.642857,26.785714,-44,1173,1256,-83,2,0,0.142857,0,0,14,14,0,0,1,7,3,false,false,false,0,1
223,247,-24,18.583333,20.583333,-24,1161,1030,131,0,1,0,0.083333,15,12,12,2.533333,0,0,17,9,false,false,false,0.363,0.637
122,197,-75,12.2,21.888889,-75,948,998,-50,0,0,0,0,33,10,9,1.121212,1,0,9,20,false,false,false,0.098,0.902
207,268,-61,14.785714,20.615385,-61,1037,913,124,1,1,0.071429,0.076923,21,14,13,1.809524,1,0,10,10,false,false,false,0.005,0.995
331,362,-31,20.6875,24.133333,-31,1656,1580,76,1,1,0.0625,0.066667,-5,16,15,-6.6,0,0,6,2,false,false,false,0.003,0.997
44,39,5,14.666667,19.5,5,613,525,88,0,0,0,0,80,3,2,0.525,0,2,16,8,false,false,false,0.014,0.986
77,73,4,15.4,14.6,4,1030,998,32,0,0,0,0,61,5,5,0.606557,0,0,9,11,false,false,false,0.487,0.513
109,65,44,21.8,16.25,44,1197,1156,41,0,0,0,0,67,5,4,0.522388,0,1,11,15,false,false,true,0.565,0.435
36,61,-25,12,20.333333,-25,818,826,-8,0,0,0,0,85,3,3,0.623529,1,0,9,19,false,false,false,0.213,0.787
71,90,-19,23.666667,30,-19,1439,1314,125,0,0,0,0,81,3,3,0.345679,0,0,12,7,false,false,false,0.377,0.623
338,387,-49,16.095238,18.428571,-49,1164,1261,-97,0,1,0,0.047619,-19,21,21,-2.210526,0,0,6,4,true,false,false,0.014,0.986
105,119,-14,21,29.75,-14,1315,1334,-19,0,1,0,0.25,65,5,4,0.553846,0,0,12,19,false,false,false,0.165,0.835
25,40,-15,12.5,20,-15,480,739,-259,0,0,0,0,85,2,2,0.458824,0,0,10,10,false,false,false,0.129,0.871
28,48,-20,14,48,-20,1315,1331,-16,0,0,0,0,90,2,1,0.366667,0,0,16,13,false,false,false,0.118,0.882
25,4,21,8.333333,1.333333,21,913,1037,-124,0,0,0,0,92,3,3,0.445652,0,0,28,9,false,false,true,0.557,0.443
104,100,4,17.333333,16.666667,4,952,870,82,0,0,0,0,58,6,6,0.637931,0,0,8,31,false,false,false,0.313,0.687
118,69,49,39.333333,23,49,1397,1405,-8,1,0,0.333333,0,70,3,3,0.414286,0,0,19,19,false,false,true,0.504,0.496
78,174,-96,13,29,-96,1793,1869,-76,0,1,0,0.166667,58,6,6,0.517241,1,0,12,10,false,false,false,0.232,0.768
41,58,-17,6.833333,9.666667,-17,1037,1016,21,0,0,0,0,75,6,6,0.773333,0,1,7,9,false,false,false,0.248,0.752
225,398,-173,13.235294,24.875,-173,940,947,-7,0,2,0,0.125,-7,17,16,-5,1,0,7,8,false,false,false,0,1
337,407,-70,30.636364,37,-70,1777,1500,277,1,2,0.090909,0.181818,5,11,11,5.6,0,0,10,17,false,false,true,0.752,0.248
158,230,-72,17.555556,28.75,-72,1572,1777,-205,0,1,0,0.125,32,9,8,1.03125,0,1,17,6,false,false,false,0.104,0.896
171,234,-63,21.375,29.25,-63,835,786,49,0,0,0,0,31,8,8,1.096774,0,0,20,17,false,false,false,0.136,0.864
78,112,-34,11.142857,18.666667,-34,651,567,84,0,0,0,0,56,7,6,0.982143,0,1,9,17,false,false,false,0.106,0.894
123,107,16,20.5,21.4,16,1205,1216,-11,0,0,0,0,65,6,5,0.507692,0,0,11,26,false,false,false,0.135,0.865
203,253,-50,18.454545,23,-50,804,1080,-276,0,0,0,0,24,11,11,1.416667,1,0,9,12,false,false,false,0.1,0.9
287,419,-132,15.105263,22.052632,-132,530,683,-153,0,1,0,0.052632,-11,19,19,-3.636364,0,0,3,3,false,false,false,0.007,0.993
109,130,-21,18.166667,26,-21,804,1080,-276,0,0,0,0,58,6,5,0.586207,0,0,8,20,false,false,false,0.106,0.894
83,103,-20,13.833333,17.166667,-20,1344,1208,136,0,0,0,0,62,6,6,0.483871,0,0,27,9,false,false,false,0.379,0.621
351,388,-37,18.473684,20.421053,-37,1043,1003,40,0,1,0,0.052632,-21,19,19,-1.809524,0,0,2,2,true,false,false,0.003,0.997
298,319,-21,18.625,21.266667,-21,971,635,336,0,0,0,0,-18,16,15,-1.777778,0,0,2,3,false,false,false,0.038,0.962
333,369,-36,18.5,20.5,-36,1397,1309,88,2,0,0.111111,0,-12,18,18,-3,0,0,3,5,true,false,false,0.06,0.94
25,16,9,12.5,16,9,683,859,-176,0,0,0,0,89,2,1,0.505618,0,1,12,25,false,false,false,0.089,0.911
29,35,-6,9.666667,17.5,-6,206,346,-140,0,0,0,0,84,3,2,0.511905,0,0,13,17,false,false,false,0.139,0.861
145,201,-56,13.181818,20.1,-56,595,540,55,0,0,0,0,34,11,10,1.264706,0,0,13,15,false,false,false,0.028,0.972
205,220,-15,29.285714,31.428571,-15,1556,1513,43,0,0,0,0,40,7,7,0.775,0,0,11,9,false,false,false,0.262,0.738
145,76,69,24.166667,15.2,69,1652,1473,179,1,0,0.166667,0,56,6,5,0.535714,0,0,21,10,false,false,true,0.895,0.105
196,259,-63,16.333333,21.583333,-63,727,820,-93,0,1,0,0.083333,15,12,12,2.333333,0,0,8,11,false,false,false,0.01,0.99
31,49,-18,10.333333,16.333333,-18,1101,1130,-29,0,0,0,0,80,3,3,0.5625,0,1,7,9,false,false,false,0.246,0.754
135,216,-81,16.875,27,-81,1656,1649,7,0,0,0,0,42,8,8,0.761905,0,0,19,13,false,false,false,0.105,0.895
251,205,46,20.916667,17.083333,46,742,594,148,0,0,0,0,21,12,12,1.857143,1,0,10,13,false,false,true,0.981,0.019
243,397,-154,16.2,28.357143,-154,926,973,-47,0,0,0,0,-1,15,14,-35,0,0,5,5,false,false,false,0.005,0.995
327,345,-18,19.235294,21.5625,-18,1344,1314,30,0,2,0,0.125,-13,17,16,-2.615385,0,0,7,4,false,false,false,0.013,0.987
224,282,-58,24.888889,31.333333,-58,1164,1261,-97,0,1,0,0.111111,40,9,9,1.05,0,0,13,7,false,false,false,0.074,0.926
281,379,-98,18.733333,25.266667,-98,527,954,-427,0,1,0,0.066667,0,15,15,0,0,0,18,8,false,false,false,0.011,0.989
184,280,-96,16.727273,25.454545,-96,892,856,36,0,1,0,0.090909,21,11,11,1.666667,1,0,13,11,false,false,false,0.006,0.994
142,162,-20,14.2,18,-20,848,976,-128,0,0,0,0,42,10,9,0.952381,0,0,25,12,false,false,false,0.111,0.889
283,331,-48,17.6875,22.066667,-48,387,683,-296,0,0,0,0,-15,16,15,-2.266667,1,0,3,5,false,false,false,0.006,0.994
57,112,-55,14.25,37.333333,-55,1572,1777,-205,0,1,0,0.333333,69,4,3,0.478261,0,0,15,12,false,false,false,0.106,0.894
225,246,-21,15,16.4,-21,999,1165,-166,0,0,0,0,13,15,15,3.538462,1,1,15,6,false,false,false,0.244,0.756
57,38,19,28.5,19,19,1556,1513,43,0,0,0,0,83,2,2,0.373494,0,0,16,13,false,false,true,0.525,0.475
189,208,-19,14.538462,16,-19,913,1037,-124,0,1,0,0.076923,28,13,13,1.464286,0,1,19,10,false,false,false,0.25,0.75
260,308,-48,18.571429,23.692308,-48,954,939,15,1,0,0.071429,0,1,14,13,36,0,1,7,11,false,false,false,0.005,0.995
201,390,-189,11.823529,22.941176,-189,1075,1189,-114,0,0,0,0,-8,17,17,-5,0,0,6,8,false,false,false,0.005,0.995
62,51,11,15.5,17,11,360,371,-11,0,0,0,0,77,4,3,0.480519,0,1,12,12,false,false,false,0.234,0.766
209,316,-107,17.416667,26.333333,-107,1315,1331,-16,0,0,0,0,14,12,12,2.357143,0,0,7,10,false,false,false,0.005,0.995
12,0,12,12,0,12,651,996,-345,0,0,0,0,97,1,0,0.463918,0,0,12,0,false,false,false,0.252,0.748
201,213,-12,20.1,21.3,-12,566,742,-176,0,1,0,0.1,23,10,10,1.391304,0,0,15,10,false,false,true,0.704,0.296
253,265,-12,23,26.5,-12,1388,1366,22,0,1,0,0.1,18,11,10,1.777778,0,0,11,13,false,false,false,0.289,0.711
104,70,34,20.8,17.5,34,387,683,-296,0,0,0,0,64,5,4,0.53125,1,0,8,10,false,false,true,0.515,0.485
129,121,8,21.5,20.166667,8,980,965,15,0,0,0,0,59,6,6,0.644068,0,1,13,6,false,false,false,0.476,0.524
305,343,-38,17.941176,20.176471,-38,952,870,82,0,0,0,0,-16,17,17,-2.3125,0,0,5,3,false,false,false,0.028,0.972
228,291,-63,16.285714,22.384615,-63,917,856,61,0,1,0,0.076923,12,14,13,2.75,0,0,7,11,false,false,false,0.005,0.995
139,224,-85,13.9,22.4,-85,837,844,-7,0,0,0,0,43,10,10,0.953488,1,1,6,7,false,false,false,0.022,0.978
80,36,44,40,36,44,1488,1428,60,1,0,0.5,0,87,2,1,0.425287,0,0,10,8,false,false,true,0.521,0.479
28,0,28,28,0,28,306,468,-162,0,0,0,0,95,1,0,0.389474,0,0,12,0,false,false,true,0.809,0.191
170,223,-53,17,22.3,-53,1161,1176,-15,1,1,0.1,0.1,26,10,10,1.461538,0,0,10,17,false,false,false,0.06,0.94
163,153,10,18.111111,19.125,10,803,786,17,0,0,0,0,49,9,8,0.653061,0,0,14,15,false,false,true,0.5,0.5
238,301,-63,21.636364,30.1,-63,1770,1745,25,1,0,0.090909,0,28,11,10,1.178571,1,0,6,7,false,false,false,0.217,0.783
261,281,-20,15.352941,17.5625,-20,595,538,57,0,0,0,0,-7,17,16,-5.428571,0,0,4,4,false,false,false,0.097,0.903
309,343,-34,22.071429,26.384615,-34,1071,1065,6,0,0,0,0,-7,14,13,-4.428571,0,0,3,10,false,false,false,0.017,0.983
216,269,-53,18,22.416667,-53,1037,1016,21,1,0,0.083333,0,31,12,12,1.870968,1,0,16,10,false,false,false,0.009,0.991
259,346,-87,16.1875,23.066667,-87,1195,1397,-202,0,2,0,0.133333,2,16,15,20,0,1,9,11,false,false,false,0.001,0.999
241,262,-21,17.214286,20.153846,-21,785,892,-107,0,0,0,0,15,14,13,2.466667,0,0,14,12,false,false,false,0.195,0.805
128,194,-66,18.285714,32.333333,-66,1656,1649,7,0,0,0,0,48,7,6,0.666667,0,0,7,10,false,false,false,0.105,0.895
369,362,7,21.705882,21.294118,7,1156,1279,-123,2,0,0.117647,0,-14,17,17,-2.857143,0,0,2,3,false,false,true,0.785,0.215
53,175,-122,10.6,35,-122,760,976,-216,0,1,0,0.2,62,5,5,0.580645,0,0,14,10,false,false,false,0.008,0.992
282,340,-58,20.142857,24.285714,-58,1101,1237,-136,1,0,0.071429,0,7,14,14,4.857143,1,0,26,9,false,false,false,0.006,0.994
256,334,-78,14.222222,19.647059,-78,1037,1016,21,1,0,0.055556,0,4,18,17,14.5,1,0,18,9,false,false,false,0.005,0.995
403,492,-89,31,37.846154,-89,1699,1580,119,3,2,0.230769,0.153846,-2,13,13,-15,0,0,4,5,false,false,false,0.006,0.994
179,157,22,22.375,22.428571,22,621,786,-165,0,0,0,0,34,8,7,0.882353,0,0,9,10,false,false,false,0.435,0.565
28,62,-34,14,62,-34,1407,1473,-66,0,1,0,1,89,2,1,0.348315,0,0,15,8,false,false,false,0.355,0.645
8,13,-5,8,13,-5,361,413,-52,0,0,0,0,93,1,1,0.44086,0,0,26,13,false,false,false,0.31,0.69
268,273,-5,19.142857,21,-5,1270,1261,9,1,0,0.071429,0,20,14,13,1.85,0,0,12,7,false,false,false,0.388,0.612
66,43,23,33,21.5,23,1793,1957,-164,0,0,0,0,83,2,2,0.349398,0,1,11,18,false,false,false,0.267,0.733
42,52,-10,14,17.333333,-10,977,1100,-123,0,0,0,0,77,3,3,0.532468,0,0,7,9,false,false,false,0.255,0.745
195,237,-42,21.666667,29.625,-42,991,1063,-72,0,1,0,0.125,41,9,8,0.926829,0,0,12,11,false,false,false,0.117,0.883
46,75,-29,11.5,25,-29,952,826,126,0,0,0,0,83,4,3,0.518072,0,0,12,7,false,false,false,0.116,0.884
16,0,16,16,0,16,977,1100,-123,0,0,0,0,95,1,0,0.431579,0,0,8,0,false,false,false,0.347,0.653
46,68,-22,6.571429,9.714286,-22,1037,1016,21,0,0,0,0,70,7,7,0.828571,0,1,13,9,false,false,false,0.246,0.754
115,148,-33,12.777778,18.5,-33,830,787,43,0,0,0,0,42,9,8,0.904762,0,0,17,7,false,false,false,0.109,0.891
211,208,3,21.1,20.8,3,1422,1583,-161,0,1,0,0.1,33,10,10,1.242424,1,1,6,22,false,false,false,0.199,0.801
164,214,-50,16.4,23.777778,-50,1633,1620,13,0,0,0,0,33,10,9,1.090909,0,0,7,9,false,false,false,0.106,0.894
191,215,-24,23.875,26.875,-24,1305,1211,94,1,0,0.125,0,47,8,8,0.702128,1,0,6,12,false,false,true,0.602,0.398
177,230,-53,13.615385,19.166667,-53,683,859,-176,0,0,0,0,26,13,12,1.730769,0,0,11,15,false,false,false,0.011,0.989
12,14,-2,12,14,-2,785,892,-107,0,0,0,0,93,1,1,0.397849,1,0,8,11,false,false,false,0.478,0.522
77,52,25,15.4,10.4,25,491,651,-160,0,0,0,0,70,5,5,0.428571,0,1,12,11,false,false,false,0.366,0.634
110,110,0,12.222222,13.75,0,226,361,-135,0,0,0,0,42,9,8,1.047619,0,0,7,12,false,false,false,0.141,0.859
153,120,33,25.5,20,33,1274,1394,-120,0,0,0,0,51,6,6,0.588235,0,0,15,9,false,false,true,0.66,0.34
260,226,34,26,25.111111,34,691,695,-4,1,0,0.1,0,30,10,9,1.066667,0,0,10,14,false,false,true,0.736,0.264
331,346,-15,20.6875,23.066667,-15,1691,1551,140,1,0,0.0625,0,-6,16,15,-6.166667,0,0,6,9,false,false,false,0.047,0.953
97,152,-55,9.7,15.2,-55,1045,1082,-37,0,0,0,0,37,10,10,1.216216,1,0,17,7,false,false,false,0.244,0.756
232,293,-61,15.466667,20.928571,-61,1101,1130,-29,1,1,0.066667,0.071429,13,15,14,3.461538,0,1,9,8,false,false,false,0.004,0.996
101,90,11,16.833333,15,11,1220,1185,35,0,0,0,0,62,6,6,0.758065,0,1,27,6,false,false,true,0.512,0.488
90,237,-147,8.181818,21.545455,-147,1101,1130,-29,0,1,0,0.090909,40,11,11,1.125,0,1,8,10,false,false,false,0.001,0.999
139,91,48,13.9,10.111111,48,491,651,-160,0,0,0,0,46,10,9,0.652174,0,1,7,6,false,false,false,0.333,0.667
275,271,4,15.277778,15.055556,4,796,800,-4,1,0,0.055556,0,2,18,18,24,0,1,10,6,false,false,false,0.12,0.88
331,330,1,18.388889,19.411765,1,804,766,38,0,1,0,0.058824,-3,18,17,-13.666667,0,0,7,7,false,false,false,0.122,0.878
192,264,-72,14.769231,20.307692,-72,837,844,-7,0,0,0,0,26,13,13,1.576923,1,1,12,6,false,false,false,0.012,0.988
18,0,18,18,0,18,451,448,3,0,0,0,0,96,1,0,0.385417,0,0,22,0,false,false,true,0.652,0.348
261,264,-3,13.05,13.2,-3,306,302,4,0,0,0,0,-28,20,20,-1.464286,0,0,3,1,false,false,true,0.722,0.278
310,320,-10,18.235294,18.823529,-10,907,910,-3,0,1,0,0.058824,2,17,17,21.5,0,0,8,9,false,false,false,0.127,0.873
286,307,-21,14.3,15.35,-21,1123,1062,61,0,0,0,0,-19,20,20,-2.315789,0,0,3,10,false,false,false,0.135,0.865
229,384,-155,17.615385,32,-155,724,398,326,1,1,0.076923,0.083333,24,13,12,1.625,1,0,6,9,false,false,false,0.002,0.998
157,143,14,17.444444,15.888889,14,671,638,33,0,0,0,0,35,9,9,1.4,0,0,14,16,false,false,true,0.727,0.273
100,109,-9,16.666667,18.166667,-9,1248,1220,28,0,1,0,0.166667,65,6,6,0.8,0,0,8,23,false,false,false,0.196,0.804
331,352,-21,19.470588,20.705882,-21,1227,1189,38,0,0,0,0,-18,17,17,-1.944444,0,0,2,2,false,false,false,0.188,0.812
143,354,-211,14.3,35.4,-211,1093,1100,-7,0,2,0,0.2,32,10,10,1.09375,0,0,10,12,false,false,false,0.001,0.999
215,261,-46,19.545455,26.1,-46,954,939,15,1,0,0.090909,0,22,11,10,1.636364,0,1,10,7,false,false,false,0.003,0.997
120,262,-142,15,32.75,-142,1164,1149,15,0,1,0,0.125,51,8,8,0.921569,0,0,12,11,false,false,false,0.005,0.995
123,197,-74,13.666667,21.888889,-74,1064,1397,-333,0,2,0,0.222222,54,9,9,0.796296,1,0,13,9,false,false,false,0.106,0.894
22,8,14,11,8,14,889,895,-6,0,0,0,0,87,2,1,0.425287,0,0,12,10,false,false,false,0.486,0.514
28,18,10,14,18,10,671,638,33,0,0,0,0,88,2,1,0.556818,0,1,10,8,false,false,false,0.426,0.574
68,140,-72,8.5,17.5,-72,1037,1016,21,0,0,0,0,58,8,8,1,0,0,13,26,false,false,false,0.104,0.896
265,159,106,29.444444,19.875,106,1156,1279,-123,2,0,0.222222,0,35,9,8,1.142857,0,1,11,18,false,false,true,0.938,0.062
195,278,-83,16.25,23.166667,-83,1161,1176,-15,1,1,0.083333,0.083333,12,12,12,3.166667,0,0,12,19,false,false,false,0.006,0.994
0,32,-32,0,32,-32,1397,1309,88,0,0,0,0,94,1,1,0.382979,1,1,18,27,false,false,false,0.12,0.88
58,92,-34,19.333333,30.666667,-34,1182,1075,107,0,1,0,0.333333,75,3,3,0.52,0,0,15,7,false,false,false,0.468,0.532
80,58,22,16,11.6,22,1065,948,117,0,0,0,0,68,5,5,0.573529,1,0,19,17,false,false,true,0.684,0.316
288,352,-64,20.571429,25.142857,-64,1266,1339,-73,0,1,0,0.071429,6,14,14,5.833333,0,0,11,5,false,false,false,0.01,0.99
231,251,-20,13.588235,15.6875,-20,999,1165,-166,0,0,0,0,7,17,16,6.571429,1,1,15,6,false,false,false,0.238,0.762
248,244,4,17.714286,17.428571,4,1203,1270,-67,1,0,0.071429,0,19,14,14,2.315789,1,0,6,12,false,false,true,0.651,0.349
279,284,-5,17.4375,18.933333,-5,451,448,3,0,0,0,0,-2,16,15,-18.5,0,0,13,15,false,false,false,0.106,0.894
257,301,-44,25.7,33.444444,-44,1253,1324,-71,0,1,0,0.111111,24,10,9,1.208333,0,0,23,7,false,false,false,0.143,0.857
139,117,22,23.166667,19.5,22,785,892,-107,0,0,0,0,56,6,6,0.660714,0,0,13,9,false,false,true,0.823,0.177
70,69,1,70,69,1,1689,1777,-88,1,0,1,0,85,1,1,0.352941,0,0,8,17,false,false,false,0.355,0.645
138,119,19,19.714286,19.833333,19,1493,1413,80,0,0,0,0,57,7,6,0.631579,0,0,21,17,false,false,false,0.287,0.713
235,316,-81,13.055556,18.588235,-81,907,878,29,0,0,0,0,3,18,17,14.333333,0,0,10,18,false,false,false,0.006,0.994
207,329,-122,15.923077,27.416667,-122,1484,1556,-72,0,2,0,0.166667,3,13,12,10.333333,1,0,24,16,false,false,false,0.001,0.999
129,161,-32,21.5,32.2,-32,503,527,-24,0,1,0,0.2,52,6,5,0.634615,0,0,12,10,false,false,false,0.379,0.621
125,149,-24,15.625,21.285714,-24,1803,1658,145,0,0,0,0,46,8,7,0.717391,2,0,8,11,false,false,true,0.565,0.435
261,322,-61,13.05,16.1,-61,951,976,-25,0,0,0,0,-19,20,20,-2.315789,0,0,3,3,false,false,false,0.006,0.994
174,254,-80,14.5,21.166667,-80,603,721,-118,0,0,0,0,23,12,12,1.869565,0,0,15,13,false,false,false,0.006,0.994
45,63,-18,11.25,15.75,-18,1656,1580,76,0,0,0,0,73,4,4,0.452055,0,0,16,9,false,false,false,0.285,0.715
34,25,9,17,12.5,9,758,904,-146,0,0,0,0,84,2,2,0.404762,1,0,12,14,false,false,true,0.519,0.481
156,272,-116,13,22.666667,-116,1305,1307,-2,0,1,0,0.083333,20,12,12,2.05,0,0,10,11,false,false,false,0.005,0.995
295,316,-21,14.75,16.631579,-21,970,1030,-60,0,1,0,0.052632,-28,20,19,-1.428571,1,0,1,1,false,false,false,0.398,0.602
327,372,-45,21.8,24.8,-45,1274,1394,-120,0,1,0,0.066667,-12,15,15,-2.5,0,0,8,3,true,false,false,0.012,0.988
30,0,30,30,0,30,1334,1486,-152,0,0,0,0,94,1,0,0.308511,0,0,13,0,false,false,false,0.492,0.508
30,22,8,15,11,8,391,542,-151,0,0,0,0,86,2,2,0.534884,0,1,10,9,false,false,false,0.049,0.951
228,315,-87,16.285714,22.5,-87,917,856,61,0,1,0,0.071429,10,14,14,3.3,0,0,7,11,false,false,false,0.004,0.996
4,30,-26,4,30,-26,1110,1399,-289,0,0,0,0,94,1,1,0.361702,0,0,12,11,false,false,false,0.113,0.887
158,268,-110,13.166667,22.333333,-110,948,998,-50,0,0,0,0,16,12,12,2.3125,0,0,18,12,false,false,false,0.005,0.995
249,302,-53,16.6,21.571429,-53,805,918,-113,0,0,0,0,-3,15,14,-12,0,1,6,17,false,false,false,0.006,0.994
156,155,1,15.6,15.5,1,1030,998,32,0,0,0,0,32,10,10,1.15625,0,0,8,8,false,false,false,0.345,0.655
342,376,-34,18,20.888889,-34,721,757,-36,0,2,0,0.111111,-19,19,18,-2,0,0,1,1,false,false,false,0.014,0.986
30,73,-43,7.5,24.333333,-43,795,786,9,0,0,0,0,86,4,3,0.44186,0,1,12,9,false,false,false,0.109,0.891
100,160,-60,14.285714,22.857143,-60,430,542,-112,0,1,0,0.142857,52,7,7,0.923077,0,0,19,10,false,false,false,0.143,0.857
100,47,53,50,23.5,53,1167,1245,-78,1,0,0.5,0,80,2,2,0.35,0,0,16,26,false,false,false,0.374,0.626
223,283,-60,17.153846,21.769231,-60,1422,1583,-161,0,1,0,0.076923,17,13,13,2.411765,1,0,7,16,false,false,false,0.089,0.911
256,369,-113,14.222222,21.705882,-113,503,668,-165,0,1,0,0.058824,-14,18,17,-2.642857,1,0,6,2,false,false,false,0.005,0.995
160,160,0,20,20,0,985,1062,-77,0,0,0,0,40,8,8,0.925,0,0,10,9,false,false,false,0.246,0.754
101,200,-99,11.222222,22.222222,-99,795,786,9,0,0,0,0,49,9,9,0.77551,0,0,9,20,false,false,false,0.006,0.994
154,130,24,19.25,16.25,24,771,668,103,0,0,0,0,35,8,8,1.085714,0,0,7,15,false,false,true,0.731,0.269
137,80,57,22.833333,16,57,664,786,-122,0,0,0,0,66,6,5,0.5,0,0,12,16,false,false,true,0.855,0.145
145,161,-16,16.111111,20.125,-16,813,698,115,1,0,0.111111,0,44,9,8,1.090909,0,1,7,19,false,false,false,0.064,0.936
234,337,-103,13.764706,21.0625,-103,632,603,29,0,1,0,0.0625,-17,17,16,-2.235294,0,0,6,8,false,false,false,0.004,0.996
101,97,4,20.2,24.25,4,965,1078,-113,0,0,0,0,67,5,4,0.552239,0,0,8,16,false,false,false,0.116,0.884
42,61,-19,14,30.5,-19,561,688,-127,0,0,0,0,79,3,2,0.582278,0,1,8,8,false,false,false,0.016,0.984
202,227,-25,14.428571,16.214286,-25,970,1030,-60,0,0,0,0,8,14,14,5,0,0,17,16,false,false,false,0.178,0.822
283,353,-70,18.866667,23.533333,-70,566,742,-176,0,1,0,0.066667,-8,15,15,-4,0,0,2,1,false,false,false,0.017,0.983
81,177,-96,13.5,29.5,-96,1220,1202,18,0,0,0,0,59,6,6,0.847458,0,0,20,7,false,false,false,0.097,0.903
214,257,-43,19.454545,23.363636,-43,694,658,36,0,1,0,0.090909,26,11,11,1.423077,0,0,17,17,false,false,false,0.13,0.87
180,253,-73,18,25.3,-73,971,800,171,0,1,0,0.1,12,10,10,2.416667,0,0,12,10,false,false,false,0.007,0.993
12,0,12,12,0,12,785,892,-107,0,0,0,0,96,1,0,0.385417,1,0,8,0,false,false,false,0.475,0.525
247,205,42,35.285714,29.285714,42,1777,1689,88,1,1,0.142857,0.142857,36,7,7,0.75,0,0,18,13,false,false,true,0.732,0.268
53,132,-79,17.666667,44,-79,1656,1649,7,0,0,0,0,71,3,3,0.450704,0,0,11,15,false,false,false,0.105,0.895
97,214,-117,19.4,42.8,-117,1093,1100,-7,0,1,0,0.2,59,5,5,0.59322,0,0,7,11,false,false,false,0.008,0.992
354,360,-6,22.125,24,-6,1407,1473,-66,1,2,0.0625,0.133333,-14,16,15,-2.214286,0,0,4,6,true,false,false,0.075,0.925
113,102,11,14.125,12.75,11,1193,1220,-27,0,0,0,0,44,8,8,0.977273,1,1,12,18,false,false,false,0.299,0.701
318,330,-12,18.705882,19.411765,-12,804,766,38,0,1,0,0.058824,0,17,17,0,0,0,11,7,false,false,false,0.108,0.892
292,302,-10,17.176471,18.875,-10,822,845,-23,0,0,0,0,-11,17,16,-3.181818,0,0,9,2,false,false,false,0.3,0.7
247,316,-69,10.73913,13.73913,-69,1220,1202,18,0,0,0,0,-26,23,23,-1.923077,0,1,26,11,false,false,false,0.001,0.999
150,134,16,18.75,19.142857,16,615,542,73,0,0,0,0,53,8,7,0.792453,0,0,12,11,false,false,true,0.712,0.288
290,352,-62,17.058824,20.705882,-62,1493,1453,40,0,0,0,0,-20,17,17,-1.75,0,2,1,2,false,false,false,0.007,0.993
259,346,-87,16.1875,21.625,-87,805,918,-113,0,0,0,0,-12,16,16,-3,0,0,4,5,false,false,false,0.005,0.995
144,159,-15,16,19.875,-15,840,1055,-215,0,0,0,0,42,9,8,0.833333,0,0,12,7,false,false,false,0.107,0.893
74,67,7,24.666667,22.333333,7,1417,1482,-65,0,0,0,0,80,3,3,0.4125,0,0,25,12,false,false,false,0.486,0.514
197,365,-168,13.133333,24.333333,-168,530,683,-153,0,1,0,0.066667,11,15,15,3.636364,0,0,20,9,false,false,false,0.005,0.995
176,207,-31,22,29.571429,-31,1422,1798,-376,0,1,0,0.142857,42,8,7,0.761905,0,1,18,13,false,false,false,0.106,0.894
67,90,-23,16.75,22.5,-23,818,826,-8,0,0,0,0,78,4,4,0.679487,1,0,8,15,false,false,false,0.302,0.698
8,0,8,8,0,8,840,1055,-215,0,0,0,0,96,1,0,0.364583,0,0,10,0,false,false,false,0.255,0.745
14,20,-6,14,20,-6,1632,2020,-388,0,0,0,0,92,1,1,0.336957,0,0,16,28,false,false,false,0.106,0.894
277,314,-37,15.388889,18.470588,-37,889,855,34,0,1,0,0.058824,-12,18,17,-3.333333,0,1,5,3,false,false,false,0,1
372,397,-25,17.714286,19.85,-25,1093,1173,-80,1,1,0.047619,0.05,-23,21,20,-1.869565,0,0,2,4,false,false,false,0.103,0.897
136,88,48,27.2,22,48,1281,1268,13,0,0,0,0,65,5,4,0.646154,0,0,7,10,false,false,true,0.621,0.379
158,145,13,26.333333,24.166667,13,1633,1739,-106,1,0,0.166667,0,61,6,6,0.557377,0,0,10,15,false,false,false,0.182,0.818
0,26,-26,0,26,-26,980,965,15,0,0,0,0,96,1,1,0.395833,0,1,9,9,false,false,false,0.233,0.767
30,16,14,15,16,14,1885,1842,43,0,0,0,0,89,2,1,0.303371,0,0,9,12,false,false,false,0.266,0.734
111,59,52,18.5,11.8,52,675,570,105,0,0,0,0,60,6,5,0.583333,0,0,14,29,false,false,true,0.736,0.264
254,267,-13,16.933333,19.071429,-13,1281,1268,13,0,0,0,0,14,15,14,3,1,0,6,10,false,false,false,0.234,0.766
163,181,-18,16.3,20.111111,-18,711,746,-35,0,0,0,0,38,10,9,1,0,0,9,19,false,false,false,0.117,0.883
47,17,30,15.666667,8.5,30,889,855,34,0,0,0,0,85,3,2,0.470588,0,0,11,16,false,false,true,0.52,0.48
20,0,20,20,0,20,1344,1314,30,0,0,0,0,95,1,0,0.357895,0,0,7,0,false,false,false,0.468,0.532
292,298,-6,15.368421,16.555556,-6,1203,1270,-67,1,0,0.052632,0,-9,19,18,-4.888889,1,1,9,9,false,false,false,0.076,0.924
29,8,21,14.5,8,21,786,885,-99,0,0,0,0,91,2,1,0.373626,0,0,11,20,false,false,false,0.229,0.771
106,141,-35,15.142857,23.5,-35,1176,1211,-35,0,0,0,0,48,7,6,0.6875,1,0,7,15,false,false,false,0.117,0.883
257,321,-64,16.0625,20.0625,-64,1161,1176,-15,1,1,0.0625,0.0625,-15,16,16,-2.533333,0,0,5,19,false,false,false,0.025,0.975
210,209,1,21,20.9,1,576,602,-26,0,0,0,0,38,10,10,1.105263,1,0,6,16,false,false,false,0.268,0.732
199,234,-35,18.090909,23.4,-35,725,668,57,0,0,0,0,29,11,10,1.206897,0,0,14,9,false,false,false,0.105,0.895
345,356,-11,21.5625,23.733333,-11,1436,1489,-53,1,1,0.0625,0.066667,1,16,15,37,0,0,6,7,false,false,false,0.043,0.957
147,280,-133,13.363636,28,-133,710,758,-48,0,1,0,0.1,36,11,10,1.027778,0,0,12,14,false,false,false,0.005,0.995
254,235,19,18.142857,18.076923,19,1281,1268,13,0,0,0,0,18,14,13,2.333333,0,0,8,12,false,false,false,0.412,0.588
35,14,21,17.5,14,21,1777,1689,88,0,0,0,0,89,2,1,0.303371,1,0,7,13,false,false,true,0.824,0.176
12,25,-13,4,12.5,-13,710,758,-48,0,0,0,0,88,3,2,0.420455,0,1,18,9,false,false,false,0.243,0.757
116,98,18,19.333333,16.333333,18,704,523,181,0,0,0,0,54,6,6,0.648148,0,0,14,11,false,false,true,0.824,0.176
213,250,-37,16.384615,19.230769,-37,1176,1211,-35,0,0,0,0,3,13,13,11,1,0,13,17,false,false,false,0.109,0.891
124,82,42,17.714286,13.666667,42,671,638,33,0,0,0,0,53,7,6,0.924528,0,0,16,16,false,false,true,0.798,0.202
188,242,-54,26.857143,40.333333,-54,1164,1261,-97,0,1,0,0.166667,55,7,6,0.763636,0,0,12,10,false,false,false,0.099,0.901
93,85,8,18.6,17,8,704,523,181,0,0,0,0,62,5,5,0.564516,0,0,13,13,false,false,true,0.666,0.334
88,45,43,22,15,43,675,570,105,0,0,0,0,73,4,3,0.479452,0,0,7,30,false,false,true,0.723,0.277
302,334,-32,23.230769,27.833333,-32,1331,1347,-16,1,1,0.076923,0.083333,-5,13,12,-6.4,0,1,10,6,false,false,false,0.001,0.999
52,67,-15,13,22.333333,-15,1123,1062,61,0,0,0,0,72,4,3,0.611111,0,0,7,17,false,false,false,0.112,0.888
186,141,45,15.5,12.818182,45,1040,1091,-51,0,0,0,0,28,12,11,1.678571,0,1,10,20,false,false,false,0.271,0.729
106,123,-17,35.333333,41,-17,801,679,122,1,0,0.333333,0,73,3,3,0.39726,0,0,9,8,false,false,false,0.286,0.714
18,73,-55,18,73,-55,503,527,-24,0,1,0,1,89,1,1,0.370787,0,0,12,15,false,false,false,0.366,0.634
162,161,1,20.25,23,1,1210,1162,48,0,0,0,0,48,8,7,0.666667,0,0,10,19,false,false,false,0.125,0.875
230,323,-93,25.555556,40.375,-93,1777,1500,277,1,2,0.111111,0.25,26,9,8,1.076923,0,0,18,18,false,false,false,0.127,0.873
134,173,-39,14.888889,19.222222,-39,341,416,-75,0,0,0,0,47,9,9,0.829787,0,0,11,12,false,false,false,0.157,0.843
90,116,-26,18,29,-26,1232,1281,-49,0,1,0,0.25,58,5,4,0.534483,0,1,12,7,false,false,false,0.215,0.785
211,224,-13,14.066667,16,-13,361,413,-52,0,0,0,0,4,15,14,10.25,1,0,9,8,false,false,false,0.302,0.698
193,307,-114,16.083333,27.909091,-114,965,1078,-113,0,1,0,0.090909,22,12,11,1.681818,0,0,8,15,false,false,false,0.005,0.995
70,86,-16,17.5,28.666667,-16,473,683,-210,0,0,0,0,75,4,3,0.506667,0,0,10,26,false,false,false,0.107,0.893
42,32,10,21,32,10,1021,1094,-73,0,0,0,0,91,2,1,0.406593,0,0,10,17,false,false,false,0.174,0.826
59,72,-13,19.666667,24,-13,1388,1366,22,0,0,0,0,78,3,3,0.410256,0,0,9,10,false,false,false,0.285,0.715
207,247,-40,17.25,20.583333,-40,451,448,3,0,0,0,0,18,12,12,2.055556,0,0,14,8,false,false,false,0.15,0.85
124,242,-118,8.266667,16.133333,-118,651,996,-345,0,1,0,0.066667,7,15,15,6.428571,0,2,33,5,false,false,false,0.004,0.996
153,135,18,19.125,19.285714,18,758,791,-33,0,0,0,0,47,8,7,0.829787,0,1,11,10,false,false,false,0.281,0.719
209,261,-52,19,23.727273,-52,1656,1580,76,0,1,0,0.090909,23,11,11,1.434783,2,0,5,19,false,false,false,0.072,0.928
169,187,-18,15.363636,18.7,-18,402,448,-46,0,0,0,0,32,11,10,1.15625,0,2,11,13,false,false,false,0.001,0.999
212,248,-36,17.666667,22.545455,-36,1055,840,215,0,1,0,0.090909,20,12,11,1.8,1,0,7,16,false,false,false,0.009,0.991
91,212,-121,15.166667,42.4,-121,2143,2219,-76,0,0,0,0,59,6,5,0.525424,0,0,17,20,false,false,false,0.056,0.944
195,224,-29,16.25,20.363636,-29,804,766,38,0,1,0,0.090909,38,12,11,1.078947,0,1,18,10,false,false,false,0.076,0.924
40,50,-10,13.333333,25,-10,1030,1014,16,0,0,0,0,86,3,2,0.383721,1,0,9,14,false,false,false,0.327,0.673
273,347,-74,18.2,24.785714,-74,710,758,-48,1,1,0.066667,0.071429,8,15,14,4.625,0,0,11,10,false,false,false,0.035,0.965
198,275,-77,14.142857,19.642857,-77,306,361,-55,0,0,0,0,-2,14,14,-18,0,0,12,8,false,false,false,0.006,0.994
94,121,-27,13.428571,20.166667,-27,913,1037,-124,0,1,0,0.166667,68,7,6,0.602941,0,0,26,9,false,false,false,0.14,0.86
86,78,8,14.333333,15.6,8,526,502,24,0,0,0,0,67,6,5,0.746269,0,0,18,14,false,false,true,0.502,0.498
101,109,-8,20.2,21.8,-8,1388,1366,22,0,0,0,0,63,5,5,0.507937,0,2,11,6,false,false,true,0.628,0.372
215,277,-62,12.647059,16.294118,-62,226,361,-135,0,0,0,0,-18,17,17,-2.444444,0,0,18,16,false,false,false,0.022,0.978
317,359,-42,18.647059,22.4375,-42,1397,1309,88,2,0,0.117647,0,-5,17,16,-7.2,0,0,3,9,false,false,false,0.034,0.966
24,16,8,24,16,8,1341,1606,-265,0,0,0,0,89,1,1,0.370787,2,0,6,17,false,false,true,0.784,0.216
280,299,-19,15.555556,17.588235,-19,450,503,-53,0,0,0,0,-13,18,17,-3,0,0,5,7,false,false,false,0.04,0.96
112,194,-82,18.666667,32.333333,-82,1656,1649,7,0,0,0,0,52,6,6,0.615385,0,0,9,10,false,false,false,0.106,0.894
88,82,6,14.666667,13.666667,6,1278,1101,177,0,0,0,0,61,6,6,0.606557,1,0,8,14,false,false,true,0.542,0.458
12,42,-30,4,14,-30,710,758,-48,0,0,0,0,84,3,3,0.440476,0,1,18,13,false,false,false,0.152,0.848
99,94,5,19.8,18.8,5,785,892,-107,0,0,0,0,64,5,5,0.578125,0,0,28,11,false,false,true,0.58,0.42
129,158,-29,12.9,17.555556,-29,970,1030,-60,0,0,0,0,36,10,9,1.111111,0,0,24,7,false,false,false,0.108,0.892
189,270,-81,17.181818,27,-81,935,995,-60,1,1,0.090909,0.1,30,11,10,1.3,0,0,7,17,false,false,false,0.006,0.994
204,236,-32,12.75,15.733333,-32,668,363,305,0,0,0,0,14,16,15,3.357143,1,1,9,10,false,false,false,0.007,0.993
146,155,-9,16.222222,19.375,-9,1248,1220,28,0,1,0,0.125,50,9,8,1.04,1,0,6,17,false,false,false,0.229,0.771
294,336,-42,16.333333,18.666667,-42,995,965,30,0,1,0,0.055556,-15,18,18,-2.666667,0,0,3,2,false,false,false,0.013,0.987
215,367,-152,13.4375,24.466667,-152,940,947,-7,0,2,0,0.133333,-1,16,15,-35,1,0,11,13,false,false,false,0,1
190,240,-50,14.615385,20,-50,813,698,115,1,0,0.076923,0,29,13,12,1.655172,0,1,9,6,false,false,false,0.002,0.998
89,127,-38,8.090909,12.7,-38,288,359,-71,0,0,0,0,46,11,10,0.586957,0,0,14,15,false,false,false,0.108,0.892
10,15,-5,10,15,-5,848,976,-128,0,0,0,0,92,1,1,0.434783,0,0,9,9,false,false,false,0.325,0.675
228,341,-113,16.285714,26.230769,-113,915,971,-56,0,0,0,0,4,14,13,8.25,1,0,11,9,false,false,false,0.005,0.995
184,234,-50,23,29.25,-50,1101,1237,-136,1,0,0.125,0,40,8,8,0.85,0,0,7,8,false,false,false,0.069,0.931
38,30,8,38,30,8,1417,1482,-65,0,0,0,0,92,1,1,0.358696,0,0,24,15,false,false,false,0.444,0.556
46,60,-14,15.333333,20,-14,995,965,30,0,0,0,0,76,3,3,0.526316,0,0,12,8,false,false,false,0.433,0.567
94,233,-139,11.75,33.285714,-139,935,995,-60,0,1,0,0.142857,53,8,7,0.735849,2,0,16,22,false,false,false,0.03,0.97
287,365,-78,14.35,18.25,-78,1101,1130,-29,1,1,0.05,0.05,-17,20,20,-2.647059,0,1,3,2,false,false,false,0.001,0.999
273,358,-85,14.368421,19.888889,-85,837,844,-7,0,0,0,0,-12,19,18,-3.416667,0,0,4,2,false,false,false,0.005,0.995
195,204,-9,17.727273,20.4,-9,1439,1428,11,0,0,0,0,36,11,10,1.111111,0,0,18,11,false,false,false,0.109,0.891
247,316,-69,10.291667,13.166667,-69,1220,1202,18,0,0,0,0,-26,24,24,-1.923077,0,1,26,11,false,false,false,0.001,0.999
39,103,-64,5.571429,17.166667,-64,1078,983,95,0,0,0,0,66,7,6,0.727273,1,0,16,13,false,false,false,0.136,0.864
220,374,-154,22,37.4,-154,2143,2219,-76,0,0,0,0,20,10,10,1.55,0,0,14,9,false,false,false,0.007,0.993
175,125,50,19.444444,15.625,50,952,870,82,0,0,0,0,38,9,8,0.973684,1,0,9,35,false,false,true,0.575,0.425
188,290,-102,11.75,19.333333,-102,977,1100,-123,0,1,0,0.066667,12,16,15,3.416667,0,1,12,18,false,false,false,0.005,0.995
293,302,-9,15.421053,16.777778,-9,970,1030,-60,0,1,0,0.055556,-22,19,18,-1.818182,1,0,1,7,false,false,true,0.607,0.393
73,109,-36,18.25,36.333333,-36,976,995,-19,0,1,0,0.333333,76,4,3,0.5,0,0,11,10,false,false,false,0.142,0.858
331,342,-11,19.470588,21.375,-11,1227,1189,38,0,0,0,0,-16,17,16,-2.1875,0,0,2,2,false,false,false,0.159,0.841
67,72,-5,13.4,14.4,-5,1220,1185,35,0,0,0,0,68,5,5,0.691176,0,1,33,6,false,false,true,0.505,0.495
120,408,-288,8,29.142857,-288,1164,1149,15,0,2,0,0.142857,31,15,14,1.516129,0,0,12,8,false,false,false,0.066,0.934
243,430,-187,17.357143,30.714286,-187,1093,1100,-7,0,2,0,0.142857,6,14,14,5.833333,0,0,26,10,false,false,false,0.002,0.998
211,337,-126,13.1875,21.0625,-126,632,603,29,0,1,0,0.0625,-14,16,16,-2.714286,0,0,10,8,false,false,false,0.004,0.996
275,282,-7,16.176471,17.625,-7,970,1030,-60,0,1,0,0.0625,-9,17,16,-4.444444,1,0,6,11,false,false,false,0.453,0.547
209,365,-156,14.928571,26.071429,-156,473,683,-210,0,0,0,0,7,14,14,5.428571,0,0,8,9,false,false,false,0.005,0.995
199,181,18,19.9,18.1,18,1078,1095,-17,1,0,0.1,0,35,10,10,1.057143,0,2,14,14,false,false,false,0.004,0.996
245,354,-109,15.3125,23.6,-109,342,263,79,0,0,0,0,-19,16,15,-1.789474,1,0,1,2,false,false,false,0.005,0.995
187,177,10,23.375,22.125,10,1093,1173,-80,0,0,0,0,48,8,8,0.895833,0,0,16,16,false,false,true,0.632,0.368
60,36,24,20,18,24,704,523,181,0,0,0,0,80,3,2,0.4375,1,0,12,16,false,false,true,0.577,0.423
122,177,-55,17.428571,29.5,-55,700,820,-120,0,1,0,0.166667,51,7,6,0.745098,0,0,13,7,false,false,false,0.106,0.894
97,192,-95,19.4,48,-95,1093,1100,-7,0,1,0,0.25,61,5,4,0.57377,0,0,7,11,false,false,false,0.034,0.966
190,242,-52,19,24.2,-52,621,786,-165,0,0,0,0,17,10,10,1.764706,0,0,14,12,false,false,false,0.078,0.922
98,88,10,19.6,22,10,796,800,-4,0,0,0,0,71,5,4,0.676056,0,0,10,7,false,false,false,0.401,0.599
102,115,-13,10.2,11.5,-13,925,1000,-75,0,0,0,0,37,10,10,1.189189,0,0,10,21,false,false,false,0.107,0.893
224,365,-141,14,22.8125,-141,530,683,-153,0,1,0,0.0625,8,16,16,5,0,0,23,11,false,false,false,0.006,0.994
33,79,-46,11,39.5,-46,1803,1658,145,0,0,0,0,77,3,2,0.428571,1,0,8,13,false,false,false,0.166,0.834
159,157,2,19.875,22.428571,2,967,856,111,0,0,0,0,46,8,7,0.717391,0,0,17,15,false,false,false,0.419,0.581
68,0,68,68,0,68,595,733,-138,1,0,1,0,93,1,0,0.419355,0,0,23,0,false,false,true,0.539,0.461
280,356,-76,14.736842,18.736842,-76,1101,1130,-29,1,1,0.052632,0.052632,-11,19,19,-4.090909,0,1,5,3,false,false,false,0.001,0.999
281,467,-186,20.071429,33.357143,-186,1368,1452,-84,1,2,0.071429,0.142857,-1,14,14,-32,0,0,8,3,false,false,false,0,1
98,108,-10,14,18,-10,1040,1364,-324,0,0,0,0,52,7,6,0.692308,0,1,22,11,false,false,false,0.169,0.831
156,226,-70,19.5,28.25,-70,1045,1100,-55,0,0,0,0,46,8,8,0.73913,0,1,8,10,false,false,false,0.063,0.937
307,365,-58,15.35,18.25,-58,668,771,-103,0,0,0,0,-10,20,20,-4,0,1,1,1,true,false,false,0.008,0.992
184,254,-70,16.727273,25.4,-70,892,856,36,0,1,0,0.1,27,11,10,1.296296,1,0,13,13,false,false,false,0.021,0.979
133,185,-52,19,30.833333,-52,1408,1539,-131,0,1,0,0.166667,50,7,6,0.68,0,0,8,7,false,false,false,0.106,0.894
87,59,28,21.75,19.666667,28,1428,1361,67,0,0,0,0,73,4,3,0.452055,0,0,9,11,false,false,true,0.509,0.491
48,97,-49,12,24.25,-49,342,263,79,0,0,0,0,69,4,4,0.492754,0,1,8,11,false,false,false,0.017,0.983
354,386,-32,18.631579,21.444444,-32,1691,1551,140,1,0,0.052632,0,-23,19,18,-1.608696,0,0,1,2,true,false,false,0,1
111,71,40,22.2,14.2,40,742,594,148,0,0,0,0,63,5,5,0.619048,0,0,28,16,false,false,true,0.83,0.17
118,88,30,23.6,22,30,595,733,-138,1,0,0.2,0,61,5,4,0.639344,0,0,14,11,false,false,false,0.474,0.526
197,286,-89,19.7,28.6,-89,724,398,326,1,1,0.1,0.1,39,10,10,1,1,0,9,8,false,false,false,0.001,0.999
225,235,-10,15,16.785714,-10,999,1165,-166,0,0,0,0,16,15,14,2.875,1,1,15,9,false,false,false,0.245,0.755
226,284,-58,22.6,28.4,-58,1126,1277,-151,0,0,0,0,16,10,10,2.1875,1,0,6,28,false,false,false,0.101,0.899
251,274,-23,17.928571,21.076923,-23,1220,1185,35,0,1,0,0.076923,16,14,13,2.9375,0,1,18,19,false,false,false,0.005,0.995
234,262,-28,39,52.4,-28,2147,2219,-72,1,2,0.166667,0.4,42,6,5,0.571429,0,0,11,9,false,false,false,0.092,0.908
234,252,-18,18,21,-18,822,845,-23,0,0,0,0,19,13,12,1.842105,0,0,8,10,false,false,false,0.177,0.823
158,194,-36,17.555556,21.555556,-36,1030,1014,16,0,0,0,0,42,9,9,0.785714,0,1,20,7,false,false,false,0.109,0.891
327,372,-45,21.8,26.571429,-45,1274,1394,-120,0,1,0,0.071429,-12,15,14,-2.5,0,0,8,3,false,false,false,0.007,0.993
139,160,-21,11.583333,14.545455,-21,391,542,-151,1,0,0.083333,0,28,12,11,1.642857,0,0,10,7,false,false,false,0.172,0.828
258,318,-60,13.578947,17.666667,-60,813,698,115,1,0,0.052632,0,-9,19,18,-5.333333,0,0,6,17,false,false,false,0.034,0.966
195,264,-69,13.928571,18.857143,-69,518,414,104,0,1,0,0.071429,12,14,14,3.166667,0,0,13,12,false,false,false,0.034,0.966
253,305,-52,18.071429,21.785714,-52,1210,1162,48,0,0,0,0,7,14,14,4.571429,1,0,13,24,false,false,false,0.039,0.961
67,99,-32,9.571429,16.5,-32,977,1100,-123,0,0,0,0,65,7,6,0.630769,1,0,16,8,false,false,false,0.245,0.755
101,149,-48,14.428571,24.833333,-48,563,523,40,0,0,0,0,58,7,6,0.637931,0,0,7,11,false,false,false,0.104,0.896
174,187,-13,17.4,18.7,-13,1203,1270,-67,0,0,0,0,42,10,10,1.047619,1,0,9,13,false,false,false,0.246,0.754
195,347,-152,13.928571,24.785714,-152,760,976,-216,0,1,0,0.071429,0,14,14,0,0,1,10,21,false,false,false,0.005,0.995
176,169,7,25.142857,24.142857,7,1633,1739,-106,1,0,0.142857,0,53,7,7,0.641509,0,0,11,17,false,false,false,0.154,0.846
191,229,-38,17.363636,20.818182,-38,451,448,3,0,0,0,0,26,11,11,1.423077,0,0,12,7,false,false,false,0.251,0.749
298,390,-92,17.529412,22.941176,-92,907,1070,-163,0,1,0,0.058824,-7,17,17,-5,0,2,6,7,false,false,false,0,1
280,360,-80,14,18.947368,-80,837,844,-7,0,0,0,0,-16,20,19,-2.5625,0,0,2,1,false,false,false,0.005,0.995
17,19,-2,8.5,19,-2,724,398,326,0,0,0,0,92,2,1,0.423913,0,0,14,9,false,false,false,0.419,0.581
122,141,-19,13.555556,17.625,-19,360,371,-11,0,0,0,0,38,9,8,0.973684,0,0,17,17,false,false,false,0.206,0.794
65,162,-97,16.25,40.5,-97,1583,1403,180,0,0,0,0,62,4,4,0.516129,0,0,11,16,false,false,false,0.022,0.978
97,225,-128,19.4,45,-128,786,848,-62,0,1,0,0.2,64,5,5,0.484375,1,0,13,11,false,false,false,0.01,0.99
89,68,21,14.833333,13.6,21,651,700,-49,0,0,0,0,66,6,5,0.848485,1,0,8,14,false,false,false,0.489,0.511
255,237,18,23.181818,23.7,18,824,830,-6,1,0,0.090909,0,30,11,10,1.466667,0,0,7,19,false,false,true,0.69,0.31
0,0,0,0,0,0,1334,1439,-105,0,0,0,0,100,1,0,0.36,2,0,12,0,false,false,true,0.847,0.153
185,297,-112,18.5,29.7,-112,1232,1281,-49,0,2,0,0.2,19,10,10,1.631579,1,0,12,19,false,false,false,0.001,0.999
86,22,64,43,22,64,595,733,-138,1,0,0.5,0,86,2,1,0.453488,0,0,19,10,false,false,true,0.692,0.308
120,166,-46,24,33.2,-46,1045,1100,-55,0,0,0,0,65,5,5,0.523077,0,1,7,14,false,false,false,0.104,0.896
191,285,-94,17.363636,25.909091,-94,1349,1203,146,0,1,0,0.090909,26,11,11,1.230769,0,1,8,12,false,false,false,0.001,0.999
313,352,-39,20.866667,25.142857,-39,1266,1339,-73,0,1,0,0.071429,3,15,14,11.666667,0,0,4,5,false,false,false,0.014,0.986
281,349,-68,10.807692,13.96,-68,651,700,-49,0,0,0,0,-44,26,25,-1.272727,0,0,14,10,false,false,false,0.033,0.967
327,472,-145,20.4375,31.466667,-145,1554,1685,-131,0,2,0,0.133333,-11,16,15,-2.909091,0,0,1,2,false,false,false,0,1
225,280,-55,25,31.111111,-55,1274,1394,-120,0,1,0,0.111111,24,9,9,1.25,0,0,10,24,false,false,false,0.087,0.913
12,0,12,12,0,12,1055,1019,36,0,0,0,0,96,1,0,0.34375,1,0,7,0,false,false,true,0.519,0.481
256,223,33,21.333333,20.272727,33,1803,1658,145,1,0,0.083333,0,13,12,11,2.538462,0,0,7,19,false,false,true,0.615,0.385
23,24,-1,11.5,12,-1,1452,1388,64,0,0,0,0,88,2,2,0.397727,0,0,12,21,false,false,false,0.225,0.775
134,101,33,26.8,20.2,33,804,1074,-270,0,0,0,0,61,5,5,0.52459,0,0,12,16,false,false,true,0.706,0.294
218,180,38,19.818182,18,38,952,870,82,0,0,0,0,27,11,10,1.37037,1,0,6,34,false,false,true,0.784,0.216
290,288,2,20.714286,20.571429,2,1094,1041,53,1,0,0.071429,0,0,14,14,0,0,0,17,7,false,false,true,0.725,0.275
288,387,-99,18,24.1875,-99,967,856,111,0,1,0,0.0625,-8,16,16,-4.125,0,1,5,2,false,false,false,0,1
119,193,-74,13.222222,21.444444,-74,683,859,-176,0,0,0,0,49,9,9,0.918367,1,0,15,13,false,false,false,0.088,0.912
186,262,-76,16.909091,26.2,-76,1407,1473,-66,0,2,0,0.2,20,11,10,1.55,0,0,9,19,false,false,false,0.003,0.997
294,339,-45,15.473684,18.833333,-45,758,791,-33,0,0,0,0,-24,19,18,-1.625,0,0,2,1,false,false,false,0.006,0.994
46,116,-70,23,58,-70,1331,1432,-101,0,0,0,0,76,2,2,0.355263,0,0,15,13,false,false,false,0.107,0.893
223,272,-49,17.153846,22.666667,-49,691,704,-13,0,1,0,0.083333,18,13,12,2.111111,0,0,7,14,false,false,false,0.027,0.973
107,106,1,21.4,26.5,1,1093,1173,-80,0,0,0,0,73,5,4,0.589041,0,0,10,7,false,false,false,0.163,0.837
167,212,-45,12.846154,17.666667,-45,651,700,-49,0,0,0,0,21,13,12,2.666667,1,0,9,15,false,false,false,0.098,0.902
336,399,-63,19.764706,24.9375,-63,991,1063,-72,0,1,0,0.0625,-11,17,16,-3.454545,0,0,3,8,false,false,false,0.02,0.98
261,289,-28,15.352941,18.0625,-28,1312,1334,-22,0,0,0,0,-11,17,16,-3.545455,0,0,5,6,false,false,false,0.1,0.9
270,326,-56,18,23.285714,-56,954,939,15,1,0,0.066667,0,-6,15,14,-6,0,1,9,11,false,false,false,0.005,0.995
216,217,-1,21.6,24.111111,-1,786,885,-99,1,1,0.1,0.111111,36,10,9,0.944444,0,0,10,26,false,false,true,0.517,0.483
145,166,-21,12.083333,15.090909,-21,814,830,-16,0,0,0,0,25,12,11,1.64,0,0,19,28,false,false,false,0.122,0.878
239,233,6,18.384615,19.416667,6,387,683,-296,0,0,0,0,3,13,12,11.333333,1,0,10,19,false,false,false,0.132,0.868
156,115,41,22.285714,16.428571,41,1652,1473,179,1,0,0.142857,0,44,7,7,0.681818,0,0,18,12,false,false,true,0.848,0.152
235,299,-64,16.785714,21.357143,-64,344,315,29,1,1,0.071429,0.071429,-7,14,14,-5.714286,0,0,19,10,false,false,false,0.104,0.896
131,218,-87,26.2,43.6,-87,1925,1885,40,1,1,0.2,0.2,52,5,5,0.480769,0,0,8,7,false,false,false,0.01,0.99
216,234,-18,16.615385,18,-18,561,688,-127,0,0,0,0,24,13,13,1.916667,0,0,16,13,false,false,false,0.399,0.601
181,146,35,30.166667,29.2,35,714,820,-106,1,0,0.166667,0,59,6,5,0.525424,0,0,13,14,false,false,true,0.731,0.269
191,233,-42,17.363636,21.181818,-42,1123,1062,61,0,0,0,0,27,11,11,1.62963,0,0,15,12,false,false,false,0.109,0.891
39,110,-71,19.5,55,-71,1925,1885,40,0,0,0,0,81,2,2,0.308642,0,0,13,18,false,false,false,0.027,0.973
227,464,-237,17.461538,35.692308,-237,1334,1486,-152,2,1,0.153846,0.076923,10,13,13,2.9,0,0,11,9,false,false,false,0.005,0.995
128,147,-19,11.636364,14.7,-19,999,1071,-72,0,0,0,0,32,11,10,1.25,1,0,15,21,false,false,false,0.115,0.885
81,33,48,27,16.5,48,991,1063,-72,0,0,0,0,85,3,2,0.447059,0,0,8,22,false,false,true,0.663,0.337
216,200,16,27,28.571429,16,1354,1210,144,0,1,0,0.142857,45,8,7,0.733333,0,0,10,9,false,false,false,0.183,0.817
170,201,-31,12.142857,15.461538,-31,814,830,-16,0,0,0,0,12,14,13,3.416667,0,1,19,25,false,false,false,0.087,0.913
54,70,-16,10.8,17.5,-16,1344,1314,30,0,1,0,0.25,70,5,4,0.485714,0,0,12,9,false,false,false,0.274,0.726
152,295,-143,13.818182,29.5,-143,940,947,-7,0,2,0,0.2,23,11,10,1.521739,1,0,18,17,false,false,false,0.001,0.999
204,197,7,34,32.833333,7,1699,1580,119,2,0,0.333333,0,49,6,6,0.612245,0,0,9,7,false,false,false,0.313,0.687
24,0,24,24,0,24,576,602,-26,0,0,0,0,97,1,0,0.43299,0,0,12,0,false,false,true,0.604,0.396
27,61,-34,9,20.333333,-34,1257,1176,81,0,0,0,0,87,3,3,0.390805,0,0,14,9,false,false,false,0.157,0.843
148,168,-20,18.5,21,-20,971,635,336,0,0,0,0,43,8,8,0.744186,0,0,22,12,false,false,true,0.541,0.459
167,167,0,18.555556,20.875,0,480,518,-38,0,0,0,0,37,9,8,1.081081,0,1,10,8,false,false,false,0.131,0.869
127,162,-35,15.875,20.25,-35,306,361,-55,0,0,0,0,40,8,8,0.9,0,2,10,7,false,false,false,0.001,0.999
81,68,13,16.2,13.6,13,651,700,-49,0,0,0,0,70,5,5,0.8,0,0,7,14,false,false,true,0.506,0.494
323,395,-72,35.888889,49.375,-72,2010,2219,-209,1,1,0.111111,0.125,19,9,8,1.368421,0,0,11,7,false,false,false,0.018,0.982
327,329,-2,17.210526,18.277778,-2,742,594,148,0,0,0,0,-20,19,18,-1.95,0,0,3,2,false,false,false,0.088,0.912
113,105,8,14.125,15,8,1030,998,32,0,0,0,0,45,8,7,0.822222,0,0,17,15,false,false,false,0.237,0.763
287,261,26,19.133333,18.642857,26,824,830,-6,1,0,0.066667,0,12,15,14,3.666667,0,0,10,20,false,false,true,0.586,0.414
66,63,3,22,21,3,599,448,151,0,0,0,0,78,3,3,0.461538,0,0,8,9,false,false,true,0.596,0.404
241,280,-39,24.1,31.111111,-39,1274,1394,-120,0,1,0,0.111111,21,10,9,1.428571,0,0,7,24,false,false,false,0.095,0.905
49,104,-55,16.333333,52,-55,1576,1556,20,0,1,0,0.5,81,3,2,0.37037,0,0,7,10,false,false,false,0.009,0.991
16,17,-1,8,8.5,-1,95,453,-358,0,0,0,0,93,2,2,0.419355,0,0,10,15,false,false,false,0.116,0.884
175,172,3,29.166667,28.666667,3,1305,1211,94,1,0,0.166667,0,60,6,6,0.55,1,0,8,11,false,false,true,0.853,0.147
356,363,-7,22.25,24.2,-7,1388,1366,22,0,1,0,0.066667,-11,16,15,-2.909091,0,0,1,3,false,false,false,0.07,0.93
69,108,-39,11.5,21.6,-39,1302,1351,-49,0,0,0,0,63,6,5,0.587302,1,0,14,11,false,false,false,0.237,0.763
32,51,-19,16,25.5,-19,360,371,-11,0,0,0,0,84,2,2,0.440476,0,0,14,7,false,false,false,0.293,0.707
228,279,-51,19,23.25,-51,1055,1019,36,0,0,0,0,7,12,12,4.714286,1,0,13,16,false,false,false,0.114,0.886
235,346,-111,15.666667,23.066667,-111,1195,1397,-202,0,2,0,0.133333,5,15,15,8,0,1,18,11,false,false,false,0.003,0.997
248,316,-68,15.5,19.75,-68,306,468,-162,1,0,0.0625,0,-2,16,16,-18.5,0,0,17,5,false,false,false,0.035,0.965
107,146,-39,17.833333,24.333333,-39,1127,995,132,0,1,0,0.166667,59,6,6,0.559322,0,1,18,10,false,false,false,0.013,0.987
243,213,30,15.1875,13.3125,30,671,638,33,0,0,0,0,3,16,16,16.333333,0,0,12,21,false,false,true,0.874,0.126
124,150,-26,17.714286,21.428571,-26,889,895,-6,0,1,0,0.142857,52,7,7,0.711538,0,1,8,8,false,false,false,0.138,0.862
276,289,-13,21.230769,24.083333,-13,1652,1473,179,1,1,0.076923,0.083333,7,13,12,4.285714,0,0,9,10,false,false,false,0.106,0.894
276,296,-20,18.4,21.142857,-20,758,904,-146,1,0,0.066667,0,-8,15,14,-4.25,0,1,11,12,false,false,false,0.001,0.999
267,298,-31,17.8,21.285714,-31,387,683,-296,0,0,0,0,-9,15,14,-3.777778,1,1,6,16,false,false,false,0,1
285,384,-99,15.833333,22.588235,-99,1003,1018,-15,0,0,0,0,-34,18,17,-1.088235,0,0,1,2,false,false,false,0.005,0.995
157,243,-86,19.625,30.375,-86,1636,1796,-160,0,0,0,0,38,8,8,0.710526,0,0,10,19,false,false,false,0.099,0.901
331,345,-14,18.388889,19.166667,-14,944,1095,-151,0,1,0,0.055556,-10,18,18,-3.9,0,0,2,3,false,false,false,0.073,0.927
54,70,-16,7.714286,11.666667,-16,288,359,-71,0,0,0,0,66,7,6,0.409091,0,0,23,10,false,false,false,0.134,0.866
75,128,-53,15,32,-53,1195,1397,-202,0,1,0,0.25,66,5,4,0.606061,0,0,11,13,false,false,false,0.106,0.894
210,279,-69,13.125,17.4375,-69,813,698,115,1,0,0.0625,0,10,16,16,4.8,0,0,15,11,false,false,false,0.033,0.967
89,79,10,14.833333,15.8,10,1161,1176,-15,0,0,0,0,64,6,5,0.59375,0,2,10,5,false,false,true,0.827,0.173
215,281,-66,14.333333,20.071429,-66,642,952,-310,0,0,0,0,10,15,14,4.4,0,0,14,11,false,false,false,0.005,0.995
298,272,26,33.111111,30.222222,26,820,718,102,0,2,0,0.222222,22,9,9,1.272727,0,0,10,11,false,false,false,0.375,0.625
42,44,-2,10.5,14.666667,-2,771,668,103,0,0,0,0,74,4,3,0.513514,1,0,11,10,false,false,true,0.516,0.484
189,333,-144,7.269231,13.32,-144,651,567,84,0,0,0,0,-23,26,25,-2.391304,0,0,4,13,false,false,false,0.001,0.999
117,97,20,19.5,19.4,20,1331,1374,-43,0,0,0,0,55,6,5,0.6,0,0,21,16,false,false,false,0.294,0.706
309,417,-108,17.166667,24.529412,-108,726,818,-92,0,1,0,0.058824,-16,18,17,-2.1875,0,0,5,2,true,false,false,0.005,0.995
95,55,40,19,13.75,40,306,468,-162,0,0,0,0,75,5,4,0.493333,1,0,10,15,false,false,true,0.585,0.415
146,160,-14,24.333333,32,-14,907,910,-3,0,1,0,0.2,63,6,5,0.68254,0,0,11,10,false,false,true,0.518,0.482
113,180,-67,16.142857,30,-67,473,683,-210,0,0,0,0,53,7,6,0.716981,0,0,10,15,false,false,false,0.025,0.975
125,208,-83,12.5,20.8,-83,388,542,-154,0,0,0,0,29,10,10,1.275862,0,0,13,18,false,false,false,0.006,0.994
330,340,-10,15.714286,17,-10,720,437,283,0,0,0,0,-20,21,20,-2.1,0,0,3,2,false,false,false,0.007,0.993
267,400,-133,14.833333,22.222222,-133,530,683,-153,0,1,0,0.055556,-5,18,18,-8,0,0,10,8,false,false,false,0.008,0.992
209,298,-89,17.416667,27.090909,-89,1315,1331,-16,0,0,0,0,19,12,11,1.736842,0,0,7,11,false,false,false,0.006,0.994
127,129,-2,10.583333,11.727273,-2,925,1000,-75,0,0,0,0,29,12,11,1.517241,0,0,16,19,false,false,false,0.112,0.888
109,144,-35,15.571429,24,-35,1030,1014,16,0,0,0,0,60,7,6,0.55,1,1,10,11,false,false,false,0.239,0.761
89,139,-50,17.8,34.75,-50,1315,1331,-16,0,0,0,0,66,5,4,0.5,2,0,13,15,false,false,true,0.632,0.368
292,251,41,22.461538,19.307692,41,1331,1374,-43,0,0,0,0,3,13,13,11,0,0,22,12,false,false,true,0.785,0.215
125,147,-22,12.5,14.7,-22,999,1071,-72,0,0,0,0,34,10,10,1.176471,1,0,15,21,false,false,false,0.132,0.868
125,118,7,15.625,14.75,7,1344,1314,30,0,1,0,0.125,46,8,8,0.73913,0,0,10,18,false,false,false,0.489,0.511
331,387,-56,18.388889,22.764706,-56,1047,1253,-206,1,1,0.055556,0.058824,-16,18,17,-2.3125,1,0,4,3,false,false,false,0.007,0.993
165,205,-40,15,20.5,-40,518,414,104,0,1,0,0.1,32,11,10,1.1875,0,1,9,10,false,false,false,0.004,0.996
253,364,-111,16.866667,24.266667,-111,935,995,-60,1,1,0.066667,0.066667,2,15,15,19.5,0,0,16,9,false,false,false,0.011,0.989
16,5,11,16,5,11,1003,1004,-1,0,0,0,0,93,1,1,0.376344,0,0,19,28,false,false,false,0.293,0.707
125,115,10,31.25,28.75,10,1237,1265,-28,1,0,0.25,0,61,4,4,0.590164,0,0,26,10,false,false,false,0.302,0.698
215,340,-125,15.357143,24.285714,-125,771,668,103,1,0,0.071429,0,-2,14,14,-19,0,0,7,20,false,false,false,0.005,0.995
116,170,-54,16.571429,24.285714,-54,1493,1453,40,0,0,0,0,52,7,7,0.673077,0,0,14,19,false,false,false,0.106,0.894
82,153,-71,13.666667,25.5,-71,342,263,79,0,0,0,0,54,6,6,0.62963,0,0,8,9,false,false,false,0.088,0.912
298,290,8,18.625,18.125,8,675,570,105,0,0,0,0,-18,16,16,-1.944444,0,0,19,2,false,false,true,0.781,0.219
75,117,-42,15,23.4,-42,527,954,-427,0,0,0,0,66,5,5,0.530303,0,1,19,10,false,false,false,0,1
323,401,-78,26.916667,36.454545,-78,2143,2219,-76,1,0,0.083333,0,8,12,11,3.875,0,0,7,7,false,false,false,0.005,0.995
268,280,-12,19.142857,20,-12,1270,1261,9,1,0,0.071429,0,18,14,14,2.055556,0,0,12,7,false,false,false,0.375,0.625
245,324,-79,27.222222,40.5,-79,1537,1539,-2,0,1,0,0.125,25,9,8,1.36,0,1,9,19,false,false,false,0,1
314,425,-111,19.625,28.333333,-111,999,1283,-284,0,2,0,0.133333,-12,16,15,-2.75,0,0,1,2,false,false,false,0.005,0.995
125,218,-93,25,43.6,-93,1633,1680,-47,0,1,0,0.2,49,5,5,0.571429,0,0,8,14,false,false,false,0.03,0.97
122,216,-94,17.428571,36,-94,1232,1281,-49,0,2,0,0.333333,41,7,6,0.756098,0,0,12,18,false,false,false,0.01,0.99
331,368,-37,20.6875,23,-37,1656,1580,76,1,1,0.0625,0.0625,-9,16,16,-3.666667,0,0,6,2,false,false,false,0.003,0.997
153,250,-97,11.769231,20.833333,-97,388,542,-154,0,0,0,0,14,13,12,2.642857,0,1,7,9,false,false,false,0,1
366,433,-67,26.142857,30.928571,-67,1388,1455,-67,0,0,0,0,-10,14,14,-2.8,0,0,3,3,true,false,false,0.006,0.994
37,27,10,12.333333,13.5,10,278,1,277,0,0,0,0,78,3,2,0.474359,0,0,14,12,false,false,true,0.538,0.462
237,282,-45,16.928571,20.142857,-45,1432,1452,-20,0,1,0,0.071429,6,14,14,6,1,0,8,22,false,false,false,0.095,0.905
20,20,0,10,20,0,1305,1307,-2,0,0,0,0,88,2,1,0.465909,0,1,7,9,false,false,false,0.247,0.753
79,111,-32,13.166667,22.2,-32,668,771,-103,0,0,0,0,61,6,5,0.655738,0,0,21,18,false,false,false,0.109,0.891
18,29,-11,18,29,-11,620,698,-78,0,0,0,0,92,1,1,0.445652,0,0,10,16,false,false,false,0.252,0.748
245,292,-47,15.3125,19.466667,-47,402,448,-46,0,0,0,0,-5,16,15,-7.4,0,1,17,15,false,false,false,0.006,0.994
30,51,-21,15,25.5,-21,995,965,30,0,0,0,0,85,2,2,0.470588,0,0,16,10,false,false,false,0.279,0.721
197,233,-36,15.153846,19.416667,-36,1312,1334,-22,0,0,0,0,11,13,12,3.545455,1,0,17,8,false,false,false,0.193,0.807
254,363,-109,19.538462,27.923077,-109,874,868,6,0,0,0,0,0,13,13,0,0,0,11,12,false,false,false,0.005,0.995
190,266,-76,15.833333,24.181818,-76,1094,1159,-65,0,0,0,0,15,12,11,2.533333,1,0,15,23,false,false,false,0.022,0.978
0,38,-38,0,38,-38,1038,917,121,0,0,0,0,95,1,1,0.368421,0,1,7,16,false,false,false,0.098,0.902
164,138,26,16.4,15.333333,26,1344,1314,30,0,1,0,0.111111,38,10,9,0.894737,0,0,10,22,false,false,true,0.558,0.442
45,24,21,22.5,24,21,985,1062,-77,0,0,0,0,91,2,1,0.406593,0,0,8,14,false,false,false,0.369,0.631
35,27,8,17.5,27,8,842,926,-84,0,0,0,0,86,2,1,0.348837,0,0,16,17,false,false,false,0.263,0.737
57,72,-15,19,24,-15,1003,1004,-1,0,0,0,0,81,3,3,0.432099,0,0,24,13,false,false,false,0.283,0.717
326,327,-1,25.076923,27.25,-1,169,306,-137,2,1,0.153846,0.083333,-6,13,12,-5.166667,0,0,6,12,false,false,false,0.006,0.994
212,264,-52,19.272727,26.4,-52,999,1283,-284,0,1,0,0.1,28,11,10,1.178571,0,0,10,7,false,false,false,0.042,0.958
264,275,-11,17.6,19.642857,-11,500,509,-9,0,0,0,0,7,15,14,5.857143,0,0,7,12,false,false,false,0.118,0.882
210,167,43,30,23.857143,43,1397,1405,-8,1,0,0.142857,0,43,7,7,0.674419,0,0,13,12,false,false,true,0.798,0.202
57,68,-11,14.25,17,-11,568,570,-2,0,0,0,0,74,4,4,0.5,0,0,8,24,false,false,false,0.18,0.82
281,379,-98,15.611111,21.055556,-98,952,826,126,0,1,0,0.055556,-6,18,18,-7.166667,0,0,12,6,false,false,false,0.007,0.993
258,283,-25,23.454545,28.3,-25,1331,1347,-16,1,1,0.090909,0.1,10,11,10,3.2,0,0,7,7,false,false,false,0.273,0.727
186,273,-87,16.909091,24.818182,-87,721,757,-36,0,2,0,0.181818,25,11,11,1.52,0,0,13,14,false,false,false,0.03,0.97
112,141,-29,14,17.625,-29,360,371,-11,0,0,0,0,41,8,8,0.902439,0,0,19,17,false,false,false,0.386,0.614
310,330,-20,17.222222,19.411765,-20,824,830,-6,1,0,0.055556,0,-3,18,17,-14.666667,0,0,9,12,false,false,false,0.037,0.963
0,0,0,0,0,0,935,995,-60,0,0,0,0,100,1,0,0.39,1,0,14,0,false,false,false,0.352,0.648
74,122,-48,12.333333,24.4,-48,653,1004,-351,0,0,0,0,60,6,5,0.483333,1,1,12,8,false,false,false,0.001,0.999
184,201,-17,16.727273,18.272727,-17,1176,1211,-35,0,0,0,0,17,11,11,1.941176,1,0,8,15,false,false,false,0.222,0.778
139,191,-52,19.857143,27.285714,-52,1167,1245,-78,0,0,0,0,34,7,7,0.676471,0,0,10,13,false,false,false,0.108,0.892
118,210,-92,9.076923,17.5,-92,1078,983,95,0,0,0,0,30,13,12,1.6,1,1,7,17,false,false,false,0.002,0.998
25,4,21,12.5,2,21,913,1037,-124,0,0,0,0,92,2,2,0.445652,0,0,25,12,false,false,true,0.55,0.45
222,133,89,27.75,19,89,1563,1539,24,0,0,0,0,40,8,7,0.875,0,2,17,7,false,false,true,0.874,0.126
316,356,-40,21.066667,25.428571,-40,1030,1014,16,0,1,0,0.071429,1,15,14,33,0,0,6,7,false,false,false,0.031,0.969
217,321,-104,15.5,22.928571,-104,503,668,-165,0,1,0,0.071429,5,14,14,7.4,2,0,6,12,false,false,false,0.006,0.994
235,298,-63,19.583333,27.090909,-63,653,1004,-351,0,0,0,0,9,12,11,3.222222,0,0,16,12,false,false,false,0.006,0.994
89,128,-39,14.833333,21.333333,-39,668,363,305,0,0,0,0,63,6,6,0.746032,0,0,8,12,false,false,false,0.247,0.753
170,241,-71,13.076923,18.538462,-71,951,976,-25,0,0,0,0,23,13,13,1.913043,0,0,10,10,false,false,false,0.013,0.987
14,23,-9,7,11.5,-9,1344,1208,136,0,0,0,0,88,2,2,0.340909,0,0,14,21,false,false,false,0.237,0.763
189,205,-16,17.181818,20.5,-16,500,509,-9,0,0,0,0,27,11,10,1.518519,0,0,17,11,false,false,false,0.438,0.562
262,318,-56,21.833333,26.5,-56,1454,1479,-25,1,0,0.083333,0,9,12,12,3.444444,0,0,21,19,false,false,false,0.007,0.993
235,319,-84,16.785714,22.785714,-84,1071,1181,-110,0,0,0,0,10,14,14,3.4,0,1,20,12,false,false,false,0.005,0.995
220,316,-96,12.941176,18.588235,-96,907,878,29,0,0,0,0,7,17,17,6.142857,2,0,6,18,false,false,false,0.013,0.987
171,238,-67,12.214286,18.307692,-67,613,525,88,0,0,0,0,19,14,13,2.210526,0,1,13,6,false,false,false,0.005,0.995
25,103,-78,8.333333,34.333333,-78,1454,1479,-25,0,0,0,0,74,3,3,0.418919,1,0,14,10,false,false,false,0.144,0.856
223,198,25,17.153846,16.5,25,1203,1270,-67,0,0,0,0,31,13,12,1.419355,1,0,6,24,false,false,false,0.281,0.719
249,248,1,19.153846,20.666667,1,758,904,-146,1,0,0.076923,0,4,13,12,8.5,0,1,8,9,false,false,false,0.018,0.982
192,233,-41,12,14.5625,-41,391,542,-151,1,0,0.0625,0,0,16,16,0,0,0,16,22,false,false,false,0.036,0.964
118,252,-134,11.8,25.2,-134,1305,1307,-2,0,1,0,0.1,28,10,10,1.464286,0,0,12,24,false,false,false,0.005,0.995
95,124,-29,13.571429,20.666667,-29,1302,1351,-49,0,0,0,0,56,7,6,0.660714,1,0,8,8,false,false,false,0.245,0.755
207,288,-81,14.785714,20.571429,-81,837,844,-7,0,0,0,0,17,14,14,2.411765,1,0,10,16,false,false,false,0.006,0.994
253,234,19,19.461538,19.5,19,664,786,-122,0,0,0,0,13,13,12,2.538462,1,0,11,7,false,false,true,0.597,0.403
41,80,-39,13.666667,26.666667,-39,615,542,73,0,0,0,0,81,3,3,0.518519,0,0,17,16,false,false,false,0.233,0.767
56,42,14,18.666667,14,14,725,668,57,0,0,0,0,81,3,3,0.432099,0,0,11,25,false,false,true,0.538,0.462
152,261,-109,15.2,26.1,-109,1047,1253,-206,1,1,0.1,0.1,34,10,10,1.088235,0,0,16,10,false,false,false,0.005,0.995
25,20,5,12.5,20,5,651,996,-345,0,0,0,0,92,2,1,0.48913,0,0,9,12,false,false,false,0.151,0.849
178,103,75,35.6,25.75,75,691,695,-4,1,0,0.2,0,65,5,4,0.492308,0,0,8,18,false,false,true,0.743,0.257
192,221,-29,19.2,22.1,-29,1161,1030,131,0,1,0,0.1,29,10,10,1.310345,0,0,23,13,false,false,true,0.643,0.357
14,0,14,14,0,14,542,605,-63,0,0,0,0,95,1,0,0.378947,1,0,13,0,false,false,true,0.545,0.455
323,322,1,17.944444,17.888889,1,1488,1428,60,1,0,0.055556,0,-13,18,18,-2.846154,0,1,29,4,false,false,false,0.49,0.51
12,0,12,12,0,12,1123,1062,61,0,0,0,0,97,1,0,0.453608,0,0,9,0,false,false,false,0.463,0.537
66,33,33,22,16.5,33,675,570,105,0,0,0,0,80,3,2,0.4375,0,0,14,21,false,false,true,0.682,0.318
146,170,-24,14.6,17,-24,995,965,30,0,0,0,0,32,10,10,1.25,0,0,25,12,false,false,false,0.234,0.766
237,391,-154,19.75,35.545455,-154,1636,1727,-91,0,2,0,0.181818,9,12,11,3.333333,1,0,9,23,false,false,false,0.002,0.998
204,240,-36,17,21.818182,-36,344,315,29,1,0,0.083333,0,10,12,11,4,0,0,19,18,false,false,false,0.1,0.9
111,132,-21,18.5,26.4,-21,1803,1658,145,0,0,0,0,57,6,5,0.578947,2,0,9,7,false,false,true,0.693,0.307
174,226,-52,24.857143,32.285714,-52,1331,1432,-101,0,0,0,0,36,7,7,0.75,0,0,20,13,false,false,false,0.121,0.879
321,367,-46,17.833333,20.388889,-46,1063,1134,-71,1,0,0.055556,0,-2,18,18,-22,0,0,8,5,false,false,false,0.036,0.964
105,130,-25,21,32.5,-25,1021,897,124,0,1,0,0.25,64,5,4,0.578125,1,0,7,11,false,false,false,0.373,0.627
241,358,-117,15.0625,22.375,-117,503,668,-165,0,1,0,0.0625,-5,16,16,-7.4,1,0,8,6,false,false,false,0.005,0.995
86,100,-14,14.333333,20,-14,952,826,126,0,0,0,0,70,6,5,0.614286,0,0,9,10,false,false,false,0.119,0.881
279,412,-133,17.4375,25.75,-133,1229,1220,9,0,1,0,0.0625,-4,16,16,-9.25,0,0,6,3,false,false,false,0.001,0.999
226,262,-36,14.125,16.375,-36,526,502,24,0,0,0,0,3,16,16,16.666667,0,0,11,21,false,false,false,0.039,0.961
235,323,-88,13.823529,19,-88,714,892,-178,0,2,0,0.117647,-5,17,17,-8.4,0,0,12,8,false,false,false,0.035,0.965
233,306,-73,15.533333,20.4,-73,952,826,126,0,1,0,0.066667,10,15,15,4.3,0,0,13,14,false,false,false,0.005,0.995
285,307,-22,13.571429,15.35,-22,999,1165,-166,0,0,0,0,-14,21,20,-3.285714,1,1,17,7,false,false,false,0.03,0.97
155,85,70,38.75,28.333333,70,824,830,-6,1,0,0.25,0,71,4,3,0.619718,0,0,9,17,false,false,true,0.745,0.255
199,334,-135,15.307692,25.692308,-135,965,1078,-113,0,1,0,0.076923,12,13,13,3.083333,1,0,7,23,false,false,false,0.005,0.995
134,154,-20,14.888889,19.25,-20,341,416,-75,0,0,0,0,52,9,8,0.75,0,0,11,12,false,false,false,0.177,0.823
108,61,47,36,20.333333,47,724,398,326,1,0,0.333333,0,77,3,3,0.506494,0,0,16,21,false,false,true,0.738,0.262
212,249,-37,19.272727,22.636364,-37,1078,1095,-17,1,1,0.090909,0.090909,24,11,11,1.541667,0,0,10,13,false,false,false,0.195,0.805
26,18,8,13,18,8,632,603,29,0,0,0,0,86,2,1,0.44186,1,0,6,14,false,false,true,0.518,0.482
156,106,50,26,21.2,50,786,885,-99,1,0,0.166667,0,63,6,5,0.539683,0,1,7,11,false,false,false,0.002,0.998
232,232,0,23.2,25.777778,0,1606,1890,-284,0,0,0,0,25,10,9,1.12,1,0,10,8,false,false,false,0.369,0.631
320,423,-103,11.034483,14.586207,-103,1037,1016,21,1,0,0.034483,0,-31,29,29,-1.870968,1,0,0,5,true,false,false,0.007,0.993
141,160,-19,15.666667,17.777778,-19,306,468,-162,0,0,0,0,51,9,9,0.72549,0,0,17,10,false,false,false,0.434,0.566
14,0,14,14,0,14,1000,960,40,0,0,0,0,96,1,0,0.46875,0,0,9,0,false,false,false,0.495,0.505
182,293,-111,12.133333,20.928571,-111,1305,1307,-2,0,1,0,0.071429,6,15,14,6.833333,0,1,8,10,false,false,false,0,1
83,114,-31,13.833333,22.8,-31,1094,1159,-65,0,0,0,0,59,6,5,0.644068,0,0,23,15,false,false,false,0.109,0.891
312,340,-28,28.363636,34,-28,1431,1399,32,0,2,0,0.2,2,11,10,12.5,0,0,21,14,false,false,false,0.111,0.889
281,331,-50,16.529412,19.470588,-50,1281,1268,13,0,0,0,0,-1,17,17,-42,1,0,4,5,false,false,false,0.037,0.963
356,363,-7,22.25,22.6875,-7,1388,1366,22,0,1,0,0.0625,-11,16,16,-2.909091,0,0,1,3,true,false,false,0.229,0.771
42,86,-44,10.5,21.5,-44,1210,1162,48,0,0,0,0,72,4,4,0.444444,0,0,10,11,false,false,false,0.108,0.892
95,30,65,23.75,10,65,742,594,148,0,0,0,0,73,4,3,0.534247,0,0,20,11,false,false,true,0.894,0.106
229,238,-9,12.722222,14,-9,342,53,289,0,0,0,0,-19,18,17,-2.157895,0,0,4,9,false,false,false,0.069,0.931
281,444,-163,21.615385,34.153846,-163,1633,1680,-47,0,2,0,0.153846,-9,13,13,-3.111111,1,0,5,10,false,false,false,0.001,0.999
44,101,-57,14.666667,33.666667,-57,944,1095,-151,0,1,0,0.333333,79,3,3,0.493671,0,0,13,19,false,false,false,0.108,0.892
266,434,-168,20.461538,33.384615,-168,1636,1796,-160,0,1,0,0.076923,-8,13,13,-3.375,0,1,6,6,false,false,false,0,1
51,45,6,12.75,15,6,1269,1477,-208,0,0,0,0,79,4,3,0.443038,0,0,7,13,false,false,false,0.236,0.764
114,102,12,16.285714,17,12,1344,1314,30,0,1,0,0.166667,57,7,6,0.596491,0,0,10,9,false,false,false,0.435,0.565
286,330,-44,19.066667,22,-44,480,739,-259,1,0,0.066667,0,3,15,15,13,0,0,8,17,false,false,false,0.029,0.971
114,132,-18,12.666667,14.666667,-18,163,346,-183,0,0,0,0,38,9,9,1.026316,0,1,16,15,false,false,false,0.009,0.991
251,206,45,22.818182,18.727273,45,1652,1473,179,1,0,0.090909,0,21,11,11,1.428571,0,1,9,8,false,false,false,0.444,0.556
148,206,-58,18.5,29.428571,-58,954,939,15,0,0,0,0,44,8,7,0.818182,1,1,10,11,false,false,false,0.103,0.897
141,256,-115,15.666667,28.444444,-115,710,758,-48,0,1,0,0.111111,42,9,9,0.880952,0,0,9,15,false,false,false,0.005,0.995
32,17,15,16,17,15,1606,1593,13,0,0,0,0,89,2,1,0.325843,0,0,27,14,false,false,true,0.506,0.494
152,317,-165,13.818182,28.818182,-165,940,947,-7,0,2,0,0.181818,21,11,11,1.666667,1,0,18,14,false,false,false,0.001,0.999
194,256,-62,12.933333,18.285714,-62,1248,1220,28,0,1,0,0.071429,20,15,14,2.6,1,0,9,14,false,false,false,0.022,0.978
66,45,21,22,15,21,675,570,105,0,0,0,0,76,3,3,0.460526,0,0,14,30,false,false,true,0.722,0.278
80,20,60,80,20,60,1373,1334,39,1,0,1,0,88,1,1,0.363636,0,0,18,10,false,false,true,0.67,0.33
125,149,-24,17.857143,21.285714,-24,1803,1658,145,0,0,0,0,46,7,7,0.717391,2,0,8,11,false,false,true,0.777,0.223
135,194,-59,16.875,24.25,-59,451,448,3,0,0,0,0,46,8,8,0.804348,0,0,12,14,false,false,false,0.055,0.945
370,394,-24,19.473684,21.888889,-24,1093,1173,-80,1,1,0.052632,0.055556,-18,19,18,-2.388889,0,0,3,5,false,false,false,0.051,0.949
83,88,-5,16.6,17.6,-5,952,870,82,0,0,0,0,64,5,5,0.578125,0,0,9,29,false,false,false,0.229,0.771
334,362,-28,20.875,22.625,-28,1331,1347,-16,1,1,0.0625,0.0625,-25,16,16,-1.28,0,0,2,1,true,false,false,0.029,0.971
184,179,5,26.285714,25.571429,5,1101,1237,-136,1,0,0.142857,0,43,7,7,0.790698,0,0,22,15,false,false,true,0.642,0.358
110,113,-3,15.714286,18.833333,-3,1159,1131,28,0,1,0,0.166667,57,7,6,0.649123,0,1,8,7,false,false,false,0.176,0.824
253,528,-275,18.071429,37.714286,-275,1334,1486,-152,3,1,0.214286,0.071429,-5,14,14,-5.8,0,0,7,9,false,false,false,0,1
328,391,-63,21.866667,26.066667,-63,1101,1115,-14,1,1,0.066667,0.066667,-12,15,15,-2.5,1,0,8,5,true,false,false,0.018,0.982
288,423,-135,12,17.625,-135,1037,1016,21,1,0,0.041667,0,-18,24,24,-3.222222,1,0,7,5,false,false,false,0.005,0.995
65,68,-3,13,13.6,-3,226,361,-135,0,0,0,0,62,5,5,0.709677,0,0,16,14,false,false,false,0.4,0.6
25,104,-79,12.5,52,-79,1576,1556,20,0,1,0,0.5,85,2,2,0.352941,0,0,13,10,false,false,false,0.012,0.988
222,206,16,31.714286,29.428571,16,1167,1245,-78,1,0,0.142857,0,40,7,7,0.7,1,0,7,10,false,false,true,0.825,0.175
201,221,-20,15.461538,18.416667,-20,430,542,-112,0,1,0,0.083333,18,13,12,2.666667,0,0,36,10,false,false,true,0.567,0.433
180,239,-59,16.363636,23.9,-59,1159,1131,28,0,2,0,0.2,28,11,10,1.321429,0,0,9,19,false,false,false,0.005,0.995
12,0,12,12,0,12,542,390,152,0,0,0,0,97,1,0,0.515464,0,0,10,0,false,false,true,0.528,0.472
175,286,-111,14.583333,23.833333,-111,595,412,183,0,1,0,0.083333,21,12,12,2.47619,0,0,13,12,false,false,false,0.001,0.999
153,249,-96,9.5625,15.5625,-96,818,826,-8,0,0,0,0,15,16,16,3.533333,0,0,7,24,false,false,false,0.005,0.995
163,212,-49,20.375,26.5,-49,503,527,-24,0,1,0,0.125,34,8,8,0.970588,0,0,7,11,false,false,false,0.346,0.654
87,79,8,21.75,26.333333,8,1161,1030,131,0,0,0,0,73,4,3,0.520548,0,0,10,7,false,false,false,0.479,0.521
182,145,37,20.222222,18.125,37,1078,1095,-17,1,0,0.111111,0,44,9,8,0.840909,0,1,17,9,false,false,true,0.593,0.407
280,332,-52,12.727273,15.090909,-52,1040,1091,-51,0,0,0,0,-30,22,22,-1.566667,0,0,6,1,false,false,false,0.01,0.99
274,325,-51,22.833333,27.083333,-51,1176,1133,43,1,0,0.083333,0,23,12,12,1.478261,0,0,7,10,false,false,false,0.017,0.983
286,411,-125,35.75,51.375,-125,1398,1431,-33,0,0,0,0,17,8,8,1.647059,0,1,14,11,false,false,false,0,1
299,386,-87,18.6875,25.733333,-87,1269,1477,-208,1,0,0.0625,0,-3,16,15,-11.666667,0,0,5,5,false,false,false,0.005,0.995
318,390,-72,17.666667,21.666667,-72,480,739,-259,1,0,0.055556,0,-12,18,18,-3.25,0,0,3,1,false,false,false,0.028,0.972
223,311,-88,11.736842,17.277778,-88,595,662,-67,0,1,0,0.055556,-15,19,18,-2.933333,0,0,5,11,false,false,false,0.007,0.993
302,349,-47,23.230769,26.846154,-47,1495,1597,-102,0,1,0,0.076923,5,13,13,6.4,0,1,10,9,false,false,false,0.003,0.997
267,316,-49,22.25,26.333333,-49,1021,897,124,0,2,0,0.166667,8,12,12,4.625,0,0,12,12,false,false,false,0.008,0.992
291,302,-11,13.227273,14.380952,-11,796,800,-4,1,0,0.045455,0,-12,22,21,-4,0,1,12,6,false,false,false,0.042,0.958
189,333,-144,7,12.807692,-144,651,567,84,0,0,0,0,-23,27,26,-2.391304,0,0,4,13,false,false,false,0.001,0.999
46,25,21,15.333333,12.5,21,758,904,-146,0,0,0,0,81,3,2,0.419753,1,0,9,14,false,false,false,0.475,0.525
280,268,12,20,19.142857,12,742,594,148,0,0,0,0,8,14,14,4.875,1,0,7,7,false,false,true,0.959,0.041
239,220,19,18.384615,18.333333,19,1281,1268,13,0,0,0,0,23,13,12,1.826087,0,0,8,11,false,false,false,0.358,0.642
250,241,9,17.857143,18.538462,9,1000,960,40,0,0,0,0,13,14,13,3.461538,0,0,7,8,false,false,false,0.418,0.582
150,207,-57,18.75,25.875,-57,1232,1448,-216,0,1,0,0.125,40,8,8,0.875,0,1,10,15,false,false,false,0.105,0.895
299,343,-44,23,26.384615,-44,1071,1065,6,0,0,0,0,-2,13,13,-15.5,0,0,10,10,false,false,false,0.02,0.98
94,137,-43,13.428571,19.571429,-43,913,1037,-124,0,1,0,0.142857,65,7,7,0.630769,0,0,26,7,false,false,false,0.15,0.85
125,140,-15,17.857143,23.333333,-15,1094,1159,-65,0,0,0,0,51,7,6,0.745098,0,0,18,21,false,false,false,0.112,0.888
280,363,-83,14,18.15,-83,837,844,-7,0,0,0,0,-18,20,20,-2.277778,0,0,2,1,false,false,false,0.006,0.994
8,26,-18,8,26,-18,563,523,40,0,0,0,0,92,1,1,0.402174,0,0,12,12,false,false,false,0.277,0.723
298,292,6,21.285714,20.857143,6,939,969,-30,0,0,0,0,-7,14,14,-4.714286,0,0,4,9,false,false,true,0.937,0.063
33,113,-80,8.25,28.25,-80,940,947,-7,0,1,0,0.25,69,4,4,0.507246,0,1,11,8,false,false,false,0.101,0.899
271,282,-11,15.055556,15.666667,-11,361,413,-52,0,0,0,0,-22,18,18,-1.863636,0,0,8,4,false,false,false,0.167,0.833
145,97,48,20.714286,13.857143,48,771,668,103,0,0,0,0,43,7,7,0.883721,0,0,12,11,false,false,true,0.893,0.107
268,344,-76,11.166667,14.956522,-76,813,698,115,1,0,0.041667,0,-27,24,23,-1.777778,0,0,1,4,false,false,false,0.027,0.973
91,88,3,15.166667,14.666667,3,1312,1334,-22,0,0,0,0,58,6,6,0.672414,0,1,17,19,false,false,false,0.217,0.783
127,118,9,21.166667,23.6,9,1055,840,215,0,0,0,0,59,6,5,0.610169,0,0,7,9,false,false,false,0.335,0.665
8,0,8,8,0,8,540,498,42,0,0,0,0,97,1,0,0.474227,0,0,17,0,false,false,true,0.523,0.477
209,303,-94,17.416667,25.25,-94,1407,1473,-66,0,2,0,0.166667,11,12,12,2.818182,0,0,7,17,false,false,false,0,1
136,139,-3,15.111111,15.444444,-3,361,413,-52,0,0,0,0,42,9,9,0.97619,1,0,10,8,false,false,true,0.548,0.452
287,365,-78,13.666667,18.25,-78,1101,1130,-29,1,1,0.047619,0.05,-17,21,20,-2.647059,0,1,3,2,false,false,false,0,1
186,244,-58,16.909091,22.181818,-58,758,791,-33,0,0,0,0,22,11,11,1.772727,0,0,7,23,false,false,false,0.017,0.983
11,36,-25,5.5,18,-25,1636,1702,-66,0,0,0,0,89,2,2,0.325843,0,1,19,11,false,false,false,0.249,0.751
268,315,-47,17.866667,22.5,-47,727,820,-93,0,1,0,0.071429,-2,15,14,-17.5,0,1,13,9,false,false,false,0.006,0.994
145,123,22,20.714286,20.5,22,1488,1428,60,1,0,0.142857,0,53,7,6,0.698113,0,0,22,18,false,false,false,0.339,0.661
132,130,2,18.857143,21.666667,2,1305,1254,51,0,0,0,0,49,7,6,0.653061,0,0,11,12,false,false,false,0.182,0.818
313,306,7,16.473684,17,7,540,498,42,1,0,0.052632,0,-23,19,18,-2,0,0,7,14,false,false,true,0.586,0.414
138,134,4,19.714286,19.142857,4,615,542,73,0,0,0,0,56,7,7,0.75,0,0,7,11,false,false,true,0.705,0.295
281,328,-47,20.071429,23.428571,-47,621,786,-165,0,0,0,0,-14,14,14,-2.142857,0,0,1,2,false,false,false,0.008,0.992
192,271,-79,19.2,27.1,-79,1127,995,132,0,1,0,0.1,30,10,10,1.1,0,0,9,12,false,false,false,0.001,0.999
135,147,-12,19.285714,24.5,-12,1055,840,215,0,0,0,0,51,7,6,0.705882,0,0,9,12,false,false,false,0.241,0.759
242,247,-5,18.615385,19,-5,500,509,-9,0,0,0,0,16,13,13,2.5625,0,0,7,16,false,false,false,0.473,0.527
262,212,50,18.714286,16.307692,50,1344,1314,30,0,1,0,0.076923,11,14,13,3.090909,0,2,10,6,false,false,false,0.337,0.663
216,219,-3,18,18.25,-3,561,688,-127,0,0,0,0,28,12,12,1.642857,0,0,16,11,false,false,false,0.479,0.521
126,114,12,14,14.25,12,814,830,-16,0,0,0,0,46,9,8,0.891304,0,0,20,19,false,false,false,0.399,0.601
26,42,-16,8.666667,14,-16,917,856,61,0,0,0,0,79,3,3,0.417722,0,1,13,15,false,false,false,0.232,0.768
24,12,12,24,12,12,621,786,-165,0,0,0,0,91,1,1,0.32967,0,0,21,11,false,false,true,0.61,0.39
278,328,-50,19.857143,25.230769,-50,1110,1399,-289,0,1,0,0.076923,17,14,13,2,0,0,8,16,false,false,false,0.008,0.992
82,104,-22,11.714286,17.333333,-22,391,542,-151,1,0,0.142857,0,54,7,6,0.851852,0,0,10,8,false,false,false,0.108,0.892
180,233,-53,15,19.416667,-53,907,910,-3,0,1,0,0.083333,39,12,12,1.102564,0,1,12,17,false,false,false,0.007,0.993
237,239,-2,18.230769,19.916667,-2,206,346,-140,1,0,0.076923,0,12,13,12,3.583333,0,0,17,10,false,false,false,0.176,0.824
242,291,-49,16.133333,19.4,-49,360,371,-11,0,0,0,0,-13,15,15,-2.846154,0,0,9,6,false,false,false,0.018,0.982
103,101,2,20.6,20.2,2,1043,1003,40,0,0,0,0,64,5,5,0.59375,0,0,22,13,false,false,false,0.378,0.622
75,160,-85,15,32,-85,1195,1397,-202,0,1,0,0.2,63,5,5,0.634921,0,0,11,9,false,false,false,0.106,0.894
24,7,17,12,3.5,17,1315,1334,-19,0,0,0,0,87,2,2,0.413793,0,0,10,17,false,false,false,0.419,0.581
188,194,-6,12.533333,13.857143,-6,342,53,289,0,0,0,0,2,15,14,20.5,0,0,10,21,false,false,true,0.639,0.361
172,261,-89,17.2,26.1,-89,926,973,-47,0,0,0,0,24,10,10,1.458333,0,0,7,17,false,false,false,0.006,0.994
39,120,-81,13,60,-81,1220,1202,18,0,0,0,0,80,3,2,0.625,0,0,16,10,false,false,false,0.057,0.943
249,159,90,31.125,19.875,90,1156,1279,-123,2,0,0.25,0,40,8,8,1,0,1,13,18,false,false,false,0.459,0.541
174,163,11,17.4,18.111111,11,1203,1270,-67,0,0,0,0,45,10,9,0.977778,1,0,9,11,false,false,false,0.256,0.744
45,75,-30,9,15,-30,342,53,289,0,0,0,0,67,5,5,0.61194,0,0,11,19,false,false,false,0.322,0.678
57,73,-16,19,36.5,-16,620,698,-78,0,0,0,0,83,3,2,0.493976,1,0,17,13,false,false,false,0.316,0.684
119,119,0,23.8,29.75,0,1397,1309,88,1,0,0.2,0,70,5,4,0.514286,0,1,7,17,false,false,false,0.184,0.816
111,202,-91,13.875,25.25,-91,342,263,79,0,0,0,0,40,8,8,0.85,0,0,11,16,false,false,false,0.006,0.994
308,392,-84,23.692308,32.666667,-84,1537,1539,-2,0,1,0,0.083333,4,13,12,8.5,0,1,7,9,false,false,false,0,1
57,149,-92,28.5,74.5,-92,1556,1656,-100,0,1,0,0.5,77,2,2,0.38961,0,0,8,12,false,false,false,0.007,0.993
35,38,-3,11.666667,12.666667,-3,1452,1388,64,0,0,0,0,81,3,3,0.432099,0,0,10,18,false,false,false,0.25,0.75
215,291,-76,15.357143,22.384615,-76,341,416,-75,0,0,0,0,10,14,13,3.9,0,0,10,12,false,false,false,0.006,0.994
16,0,16,16,0,16,742,868,-126,0,0,0,0,96,1,0,0.34375,0,0,19,0,false,false,true,0.514,0.486
273,260,13,18.2,18.571429,13,206,346,-140,1,0,0.066667,0,-1,15,14,-43,0,0,31,13,false,false,false,0.225,0.775
298,314,-16,17.529412,19.625,-16,1245,1148,97,0,0,0,0,-17,17,16,-2.058824,0,0,10,2,false,false,false,0.123,0.877
121,80,41,20.166667,16,41,1633,1556,77,0,0,0,0,60,6,5,0.55,0,0,18,7,false,false,true,0.528,0.472
165,170,-5,18.333333,18.888889,-5,742,868,-126,0,0,0,0,39,9,9,0.846154,0,1,14,13,false,false,false,0.113,0.887
135,222,-87,16.875,31.714286,-87,653,1004,-351,0,0,0,0,41,8,7,0.707317,0,0,9,16,false,false,false,0.006,0.994
180,127,53,22.5,18.142857,53,1691,1510,181,0,0,0,0,48,8,7,0.625,0,0,16,18,false,false,true,0.819,0.181
138,235,-97,11.5,19.583333,-97,907,878,29,0,0,0,0,40,12,12,1.075,1,0,12,11,false,false,false,0.007,0.993
54,61,-7,18,30.5,-7,1699,1803,-104,0,0,0,0,83,3,2,0.421687,0,1,9,7,false,false,false,0.245,0.755
187,224,-37,13.357143,16,-37,808,749,59,0,0,0,0,4,14,14,10.5,0,0,7,11,false,false,false,0.108,0.892
24,0,24,24,0,24,1188,1334,-146,0,0,0,0,97,1,0,0.309278,0,0,10,0,false,false,false,0.384,0.616
112,141,-29,14,17.625,-29,907,1070,-163,0,0,0,0,46,8,8,0.76087,0,0,17,19,false,false,false,0.106,0.894
145,222,-77,13.181818,20.181818,-77,1071,1000,71,0,0,0,0,35,11,11,1.342857,0,1,16,10,false,false,false,0.019,0.981
180,160,20,20,20,20,985,1062,-77,0,0,0,0,38,9,8,0.973684,0,0,7,9,false,false,false,0.23,0.77
325,418,-93,20.3125,27.866667,-93,1334,1439,-105,1,1,0.0625,0.066667,4,16,15,9,0,0,8,10,false,false,false,0.008,0.992
372,397,-25,18.6,20.894737,-25,1093,1173,-80,1,1,0.05,0.052632,-23,20,19,-1.869565,0,0,2,4,false,false,false,0.071,0.929
284,332,-48,16.705882,20.75,-48,568,570,-2,0,0,0,0,-6,17,16,-6.166667,0,0,3,4,false,false,false,0.014,0.986
111,70,41,18.5,11.666667,41,675,570,105,0,0,0,0,58,6,6,0.603448,0,0,14,31,false,false,true,0.737,0.263
82,113,-31,10.25,16.142857,-31,999,1165,-166,0,0,0,0,56,8,7,0.821429,0,0,20,7,false,false,false,0.116,0.884
103,201,-98,9.363636,20.1,-98,1078,983,95,0,0,0,0,43,11,10,1.116279,1,1,7,15,false,false,false,0.005,0.995
117,168,-51,16.714286,24,-51,915,971,-56,0,0,0,0,50,7,7,0.66,0,0,7,29,false,false,false,0.105,0.895
28,27,1,14,13.5,1,830,787,43,0,0,0,0,85,2,2,0.447059,0,0,22,21,false,false,false,0.296,0.704
291,304,-13,12.652174,13.217391,-13,797,796,1,0,0,0,0,-24,23,23,-2.041667,0,0,5,4,false,false,false,0.256,0.744
340,343,-3,20,21.4375,-3,1428,1361,67,0,0,0,0,-14,17,16,-2.357143,1,0,1,1,true,false,true,0.559,0.441
230,251,-21,16.428571,19.307692,-21,1312,1334,-22,0,0,0,0,3,14,13,13,0,0,14,7,false,false,false,0.107,0.893
125,110,15,12.5,12.222222,15,542,390,152,0,0,0,0,54,10,9,0.925926,0,0,8,28,false,false,false,0.469,0.531
281,283,-2,25.545455,25.727273,-2,1563,1539,24,0,1,0,0.090909,13,11,11,2.692308,0,0,7,10,false,false,false,0.453,0.547
304,451,-147,21.714286,34.692308,-147,1556,1656,-100,0,2,0,0.153846,-10,14,13,-3,0,0,2,4,false,false,false,0,1
6,86,-80,6,86,-80,1220,1202,18,0,0,0,0,87,1,1,0.574713,0,0,19,13,false,false,false,0.001,0.999
222,230,-8,17.076923,19.166667,-8,615,542,73,0,0,0,0,22,13,12,1.909091,0,0,10,9,false,false,false,0.444,0.556
347,436,-89,20.411765,27.25,-89,1537,1539,-2,0,1,0,0.0625,-24,17,16,-1.416667,0,1,1,1,false,false,false,0,1
309,325,-16,15.45,17.105263,-16,1000,960,40,0,0,0,0,-22,20,19,-2.045455,0,0,5,3,false,false,false,0.069,0.931
122,132,-10,12.2,14.666667,-10,163,346,-183,0,0,0,0,34,10,9,1.147059,0,1,17,15,false,false,false,0.028,0.972
90,111,-21,22.5,37,-21,1645,1636,9,0,1,0,0.333333,69,4,3,0.478261,0,0,17,16,false,false,false,0.206,0.794
22,39,-17,11,19.5,-17,939,969,-30,0,0,0,0,83,2,2,0.39759,0,0,11,19,false,false,false,0.154,0.846
156,202,-46,17.333333,25.25,-46,1229,1220,9,0,1,0,0.125,41,9,8,0.902439,0,0,14,8,false,false,false,0.106,0.894
138,168,-30,15.333333,21,-30,1302,1351,-49,0,0,0,0,42,9,8,0.880952,0,0,16,12,false,false,false,0.106,0.894
205,284,-79,14.642857,20.285714,-79,714,892,-178,0,2,0,0.142857,7,14,14,6,0,0,12,7,false,false,false,0.03,0.97
206,267,-61,13.733333,19.071429,-61,907,878,29,0,0,0,0,25,15,14,1.72,2,0,5,8,false,false,false,0.4,0.6
186,177,9,11.625,11.8,9,542,390,152,0,0,0,0,25,16,15,2,1,0,6,19,false,false,true,0.837,0.163
49,132,-83,16.333333,44,-83,1576,1556,20,0,1,0,0.333333,76,3,3,0.394737,0,0,7,15,false,false,false,0.015,0.985
80,65,15,16,16.25,15,848,976,-128,0,0,0,0,72,5,4,0.555556,0,0,7,15,false,false,false,0.141,0.859
70,108,-38,17.5,27,-38,1182,1075,107,0,1,0,0.25,69,4,4,0.565217,0,0,14,14,false,false,false,0.259,0.741
205,297,-92,15.769231,24.75,-92,1003,1018,-15,0,0,0,0,7,13,12,5.285714,0,0,8,8,false,false,false,0.005,0.995
165,266,-101,15,24.181818,-101,1094,1159,-65,0,0,0,0,18,11,11,2.111111,1,0,18,23,false,false,false,0.008,0.992
71,171,-100,10.142857,24.428571,-100,795,786,9,0,0,0,0,63,7,7,0.603175,0,0,10,8,false,false,false,0.015,0.985
140,170,-30,15.555556,21.25,-30,430,542,-112,0,1,0,0.125,42,9,8,1.142857,0,0,17,12,false,false,false,0.401,0.599
218,277,-59,16.769231,23.083333,-59,452,698,-246,0,1,0,0.083333,16,13,12,2.5625,0,0,21,10,false,false,false,0.026,0.974
151,247,-96,13.727273,24.7,-96,563,523,40,0,0,0,0,31,11,10,1.193548,0,0,7,17,false,false,false,0.005,0.995
28,66,-38,14,33,-38,1315,1331,-16,0,0,0,0,85,2,2,0.388235,0,0,16,12,false,false,false,0.116,0.884
254,192,62,21.166667,17.454545,62,675,570,105,0,0,0,0,16,12,11,2.1875,0,0,13,13,false,false,true,0.899,0.101
55,14,41,27.5,14,41,1164,1149,15,0,0,0,0,89,2,1,0.52809,0,0,14,9,false,false,true,0.565,0.435
266,245,21,20.461538,18.846154,21,675,570,105,0,0,0,0,4,13,13,8.75,1,0,10,11,false,false,true,0.951,0.049
161,167,-6,23,27.833333,-6,576,602,-26,0,0,0,0,57,7,6,0.736842,0,0,8,7,false,false,false,0.268,0.732
210,283,-73,16.153846,21.769231,-73,1161,1176,-15,1,1,0.076923,0.076923,6,13,13,6.333333,0,0,9,18,false,false,false,0.007,0.993
228,262,-34,17.538462,20.153846,-34,785,892,-107,0,0,0,0,17,13,13,2.176471,0,0,9,12,false,false,false,0.119,0.881
48,136,-88,9.6,27.2,-88,1101,1130,-29,0,1,0,0.2,66,5,5,0.681818,0,0,7,16,false,false,false,0.105,0.895
345,334,11,23,23.857143,11,1354,1210,144,0,1,0,0.071429,-5,15,14,-6.6,0,1,7,7,false,false,false,0.295,0.705
343,433,-90,20.176471,27.0625,-90,1334,1439,-105,1,1,0.058824,0.0625,-6,17,16,-6,0,0,3,4,false,false,false,0.008,0.992
116,269,-153,19.333333,44.833333,-153,1632,2020,-388,0,1,0,0.166667,50,6,6,0.62,0,0,8,8,false,false,false,0.006,0.994
163,279,-116,18.111111,31,-116,653,1004,-351,0,0,0,0,29,9,9,1,0,0,14,8,false,false,false,0.005,0.995
299,397,-98,16.611111,23.352941,-98,1094,1159,-65,0,0,0,0,-21,18,17,-1.809524,0,0,1,1,false,false,false,0.005,0.995
334,370,-36,16.7,19.473684,-36,1063,1134,-71,1,0,0.05,0,-10,20,19,-4.4,0,0,2,3,false,false,false,0.036,0.964
90,63,27,18,12.6,27,1188,1334,-146,0,0,0,0,65,5,5,0.461538,0,0,9,12,false,false,false,0.42,0.58
143,182,-39,15.888889,20.222222,-39,727,820,-93,0,1,0,0.111111,35,9,9,1,0,0,12,8,false,false,false,0.169,0.831
38,48,-10,12.666667,16,-10,999,1071,-72,0,0,0,0,79,3,3,0.506329,0,0,8,10,false,false,false,0.263,0.737
18,21,-3,18,21,-3,691,704,-13,0,0,0,0,93,1,1,0.408602,1,0,10,8,false,false,true,0.527,0.473
88,119,-31,12.571429,17,-31,1045,1082,-37,0,0,0,0,57,7,7,0.789474,1,0,20,8,false,false,false,0.294,0.706
252,248,4,28,27.555556,4,714,820,-106,1,0,0.111111,0,35,9,9,0.885714,0,0,11,7,false,false,true,0.726,0.274
240,134,106,20,11.166667,106,1065,948,117,0,0,0,0,34,12,12,1.147059,0,0,9,8,false,false,true,0.995,0.005
152,168,-16,15.2,16.8,-16,1220,1185,35,0,0,0,0,43,10,10,1.093023,0,1,27,8,false,false,false,0.232,0.768
338,357,-19,24.142857,25.5,-19,169,306,-137,2,1,0.142857,0.071429,-15,14,14,-2.066667,0,0,2,3,false,false,false,0.005,0.995
37,59,-22,12.333333,19.666667,-22,683,859,-176,0,0,0,0,80,3,3,0.5625,1,1,10,17,false,false,false,0.032,0.968
203,324,-121,11.941176,20.25,-121,977,1100,-123,0,1,0,0.0625,5,17,16,8.2,0,0,9,24,false,false,false,0.005,0.995
30,49,-19,15,24.5,-19,1770,1751,19,0,0,0,0,80,2,2,0.3625,0,1,12,8,false,false,false,0.248,0.752
197,251,-54,15.153846,19.307692,-54,1312,1334,-22,0,0,0,0,6,13,13,6.5,1,0,17,7,false,false,false,0.18,0.82
69,84,-15,13.8,21,-15,1030,1014,16,0,0,0,0,75,5,4,0.44,1,0,6,16,false,false,false,0.237,0.763
136,335,-199,17,47.857143,-199,1219,1216,3,1,3,0.125,0.428571,27,8,7,1,0,0,10,17,false,false,false,0,1
222,181,41,22.2,20.111111,41,540,498,42,1,0,0.1,0,33,10,9,1.393939,0,1,10,17,false,false,false,0.012,0.988
174,323,-149,7.565217,14.681818,-149,651,567,84,0,0,0,0,-14,23,22,-3.928571,0,0,7,11,false,false,false,0.004,0.996
0,0,0,0,0,0,1047,1253,-206,0,0,0,0,100,1,0,0.37,1,0,12,0,false,false,false,0.25,0.75
20,18,2,10,18,2,775,786,-11,0,0,0,0,89,2,1,0.483146,0,0,10,21,false,false,false,0.155,0.845
279,265,14,19.928571,18.928571,14,675,570,105,0,0,0,0,-6,14,14,-5.833333,0,0,17,9,false,false,true,0.747,0.253
62,62,0,20.666667,31,0,1102,1245,-143,0,0,0,0,79,3,2,0.367089,0,0,7,16,false,false,false,0.111,0.889
251,391,-140,17.928571,27.928571,-140,1656,1649,7,0,0,0,0,1,14,14,32,0,0,11,7,false,false,false,0.006,0.994
333,346,-13,20.8125,23.066667,-13,1237,1265,-28,1,0,0.0625,0,-17,16,15,-2.117647,0,0,4,11,false,false,false,0.194,0.806
302,452,-150,25.166667,37.666667,-150,1925,1885,40,1,2,0.083333,0.166667,-13,12,12,-1.923077,0,0,1,1,false,false,false,0.006,0.994
125,123,2,20.833333,20.5,2,1488,1428,60,1,0,0.166667,0,56,6,6,0.660714,0,0,20,18,false,false,false,0.294,0.706
234,335,-101,29.25,41.875,-101,1689,1777,-88,1,1,0.125,0.125,29,8,8,1.034483,0,0,19,10,false,false,false,0.005,0.995
324,385,-61,23.142857,27.5,-61,1454,1479,-25,1,0,0.071429,0,-5,14,14,-6.2,0,0,14,6,false,false,false,0.006,0.994
205,257,-52,13.666667,18.357143,-52,278,1,277,0,0,0,0,0,15,14,0,0,0,14,14,false,false,false,0.027,0.973
159,175,-16,14.454545,17.5,-16,714,892,-178,0,0,0,0,38,11,10,1.105263,0,1,9,6,false,false,false,0.174,0.826
255,334,-79,15.9375,22.266667,-79,725,668,57,0,0,0,0,0,16,15,0,1,0,5,6,false,false,false,0.005,0.995
295,341,-46,14.75,17.947368,-46,814,830,-16,0,0,0,0,-31,20,19,-1.322581,0,0,5,2,false,false,false,0.007,0.993
285,326,-41,12.954545,14.818182,-41,951,976,-25,0,0,0,0,-27,22,22,-1.62963,0,0,1,1,true,false,false,0.006,0.994
63,72,-9,21,24,-9,1777,1500,277,0,0,0,0,73,3,3,0.383562,1,1,8,17,false,false,false,0.073,0.927
15,39,-24,5,13,-24,1422,1510,-88,0,0,0,0,88,3,3,0.443182,0,1,10,9,false,false,false,0.251,0.749
24,22,2,24,22,2,1422,1798,-376,0,0,0,0,92,1,1,0.347826,0,0,10,9,false,false,false,0.246,0.754
66,130,-64,16.5,32.5,-64,1021,897,124,0,1,0,0.25,70,4,4,0.528571,0,0,13,11,false,false,false,0.145,0.855
55,95,-40,13.75,23.75,-40,840,1055,-215,0,0,0,0,72,4,4,0.486111,0,0,15,13,false,false,false,0.106,0.894
170,140,30,18.888889,17.5,30,387,683,-296,0,0,0,0,34,9,8,1,1,0,14,8,false,false,true,0.551,0.449
55,36,19,27.5,18,19,651,700,-49,0,0,0,0,86,2,2,0.651163,0,0,7,14,false,false,true,0.725,0.275
199,141,58,19.9,15.666667,58,952,870,82,0,0,0,0,33,10,9,1.121212,1,0,6,42,false,false,true,0.993,0.007
63,172,-109,15.75,43,-109,1656,1649,7,0,0,0,0,64,4,4,0.5,0,0,11,13,false,false,false,0.099,0.901
299,312,-13,23,26,-13,1071,1065,6,0,0,0,0,3,13,12,10.333333,0,1,10,10,false,false,false,0.085,0.915
155,191,-36,11.071429,14.692308,-36,391,542,-151,1,0,0.071429,0,15,14,13,3.066667,0,0,14,20,false,false,false,0.025,0.975
156,217,-61,26,36.166667,-61,1388,1455,-67,0,0,0,0,45,6,6,0.622222,1,1,14,14,false,false,false,0.107,0.893
275,458,-183,19.642857,32.714286,-183,842,926,-84,0,1,0,0.071429,-11,14,14,-2.727273,0,0,3,2,false,false,false,0.005,0.995
122,170,-48,24.4,42.5,-48,1556,1616,-60,0,0,0,0,69,5,4,0.42029,0,2,12,9,false,false,false,0.001,0.999
145,178,-33,20.714286,29.666667,-33,964,1003,-39,0,1,0,0.166667,54,7,6,0.722222,0,0,10,9,false,false,false,0.115,0.885
140,146,-6,12.727273,14.6,-6,542,390,152,0,0,0,0,48,11,10,1.041667,0,0,7,20,false,false,false,0.432,0.568
64,214,-150,7.111111,23.777778,-150,1037,913,124,0,1,0,0.111111,51,9,9,0.745098,1,0,11,8,false,false,false,0.002,0.998
240,130,110,20,11.818182,110,1065,948,117,0,0,0,0,37,12,11,1.054054,0,0,9,8,false,false,true,0.994,0.006
317,329,-12,13.208333,13.708333,-12,526,502,24,0,0,0,0,-36,24,24,-1.388889,0,0,13,13,false,false,false,0.19,0.81
10,51,-41,5,25.5,-41,1257,1176,81,0,0,0,0,92,2,2,0.369565,0,0,17,9,false,false,false,0.119,0.881
157,218,-61,26.166667,43.6,-61,1925,1885,40,1,1,0.166667,0.2,46,6,5,0.543478,1,0,16,7,false,false,false,0.103,0.897
60,55,5,20,27.5,5,1110,1399,-289,0,0,0,0,80,3,2,0.425,0,0,15,7,false,false,false,0.235,0.765
296,387,-91,14.8,19.35,-91,1195,1397,-202,0,2,0,0.1,-21,20,20,-1.904762,0,1,4,2,true,false,false,0,1
37,32,5,18.5,32,5,595,538,57,0,0,0,0,90,2,1,0.422222,1,0,9,12,false,false,true,0.532,0.468
36,21,15,18,21,15,613,525,88,0,0,0,0,86,2,1,0.488372,0,1,17,11,false,false,true,0.519,0.481
239,232,7,23.9,23.2,7,1102,1245,-143,0,0,0,0,21,10,10,1.380952,0,0,9,8,false,false,false,0.352,0.648
32,12,20,16,12,20,163,346,-183,0,0,0,0,87,2,1,0.448276,0,1,9,6,false,false,false,0.001,0.999
285,354,-69,20.357143,25.285714,-69,1232,1281,-49,0,2,0,0.142857,-7,14,14,-4.428571,0,0,3,5,false,false,false,0.001,0.999
283,243,40,14.15,12.789474,40,671,638,33,0,0,0,0,-17,20,19,-2.882353,0,0,5,18,false,false,true,0.996,0.004
40,17,23,20,17,23,1248,1220,28,0,0,0,0,90,2,1,0.577778,0,1,8,10,false,false,false,0.319,0.681
330,434,-104,25.384615,33.384615,-104,1770,1751,19,0,1,0,0.076923,-7,13,13,-4.142857,0,0,4,2,false,false,false,0.001,0.999
180,256,-76,16.363636,23.272727,-76,1159,1131,28,0,2,0,0.181818,24,11,11,1.541667,0,0,9,19,false,false,false,0.001,0.999
32,17,15,16,17,15,344,315,29,0,0,0,0,86,2,1,0.465116,1,0,7,10,false,false,true,0.525,0.475
78,120,-42,15.6,24,-42,668,363,305,0,0,0,0,70,5,5,0.671429,0,0,8,9,false,false,false,0.252,0.748
59,52,7,11.8,13,7,1452,1388,64,0,0,0,0,71,5,4,0.492958,0,0,14,22,false,false,false,0.123,0.877
0,0,0,0,0,0,1407,1473,-66,0,0,0,0,100,1,0,0.31,0,0,0,0,false,false,false,0.245,0.755
323,311,12,17.944444,18.294118,12,1488,1428,60,1,0,0.055556,0,-8,18,17,-4.625,0,1,29,4,false,false,true,0.516,0.484
163,361,-198,18.111111,45.125,-198,1219,1216,3,1,3,0.111111,0.375,17,9,8,1.588235,0,0,26,12,false,false,false,0,1
274,344,-70,21.076923,26.461538,-70,1176,1133,43,1,0,0.076923,0,20,13,13,1.7,0,0,7,11,false,false,false,0.008,0.992
300,336,-36,20,24,-36,561,633,-72,0,1,0,0.071429,3,15,14,11.666667,0,0,8,10,false,false,false,0.036,0.964
309,340,-31,14.714286,17,-31,1281,1268,13,0,0,0,0,-22,21,20,-1.909091,0,0,1,2,false,false,false,0.009,0.991
138,139,-1,17.25,19.857143,-1,561,688,-127,0,0,0,0,53,8,7,0.867925,0,0,13,7,false,false,false,0.159,0.841
245,340,-95,15.3125,21.25,-95,402,448,-46,0,0,0,0,-11,16,16,-3.363636,0,0,17,2,false,false,false,0.006,0.994
185,204,-19,18.5,22.666667,-19,518,461,57,0,0,0,0,34,10,9,1.058824,0,1,16,8,false,false,false,0.118,0.882
27,86,-59,13.5,86,-59,1220,1202,18,0,0,0,0,85,2,1,0.588235,0,0,16,13,false,false,false,0.001,0.999
162,205,-43,13.5,18.636364,-43,651,700,-49,0,0,0,0,27,12,11,2.074074,1,0,6,12,false,false,false,0.105,0.895
237,505,-268,18.230769,38.846154,-268,1632,2020,-388,0,2,0,0.153846,-1,13,13,-31,0,0,21,8,false,false,false,0.005,0.995
117,100,17,23.4,25,17,1556,1513,43,0,0,0,0,61,5,4,0.508197,2,0,9,17,false,false,true,0.862,0.138
268,341,-73,12.181818,16.238095,-73,813,698,115,1,0,0.045455,0,-25,22,21,-1.92,0,0,1,6,false,false,false,0.023,0.977
282,380,-98,14.1,20,-98,1037,1016,21,1,0,0.05,0,-7,20,19,-8.285714,1,0,12,13,false,false,false,0.005,0.995
168,212,-44,16.8,23.555556,-44,822,845,-23,0,0,0,0,39,10,9,0.897436,1,0,18,8,false,false,false,0.108,0.892
55,54,1,27.5,27,1,1417,1482,-65,0,0,0,0,86,2,2,0.383721,0,0,26,12,false,false,false,0.434,0.566
86,110,-24,10.75,13.75,-24,226,361,-135,0,0,0,0,44,8,8,1,0,0,16,12,false,false,false,0.157,0.843
139,110,29,15.444444,13.75,29,1030,998,32,0,0,0,0,39,9,8,0.948718,0,0,7,15,false,false,false,0.392,0.608
207,232,-25,17.25,19.333333,-25,907,1070,-163,0,0,0,0,23,12,12,1.521739,0,1,10,18,false,false,false,0.101,0.899
164,224,-60,12.615385,17.230769,-60,668,363,305,0,0,0,0,23,13,13,2.043478,1,0,9,13,false,false,false,0.009,0.991
45,63,-18,11.25,21,-18,653,1004,-351,0,0,0,0,77,4,3,0.376623,0,0,8,7,false,false,false,0.125,0.875
175,219,-44,17.5,21.9,-44,450,624,-174,0,0,0,0,26,10,10,1.269231,0,0,20,8,false,false,false,0.114,0.886
164,293,-129,16.4,29.3,-129,1193,1177,16,0,1,0,0.1,32,10,10,1.09375,0,0,17,18,false,false,false,0.005,0.995
74,79,-5,18.5,26.333333,-5,1127,995,132,0,1,0,0.333333,75,4,3,0.44,0,0,21,15,false,false,false,0.448,0.552
304,309,-5,16,17.166667,-5,430,542,-112,0,1,0,0.055556,-10,19,18,-4.8,0,0,10,12,false,false,false,0.111,0.889
204,228,-24,18.545455,22.8,-24,1334,1439,-105,1,0,0.090909,0,42,11,10,0.857143,0,0,18,9,false,false,false,0.112,0.888
0,0,0,0,0,0,786,848,-62,0,0,0,0,100,1,0,0.31,0,0,0,0,false,false,false,0.246,0.754
42,62,-20,14,20.666667,-20,344,315,29,1,0,0.333333,0,70,3,3,0.571429,0,0,8,10,false,false,false,0.282,0.718
168,221,-53,15.272727,20.090909,-53,1064,1397,-333,0,2,0,0.181818,40,11,11,1.075,1,0,27,7,false,false,false,0.151,0.849
164,186,-22,14.909091,16.909091,-22,526,502,24,0,0,0,0,36,11,11,1.388889,0,0,13,11,false,false,false,0.436,0.564
251,324,-73,17.928571,23.142857,-73,1633,1739,-106,1,0,0.071429,0,4,14,14,8.5,1,0,6,17,false,false,false,0.007,0.993
81,41,40,16.2,10.25,40,1278,1101,177,0,0,0,0,71,5,4,0.521127,1,0,8,13,false,false,true,0.727,0.273
160,180,-20,26.666667,36,-20,724,398,326,1,1,0.166667,0.2,59,6,5,0.661017,0,0,9,12,false,false,false,0.136,0.864
158,186,-28,12.153846,14.307692,-28,999,1071,-72,0,0,0,0,16,13,13,2.5,1,0,15,19,false,false,false,0.131,0.869
122,121,1,20.333333,20.166667,1,742,868,-126,0,0,0,0,59,6,6,0.559322,0,0,11,12,false,false,false,0.266,0.734
128,199,-71,11.636364,19.9,-71,830,787,43,0,0,0,0,31,11,10,1.225806,1,0,15,7,false,false,false,0.101,0.899
280,379,-99,15.555556,22.294118,-99,1195,1397,-202,0,2,0,0.117647,-8,18,17,-5,0,1,6,6,false,false,false,0,1
141,204,-63,15.666667,25.5,-63,944,1095,-151,0,1,0,0.125,47,9,8,0.829787,0,1,8,12,false,false,false,0.059,0.941
379,441,-62,25.266667,29.4,-62,1093,1100,-7,3,0,0.2,0,-5,15,15,-6.2,0,0,6,9,false,false,false,0,1
178,222,-44,17.8,24.666667,-44,1488,1403,85,0,1,0,0.111111,29,10,9,1.172414,0,0,11,9,false,false,false,0.013,0.987
143,121,22,20.428571,20.166667,22,980,965,15,0,0,0,0,56,7,6,0.678571,0,1,12,6,false,false,false,0.403,0.597
188,135,53,23.5,19.285714,53,1341,1606,-265,1,0,0.125,0,41,8,7,0.804878,0,0,8,7,false,false,true,0.574,0.426
255,290,-35,17,19.333333,-35,907,1070,-163,0,0,0,0,10,15,15,3.5,0,1,9,12,false,false,false,0.009,0.991
251,290,-39,16.733333,19.333333,-39,1220,1185,35,0,1,0,0.066667,10,15,15,4.7,0,1,19,18,false,false,false,0.001,0.999
14,22,-8,14,22,-8,1000,960,40,0,0,0,0,92,1,1,0.48913,0,0,9,19,false,false,false,0.242,0.758
261,315,-54,18.642857,24.230769,-54,503,527,-24,0,1,0,0.076923,-4,14,13,-8.25,0,0,8,7,false,false,false,0.028,0.972
153,140,13,21.857143,23.333333,13,566,742,-176,0,1,0,0.166667,50,7,6,0.64,0,0,11,18,false,false,true,0.708,0.292
203,238,-35,20.3,26.444444,-35,1305,1211,94,1,0,0.1,0,38,10,9,0.868421,1,0,6,8,false,false,false,0.122,0.878
270,248,22,19.285714,19.076923,22,356,498,-142,0,1,0,0.076923,9,14,13,3.888889,0,0,7,18,false,false,true,0.716,0.284
46,99,-53,15.333333,33,-53,804,766,38,0,1,0,0.333333,78,3,3,0.525641,0,1,17,9,false,false,false,0.195,0.805
313,322,-9,16.473684,16.947368,-9,540,498,42,1,0,0.052632,0,-26,19,19,-1.769231,0,0,7,13,false,false,false,0.329,0.671
82,135,-53,16.4,27,-53,915,971,-56,0,0,0,0,63,5,5,0.52381,0,0,8,26,false,false,false,0.106,0.894
36,143,-107,7.2,28.6,-107,1422,1510,-88,0,1,0,0.2,74,5,5,0.527027,0,0,11,28,false,false,false,0.101,0.899
58,52,6,14.5,17.333333,6,720,437,283,0,0,0,0,82,4,3,0.512195,0,0,17,18,false,false,false,0.474,0.526
275,238,37,14.473684,13.222222,37,671,638,33,0,0,0,0,-12,19,18,-4.083333,0,0,8,18,false,false,true,0.987,0.013
343,351,-8,18.052632,18.473684,-8,1094,1041,53,1,0,0.052632,0,-27,19,19,-1.407407,0,0,2,1,true,false,false,0.343,0.657
323,323,0,20.1875,21.533333,0,1341,1606,-265,1,0,0.0625,0,-13,16,15,-2.538462,0,0,3,1,false,false,false,0.228,0.772
173,173,0,13.307692,14.416667,0,1045,1082,-37,0,0,0,0,21,13,12,2.142857,1,0,16,24,false,false,false,0.125,0.875
278,301,-23,27.8,30.1,-23,1331,1432,-101,0,0,0,0,16,10,10,1.6875,0,0,16,9,false,false,false,0.216,0.784
168,216,-48,15.272727,21.6,-48,1064,1397,-333,0,2,0,0.2,43,11,10,1,1,0,27,7,false,false,false,0.118,0.882
130,116,14,13,12.888889,14,342,53,289,0,0,0,0,38,10,9,1.078947,1,0,12,9,false,false,true,0.865,0.135
166,226,-60,16.6,22.6,-60,964,1003,-39,0,1,0,0.1,31,10,10,1.258065,1,0,16,24,false,false,false,0.1,0.9
147,167,-20,24.5,27.833333,-20,576,602,-26,0,0,0,0,59,6,6,0.711864,0,0,8,7,false,false,false,0.356,0.644
74,101,-27,12.333333,20.2,-27,1071,1000,71,0,0,0,0,68,6,5,0.691176,1,0,6,14,false,false,false,0.23,0.77
135,109,26,19.285714,18.166667,26,991,1063,-72,0,0,0,0,58,7,6,0.655172,0,0,16,17,false,false,false,0.399,0.601
244,273,-29,18.769231,22.75,-29,1078,1095,-17,1,1,0.076923,0.083333,16,13,12,2.3125,0,0,7,10,false,false,false,0.055,0.945
85,200,-115,21.25,50,-115,786,848,-62,0,1,0,0.25,72,4,4,0.430556,1,0,13,11,false,false,false,0.048,0.952
0,0,0,0,0,0,288,359,-71,0,0,0,0,100,1,0,0.27,0,0,0,0,false,false,false,0.257,0.743
26,46,-20,13,46,-20,615,542,73,0,0,0,0,90,2,1,0.466667,0,0,8,20,false,false,false,0.178,0.822
150,138,12,18.75,19.714286,12,1232,1448,-216,0,0,0,0,47,8,7,0.744681,0,0,10,7,false,false,false,0.229,0.771
174,225,-51,13.384615,18.75,-51,595,540,55,0,0,0,0,24,13,12,1.791667,0,0,10,12,false,false,false,0.012,0.988
275,343,-68,17.1875,21.4375,-68,452,698,-246,0,1,0,0.0625,-7,16,16,-5.857143,0,0,11,5,false,false,false,0.035,0.965
229,303,-74,16.357143,23.307692,-74,563,523,40,0,0,0,0,8,14,13,4.625,0,1,10,15,false,false,false,0.005,0.995
104,151,-47,11.555556,16.777778,-47,999,1165,-166,0,0,0,0,47,9,9,0.978723,0,0,24,10,false,false,false,0.106,0.894
168,198,-30,21,28.285714,-30,1126,1277,-151,0,0,0,0,39,8,7,0.897436,0,0,7,15,false,false,false,0.106,0.894
238,227,11,15.866667,16.214286,11,970,1030,-60,0,0,0,0,6,15,14,6.666667,0,0,13,16,false,false,false,0.42,0.58
297,343,-46,15.631579,19.055556,-46,344,315,29,1,1,0.052632,0.055556,-32,19,18,-1.25,0,0,1,4,false,false,false,0.043,0.957
40,36,4,20,18,4,1000,960,40,0,0,0,0,85,2,2,0.529412,0,0,7,16,false,false,false,0.368,0.632
234,296,-62,26,32.888889,-62,1554,1685,-131,0,1,0,0.111111,31,9,9,1.032258,0,1,10,13,false,false,false,0.044,0.956
42,52,-10,10.5,13,-10,595,662,-67,0,0,0,0,71,4,4,0.619718,0,0,20,16,false,false,false,0.269,0.731
285,312,-27,12.391304,13.565217,-27,999,1165,-166,0,0,0,0,-17,23,23,-2.705882,1,1,17,6,true,false,false,0.016,0.984
120,521,-401,7.058824,30.647059,-401,1164,1149,15,0,3,0,0.176471,17,17,17,2.764706,0,1,12,6,false,false,false,0.066,0.934
169,200,-31,16.9,22.222222,-31,795,786,9,1,0,0.1,0,42,10,9,0.904762,0,0,9,20,false,false,false,0.044,0.956
168,192,-24,15.272727,17.454545,-24,1580,1629,-49,0,0,0,0,29,11,11,1.275862,0,0,12,7,false,false,false,0.175,0.825
300,359,-59,20,23.933333,-59,1305,1254,51,1,1,0.066667,0.066667,-14,15,15,-2.285714,0,0,1,6,false,false,false,0.005,0.995
182,210,-28,13,16.153846,-28,1045,1082,-37,0,0,0,0,17,14,13,2.647059,1,0,13,16,false,false,false,0.118,0.882
284,343,-59,16.705882,21.4375,-59,452,698,-246,0,1,0,0.0625,-9,17,16,-4.555556,0,0,7,5,false,false,false,0.031,0.969
159,225,-66,19.875,28.125,-66,1038,917,121,1,1,0.125,0.125,42,8,8,0.833333,0,0,13,10,false,false,false,0.029,0.971
191,244,-53,14.692308,20.333333,-53,1195,1397,-202,0,1,0,0.083333,25,13,12,1.6,0,0,8,8,false,false,false,0.068,0.932
272,372,-100,16,21.882353,-100,952,826,126,0,1,0,0.058824,0,17,17,0,0,0,12,7,false,false,false,0.005,0.995
284,357,-73,21.846154,27.461538,-73,1793,1869,-76,0,1,0,0.076923,5,13,13,6,1,0,6,14,false,false,false,0.101,0.899
288,303,-15,19.2,21.642857,-15,971,800,171,0,1,0,0.071429,-16,15,14,-1.8125,0,0,4,6,true,false,false,0.019,0.981
167,274,-107,15.181818,24.909091,-107,1003,1018,-15,0,0,0,0,22,11,11,1.681818,0,0,17,7,false,false,false,0.006,0.994
33,48,-15,16.5,24,-15,1633,1620,13,0,0,0,0,85,2,2,0.423529,0,0,10,24,false,false,false,0.111,0.889
164,152,12,20.5,21.714286,12,1331,1374,-43,0,0,0,0,42,8,7,0.785714,0,0,22,12,false,false,false,0.27,0.73
289,332,-43,14.45,16.6,-43,889,855,34,0,1,0,0.05,-22,20,20,-1.818182,0,0,1,1,true,false,false,0.002,0.998
240,278,-38,20,25.272727,-38,980,965,15,0,0,0,0,19,12,11,2,1,0,6,22,false,false,false,0.086,0.914
315,371,-56,22.5,28.538462,-56,1699,1803,-104,1,1,0.071429,0.076923,17,14,13,2.058824,0,0,14,10,false,false,false,0.017,0.983
158,168,-10,17.555556,18.666667,-10,500,532,-32,0,0,0,0,39,9,9,1.051282,0,0,14,12,false,false,true,0.646,0.354
161,250,-89,13.416667,20.833333,-89,1037,913,124,1,1,0.083333,0.083333,29,12,12,1.310345,0,0,13,10,false,false,false,0.007,0.993
218,258,-40,14.533333,17.2,-40,1040,1091,-51,0,0,0,0,11,15,15,4.272727,0,0,9,12,false,false,false,0.077,0.923
127,211,-84,15.875,26.375,-84,480,739,-259,0,0,0,0,45,8,8,0.866667,0,0,8,7,false,false,false,0.008,0.992
119,124,-5,23.8,24.8,-5,1245,1148,97,0,0,0,0,62,5,5,0.564516,1,0,18,14,false,false,true,0.856,0.144
118,127,-9,16.857143,21.166667,-9,725,668,57,0,0,0,0,56,7,6,0.625,0,1,23,20,false,false,false,0.153,0.847
57,43,14,19,14.333333,14,450,427,23,0,0,0,0,79,3,3,0.468354,0,1,15,10,false,false,true,0.528,0.472
180,213,-33,16.363636,19.363636,-33,775,786,-11,0,0,0,0,27,11,11,1.592593,1,0,12,19,false,false,false,0.112,0.888
252,297,-45,16.8,21.214286,-45,595,733,-138,1,1,0.066667,0.071429,-5,15,14,-7.8,0,1,23,12,false,false,false,0.026,0.974
74,67,7,18.5,16.75,7,1094,1041,53,0,0,0,0,67,4,4,0.567164,1,0,13,14,false,false,true,0.557,0.443
254,319,-65,19.538462,24.538462,-65,1205,1216,-11,0,0,0,0,9,13,13,3.666667,0,0,7,12,false,false,false,0.007,0.993
62,49,13,20.666667,16.333333,13,1197,1156,41,0,0,0,0,76,3,3,0.460526,0,1,13,8,false,false,true,0.509,0.491
336,337,-1,16,16.047619,-1,206,346,-140,1,0,0.047619,0,-28,21,21,-1.535714,0,0,11,2,false,false,false,0.23,0.77
104,133,-29,11.555556,16.625,-29,999,1165,-166,0,0,0,0,50,9,8,0.92,0,0,24,11,false,false,false,0.106,0.894
201,166,35,28.714286,23.714286,35,691,695,-4,1,0,0.142857,0,50,7,7,0.64,1,0,8,21,false,false,true,0.864,0.136
248,279,-31,17.714286,21.461538,-31,758,791,-33,0,0,0,0,4,14,13,9.75,0,0,10,19,false,false,false,0.023,0.977
158,174,-16,12.153846,13.384615,-16,542,390,152,0,0,0,0,36,13,13,1.388889,0,0,7,19,false,false,false,0.443,0.557
53,60,-7,10.6,15,-7,830,787,43,0,0,0,0,70,5,4,0.542857,0,0,27,12,false,false,false,0.282,0.718
234,280,-46,26,35,-46,1554,1685,-131,0,1,0,0.125,34,9,8,0.941176,0,0,10,14,false,false,false,0.104,0.896
287,353,-66,14.35,18.578947,-66,1422,1583,-161,0,1,0,0.052632,-10,20,19,-4.1,1,0,2,13,false,false,false,0.006,0.994
215,295,-80,12.647059,17.352941,-80,951,976,-25,0,0,0,0,-3,17,17,-14.666667,0,0,12,9,false,false,false,0.006,0.994
60,216,-156,7.5,27,-156,1422,1510,-88,0,1,0,0.125,59,8,8,0.661017,0,0,17,13,false,false,false,0.005,0.995
14,6,8,14,6,8,991,1063,-72,0,0,0,0,94,1,1,0.404255,0,0,14,25,false,false,false,0.231,0.769
186,231,-45,20.666667,25.666667,-45,1055,1019,36,0,0,0,0,25,9,9,1.32,1,0,13,11,false,false,false,0.224,0.776
336,328,8,17.684211,18.222222,8,1168,1062,106,0,0,0,0,-9,19,18,-4.777778,0,0,2,4,false,false,false,0.412,0.588
174,260,-86,21.75,32.5,-86,1436,1489,-53,1,1,0.125,0.125,47,8,8,0.787234,0,0,10,9,false,false,false,0.006,0.994
63,92,-29,15.75,23,-29,668,771,-103,0,0,0,0,68,4,4,0.588235,0,0,15,18,false,false,false,0.147,0.853
12,6,6,12,6,6,526,502,24,0,0,0,0,92,1,1,0.543478,0,1,25,18,false,false,false,0.47,0.53
283,323,-40,13.47619,15.380952,-40,925,1000,-75,0,0,0,0,-26,21,21,-1.692308,0,0,4,1,false,false,false,0.021,0.979
168,232,-64,18.666667,29,-64,594,648,-54,1,1,0.111111,0.125,40,9,8,1,0,0,7,16,false,false,false,0.008,0.992
287,393,-106,17.9375,24.5625,-106,1094,1159,-65,0,0,0,0,-13,16,16,-2.923077,1,0,3,3,false,false,false,0.005,0.995
314,290,24,31.4,29,24,820,718,102,0,2,0,0.2,14,10,10,2,0,0,13,7,false,false,false,0.467,0.533
16,10,6,8,10,6,342,53,289,0,0,0,0,88,2,1,0.465909,0,0,7,24,false,false,false,0.313,0.687
243,270,-27,18.692308,22.5,-27,668,771,-103,0,0,0,0,21,13,12,1.904762,0,0,14,11,false,false,false,0.082,0.918
306,342,-36,21.857143,24.428571,-36,1021,897,124,0,2,0,0.142857,-9,14,14,-4.111111,0,0,13,8,false,false,false,0.01,0.99
242,258,-16,15.125,17.2,-16,1040,1091,-51,0,0,0,0,5,16,15,9.4,0,0,15,12,false,false,false,0.218,0.782
89,132,-43,12.714286,22,-43,818,826,-8,0,0,0,0,68,7,6,0.779412,1,1,11,13,false,false,false,0.198,0.802
94,233,-139,13.428571,33.285714,-139,935,995,-60,0,1,0,0.142857,53,7,7,0.735849,2,0,14,22,false,false,false,0.031,0.969
187,131,56,20.777778,14.555556,56,1652,1473,179,1,0,0.111111,0,34,9,9,0.882353,0,1,17,15,false,false,true,1,0
86,61,25,21.5,20.333333,25,500,532,-32,0,0,0,0,72,4,3,0.569444,0,0,12,11,false,false,true,0.61,0.39
203,240,-37,10.684211,13.333333,-37,542,390,152,0,0,0,0,8,19,18,6.25,1,0,6,10,false,false,false,0.064,0.936
43,39,4,21.5,19.5,4,1691,1551,140,0,0,0,0,85,2,2,0.435294,0,0,10,19,false,false,false,0.417,0.583
29,26,3,14.5,13,3,804,766,38,0,0,0,0,88,2,2,0.465909,0,1,19,10,false,false,true,0.509,0.491
255,274,-19,23.181818,27.4,-19,801,679,122,1,0,0.090909,0,13,11,10,2.230769,1,0,9,14,false,false,false,0.208,0.792
26,29,-3,13,14.5,-3,1075,1189,-114,0,0,0,0,84,2,2,0.47619,0,0,13,19,false,false,false,0.159,0.841
140,147,-7,15.555556,16.333333,-7,720,437,283,0,0,0,0,51,9,9,0.823529,0,0,16,9,false,false,true,0.747,0.253
0,0,0,0,0,0,530,683,-153,0,0,0,0,100,1,1,0.4,0,1,10,16,false,false,false,0.236,0.764
104,188,-84,17.333333,31.333333,-84,732,868,-136,0,1,0,0.166667,58,6,6,0.551724,1,0,6,18,false,false,false,0.096,0.904
118,127,-9,19.666667,21.166667,-9,939,969,-30,0,0,0,0,53,6,6,0.622642,0,1,16,6,false,false,false,0.391,0.609
194,205,-11,14.923077,17.083333,-11,526,502,24,0,0,0,0,27,13,12,1.851852,0,0,13,10,false,false,false,0.428,0.572
0,88,-88,0,88,-88,786,848,-62,0,1,0,1,93,1,1,0.333333,0,0,0,21,false,false,false,0.008,0.992
236,284,-48,18.153846,21.846154,-48,1691,1551,140,0,0,0,0,16,13,13,2.3125,1,0,6,12,false,false,false,0.033,0.967
37,39,-2,18.5,39,-2,1167,1245,-78,0,0,0,0,88,2,1,0.261364,0,0,9,15,false,false,false,0.122,0.878
160,192,-32,20,27.428571,-32,804,1080,-276,0,0,0,0,46,8,7,0.73913,0,0,12,19,false,false,false,0.105,0.895
274,325,-51,21.076923,27.083333,-51,1176,1133,43,1,0,0.076923,0,23,13,12,1.478261,0,0,7,10,false,false,false,0.008,0.992
262,290,-28,18.714286,22.307692,-28,668,771,-103,0,0,0,0,14,14,13,2.857143,0,0,10,10,false,false,false,0.034,0.966
196,191,5,19.6,21.222222,5,206,346,-140,1,0,0.1,0,34,10,9,1.264706,0,0,9,8,false,false,true,0.509,0.491
336,392,-56,24,30.153846,-56,1606,1890,-284,0,1,0,0.076923,-6,14,13,-4.666667,1,0,10,9,false,false,false,0.048,0.952
308,303,5,28,27.545455,5,169,306,-137,2,1,0.181818,0.090909,3,11,11,10.333333,0,0,10,8,false,false,false,0.001,0.999
228,328,-100,19,29.818182,-100,1232,1448,-216,0,2,0,0.181818,16,12,11,2.1875,0,0,14,12,false,false,false,0.005,0.995
142,201,-59,17.75,25.125,-59,725,668,57,0,0,0,0,46,8,8,0.76087,0,0,27,10,false,false,false,0.165,0.835
88,95,-7,14.666667,15.833333,-7,1030,998,32,0,0,0,0,53,6,6,0.698113,0,0,10,16,false,false,false,0.223,0.777
221,298,-77,17,22.923077,-77,711,746,-35,0,0,0,0,12,13,13,3.166667,0,0,9,17,false,false,false,0.006,0.994
244,187,57,22.181818,18.7,57,540,498,42,1,0,0.090909,0,28,11,10,1.642857,0,1,7,17,false,false,false,0.118,0.882
211,230,-19,17.583333,19.166667,-19,1021,1094,-73,1,0,0.083333,0,22,12,12,1.681818,1,0,6,10,false,false,false,0.242,0.758
97,169,-72,19.4,33.8,-72,971,800,171,0,1,0,0.2,48,5,5,0.604167,1,0,6,8,false,false,false,0.024,0.976
132,111,21,18.857143,18.5,21,387,683,-296,0,0,0,0,49,7,6,0.693878,1,0,10,7,false,false,false,0.481,0.519
265,399,-134,18.928571,28.5,-134,874,868,6,0,0,0,0,-8,14,14,-4.125,0,0,11,3,false,false,false,0.005,0.995
276,263,13,23,23.909091,13,1093,1100,-7,2,0,0.166667,0,24,12,11,1.291667,0,0,14,10,false,false,true,0.555,0.445
270,226,44,18,16.142857,44,720,437,283,0,0,0,0,16,15,14,2.625,0,0,8,16,false,false,true,0.905,0.095
218,299,-81,12.111111,16.611111,-81,1248,1220,28,0,1,0,0.055556,6,18,18,8.666667,1,0,9,13,false,false,false,0.002,0.998
215,191,24,23.888889,23.875,24,1102,1245,-143,0,0,0,0,31,9,8,0.935484,0,0,8,19,false,false,false,0.232,0.768
297,296,1,18.5625,18.5,1,540,498,42,1,0,0.0625,0,-8,16,16,-5.75,0,0,7,16,false,false,false,0.326,0.674
278,395,-117,18.533333,26.333333,-117,726,818,-92,0,1,0,0.066667,-5,15,15,-7,0,0,14,6,false,false,false,0.006,0.994
351,387,-36,21.9375,25.8,-36,1373,1334,39,1,2,0.0625,0.133333,-9,16,15,-3.555556,1,0,3,4,false,false,false,0.009,0.991
42,87,-45,14,29,-45,1305,1211,94,0,0,0,0,82,3,3,0.402439,0,0,19,26,false,false,false,0.113,0.887
211,183,28,21.1,20.333333,28,1803,1658,145,1,0,0.1,0,28,10,9,1.178571,0,0,18,10,false,false,true,0.576,0.424
16,77,-61,5.333333,25.666667,-61,430,542,-112,0,0,0,0,83,3,3,0.578313,0,2,7,5,false,false,false,0,1
114,55,59,28.5,18.333333,59,804,1074,-270,0,0,0,0,74,4,3,0.432432,0,0,13,20,false,false,true,0.792,0.208
184,107,77,26.285714,17.833333,77,540,498,42,1,0,0.142857,0,56,7,6,0.821429,0,1,9,18,false,false,false,0.048,0.952
33,38,-5,16.5,38,-5,1045,1100,-55,0,0,0,0,90,2,1,0.377778,0,0,13,11,false,false,false,0.158,0.842
283,332,-49,16.647059,20.75,-49,480,518,-38,0,0,0,0,-10,17,16,-4,0,0,7,3,false,false,false,0.016,0.984
404,446,-42,25.25,29.733333,-42,1770,1745,25,2,1,0.125,0.066667,-9,16,15,-3.666667,0,0,2,1,false,false,false,0.021,0.979
246,146,100,30.75,20.857143,100,1552,1803,-251,2,0,0.25,0,46,8,7,0.717391,0,1,9,13,false,false,true,0.978,0.022
275,290,-15,17.1875,19.333333,-15,1220,1185,35,0,1,0,0.066667,7,16,15,6.714286,0,1,17,18,false,false,false,0.005,0.995
229,357,-128,20.818182,32.454545,-128,1636,1702,-66,0,1,0,0.090909,19,11,11,1.526316,0,0,14,17,false,false,false,0.005,0.995
265,274,-9,20.384615,22.833333,-9,971,800,171,0,1,0,0.083333,-4,13,12,-7.25,0,0,13,8,false,false,false,0.143,0.857
278,334,-56,23.166667,27.833333,-56,1331,1347,-16,1,1,0.083333,0.083333,-1,12,12,-32,0,1,10,6,false,false,false,0,1
238,375,-137,18.307692,28.846154,-137,1334,1439,-105,1,1,0.076923,0.076923,19,13,13,1.894737,0,0,16,11,false,false,false,0.005,0.995
274,352,-78,14.421053,19.555556,-78,1161,1176,-15,1,1,0.052632,0.055556,-28,19,18,-1.357143,0,0,1,5,false,false,false,0.005,0.995
160,219,-59,20,31.285714,-59,1583,1403,180,0,0,0,0,42,8,7,0.761905,0,0,12,10,false,false,false,0.058,0.942
273,366,-93,21,30.5,-93,1636,1702,-66,0,1,0,0.083333,7,13,12,4.142857,0,0,7,19,false,false,false,0.003,0.997
248,290,-42,17.714286,20.714286,-42,576,602,-26,0,0,0,0,6,14,14,7,0,0,10,16,false,false,false,0.033,0.967
91,107,-16,18.2,21.4,-16,1127,995,132,0,1,0,0.2,65,5,5,0.507692,0,0,22,15,false,false,true,0.622,0.378
50,0,50,25,0,50,1305,1254,51,0,0,0,0,92,2,1,0.347826,0,0,10,0,false,false,true,0.548,0.452
262,302,-40,17.466667,20.133333,-40,785,892,-107,0,0,0,0,5,15,15,7.4,0,1,11,7,false,false,false,0.006,0.994
163,174,-11,11.642857,13.384615,-11,542,390,152,0,0,0,0,32,14,13,1.5625,0,0,7,19,false,false,false,0.434,0.566
49,80,-31,12.25,20,-31,595,540,55,0,0,0,0,72,4,4,0.597222,0,0,12,10,false,false,false,0.216,0.784
113,110,3,14.125,13.75,3,1030,998,32,0,0,0,0,42,8,8,0.880952,0,0,17,15,false,false,false,0.326,0.674
10,0,10,10,0,10,1045,1100,-55,0,0,0,0,97,1,0,0.350515,0,0,8,0,false,false,false,0.301,0.699
295,270,25,18.4375,18,25,775,786,-11,1,0,0.0625,0,2,16,15,21.5,1,0,19,25,false,false,true,0.939,0.061
26,20,6,26,20,6,1652,1473,179,0,0,0,0,89,1,1,0.337079,0,0,8,9,false,false,true,0.536,0.464
178,172,6,19.777778,21.5,6,1495,1531,-36,0,0,0,0,49,9,8,0.755102,0,0,8,10,false,false,false,0.134,0.866
275,230,45,17.1875,15.333333,45,720,437,283,0,0,0,0,11,16,15,3.818182,0,0,10,16,false,false,true,0.908,0.092
165,273,-108,15,27.3,-108,976,995,-19,0,1,0,0.1,30,11,10,1.266667,0,0,8,9,false,false,false,0.005,0.995
64,9,55,21.333333,4.5,55,1193,1220,-27,0,0,0,0,83,3,2,0.518072,1,1,7,25,false,false,false,0.488,0.512
0,14,-14,0,14,-14,1454,1479,-25,0,0,0,0,94,1,1,0.329787,1,1,8,6,false,false,false,0.246,0.754
53,54,-1,10.6,13.5,-1,206,346,-140,0,0,0,0,72,5,4,0.597222,0,0,10,19,false,false,false,0.12,0.88
89,144,-55,14.833333,24,-55,518,414,104,0,1,0,0.166667,59,6,6,0.644068,0,0,7,13,false,false,false,0.177,0.823
165,151,14,18.333333,18.875,14,742,868,-126,0,0,0,0,42,9,8,0.785714,0,0,14,18,false,false,false,0.35,0.65
12,24,-12,12,24,-12,1205,1216,-11,0,0,0,0,94,1,1,0.351064,0,0,17,19,false,false,false,0.202,0.798
75,7,68,25,3.5,68,742,594,148,0,0,0,0,83,3,2,0.46988,0,0,15,11,false,false,true,0.913,0.087
276,287,-11,15.333333,16.882353,-11,430,542,-112,0,1,0,0.058824,-5,18,17,-9.6,0,0,18,13,false,false,false,0.064,0.936
254,333,-79,21.166667,27.75,-79,1126,1277,-151,0,0,0,0,0,12,12,0,0,0,7,23,false,false,false,0.006,0.994
139,169,-30,19.857143,28.166667,-30,1167,1245,-78,0,0,0,0,40,7,6,0.575,0,0,10,14,false,false,false,0.108,0.892
16,30,-14,8,15,-14,342,53,289,0,0,0,0,86,2,2,0.476744,0,0,7,17,false,false,false,0.298,0.702
175,182,-7,19.444444,22.75,-7,1349,1203,146,0,1,0,0.125,38,9,8,0.842105,0,0,7,26,false,false,false,0.029,0.971
259,302,-43,19.923077,23.230769,-43,1428,1361,67,0,0,0,0,5,13,13,6.6,1,0,9,9,false,false,false,0.114,0.886
109,130,-21,27.25,32.5,-21,1126,1277,-151,0,0,0,0,66,4,4,0.530303,0,0,13,9,false,false,false,0.163,0.837
131,225,-94,14.555556,25,-94,952,826,126,0,1,0,0.111111,49,9,9,0.877551,0,0,13,7,false,false,false,0.006,0.994
203,222,-19,22.555556,27.75,-19,1586,1633,-47,1,0,0.111111,0,49,9,8,0.693878,0,1,17,10,false,false,false,0.105,0.895
0,0,0,0,0,0,343,570,-227,0,0,0,0,100,1,0,0.36,0,0,8,0,false,false,false,0.249,0.751
77,192,-115,12.833333,38.4,-115,940,947,-7,0,2,0,0.4,56,6,5,0.625,0,0,10,16,false,false,false,0.001,0.999
350,376,-26,23.333333,25.066667,-26,1110,1123,-13,1,2,0.066667,0.133333,-12,15,15,-2.75,0,0,6,3,false,false,false,0.107,0.893
235,195,40,29.375,27.857143,40,1047,1127,-80,0,1,0,0.142857,36,8,7,0.75,0,0,13,9,false,false,true,0.741,0.259
265,345,-80,16.5625,21.5625,-80,795,786,9,1,0,0.0625,0,2,16,16,19,1,0,9,7,false,false,false,0.005,0.995
50,77,-27,16.666667,25.666667,-27,1633,1620,13,0,0,0,0,78,3,3,0.461538,0,0,10,20,false,false,false,0.107,0.893
192,353,-161,10.105263,18.578947,-161,651,996,-345,0,2,0,0.105263,-20,19,19,-2.25,0,0,14,4,false,false,false,0.005,0.995
285,318,-33,17.8125,19.875,-33,1210,1162,48,0,0,0,0,-3,16,16,-10.666667,0,0,6,13,true,false,false,0.024,0.976
75,115,-40,8.333333,12.777778,-40,288,359,-71,0,0,0,0,55,9,9,0.490909,0,0,14,17,false,false,false,0.127,0.873
157,300,-143,19.625,37.5,-143,2143,2219,-76,0,0,0,0,38,8,8,0.815789,0,0,12,16,false,false,false,0.006,0.994
131,236,-105,18.714286,33.714286,-105,976,995,-19,0,1,0,0.142857,51,7,7,0.745098,0,0,9,14,false,false,false,0.006,0.994
66,105,-39,13.2,21,-39,1606,1890,-284,0,0,0,0,64,5,5,0.4375,1,0,6,15,false,false,false,0.244,0.756
61,99,-38,15.25,33,-38,804,766,38,0,1,0,0.333333,74,4,3,0.554054,0,1,18,9,false,false,false,0.17,0.83
34,27,7,17,27,7,837,844,-7,0,0,0,0,91,2,1,0.450549,0,1,7,9,false,false,false,0.273,0.727
312,368,-56,18.352941,23,-56,561,633,-72,0,1,0,0.0625,-9,17,16,-3.888889,0,0,3,2,false,false,false,0.035,0.965
53,49,4,13.25,16.333333,4,278,1,277,0,0,0,0,69,4,3,0.536232,0,0,13,9,false,false,false,0.464,0.536
260,325,-65,26,32.5,-65,1554,1685,-131,0,1,0,0.1,25,10,10,1.28,0,1,12,7,false,false,false,0.013,0.987
201,205,-4,15.461538,17.083333,-4,402,448,-46,0,0,0,0,18,13,12,2.055556,0,2,17,14,false,false,false,0.002,0.998
59,42,17,19.666667,14,17,897,996,-99,0,0,0,0,80,3,3,0.4875,0,0,10,10,false,false,true,0.512,0.488
12,0,12,12,0,12,561,688,-127,0,0,0,0,96,1,0,0.479167,1,0,8,0,false,false,true,0.503,0.497
167,211,-44,11.133333,14.066667,-44,1220,1202,18,0,0,0,0,13,15,15,3.846154,0,2,33,8,false,false,false,0.079,0.921
52,45,7,26,22.5,7,518,461,57,0,0,0,0,87,2,2,0.413793,0,0,8,12,false,false,true,0.637,0.363
317,479,-162,19.8125,31.933333,-162,786,848,-62,1,2,0.0625,0.133333,-12,16,15,-2.583333,0,0,2,2,true,false,false,0.001,0.999
222,231,-9,20.181818,23.1,-9,1633,1620,13,0,0,0,0,22,11,10,1.636364,0,0,9,10,false,false,false,0.107,0.893
60,84,-24,20,28,-24,1539,1891,-352,0,1,0,0.333333,74,3,3,0.337838,0,0,17,9,false,false,false,0.252,0.748
320,306,14,20,19.125,14,1331,1374,-43,0,0,0,0,-15,16,16,-2.2,0,0,10,1,false,false,true,0.759,0.241
182,227,-45,14,17.461538,-45,830,787,43,0,0,0,0,17,13,13,2.235294,0,1,7,7,false,false,false,0.079,0.921
106,89,17,17.666667,17.8,17,1334,1439,-105,1,0,0.166667,0,78,6,5,0.461538,0,0,10,14,false,false,false,0.166,0.834
156,172,-16,19.5,24.571429,-16,356,498,-142,0,1,0,0.142857,47,8,7,0.744681,1,1,9,15,false,false,false,0.087,0.913
155,195,-40,31,39,-40,1436,1489,-53,1,1,0.2,0.2,61,5,5,0.606557,0,0,13,10,false,false,false,0.236,0.764
274,231,43,21.076923,19.25,43,1168,1216,-48,0,0,0,0,27,13,12,1.222222,0,0,7,7,false,false,true,0.706,0.294
329,461,-132,27.416667,41.909091,-132,1885,1908,-23,1,3,0.083333,0.272727,-15,12,11,-1.533333,0,0,2,6,true,false,false,0,1
189,247,-58,17.181818,22.454545,-58,889,895,-6,0,1,0,0.090909,26,11,11,1.423077,0,1,10,22,false,false,false,0.005,0.995
267,372,-105,29.666667,41.333333,-105,1925,1885,40,1,2,0.111111,0.222222,12,9,9,2.083333,0,0,9,19,false,false,false,0,1
379,384,-5,21.055556,22.588235,-5,1436,1489,-53,1,1,0.055556,0.058824,-9,18,17,-4.111111,0,0,1,3,false,false,false,0.092,0.908
293,425,-132,19.533333,30.357143,-132,1636,1702,-66,0,1,0,0.071429,-6,15,14,-4.833333,0,0,5,8,true,false,false,0.001,0.999
306,340,-34,15.3,17,-34,1281,1268,13,0,0,0,0,-20,20,20,-2.1,0,0,1,2,false,false,false,0.02,0.98
160,204,-44,20,25.5,-44,804,1080,-276,0,0,0,0,43,8,8,0.790698,0,0,12,14,false,false,false,0.105,0.895
294,377,-83,16.333333,22.176471,-83,691,704,-13,0,1,0,0.058824,-18,18,17,-2.111111,0,0,1,2,false,false,false,0.007,0.993
31,30,1,10.333333,15,1,342,53,289,0,0,0,0,83,3,2,0.493976,0,0,10,17,false,false,false,0.339,0.661
189,202,-13,23.625,25.25,-13,1063,1134,-71,1,0,0.125,0,53,8,8,0.830189,0,0,9,18,false,false,false,0.351,0.649
263,336,-73,18.785714,24,-73,1047,1253,-206,1,1,0.071429,0.071429,7,14,14,5.285714,1,0,7,17,false,false,false,0.005,0.995
199,220,-21,19.9,24.444444,-21,804,1080,-276,0,0,0,0,34,10,9,1,1,0,9,8,false,false,false,0.127,0.873
24,15,9,24,15,9,1219,1216,3,0,1,0,1,88,1,1,0.306818,0,0,7,11,false,false,true,0.568,0.432
153,176,-23,19.125,22,-23,758,791,-33,0,0,0,0,44,8,8,0.886364,0,1,11,11,false,false,false,0.109,0.891
226,379,-153,12.555556,21.055556,-153,760,976,-216,0,1,0,0.055556,-23,18,18,-1.565217,0,0,1,15,true,false,false,0.005,0.995
206,278,-72,13.733333,18.533333,-72,1045,948,97,0,0,0,0,-13,15,15,-2.615385,1,0,7,8,false,false,false,0.067,0.933
103,133,-30,20.6,26.6,-30,1439,1314,125,0,0,0,0,66,5,5,0.424242,0,0,19,9,false,false,false,0.234,0.766
70,120,-50,10,20,-50,813,698,115,0,0,0,0,60,7,6,0.8,1,1,7,7,false,false,false,0.241,0.759
238,277,-39,14,16.294118,-39,925,1000,-75,0,0,0,0,-4,17,17,-11,0,1,15,6,false,false,false,0.014,0.986
327,377,-50,19.235294,22.176471,-50,1164,1261,-97,0,1,0,0.058824,-8,17,17,-5.25,0,0,9,7,false,false,false,0.035,0.965
242,312,-70,18.615385,24,-70,700,820,-120,0,1,0,0.076923,6,13,13,6.333333,0,0,23,12,false,false,false,0.031,0.969
180,289,-109,12.857143,22.230769,-109,948,998,-50,0,0,0,0,6,14,13,6.166667,0,0,13,12,false,false,false,0.005,0.995
60,57,3,20,19,3,595,538,57,0,0,0,0,80,3,3,0.475,0,0,8,14,false,false,false,0.388,0.612
144,184,-40,20.571429,30.666667,-40,1045,1100,-55,0,0,0,0,55,7,6,0.618182,0,1,9,14,false,false,false,0.105,0.895
69,71,-2,8.625,8.875,-2,925,1000,-75,0,0,0,0,50,8,8,0.88,0,1,13,20,false,false,false,0.271,0.729
242,272,-30,15.125,17,-30,1040,1091,-51,0,0,0,0,3,16,16,15.666667,0,0,15,13,false,false,false,0.201,0.799
266,332,-66,12.666667,16.6,-66,813,698,115,1,0,0.047619,0,-21,21,20,-2.285714,0,0,2,10,false,false,false,0.029,0.971
158,232,-74,15.8,25.777778,-74,1094,1159,-65,0,0,0,0,31,10,9,1.225806,1,0,15,11,false,false,false,0.097,0.903
238,233,5,26.444444,29.125,5,1167,1245,-78,1,0,0.111111,0,19,9,8,1.210526,1,0,8,11,false,false,false,0.299,0.701
87,116,-29,21.75,29,-29,642,952,-310,0,0,0,0,69,4,4,0.637681,0,0,7,24,false,false,false,0.106,0.894
302,352,-50,21.571429,27.076923,-50,801,679,122,1,0,0.071429,0,-10,14,13,-2.9,0,0,5,1,false,false,false,0.018,0.982
29,71,-42,7.25,23.666667,-42,907,1070,-163,0,0,0,0,80,4,3,0.4375,0,0,22,7,false,false,false,0.106,0.894
26,22,4,8.666667,11,4,1580,1629,-49,0,0,0,0,87,3,2,0.425287,0,0,17,11,false,false,false,0.249,0.751
150,261,-111,16.666667,29,-111,976,995,-19,0,1,0,0.111111,39,9,9,0.974359,0,0,8,9,false,false,false,0.005,0.995
280,285,-5,17.5,19,-5,1270,1261,9,1,0,0.0625,0,13,16,15,2.846154,0,0,10,7,false,false,false,0.233,0.767
122,229,-107,10.166667,19.083333,-107,651,567,84,0,0,0,0,24,12,12,2.291667,0,0,7,8,false,false,false,0.005,0.995
288,387,-99,15.157895,20.368421,-99,1195,1397,-202,0,2,0,0.105263,-18,19,19,-2.222222,0,1,4,2,false,false,false,0,1
197,228,-31,17.909091,20.727273,-31,1302,1351,-49,0,0,0,0,28,11,11,1.321429,0,0,12,18,false,false,false,0.107,0.893
180,253,-73,12.857143,19.461538,-73,278,1,277,0,0,0,0,6,14,13,6.166667,0,0,21,7,false,false,false,0.01,0.99
260,255,5,17.333333,18.214286,5,1037,1009,28,0,0,0,0,18,15,14,2.444444,1,1,10,16,false,false,false,0.229,0.771
285,305,-20,13.571429,15.25,-20,526,502,24,0,0,0,0,-21,21,20,-2.380952,1,0,18,17,false,false,false,0.105,0.895
239,212,27,21.727273,21.2,27,1197,1156,41,0,1,0,0.1,28,11,10,1.25,1,0,9,11,false,false,true,0.923,0.077
264,301,-37,13.894737,15.842105,-37,1182,1075,107,0,1,0,0.052632,-27,19,19,-1.444444,0,1,12,3,false,false,false,0.001,0.999
135,164,-29,15,20.5,-29,721,757,-36,0,1,0,0.125,46,9,8,0.826087,0,0,14,12,false,false,false,0.223,0.777
25,47,-22,12.5,23.5,-22,342,263,79,0,0,0,0,86,2,2,0.395349,0,1,10,13,false,false,false,0.037,0.963
163,174,-11,11.642857,12.428571,-11,542,390,152,0,0,0,0,32,14,14,1.5625,0,0,7,19,false,false,false,0.455,0.545
307,321,-14,17.055556,18.882353,-14,451,448,3,0,0,0,0,-16,18,17,-2.3125,0,0,4,1,false,false,false,0.042,0.958
192,202,-10,17.454545,18.363636,-10,1417,1482,-65,0,0,0,0,39,11,11,0.846154,0,1,9,8,false,false,false,0.24,0.76
105,86,19,13.125,12.285714,19,1045,948,97,0,0,0,0,49,8,7,0.693878,0,0,9,15,false,false,false,0.347,0.653
69,127,-58,23,42.333333,-58,1537,1539,-2,0,1,0,0.333333,74,3,3,0.459459,0,0,8,11,false,false,false,0.056,0.944
78,33,45,26,16.5,45,1227,1189,38,0,0,0,0,78,3,2,0.448718,0,0,13,27,false,false,false,0.403,0.597
8,0,8,8,0,8,1210,1162,48,0,0,0,0,96,1,0,0.333333,0,0,7,0,false,false,false,0.339,0.661
68,89,-21,13.6,17.8,-21,1439,1428,11,0,0,0,0,69,5,5,0.57971,1,0,9,18,false,false,false,0.315,0.685
232,263,-31,21.090909,23.909091,-31,1269,1477,-208,1,0,0.090909,0,25,11,11,1.4,0,0,10,9,false,false,false,0.095,0.905
175,267,-92,9.210526,14.833333,-92,818,826,-8,0,0,0,0,-3,19,18,-17.666667,0,0,7,28,false,false,false,0.005,0.995
85,97,-12,21.25,24.25,-12,480,518,-38,0,0,0,0,71,4,4,0.56338,0,1,7,9,false,false,false,0.024,0.976
287,427,-140,15.944444,23.722222,-140,1315,1334,-19,0,2,0,0.111111,-17,18,18,-2.117647,0,0,1,4,true,false,false,0,1
213,218,-5,17.75,18.166667,-5,1037,1009,28,0,0,0,0,29,12,12,1.517241,1,1,7,8,false,false,false,0.246,0.754
224,320,-96,16,22.857143,-96,736,791,-55,0,0,0,0,0,14,14,0,0,0,9,7,false,false,false,0.005,0.995
229,301,-72,22.9,30.1,-72,1770,1745,25,1,0,0.1,0,30,10,10,1.1,0,0,8,7,false,false,false,0.013,0.987
93,137,-44,23.25,34.25,-44,1164,1149,15,0,0,0,0,72,4,4,0.652778,0,1,9,6,false,false,false,0.109,0.891
18,0,18,18,0,18,1037,913,124,0,0,0,0,97,1,0,0.391753,0,0,10,0,false,false,true,0.522,0.478
34,48,-14,11.333333,24,-14,915,971,-56,0,0,0,0,82,3,2,0.402439,0,0,9,30,false,false,false,0.107,0.893
185,205,-20,18.5,22.777778,-20,796,800,-4,1,0,0.1,0,34,10,9,1.411765,0,0,11,9,false,false,false,0.194,0.806
266,261,5,26.6,26.1,5,804,1074,-270,0,0,0,0,21,10,10,1.52381,0,1,8,12,false,false,false,0.12,0.88
182,163,19,18.2,18.111111,19,771,668,103,0,0,0,0,27,10,9,1.407407,0,0,7,31,false,false,true,0.686,0.314
96,201,-105,9.6,20.1,-105,1078,983,95,0,0,0,0,46,10,10,1.043478,1,1,7,15,false,false,false,0.008,0.992
231,247,-16,17.769231,20.583333,-16,1161,1030,131,0,1,0,0.083333,9,13,12,4.222222,0,0,16,9,false,false,false,0.171,0.829
70,84,-14,17.5,21,-14,874,868,6,0,0,0,0,68,4,4,0.485294,1,0,18,17,false,false,false,0.478,0.522
263,252,11,21.916667,22.909091,11,1561,1495,66,1,0,0.083333,0,8,12,11,4.125,0,0,12,15,false,false,false,0.485,0.515
79,86,-7,11.285714,12.285714,-7,1045,948,97,0,0,0,0,52,7,7,0.653846,0,0,11,15,false,false,false,0.241,0.759
136,192,-56,15.111111,24,-56,642,952,-310,0,0,0,0,44,9,8,1,0,1,9,14,false,false,false,0.001,0.999
328,381,-53,25.230769,31.75,-53,1086,926,160,0,2,0,0.166667,-5,13,12,-5.6,0,0,5,3,false,false,false,0.009,0.991
279,290,-11,17.4375,19.333333,-11,518,461,57,0,0,0,0,-8,16,15,-4.5,0,1,6,6,false,false,false,0.061,0.939
99,152,-53,9,15.2,-53,1045,1082,-37,0,0,0,0,35,11,10,1.285714,1,0,26,7,false,false,false,0.237,0.763
100,139,-39,16.666667,27.8,-39,1633,1620,13,0,0,0,0,61,6,5,0.590164,1,0,9,10,false,false,true,0.543,0.457
63,51,12,12.6,12.75,12,163,346,-183,0,0,0,0,63,5,4,0.619048,0,1,9,9,false,false,false,0.002,0.998
308,317,-9,17.111111,18.647059,-9,985,1062,-77,0,0,0,0,-17,18,17,-2.176471,1,0,2,3,false,false,false,0.374,0.626
268,230,38,20.615385,19.166667,38,1803,1658,145,1,0,0.076923,0,7,13,12,4.714286,0,0,7,16,false,false,true,0.71,0.29
52,55,-3,13,13.75,-3,561,633,-72,0,0,0,0,78,4,4,0.448718,1,1,12,10,false,false,false,0.282,0.718
140,168,-28,28,33.6,-28,1173,1256,-83,1,0,0.2,0,64,5,5,0.484375,0,1,11,8,false,false,false,0.002,0.998
50,65,-15,16.666667,21.666667,-15,1229,1220,9,0,0,0,0,78,3,3,0.474359,0,1,10,19,false,false,false,0.117,0.883
40,136,-96,10,34,-96,1270,1424,-154,0,1,0,0.25,75,4,4,0.466667,0,0,10,11,false,false,false,0.106,0.894
168,192,-24,14,17.454545,-24,848,976,-128,0,0,0,0,30,12,11,1.333333,0,0,19,12,false,false,false,0.111,0.889
282,344,-62,15.666667,20.235294,-62,1078,1095,-17,1,1,0.055556,0.058824,-14,18,17,-2.642857,0,0,6,4,false,false,false,0.03,0.97
214,407,-193,11.263158,21.421053,-193,1078,983,95,1,0,0.052632,0,-10,19,19,-4.8,0,0,12,12,false,false,false,0.005,0.995
29,45,-16,9.666667,15,-16,1269,1477,-208,0,0,0,0,83,3,3,0.421687,0,0,9,13,false,false,false,0.216,0.784
332,339,-7,19.529412,19.941176,-7,1257,1176,81,2,0,0.117647,0,-8,17,17,-4.25,0,0,3,3,true,false,false,0.129,0.871
169,302,-133,12.071429,23.230769,-133,1075,1189,-114,0,0,0,0,12,14,13,3.333333,0,1,7,21,false,false,false,0.005,0.995
372,397,-25,18.6,19.85,-25,1093,1173,-80,1,1,0.05,0.05,-23,20,20,-1.869565,0,0,2,4,false,false,false,0.178,0.822
148,190,-42,18.5,27.142857,-42,1488,1403,85,0,1,0,0.142857,45,8,7,0.755556,0,0,7,12,false,false,false,0.014,0.986
254,312,-58,14.111111,18.352941,-58,814,830,-16,0,0,0,0,-16,18,17,-2.5625,0,0,10,9,false,false,false,0.006,0.994
276,269,7,27.6,29.888889,7,1885,1842,43,0,2,0,0.222222,19,10,9,1.421053,0,1,14,9,false,false,false,0.038,0.962
187,178,9,20.777778,22.25,9,1227,1189,38,0,0,0,0,34,9,8,1.029412,0,0,11,23,false,false,false,0.197,0.803
237,330,-93,14.8125,22,-93,736,791,-55,0,0,0,0,-8,16,15,-4.75,0,0,12,16,false,false,false,0.005,0.995
212,230,-18,17.666667,19.166667,-18,615,542,73,0,0,0,0,24,12,12,1.75,0,0,13,9,false,false,true,0.572,0.428
145,161,-16,20.714286,23,-16,1495,1531,-36,0,0,0,0,58,7,7,0.637931,0,0,10,12,false,false,false,0.109,0.891
304,314,-10,25.333333,26.166667,-10,1552,1803,-251,2,0,0.166667,0,8,12,12,4.125,0,0,7,11,false,false,false,0.186,0.814
290,380,-90,16.111111,21.111111,-90,795,786,9,1,0,0.055556,0,-11,18,18,-3.454545,0,0,5,2,false,false,false,0.016,0.984
40,21,19,20,21,19,2010,2219,-209,0,0,0,0,90,2,1,0.288889,1,1,6,18,false,false,false,0.251,0.749
318,348,-30,22.714286,24.857143,-30,1188,1334,-146,1,1,0.071429,0.071429,-7,14,14,-4.285714,1,0,4,5,false,false,false,0.033,0.967
145,95,50,13.181818,9.5,50,491,651,-160,0,0,0,0,40,11,10,0.75,0,1,10,6,false,false,false,0.421,0.579
281,361,-80,18.733333,25.785714,-80,527,954,-427,0,1,0,0.071429,3,15,14,11.666667,0,0,18,10,false,false,false,0.009,0.991
253,312,-59,18.071429,24,-59,1055,1019,36,0,0,0,0,-2,14,13,-16.5,1,0,4,4,false,false,false,0.047,0.953
87,62,25,21.75,20.666667,25,985,1062,-77,0,0,0,0,73,4,3,0.506849,0,0,12,16,false,false,false,0.306,0.694
278,319,-41,14.631579,17.722222,-41,1312,1334,-22,0,0,0,0,-22,19,18,-1.772727,0,0,2,2,false,false,false,0.025,0.975
43,35,8,14.333333,17.5,8,805,918,-113,0,0,0,0,81,3,2,0.444444,0,1,35,9,false,false,true,0.507,0.493
307,365,-58,15.35,19.210526,-58,668,771,-103,0,0,0,0,-10,20,19,-4,0,1,1,1,false,false,false,0.005,0.995
248,233,15,19.076923,19.416667,15,907,910,-3,0,1,0,0.083333,31,13,12,1.387097,0,1,11,17,false,false,false,0.413,0.587
63,115,-52,12.6,23,-52,683,859,-176,0,0,0,0,68,5,5,0.661765,1,0,10,12,false,false,false,0.122,0.878
157,145,12,19.625,18.125,12,1043,1003,40,0,0,0,0,43,8,8,0.883721,0,0,18,15,false,false,true,0.67,0.33
258,329,-71,15.176471,19.352941,-71,620,698,-78,1,0,0.058824,0,-10,17,17,-4.1,0,0,18,7,false,false,false,0.034,0.966
279,408,-129,16.411765,25.5,-129,874,868,6,0,0,0,0,-20,17,16,-1.65,0,0,2,1,true,false,false,0.005,0.995
160,108,52,20,15.428571,52,742,594,148,0,0,0,0,51,8,7,0.764706,0,1,22,9,false,false,true,0.985,0.015
50,39,11,25,19.5,11,926,973,-47,0,0,0,0,84,2,2,0.416667,0,0,10,9,false,false,true,0.525,0.475
263,315,-52,18.785714,24.230769,-52,1094,1159,-65,0,0,0,0,-1,14,13,-38,1,0,6,22,false,false,false,0.039,0.961
0,40,-40,0,13.333333,-40,1334,1439,-105,0,0,0,0,95,4,3,0.378947,2,0,12,17,false,false,true,0.644,0.356
259,335,-76,15.235294,20.9375,-76,595,412,183,0,1,0,0.0625,1,17,16,52,0,0,10,10,false,false,false,0.004,0.996
84,177,-93,12,29.5,-93,1220,1202,18,0,0,0,0,56,7,6,0.892857,0,0,20,7,false,false,false,0.085,0.915
54,52,2,18,17.333333,2,621,786,-165,0,0,0,0,72,3,3,0.416667,0,0,22,10,false,false,false,0.397,0.603
198,241,-43,18,21.909091,-43,785,892,-107,0,0,0,0,27,11,11,1.37037,0,0,11,8,false,false,false,0.096,0.904
136,103,33,15.111111,11.444444,33,1040,1091,-51,0,0,0,0,46,9,9,1.021739,0,1,10,24,false,false,false,0.234,0.766
99,104,-5,16.5,20.8,-5,694,658,36,0,0,0,0,63,6,5,0.587302,0,0,37,7,false,false,true,0.541,0.459
202,264,-62,20.2,26.4,-62,999,1283,-284,0,1,0,0.1,32,10,10,1.03125,0,0,10,7,false,false,false,0.042,0.958
150,218,-68,18.75,31.142857,-68,971,800,171,0,1,0,0.142857,28,8,7,1.035714,0,0,9,9,false,false,false,0.011,0.989
40,7,33,13.333333,3.5,33,1315,1334,-19,0,0,0,0,84,3,2,0.428571,0,0,21,17,false,false,true,0.507,0.493
0,40,-40,0,13.333333,-40,1334,1439,-105,0,0,0,0,95,3,3,0.378947,2,0,12,17,false,false,true,0.645,0.355
10,0,10,10,0,10,758,904,-146,0,0,0,0,97,1,0,0.350515,0,0,20,0,false,false,false,0.468,0.532
324,392,-68,17.052632,21.777778,-68,771,668,103,2,0,0.105263,0,-32,19,18,-1.1875,0,0,1,2,false,false,false,0.034,0.966
48,77,-29,12,25.666667,-29,566,742,-176,0,0,0,0,74,4,3,0.432432,0,1,13,13,false,false,false,0.025,0.975
188,188,0,26.857143,31.333333,0,732,868,-136,0,1,0,0.166667,50,7,6,0.64,0,0,9,18,false,false,true,0.669,0.331
286,319,-33,22,24.538462,-33,1452,1388,64,0,1,0,0.076923,8,13,13,4.375,0,0,14,12,false,false,false,0.111,0.889
28,21,7,14,21,7,830,787,43,0,0,0,0,89,2,1,0.426966,0,0,22,19,false,false,false,0.286,0.714
165,250,-85,13.75,20.833333,-85,1101,1130,-29,1,1,0.083333,0.083333,30,12,12,1.5,0,1,11,17,false,false,false,0.005,0.995
151,205,-54,15.1,20.5,-54,450,427,23,0,1,0,0.1,30,10,10,1.233333,0,0,11,16,false,false,false,0.17,0.83
353,350,3,23.533333,25,3,1388,1366,22,0,1,0,0.071429,-5,15,14,-6.4,0,0,1,7,false,false,false,0.463,0.537
53,86,-33,13.25,21.5,-33,563,523,40,0,0,0,0,73,4,4,0.506849,0,0,11,21,false,false,false,0.149,0.851
288,423,-135,12.521739,18.391304,-135,1037,1016,21,1,0,0.043478,0,-18,23,23,-3.222222,1,0,7,5,false,false,false,0.005,0.995
102,221,-119,11.333333,24.555556,-119,1305,1307,-2,0,1,0,0.111111,36,9,9,1.138889,0,0,11,21,false,false,false,0.006,0.994
180,220,-40,16.363636,20,-40,907,910,-3,0,1,0,0.090909,43,11,11,1,0,1,10,19,false,false,false,0.049,0.951
223,234,-11,18.583333,21.272727,-11,1161,1030,131,0,1,0,0.090909,19,12,11,2,0,0,17,9,false,false,false,0.345,0.655
165,105,60,12.692308,8.076923,60,491,651,-160,0,0,0,0,27,13,13,1.111111,1,1,11,6,false,false,false,0.463,0.537
141,156,-15,15.666667,19.5,-15,344,315,29,1,0,0.111111,0,34,9,8,1.176471,0,0,22,13,false,false,true,0.695,0.305
137,161,-24,15.222222,20.125,-24,714,892,-178,0,0,0,0,48,9,8,0.875,0,1,11,6,false,false,false,0.121,0.879
395,539,-144,30.384615,44.916667,-144,1398,1431,-33,0,0,0,0,-18,13,12,-1.555556,0,0,1,10,false,false,false,0.003,0.997
230,263,-33,12.777778,14.611111,-33,808,749,59,0,0,0,0,-20,18,18,-2.1,0,0,6,7,false,false,false,0.131,0.869
162,208,-46,20.25,26,-46,964,1003,-39,0,1,0,0.125,43,8,8,0.906977,0,0,10,9,false,false,false,0.13,0.87
147,191,-44,18.375,23.875,-44,694,658,36,0,1,0,0.125,44,8,8,0.840909,0,1,32,6,false,false,false,0.319,0.681
66,128,-62,16.5,42.666667,-62,732,868,-136,0,1,0,0.333333,73,4,3,0.438356,0,0,7,24,false,false,false,0.106,0.894
261,278,-17,26.1,30.888889,-17,1164,1161,3,1,1,0.1,0.111111,8,10,9,2.875,0,1,25,9,false,false,false,0.243,0.757
209,270,-61,14.928571,20.769231,-61,95,453,-358,0,0,0,0,10,14,13,3.9,0,1,9,20,false,false,false,0,1
226,291,-65,17.384615,22.384615,-65,917,856,61,0,1,0,0.076923,14,13,13,2.357143,0,0,7,11,false,false,false,0.014,0.986
72,161,-89,24,53.666667,-89,1164,1261,-97,0,1,0,0.333333,76,3,3,0.552632,0,0,23,12,false,false,false,0.117,0.883
35,39,-4,8.75,9.75,-4,1037,1016,21,0,0,0,0,82,4,4,0.707317,0,1,7,8,false,false,false,0.247,0.753
185,240,-55,20.555556,26.666667,-55,980,965,15,0,0,0,0,38,9,9,1,0,0,10,8,false,false,false,0.096,0.904
59,116,-57,14.75,38.666667,-57,1422,1798,-376,0,1,0,0.333333,71,4,3,0.450704,1,0,19,10,false,false,false,0.257,0.743
302,348,-46,23.230769,26.769231,-46,1331,1347,-16,1,1,0.076923,0.076923,-10,13,13,-3.2,0,0,10,5,false,false,false,0.071,0.929
233,343,-110,19.416667,28.583333,-110,835,786,49,0,0,0,0,3,12,12,11.333333,0,0,8,7,false,false,false,0.005,0.995
89,117,-28,22.25,39,-28,1164,1161,3,0,1,0,0.333333,67,4,3,0.343284,1,0,8,26,false,false,true,0.611,0.389
199,328,-129,15.307692,27.333333,-129,1193,1177,16,0,1,0,0.083333,18,13,12,1.944444,0,0,14,10,false,false,false,0.004,0.996
212,271,-59,21.2,27.1,-59,1173,1256,-83,1,0,0.1,0,30,10,10,1.033333,1,1,13,18,false,false,false,0,1
278,371,-93,13.9,18.55,-93,595,412,183,0,1,0,0.05,-14,20,20,-3.714286,0,0,10,11,false,false,false,0.002,0.998
304,311,-7,20.266667,20.733333,-7,939,969,-30,0,0,0,0,-13,15,15,-2.538462,0,0,3,1,false,false,false,0.486,0.514
34,15,19,34,15,19,500,532,-32,0,0,0,0,91,1,1,0.450549,0,0,9,13,false,false,true,0.865,0.135
338,272,66,24.142857,20.923077,66,1156,1279,-123,2,0,0.142857,0,7,14,13,5.714286,0,1,10,24,false,false,false,0.374,0.626
267,348,-81,20.538462,26.769231,-81,732,868,-136,0,1,0,0.076923,1,13,13,32,0,0,10,18,false,false,false,0.008,0.992
329,454,-125,29.909091,45.4,-125,1885,1908,-23,1,3,0.090909,0.3,-12,11,10,-1.916667,0,0,2,6,false,false,false,0,1
25,27,-2,12.5,13.5,-2,278,1,277,0,0,0,0,83,2,2,0.445783,0,0,12,12,false,false,true,0.56,0.44
221,373,-152,15.785714,28.692308,-152,1399,1210,189,0,1,0,0.076923,8,14,13,4.375,0,0,9,7,false,false,false,0.065,0.935
14,0,14,14,0,14,671,638,33,0,0,0,0,96,1,0,0.510417,0,0,13,0,false,false,true,0.523,0.477
175,296,-121,17.5,32.888889,-121,1368,1452,-84,1,1,0.1,0.111111,36,10,9,0.888889,0,1,9,11,false,false,false,0.004,0.996
166,241,-75,18.444444,30.125,-75,1110,1399,-289,0,1,0,0.125,41,9,8,0.829268,0,0,23,9,false,false,false,0.034,0.966
87,98,-11,14.5,16.333333,-11,1452,1388,64,0,0,0,0,62,6,6,0.564516,0,0,15,18,false,false,false,0.128,0.872
145,190,-45,12.083333,15.833333,-45,814,830,-16,0,0,0,0,22,12,12,1.863636,0,0,19,25,false,false,false,0.108,0.892
342,358,-16,28.5,32.545455,-16,1793,1957,-164,1,2,0.083333,0.181818,7,12,11,4.142857,0,0,10,11,false,false,false,0.244,0.756
56,101,-45,18.666667,33.666667,-45,1422,1583,-161,0,1,0,0.333333,75,3,3,0.546667,0,0,14,9,false,false,false,0.173,0.827
296,308,-12,18.5,20.533333,-12,758,904,-146,1,0,0.0625,0,-14,16,15,-2.428571,0,1,2,7,false,false,false,0.001,0.999
25,23,2,12.5,23,2,503,668,-165,0,0,0,0,88,2,1,0.420455,0,0,7,14,false,false,false,0.126,0.874
220,304,-84,22,33.777778,-84,2143,2219,-76,0,0,0,0,24,10,9,1.291667,0,0,14,18,false,false,false,0.088,0.912
27,17,10,13.5,8.5,10,542,390,152,0,0,0,0,92,2,2,0.543478,0,0,10,21,false,false,true,0.557,0.443
73,109,-36,12.166667,18.166667,-36,1064,1397,-333,0,1,0,0.166667,78,6,6,0.551282,1,0,9,11,false,false,false,0.245,0.755
209,177,32,17.416667,16.090909,32,720,437,283,0,0,0,0,33,12,11,1.272727,1,0,13,9,false,false,true,0.97,0.03
333,375,-42,15.857143,18.75,-42,1064,1397,-333,0,2,0,0.1,-16,21,20,-2.6875,1,0,5,2,false,false,false,0.057,0.943
54,72,-18,13.5,18,-18,1439,1428,11,0,0,0,0,76,4,4,0.526316,1,0,9,20,false,false,false,0.464,0.536
148,141,7,24.666667,23.5,7,1093,1100,-7,1,0,0.166667,0,58,6,6,0.534483,0,0,7,23,false,false,false,0.43,0.57
176,214,-38,16,21.4,-38,711,746,-35,0,0,0,0,30,11,10,1.266667,0,0,12,16,false,false,false,0.092,0.908
277,294,-17,23.083333,26.727273,-17,1388,1366,22,0,1,0,0.090909,13,12,11,2.461538,0,0,8,13,false,false,false,0.196,0.804
314,317,-3,18.470588,19.8125,-3,939,969,-30,0,0,0,0,-18,17,16,-1.833333,0,0,2,1,true,false,false,0.373,0.627
279,335,-56,16.411765,19.705882,-56,344,315,29,1,1,0.058824,0.058824,-24,17,17,-1.666667,0,0,8,5,false,false,false,0.056,0.944
413,465,-52,31.769231,38.75,-52,1777,1689,88,1,1,0.076923,0.083333,-9,13,12,-3,0,0,3,1,false,false,false,0.001,0.999
14,0,14,14,0,14,1452,1388,64,0,0,0,0,97,1,0,0.360825,0,0,14,0,false,false,false,0.475,0.525
162,176,-14,18,22,-14,758,791,-33,0,0,0,0,41,9,8,0.95122,0,1,11,11,false,false,false,0.107,0.893
295,382,-87,19.666667,25.466667,-87,1127,995,132,0,1,0,0.066667,-5,15,15,-6.6,0,0,13,3,false,false,false,0.002,0.998
145,178,-33,16.111111,19.777778,-33,402,448,-46,0,0,0,0,41,9,9,0.902439,0,1,9,14,false,false,false,0.057,0.943
109,133,-24,18.166667,26.6,-24,1636,1796,-160,0,0,0,0,58,6,5,0.465517,0,0,12,9,false,false,false,0.109,0.891
48,37,11,12,9.25,11,1168,1216,-48,0,0,0,0,82,4,4,0.402439,0,0,19,27,false,false,false,0.154,0.846
146,128,18,20.857143,18.285714,18,1078,1095,-17,1,0,0.142857,0,53,7,7,0.698113,0,1,20,10,false,false,true,0.524,0.476
209,360,-151,11,20,-151,977,1100,-123,0,1,0,0.055556,-6,19,18,-6.833333,0,0,9,10,false,false,false,0.005,0.995
215,291,-76,19.545455,29.1,-76,653,1004,-351,0,0,0,0,18,11,10,1.611111,0,0,14,8,false,false,false,0.006,0.994
232,305,-73,15.466667,21.785714,-73,653,820,-167,0,0,0,0,-6,15,14,-6.333333,0,0,6,19,false,false,false,0.005,0.995
161,247,-86,16.1,24.7,-86,1003,1018,-15,0,0,0,0,30,10,10,1.233333,0,0,17,11,false,false,false,0.011,0.989
247,317,-70,15.4375,21.133333,-70,95,453,-358,0,0,0,0,-5,16,15,-7.8,0,0,4,8,false,false,false,0.005,0.995
84,97,-13,21,32.333333,-13,835,786,49,0,0,0,0,72,4,3,0.472222,0,0,22,12,false,false,false,0.284,0.716
252,267,-15,14.823529,15.705882,-15,797,796,1,0,0,0,0,7,17,17,7,1,0,8,17,false,false,false,0.348,0.652
255,300,-45,14.166667,17.647059,-45,615,542,73,0,0,0,0,-8,18,17,-5.25,0,0,11,7,false,false,false,0.027,0.973
328,348,-20,18.222222,19.333333,-20,1055,840,215,0,1,0,0.055556,-18,18,18,-2,0,0,3,1,true,false,false,0.011,0.989
291,336,-45,18.1875,21,-45,727,820,-93,0,1,0,0.0625,-11,16,16,-3.181818,0,1,9,2,false,false,false,0.009,0.991
30,23,7,30,23,7,1761,1770,-9,0,0,0,0,92,1,1,0.282609,0,0,16,8,false,false,true,0.513,0.487
172,234,-62,19.111111,26,-62,892,856,36,0,1,0,0.111111,33,9,9,1.060606,1,0,7,10,false,false,false,0.113,0.887
297,390,-93,15.631579,21.666667,-93,848,976,-128,0,1,0,0.055556,-13,19,18,-3.076923,0,0,2,5,false,false,false,0.006,0.994
222,373,-151,13.058824,23.3125,-151,760,976,-216,0,1,0,0.0625,-17,17,16,-2.117647,0,0,1,18,false,false,false,0.005,0.995
128,119,9,18.285714,19.833333,9,450,503,-53,0,0,0,0,53,7,6,0.735849,1,0,19,13,false,false,false,0.483,0.517
305,354,-49,20.333333,25.285714,-49,1232,1281,-49,0,2,0,0.142857,-12,15,14,-2.583333,0,0,2,5,false,false,false,0.002,0.998
24,28,-4,12,28,-4,915,971,-56,0,0,0,0,91,2,1,0.362637,0,0,8,30,false,false,false,0.108,0.892
59,115,-56,14.75,28.75,-56,1488,1403,85,0,1,0,0.25,70,4,4,0.485714,0,0,17,13,false,false,false,0.119,0.881
135,153,-18,19.285714,25.5,-18,1636,1796,-160,0,0,0,0,50,7,6,0.54,0,0,13,16,false,false,false,0.106,0.894
74,60,14,18.5,20,14,1094,1041,53,0,0,0,0,72,4,3,0.527778,1,0,13,8,false,false,true,0.562,0.438
309,358,-49,28.090909,32.545455,-49,1793,1957,-164,1,2,0.090909,0.181818,10,11,11,2.9,0,0,16,11,false,false,false,0.057,0.943
169,264,-95,21.125,37.714286,-95,1334,1486,-152,1,0,0.125,0,53,8,7,0.54717,0,0,9,20,false,false,false,0.005,0.995
238,312,-74,14,18.352941,-74,814,830,-16,0,0,0,0,-12,17,17,-3.416667,0,0,12,9,false,false,false,0.006,0.994
268,438,-170,12.181818,20.857143,-170,1078,983,95,1,0,0.045455,0,-26,22,21,-1.846154,0,0,6,6,false,false,false,0.003,0.997
39,33,6,13,16.5,6,1063,1134,-71,0,0,0,0,84,3,2,0.52381,0,0,13,19,false,false,false,0.122,0.878
217,372,-155,14.466667,24.8,-155,473,683,-210,0,0,0,0,-1,15,15,-38,0,0,7,9,false,false,false,0.005,0.995
96,122,-26,19.2,24.4,-26,1422,1583,-161,0,1,0,0.2,63,5,5,0.650794,0,0,14,27,false,false,false,0.108,0.892
198,225,-27,18,22.5,-27,785,892,-107,0,0,0,0,30,11,10,1.233333,0,0,11,8,false,false,false,0.106,0.894
136,227,-91,12.363636,22.7,-91,948,998,-50,0,0,0,0,26,11,10,1.423077,1,0,14,13,false,false,false,0.03,0.97
74,109,-35,12.333333,18.166667,-35,1071,1000,71,0,0,0,0,65,6,6,0.723077,1,0,6,19,false,false,false,0.151,0.849
210,247,-37,19.090909,24.7,-37,1205,1216,-11,0,0,0,0,27,11,10,1.222222,0,0,16,13,false,false,false,0.104,0.896
32,16,16,16,8,16,526,502,24,0,0,0,0,86,2,2,0.581395,0,1,21,22,false,false,false,0.378,0.622
317,355,-38,22.642857,25.357143,-38,1110,1123,-13,1,2,0.071429,0.142857,-3,14,14,-11,0,0,11,9,false,false,false,0.058,0.942
131,194,-63,32.75,64.666667,-63,2147,2219,-72,0,2,0,0.666667,63,4,3,0.380952,0,0,11,19,false,false,false,0.033,0.967
123,42,81,61.5,42,81,1436,1489,-53,1,0,0.5,0,86,2,1,0.430233,0,0,9,21,false,false,true,0.715,0.285
310,314,-4,25.833333,26.166667,-4,714,820,-106,1,0,0.083333,0,15,12,12,2.066667,0,0,12,9,false,false,false,0.179,0.821
51,64,-13,17,21.333333,-13,694,658,36,0,0,0,0,79,3,3,0.468354,0,0,13,8,false,false,false,0.346,0.654
54,76,-22,18,25.333333,-22,450,503,-53,0,0,0,0,76,3,3,0.513158,0,0,22,13,false,false,false,0.296,0.704
253,288,-35,21.083333,24,-35,1245,1148,97,0,0,0,0,11,12,12,3.181818,0,0,16,7,false,false,false,0.182,0.818
168,217,-49,14,19.727273,-49,683,859,-176,0,0,0,0,32,12,11,1.40625,1,0,10,16,false,false,false,0.087,0.913
285,412,-127,16.764706,25.75,-127,1229,1220,9,0,1,0,0.0625,-7,17,16,-5.285714,0,0,3,3,false,false,false,0,1
197,270,-73,15.153846,22.5,-73,1493,1453,40,0,0,0,0,15,13,12,2.333333,0,1,15,10,false,false,false,0.005,0.995
275,257,18,15.277778,15.117647,18,796,800,-4,1,0,0.055556,0,5,18,17,9.6,0,1,10,8,false,false,false,0.23,0.77
191,267,-76,14.692308,20.538462,-76,889,855,34,0,1,0,0.076923,18,13,13,2.222222,0,0,23,16,false,false,false,0.023,0.977
185,283,-98,26.428571,40.428571,-98,1415,1361,54,0,1,0,0.142857,41,7,7,0.756098,0,0,14,17,false,false,false,0.001,0.999
31,28,3,15.5,28,3,1176,1211,-35,0,0,0,0,86,2,1,0.383721,1,0,9,18,false,false,true,0.559,0.441
139,81,58,27.8,20.25,58,1093,1100,-7,1,0,0.2,0,68,5,4,0.455882,0,0,7,23,false,false,true,0.713,0.287
14,14,0,14,14,0,1388,1366,22,0,0,0,0,92,1,1,0.347826,0,0,11,9,false,false,false,0.454,0.546
122,193,-71,11.090909,17.545455,-71,226,361,-135,0,0,0,0,23,11,11,1.913043,0,0,8,7,false,false,false,0.013,0.987
0,30,-30,0,30,-30,1078,983,95,0,0,0,0,95,1,1,0.505263,1,0,9,12,false,false,false,0.378,0.622
270,328,-58,15,19.294118,-58,603,721,-118,0,0,0,0,-6,18,17,-7.166667,1,0,6,8,false,false,false,0.005,0.995
118,131,-13,16.857143,21.833333,-13,1037,1009,28,0,0,0,0,58,7,6,0.758621,0,1,17,6,false,false,false,0.212,0.788
129,179,-50,16.125,25.571429,-50,822,845,-23,0,0,0,0,52,8,7,0.673077,0,0,26,10,false,false,false,0.105,0.895
98,14,84,49,14,84,1397,1405,-8,1,0,0.5,0,82,2,1,0.353659,0,0,16,19,false,false,true,0.596,0.404
209,296,-87,14.928571,21.142857,-87,95,453,-358,0,0,0,0,6,14,14,6.5,0,0,9,12,false,false,false,0.005,0.995
218,395,-177,16.769231,30.384615,-177,1045,1100,-55,0,1,0,0.076923,10,13,13,3.4,0,0,12,12,false,false,false,0.005,0.995
73,102,-29,24.333333,34,-29,1885,1908,-23,0,2,0,0.666667,72,3,3,0.319444,1,0,7,19,false,false,false,0.262,0.738
272,348,-76,20.923077,26.769231,-76,1126,1277,-151,0,0,0,0,-7,13,13,-5,0,0,5,11,false,false,false,0.006,0.994
10,0,10,10,0,10,527,954,-427,0,0,0,0,97,1,0,0.360825,0,0,11,0,false,false,false,0.246,0.754
230,197,33,28.75,24.625,33,1373,1334,39,1,1,0.125,0.125,43,8,8,0.744186,0,0,12,18,false,false,true,0.783,0.217
229,399,-170,17.615385,30.692308,-170,724,398,326,1,1,0.076923,0.076923,20,13,13,1.95,1,0,6,7,false,false,false,0.006,0.994
310,362,-52,19.375,24.133333,-52,561,633,-72,0,1,0,0.066667,-3,16,15,-11.666667,0,0,4,4,false,false,false,0.036,0.964
133,188,-55,16.625,23.5,-55,736,791,-55,0,0,0,0,46,8,8,0.826087,0,0,7,7,false,false,false,0.104,0.896
105,75,30,21,18.75,30,1232,1448,-216,0,0,0,0,65,5,4,0.538462,0,0,7,19,false,false,false,0.138,0.862
236,303,-67,16.857143,21.642857,-67,795,786,9,1,0,0.071429,0,15,14,14,2.533333,0,0,12,14,false,false,false,0.027,0.973
250,276,-26,17.857143,19.714286,-26,518,461,57,0,0,0,0,2,14,14,18,0,1,9,8,false,false,false,0.017,0.983
44,34,10,22,17,10,1493,1453,40,0,0,0,0,88,2,2,0.397727,0,0,10,23,false,false,false,0.259,0.741
309,330,-21,23.769231,25.384615,-21,1305,1211,94,2,0,0.153846,0,8,13,13,4.125,0,1,15,7,false,false,false,0.014,0.986
149,122,27,16.555556,13.555556,27,897,996,-99,0,0,0,0,43,9,9,0.906977,0,0,17,10,false,false,true,0.863,0.137
226,266,-40,17.384615,20.461538,-40,595,733,-138,1,1,0.076923,0.076923,8,13,13,4.875,0,1,19,18,false,false,false,0.032,0.968
83,104,-21,13.833333,17.333333,-21,480,739,-259,0,0,0,0,63,6,6,0.619048,0,1,7,10,false,false,false,0.003,0.997
67,50,17,16.75,12.5,17,450,427,23,0,0,0,0,72,4,4,0.513889,0,2,16,8,false,false,false,0.023,0.977
162,212,-50,13.5,17.666667,-50,651,700,-49,0,0,0,0,24,12,12,2.333333,1,0,6,15,false,false,false,0.101,0.899
327,395,-68,19.235294,23.235294,-68,1495,1531,-36,0,1,0,0.058824,-8,17,17,-4.625,0,0,2,2,false,false,false,0.002,0.998
27,23,4,13.5,23,4,1270,1424,-154,0,0,0,0,91,2,1,0.384615,0,0,7,10,false,false,false,0.242,0.758
234,262,-28,11.7,13.1,-28,342,53,289,0,0,0,0,-31,20,20,-1.322581,0,0,2,1,false,false,false,0.01,0.99
14,0,14,14,0,14,2010,2219,-209,0,0,0,0,97,1,0,0.268041,1,0,11,0,false,false,true,0.619,0.381
72,56,16,18,18.666667,16,785,892,-107,0,0,0,0,74,4,3,0.5,1,0,25,9,false,false,true,0.532,0.468
326,337,-11,16.3,16.85,-11,540,498,42,1,0,0.05,0,-31,20,20,-1.483871,0,0,4,8,false,false,true,0.506,0.494
15,5,10,7.5,5,10,540,498,42,0,0,0,0,90,2,1,0.511111,0,1,18,13,false,false,false,0.464,0.536
333,432,-99,33.3,43.2,-99,2010,2219,-209,1,1,0.1,0.1,11,10,10,2.363636,0,0,13,7,false,false,false,0.01,0.99
292,319,-27,15.368421,16.789474,-27,1203,1270,-67,1,0,0.052632,0,-14,19,19,-3.142857,1,0,9,5,false,false,false,0.139,0.861
338,318,20,28.166667,28.909091,20,1885,1842,43,0,2,0,0.181818,4,12,11,6.75,0,1,12,6,false,false,false,0.167,0.833
289,303,-14,18.0625,18.9375,-14,1021,1094,-73,1,0,0.0625,0,-4,16,16,-9.25,1,1,6,5,false,false,false,0.103,0.897
173,111,62,57.666667,37,62,169,306,-137,2,1,0.666667,0.333333,61,3,3,0.508197,0,0,12,20,false,false,false,0.004,0.996
254,267,-13,18.142857,19.071429,-13,1281,1268,13,0,0,0,0,14,14,14,3,0,0,8,10,false,false,false,0.267,0.733
102,81,21,14.571429,11.571429,21,1193,1220,-27,0,0,0,0,49,7,7,0.877551,1,1,11,22,false,false,false,0.385,0.615
247,240,7,14.529412,15,7,361,413,-52,0,0,0,0,-12,17,16,-3.416667,0,0,19,7,false,false,true,0.592,0.408
63,74,-11,15.75,24.666667,-11,668,771,-103,0,0,0,0,71,4,3,0.56338,0,0,15,20,false,false,false,0.143,0.857
187,193,-6,13.357143,14.846154,-6,808,749,59,0,0,0,0,7,14,13,6,0,0,7,11,false,false,false,0.136,0.864
193,253,-60,14.846154,21.083333,-60,714,892,-178,0,1,0,0.083333,20,13,12,2.1,0,0,9,8,false,false,false,0.007,0.993
16,21,-5,16,21,-5,727,820,-93,0,0,0,0,92,1,1,0.380435,0,1,8,12,false,false,false,0.254,0.746
159,122,37,22.714286,20.333333,37,967,856,111,0,0,0,0,49,7,6,0.673469,0,0,9,21,false,false,true,0.704,0.296
67,104,-37,16.75,34.666667,-37,1248,1220,28,0,1,0,0.333333,74,4,3,0.702703,0,0,10,15,false,false,false,0.117,0.883
56,30,26,28,15,26,356,498,-142,0,0,0,0,87,2,2,0.402299,0,0,7,13,false,false,true,0.865,0.135
307,346,-39,13.347826,15.727273,-39,1045,1082,-37,0,0,0,0,-35,23,22,-1.285714,0,0,1,1,true,false,false,0.006,0.994
278,327,-49,13.9,17.210526,-49,1312,1334,-22,0,0,0,0,-25,20,19,-1.56,0,0,2,2,true,false,false,0.007,0.993
42,76,-34,10.5,25.333333,-34,803,786,17,0,0,0,0,76,4,3,0.421053,0,0,17,7,false,false,false,0.118,0.882
90,77,13,22.5,25.666667,13,1556,1513,43,0,0,0,0,69,4,3,0.449275,1,0,10,7,false,false,true,0.851,0.149
342,385,-43,24.428571,27.5,-43,1086,926,160,0,2,0,0.142857,-12,14,14,-2.333333,0,0,5,1,true,false,false,0.007,0.993
28,48,-20,14,24,-20,714,892,-178,0,0,0,0,83,2,2,0.506024,1,1,18,17,false,false,false,0.145,0.855
147,171,-24,12.25,14.25,-24,999,1071,-72,0,0,0,0,23,12,12,1.73913,1,0,15,17,false,false,false,0.206,0.794
266,354,-88,17.733333,23.6,-88,1633,1739,-106,1,0,0.066667,0,-3,15,15,-11.333333,1,0,9,16,false,false,false,0.005,0.995
72,67,5,14.4,16.75,5,775,786,-11,0,0,0,0,69,5,4,0.623188,0,0,8,16,false,false,false,0.144,0.856
147,150,-3,16.333333,16.666667,-3,913,1037,-124,0,1,0,0.111111,57,9,9,0.719298,0,0,16,11,false,false,false,0.48,0.52
14,0,14,14,0,14,725,668,57,0,0,0,0,97,1,0,0.360825,0,0,9,0,false,false,true,0.517,0.483
128,156,-28,14.222222,19.5,-28,278,1,277,0,0,0,0,35,9,8,1.057143,0,1,21,18,false,false,false,0.148,0.852
210,306,-96,19.090909,30.6,-96,1232,1448,-216,0,2,0,0.2,23,11,10,1.521739,0,0,12,9,false,false,false,0.005,0.995
278,349,-71,19.857143,24.928571,-71,1110,1399,-289,0,1,0,0.071429,14,14,14,2.428571,0,0,8,11,false,false,false,0.007,0.993
237,402,-165,19.75,33.5,-165,1636,1727,-91,0,2,0,0.166667,5,12,12,6,1,0,9,19,false,false,false,0.001,0.999
238,283,-45,14,17.6875,-45,814,830,-16,0,0,0,0,-10,17,16,-4.1,0,0,12,14,false,false,false,0.008,0.992
301,332,-31,17.705882,19.529412,-31,775,786,-11,1,0,0.058824,0,-8,17,17,-5.375,1,0,18,20,false,false,false,0.073,0.927
343,362,-19,20.176471,22.625,-19,1070,814,256,1,1,0.058824,0.0625,-14,17,16,-2.357143,0,0,2,1,true,false,false,0.008,0.992
282,359,-77,15.666667,19.944444,-77,341,416,-75,0,0,0,0,-18,18,18,-2.166667,0,0,2,1,false,false,false,0.01,0.99
262,286,-24,16.375,19.066667,-24,1176,1211,-35,0,1,0,0.066667,-15,16,15,-2.2,0,0,3,1,false,false,false,0.108,0.892
234,320,-86,15.6,21.333333,-86,595,412,183,0,1,0,0.066667,9,15,15,5.777778,0,0,12,10,false,false,false,0.003,0.997
334,365,-31,15.181818,17.380952,-31,540,498,42,1,0,0.045455,0,-37,22,21,-1.243243,0,0,2,3,false,false,false,0.054,0.946
274,331,-57,27.4,33.1,-57,1086,926,160,0,2,0,0.2,17,10,10,1.647059,0,0,9,10,false,false,false,0.014,0.986
319,372,-53,21.266667,24.8,-53,1071,1065,6,0,0,0,0,-15,15,15,-2.066667,0,0,1,1,false,false,false,0.006,0.994
53,37,16,17.666667,18.5,16,736,791,-55,0,0,0,0,83,3,2,0.457831,1,0,14,20,false,false,true,0.522,0.478
73,109,-36,12.166667,21.8,-36,1064,1397,-333,0,1,0,0.2,78,6,5,0.551282,1,0,9,19,false,false,false,0.138,0.862
60,74,-14,20,24.666667,-14,402,448,-46,0,0,0,0,77,3,3,0.480519,0,1,7,6,false,false,false,0.005,0.995
179,211,-32,17.9,21.1,-32,451,448,3,0,0,0,0,35,10,10,1.057143,0,0,7,10,false,false,false,0.285,0.715
22,48,-26,11,24,-26,795,786,9,0,0,0,0,92,2,2,0.413043,0,0,7,10,false,false,false,0.125,0.875
31,63,-32,15.5,31.5,-32,1176,1211,-35,0,0,0,0,82,2,2,0.402439,1,0,9,17,false,false,false,0.335,0.665
180,277,-97,12.857143,19.785714,-97,977,1100,-123,0,1,0,0.071429,19,14,14,2.157895,0,1,11,17,false,false,false,0.005,0.995
121,168,-47,15.125,24,-47,642,952,-310,0,0,0,0,49,8,7,0.897959,0,0,11,24,false,false,false,0.101,0.899
192,198,-6,21.333333,24.75,-6,689,804,-115,0,0,0,0,37,9,8,0.945946,0,0,13,9,false,false,false,0.194,0.806
160,190,-30,12.307692,15.833333,-30,814,830,-16,0,0,0,0,20,13,12,2.05,0,0,22,25,false,false,false,0.125,0.875
328,370,-42,17.263158,19.473684,-42,1063,1134,-71,1,0,0.052632,0,-7,19,19,-6.285714,0,0,6,3,false,false,false,0.036,0.964
297,273,24,24.75,24.818182,24,1305,1211,94,2,0,0.166667,0,18,12,11,1.833333,0,0,18,10,false,false,true,0.733,0.267
185,205,-20,18.5,20.5,-20,796,800,-4,1,0,0.1,0,34,10,10,1.411765,0,0,11,8,false,false,true,0.565,0.435
218,309,-91,21.8,34.333333,-91,1003,1004,-1,0,1,0,0.111111,31,10,9,1.129032,0,1,7,9,false,false,false,0,1
20,18,2,10,18,2,1344,1314,30,0,1,0,1,88,2,1,0.386364,0,0,8,7,false,false,true,0.536,0.464
369,414,-45,41,51.75,-45,2147,2219,-72,1,2,0.111111,0.25,11,9,8,2.181818,0,0,10,11,false,false,false,0.018,0.982
107,169,-62,11.888889,18.777778,-62,503,668,-165,0,0,0,0,43,9,9,0.860465,0,0,12,8,false,false,false,0.096,0.904
170,195,-25,28.333333,39,-25,1436,1489,-53,1,1,0.166667,0.2,59,6,5,0.627119,0,0,10,10,false,false,false,0.156,0.844
227,249,-22,14.1875,16.6,-22,1182,1075,107,0,1,0,0.066667,-7,16,15,-5.571429,0,1,15,6,false,false,false,0.007,0.993
355,389,-34,22.1875,25.933333,-34,1495,1597,-102,0,1,0,0.066667,-12,16,15,-2.666667,0,0,6,4,false,false,false,0.013,0.987
258,243,15,21.5,22.090909,15,786,885,-99,1,1,0.083333,0.090909,26,12,11,1.307692,0,0,10,33,false,false,false,0.413,0.587
304,237,67,25.333333,21.545455,67,1552,1803,-251,2,0,0.166667,0,16,12,11,2.0625,0,1,7,7,false,false,true,0.974,0.026
279,316,-37,17.4375,19.75,-37,451,448,3,0,0,0,0,-6,16,16,-6.166667,0,0,13,3,false,false,false,0.039,0.961
279,406,-127,17.4375,27.066667,-127,874,868,6,0,0,0,0,-18,16,15,-1.833333,0,0,2,1,false,false,false,0.005,0.995
204,315,-111,15.692308,26.25,-111,935,995,-60,1,1,0.076923,0.083333,19,13,12,2.052632,0,0,18,14,false,false,false,0.006,0.994
233,289,-56,33.285714,41.285714,-56,1431,1399,32,0,2,0,0.285714,29,7,7,0.862069,0,0,12,9,false,false,false,0.07,0.93
254,332,-78,19.538462,27.666667,-78,874,868,6,0,0,0,0,5,13,12,6.6,0,0,11,9,false,false,false,0.005,0.995
10,23,-13,5,23,-13,1257,1176,81,0,0,0,0,94,2,1,0.361702,0,0,17,18,false,false,false,0.117,0.883
251,333,-82,13.944444,19.588235,-82,653,820,-167,0,0,0,0,-23,18,17,-1.652174,0,0,1,3,false,false,false,0.005,0.995
246,298,-52,20.5,24.833333,-52,694,658,36,0,1,0,0.083333,21,12,12,1.761905,0,0,13,12,false,false,false,0.039,0.961
166,226,-60,16.6,22.6,-60,344,315,29,1,0,0.1,0,22,10,10,1.818182,0,0,21,11,false,false,false,0.056,0.944
26,61,-35,26,61,-35,1071,1065,6,0,0,0,0,87,1,1,0.356322,0,0,9,17,false,false,false,0.232,0.768
175,183,-8,29.166667,36.6,-8,1164,1161,3,0,1,0,0.2,49,6,5,0.469388,0,0,7,12,false,false,false,0.331,0.669
250,312,-62,14.705882,18.352941,-62,518,414,104,0,1,0,0.058824,-6,17,17,-6.333333,0,0,16,5,false,false,false,0.029,0.971
323,355,-32,21.533333,23.666667,-32,1101,1237,-136,1,0,0.066667,0,0,15,15,0,0,0,15,5,false,false,false,0.037,0.963
45,28,17,15,14,17,361,413,-52,0,0,0,0,82,3,2,0.5,0,0,26,13,false,false,true,0.592,0.408
62,44,18,20.666667,14.666667,18,356,498,-142,0,0,0,0,79,3,3,0.443038,0,0,10,11,false,false,true,0.793,0.207
59,44,15,14.75,14.666667,15,1488,1403,85,0,0,0,0,77,4,3,0.441558,0,1,17,9,false,false,false,0.308,0.692
12,0,12,12,0,12,1161,1176,-15,0,0,0,0,97,1,0,0.391753,0,0,20,0,false,false,true,0.503,0.497
188,259,-71,26.857143,37,-71,1164,1261,-97,0,1,0,0.142857,53,7,7,0.792453,0,0,12,7,false,false,false,0.069,0.931
72,125,-53,24,41.666667,-53,1632,2020,-388,0,0,0,0,75,3,3,0.413333,0,0,8,12,false,false,false,0.106,0.894
274,307,-33,22.833333,27.909091,-33,1176,1133,43,1,0,0.083333,0,26,12,11,1.307692,0,0,7,12,false,false,false,0.018,0.982
218,228,-10,14.533333,16.285714,-10,1045,1082,-37,0,0,0,0,10,15,14,4.5,1,0,9,19,false,false,false,0.124,0.876
41,44,-3,10.25,14.666667,-3,822,845,-23,0,0,0,0,82,4,3,0.426829,1,0,17,21,false,false,false,0.313,0.687
215,279,-64,21.5,27.9,-64,991,1063,-72,0,1,0,0.1,32,10,10,1.1875,0,0,10,11,false,false,false,0.014,0.986
10,47,-37,3.333333,15.666667,-37,907,878,29,0,0,0,0,87,3,3,0.494253,0,0,20,17,false,false,false,0.111,0.889
245,379,-134,11.666667,18.047619,-134,1248,1220,28,0,1,0,0.047619,-9,21,21,-5.777778,1,0,6,10,false,false,false,0,1
343,348,-5,26.384615,26.769231,-5,714,820,-106,1,0,0.076923,0,6,13,13,5.166667,0,0,7,5,false,false,false,0.122,0.878
107,113,-6,15.285714,16.142857,-6,1312,1334,-22,0,0,0,0,51,7,7,0.764706,0,0,23,10,false,false,false,0.391,0.609
91,204,-113,18.2,40.8,-113,1576,1556,20,0,1,0,0.2,59,5,5,0.508475,0,0,19,13,false,false,false,0.032,0.968
76,212,-136,15.2,42.4,-136,2143,2219,-76,0,0,0,0,65,5,5,0.476923,0,0,10,20,false,false,false,0.033,0.967
256,301,-45,23.272727,27.363636,-45,1439,1314,125,0,0,0,0,14,11,11,2,0,0,13,11,false,false,false,0.102,0.898
6,21,-15,6,21,-15,951,976,-25,0,0,0,0,93,1,1,0.473118,1,1,16,19,false,false,false,0.322,0.678
77,92,-15,11,13.142857,-15,342,53,289,0,0,0,0,59,7,7,0.694915,0,0,9,16,false,false,true,0.688,0.312
310,346,-36,20.666667,23.066667,-36,1691,1551,140,1,0,0.066667,0,-2,15,15,-18.5,0,0,12,9,false,false,false,0.032,0.968
179,270,-91,22.375,38.571429,-91,1539,1891,-352,0,1,0,0.142857,37,8,7,0.675676,1,0,19,10,false,false,false,0.349,0.651
203,175,28,20.3,19.444444,28,1257,1176,81,1,0,0.1,0,41,10,9,0.829268,1,0,9,20,false,false,true,0.721,0.279
176,223,-47,17.6,22.3,-47,805,918,-113,0,0,0,0,24,10,10,1.5,0,0,12,25,false,false,false,0.095,0.905
80,70,10,26.666667,35,10,965,1078,-113,0,0,0,0,81,3,2,0.45679,0,0,7,17,false,false,false,0.168,0.832
181,186,-5,15.083333,16.909091,-5,995,965,30,0,0,0,0,23,12,11,1.73913,0,0,19,11,false,false,false,0.175,0.825
53,100,-47,13.25,25,-47,710,758,-48,0,0,0,0,77,4,4,0.480519,0,1,12,6,false,false,false,0.112,0.888
294,225,69,17.294118,14.0625,69,1030,998,32,0,0,0,0,-2,17,16,-18.5,0,1,16,8,false,false,true,0.997,0.003
130,279,-149,8.666667,19.928571,-149,651,567,84,0,0,0,0,16,15,14,3.4375,0,0,7,11,false,false,false,0.005,0.995
50,19,31,25,19,31,1777,1500,277,0,0,0,0,85,2,1,0.329412,1,0,6,20,false,false,true,0.527,0.473
155,76,79,31,19,79,1563,1539,24,0,0,0,0,64,5,4,0.546875,0,0,17,7,false,false,true,0.877,0.123
95,81,14,31.666667,27,14,1078,1095,-17,1,0,0.333333,0,77,3,3,0.480519,0,0,10,12,false,false,false,0.301,0.699
352,390,-38,18.526316,20.526316,-38,700,820,-120,0,1,0,0.052632,-26,19,19,-1.461538,0,0,2,3,true,false,false,0.051,0.949
190,203,-13,21.111111,22.555556,-13,1168,1062,106,0,0,0,0,42,9,9,1.02381,0,0,12,9,false,false,false,0.308,0.692
85,186,-101,21.25,62,-101,786,848,-62,0,1,0,0.333333,76,4,3,0.407895,1,0,13,7,false,false,false,0.102,0.898
139,140,-1,17.375,17.5,-1,450,503,-53,0,0,0,0,45,8,8,0.866667,1,0,20,10,false,false,true,0.537,0.463
107,203,-96,10.7,22.555556,-96,632,603,29,0,0,0,0,36,10,9,1.055556,0,0,18,16,false,false,false,0.006,0.994
146,227,-81,16.222222,25.222222,-81,1003,1018,-15,0,0,0,0,34,9,9,1.088235,0,0,8,10,false,false,false,0.056,0.944
64,55,9,12.8,13.75,9,561,633,-72,0,0,0,0,75,5,4,0.466667,1,1,15,10,false,false,false,0.295,0.705
75,119,-44,15,23.8,-44,563,523,40,0,0,0,0,67,5,5,0.552239,0,0,8,12,false,false,false,0.116,0.884
190,175,15,17.272727,17.5,15,803,786,17,0,0,0,0,35,11,10,0.914286,0,0,11,14,false,false,false,0.492,0.508
64,86,-22,10.666667,17.2,-22,632,603,29,0,0,0,0,61,6,5,0.622951,1,0,6,32,false,false,false,0.109,0.891
118,41,77,39.333333,20.5,77,1397,1405,-8,1,0,0.333333,0,74,3,2,0.391892,0,0,19,19,false,false,true,0.784,0.216
343,360,-17,21.4375,24,-17,1070,814,256,1,1,0.0625,0.066667,-12,16,15,-2.75,0,0,2,1,false,false,false,0.011,0.989
145,54,91,36.25,18,91,1777,1689,88,1,0,0.25,0,67,4,3,0.402985,0,0,21,9,false,false,true,0.881,0.119
269,263,6,24.454545,23.909091,6,1093,1100,-7,2,0,0.181818,0,27,11,11,1.148148,0,0,13,10,false,false,true,0.609,0.391
116,94,22,23.2,23.5,22,1305,1254,51,0,0,0,0,64,5,4,0.5,0,0,10,10,false,false,false,0.485,0.515
190,208,-18,11.176471,13,-18,542,390,152,0,0,0,0,20,17,16,2.5,1,0,6,10,false,false,true,0.611,0.389
114,148,-34,16.285714,24.666667,-34,775,786,-11,0,0,0,0,54,7,6,0.796296,0,0,13,7,false,false,false,0.109,0.891
92,105,-13,23,35,-13,503,527,-24,0,1,0,0.333333,68,4,3,0.485294,0,0,7,19,false,false,false,0.491,0.509
16,21,-5,16,21,-5,1488,1403,85,0,0,0,0,93,1,1,0.365591,0,1,17,8,false,false,false,0.411,0.589
239,398,-159,12.578947,22.111111,-159,473,683,-210,0,0,0,0,-23,19,18,-1.652174,0,0,1,1,false,false,false,0.005,0.995
298,303,-5,21.285714,23.307692,-5,1473,1500,-27,0,2,0,0.153846,7,14,13,5.571429,1,0,10,8,false,false,false,0.179,0.821
131,295,-164,13.1,29.5,-164,940,947,-7,0,2,0,0.2,26,10,10,1.346154,0,0,17,17,false,false,false,0.001,0.999
185,246,-61,12.333333,17.571429,-61,595,662,-67,0,1,0,0.071429,10,15,14,4.4,0,0,16,13,false,false,false,0.019,0.981
222,228,-6,18.5,20.727273,-6,668,771,-103,0,0,0,0,28,12,11,1.428571,1,0,12,11,false,false,false,0.131,0.869
197,246,-49,19.7,27.333333,-49,1315,1334,-19,0,1,0,0.111111,31,10,9,1.16129,0,1,11,11,false,false,false,0.01,0.99
45,63,-18,11.25,15.75,-18,1075,1189,-114,0,0,0,0,75,4,4,0.533333,0,0,7,15,false,false,false,0.118,0.882
211,231,-20,21.1,23.1,-20,921,1045,-124,0,0,0,0,29,10,10,1.206897,0,0,18,12,false,false,false,0.239,0.761
28,6,22,14,6,22,450,427,23,0,0,0,0,88,2,1,0.420455,0,1,17,7,false,false,true,0.522,0.478
169,196,-27,15.363636,19.6,-27,1075,878,197,0,0,0,0,37,11,10,0.891892,0,0,13,10,false,false,false,0.11,0.89
271,334,-63,19.357143,23.857143,-63,1397,1309,88,2,0,0.142857,0,11,14,14,3.272727,0,0,9,9,false,false,false,0.022,0.978
84,139,-55,14,27.8,-55,944,1095,-151,0,1,0,0.2,68,6,5,0.573529,0,0,10,18,false,false,false,0.106,0.894
257,333,-76,16.0625,20.8125,-76,1439,1428,11,0,0,0,0,3,16,16,13.333333,1,0,12,7,false,false,false,0.008,0.992
36,18,18,12,9,18,1045,948,97,0,0,0,0,78,3,2,0.435897,0,0,13,16,false,false,false,0.49,0.51
221,290,-69,17,22.307692,-69,653,820,-167,0,0,0,0,2,13,13,19,0,0,7,19,false,false,false,0.006,0.994
172,87,85,28.666667,14.5,85,1188,1334,-146,1,0,0.166667,0,52,6,6,0.576923,0,1,9,12,false,false,true,0.837,0.163
120,130,-10,12,13,-10,1278,1101,177,0,0,0,0,40,10,10,0.925,1,1,18,12,false,false,false,0.107,0.893
121,146,-25,17.285714,24.333333,-25,822,845,-23,0,0,0,0,60,7,6,0.583333,0,0,23,11,false,false,false,0.125,0.875
271,278,-7,19.357143,19.857143,-7,985,1062,-77,0,0,0,0,4,14,14,9.25,1,0,10,7,false,false,false,0.34,0.66
16,8,8,16,8,8,1552,1803,-251,0,0,0,0,94,1,1,0.351064,0,0,14,9,false,false,false,0.252,0.748
14,26,-12,7,26,-12,980,965,15,0,0,0,0,93,2,1,0.408602,0,1,11,9,false,false,false,0.237,0.763
288,387,-99,16.941176,24.1875,-99,967,856,111,0,1,0,0.0625,-8,17,16,-4.125,0,1,5,2,true,false,false,0,1
302,342,-40,15.894737,19,-40,480,518,-38,0,0,0,0,-19,19,18,-2.105263,0,0,2,1,false,false,false,0.028,0.972
210,151,59,19.090909,15.1,59,897,996,-99,0,0,0,0,36,11,10,1.083333,0,0,8,10,false,false,true,0.88,0.12
330,346,-16,19.411765,21.625,-16,1645,1636,9,0,1,0,0.0625,-23,17,16,-1.434783,0,0,1,3,true,false,false,0.015,0.985
175,197,-22,21.875,24.625,-22,1093,1100,-7,1,0,0.125,0,44,8,8,0.704545,0,0,9,20,false,false,false,0.178,0.822
128,85,43,18.285714,14.166667,43,720,437,283,0,0,0,0,61,7,6,0.688525,0,1,9,13,false,false,true,0.958,0.042
161,254,-93,17.888889,31.75,-93,1193,1177,16,0,1,0,0.125,43,9,8,0.813953,0,0,15,11,false,false,false,0.006,0.994
35,40,-5,11.666667,13.333333,-5,970,1030,-60,0,0,0,0,78,3,3,0.512821,0,1,27,14,false,false,false,0.43,0.57
309,402,-93,18.176471,25.125,-93,726,818,-92,0,1,0,0.0625,-13,17,16,-2.692308,0,0,5,2,false,false,false,0.006,0.994
94,74,20,23.5,24.666667,20,450,624,-174,0,0,0,0,73,4,3,0.452055,1,0,8,14,false,false,true,0.512,0.488
18,0,18,18,0,18,1777,1500,277,0,0,0,0,94,1,0,0.297872,1,0,8,0,false,false,true,0.983,0.017
282,342,-60,17.625,22.8,-60,691,704,-13,0,1,0,0.066667,-7,16,15,-5.428571,0,0,5,10,false,false,false,0.028,0.972
97,139,-42,13.857143,19.857143,-42,542,605,-63,0,0,0,0,50,7,7,0.72,0,0,10,19,false,false,false,0.107,0.893
10,19,-9,10,19,-9,724,398,326,0,0,0,0,95,1,1,0.410526,0,0,14,9,false,false,false,0.46,0.54
55,103,-48,13.75,34.333333,-48,1454,1479,-25,0,0,0,0,71,4,3,0.43662,1,0,6,10,false,false,false,0.223,0.777
259,302,-43,19.923077,25.166667,-43,621,786,-165,0,0,0,0,-2,13,12,-15,0,0,8,7,false,false,false,0.01,0.99
131,190,-59,16.375,27.142857,-59,952,826,126,0,1,0,0.142857,55,8,7,0.781818,0,0,10,7,false,false,false,0.069,0.931
309,302,7,23.769231,25.166667,7,1436,1489,-53,1,1,0.076923,0.083333,15,13,12,2.466667,0,0,10,16,false,false,false,0.489,0.511
52,49,3,17.333333,24.5,3,480,518,-38,0,0,0,0,81,3,2,0.493827,0,1,14,13,false,false,false,0.13,0.87
53,95,-42,13.25,23.75,-42,1432,1452,-20,0,0,0,0,71,4,4,0.507042,0,0,23,10,false,false,false,0.115,0.885
264,247,17,22,20.583333,17,824,830,-6,1,0,0.083333,0,25,12,12,1.76,0,0,7,20,false,false,true,0.712,0.288
76,87,-11,15.2,17.4,-11,725,668,57,0,0,0,0,66,5,5,0.530303,0,0,15,31,false,false,false,0.305,0.695
87,113,-26,14.5,22.6,-26,1123,1062,61,0,0,0,0,60,6,5,0.733333,1,0,9,17,false,false,false,0.136,0.864
36,21,15,18,21,15,1266,1339,-73,0,0,0,0,90,2,1,0.388889,0,0,10,16,false,false,false,0.242,0.758
308,341,-33,23.692308,26.230769,-33,1552,1803,-251,2,0,0.153846,0,4,13,13,8.25,0,0,7,9,false,false,false,0.009,0.991
281,302,-21,20.071429,21.571429,-21,1245,1148,97,0,0,0,0,-4,14,14,-8.75,0,0,15,5,false,false,false,0.444,0.556
233,335,-102,19.416667,30.454545,-102,999,1283,-284,0,2,0,0.181818,17,12,11,1.941176,0,0,16,7,false,false,false,0.005,0.995
225,250,-25,16.071429,19.230769,-25,1176,1211,-35,0,0,0,0,0,14,13,0,0,0,14,17,false,false,false,0.106,0.894
183,186,-3,13.071429,14.307692,-3,999,1071,-72,0,0,0,0,13,14,13,3.076923,2,0,7,19,false,false,true,0.701,0.299
141,185,-44,17.625,23.125,-44,668,771,-103,0,0,0,0,46,8,8,0.869565,0,0,10,11,false,false,false,0.106,0.894
69,42,27,13.8,10.5,27,1045,948,97,0,0,0,0,67,5,4,0.507463,0,0,13,15,false,false,true,0.515,0.485
230,277,-47,20.909091,25.181818,-47,1645,1636,9,0,1,0,0.090909,14,11,11,2.357143,0,0,17,9,false,false,false,0.077,0.923
137,119,18,17.125,17,18,805,918,-113,0,0,0,0,45,8,7,0.8,0,1,8,19,false,false,false,0.112,0.888
237,351,-114,16.928571,25.071429,-114,1270,1424,-154,0,2,0,0.142857,6,14,14,5.833333,0,0,22,10,false,false,false,0.006,0.994
51,39,12,25.5,19.5,12,1691,1510,181,0,0,0,0,85,2,2,0.352941,0,0,13,12,false,false,true,0.558,0.442
113,110,3,22.6,27.5,3,1227,1189,38,0,0,0,0,65,5,4,0.538462,0,0,14,18,false,false,false,0.239,0.761
153,130,23,19.125,18.571429,23,387,683,-296,0,0,0,0,43,8,7,0.790698,1,0,10,9,false,false,false,0.469,0.531
140,149,-9,15.555556,18.625,-9,450,427,23,0,1,0,0.125,39,9,8,0.948718,0,0,11,12,false,false,true,0.689,0.311
225,210,15,22.5,21,15,1691,1510,181,0,1,0,0.1,27,10,10,1.111111,1,0,9,19,false,false,true,0.604,0.396
238,349,-111,18.307692,29.083333,-111,1334,1439,-105,1,1,0.076923,0.083333,23,13,12,1.565217,0,0,16,10,false,false,false,0.005,0.995
212,245,-33,19.272727,24.5,-33,561,633,-72,0,1,0,0.1,28,11,10,1.25,0,0,14,10,false,false,false,0.201,0.799
265,321,-56,15.588235,20.0625,-56,1161,1176,-15,1,1,0.058824,0.0625,-19,17,16,-2,0,0,2,19,false,false,false,0.013,0.987
20,0,20,20,0,20,360,371,-11,0,0,0,0,97,1,0,0.381443,0,0,11,0,false,false,true,0.622,0.378
201,202,-1,22.333333,25.25,-1,1063,1134,-71,1,0,0.111111,0,50,9,8,0.88,0,0,9,18,false,false,false,0.326,0.674
262,306,-44,18.714286,21.857143,-44,668,771,-103,0,0,0,0,11,14,14,3.636364,0,1,10,6,false,false,false,0.006,0.994
163,215,-52,18.111111,23.888889,-52,1305,1194,111,0,0,0,0,35,9,9,0.942857,0,0,10,10,false,false,false,0.106,0.894
215,236,-21,17.916667,19.666667,-21,1633,1556,77,0,0,0,0,10,12,12,3.3,0,1,9,11,false,false,false,0.01,0.99
280,396,-116,16.470588,24.75,-116,1193,1177,16,0,1,0,0.0625,-9,17,16,-3.888889,0,0,1,2,false,false,false,0,1
139,175,-36,23.166667,35,-36,595,733,-138,1,1,0.166667,0.2,50,6,5,0.78,0,1,19,10,false,false,false,0.001,0.999
311,357,-46,19.4375,23.8,-46,1495,1531,-36,0,1,0,0.066667,0,16,15,0,0,0,5,10,false,false,false,0.005,0.995
302,332,-30,15.894737,18.444444,-30,1302,1351,-49,0,0,0,0,-20,19,18,-1.85,0,0,1,1,true,false,false,0.021,0.979
280,304,-24,17.5,20.266667,-24,343,570,-227,0,0,0,0,-13,16,15,-2.769231,0,0,4,4,false,false,false,0.02,0.98
161,148,13,17.888889,18.5,13,561,688,-127,0,0,0,0,47,9,8,0.978723,0,0,17,7,false,false,true,0.591,0.409
188,202,-14,26.857143,28.857143,-14,732,868,-136,0,1,0,0.142857,46,7,7,0.695652,0,0,9,8,false,false,true,0.708,0.292
200,287,-87,28.571429,41,-87,1537,1539,-2,0,1,0,0.142857,36,7,7,0.944444,0,0,16,25,false,false,false,0.007,0.993
312,330,-18,16.421053,17.368421,-18,561,688,-127,0,0,0,0,-11,19,19,-4.181818,0,0,3,9,false,false,false,0.047,0.953
256,358,-102,16,22.375,-102,1580,1629,-49,0,1,0,0.0625,-8,16,16,-4.625,0,0,6,6,false,false,false,0.001,0.999
268,370,-102,15.764706,21.764706,-102,805,918,-113,0,0,0,0,-20,17,17,-1.8,0,0,1,4,false,false,false,0.005,0.995
279,297,-18,16.411765,17.470588,-18,1123,1062,61,0,0,0,0,-6,17,17,-7.333333,0,0,6,14,false,false,false,0.345,0.655
174,247,-73,24.857143,35.285714,-73,1436,1489,-53,1,1,0.142857,0.142857,51,7,7,0.72549,0,0,12,7,false,false,false,0.025,0.975
186,119,67,31,23.8,67,691,695,-4,1,0,0.166667,0,58,6,5,0.551724,0,0,10,19,false,false,true,0.738,0.262
291,295,-4,14.55,14.75,-4,796,800,-4,1,0,0.05,0,-10,20,20,-4.8,0,1,12,9,false,false,false,0.04,0.96
70,98,-28,17.5,24.5,-28,915,971,-56,0,0,0,0,70,4,4,0.471429,0,0,9,30,false,false,false,0.109,0.891
164,161,3,20.5,23,3,1495,1531,-36,0,0,0,0,55,8,7,0.672727,0,0,8,12,false,false,false,0.111,0.889
281,338,-57,14.789474,18.777778,-57,603,721,-118,0,0,0,0,-12,19,18,-3.583333,1,0,6,7,false,false,false,0.005,0.995
147,137,10,16.333333,17.125,10,913,1037,-124,0,1,0,0.125,59,9,8,0.694915,0,0,16,10,false,false,true,0.516,0.484
186,148,38,15.5,12.333333,38,1040,1091,-51,0,0,0,0,26,12,12,1.807692,0,1,10,25,false,false,false,0.297,0.703
346,357,-11,19.222222,21,-11,1563,1539,24,0,1,0,0.058824,-23,18,17,-1.521739,0,0,1,2,true,false,false,0.012,0.988
211,284,-73,19.181818,28.4,-73,1101,1115,-14,0,0,0,0,23,11,10,1.304348,0,1,11,14,false,false,false,0.006,0.994
333,381,-48,15.857143,18.142857,-48,1064,1397,-333,0,2,0,0.095238,-18,21,21,-2.388889,1,0,5,2,false,false,false,0.122,0.878
160,118,42,22.857143,16.857143,42,664,786,-122,0,0,0,0,54,7,7,0.611111,0,0,13,15,false,false,true,0.808,0.192
277,301,-24,17.3125,20.066667,-24,450,624,-174,0,0,0,0,-13,16,15,-2.538462,1,0,3,6,false,false,false,0.042,0.958
235,268,-33,21.363636,26.8,-33,1473,1500,-27,0,2,0,0.2,26,11,10,1.5,1,0,19,10,false,false,false,0.139,0.861
54,124,-70,10.8,24.8,-70,795,786,9,0,0,0,0,75,5,5,0.506667,0,0,7,16,false,false,false,0.104,0.896
281,240,41,25.545455,24,41,1563,1539,24,0,1,0,0.1,17,11,10,2.058824,0,0,7,15,false,false,true,0.726,0.274
162,229,-67,14.727273,22.9,-67,542,605,-63,0,0,0,0,28,11,10,1.285714,0,0,10,16,false,false,false,0.006,0.994
70,130,-60,14,26,-60,837,844,-7,0,0,0,0,73,5,5,0.561644,0,1,13,12,false,false,false,0.104,0.896
116,131,-15,16.571429,18.714286,-15,651,700,-49,0,0,0,0,52,7,7,1.076923,1,0,11,21,false,false,false,0.21,0.79
108,222,-114,15.428571,31.714286,-114,653,1004,-351,0,0,0,0,45,7,7,0.644444,1,0,11,16,false,false,false,0.006,0.994
111,133,-22,15.857143,19,-22,603,721,-118,0,0,0,0,56,7,7,0.767857,0,0,12,21,false,false,false,0.12,0.88
159,201,-42,17.666667,22.333333,-42,451,448,3,0,0,0,0,40,9,9,0.925,0,0,7,12,false,false,false,0.121,0.879
239,293,-54,19.916667,24.416667,-54,503,527,-24,0,1,0,0.083333,7,12,12,4.714286,0,0,9,14,false,false,false,0.041,0.959
57,28,29,28.5,14,29,306,468,-162,0,0,0,0,88,2,2,0.420455,0,0,11,19,false,false,true,0.755,0.245
286,315,-29,19.066667,22.5,-29,480,739,-259,1,0,0.066667,0,6,15,14,6.5,0,0,8,19,false,false,false,0.028,0.972
156,201,-45,19.5,25.125,-45,892,856,36,0,1,0,0.125,41,8,8,0.853659,1,0,11,16,false,false,false,0.213,0.787
195,221,-26,16.25,18.416667,-26,430,542,-112,0,1,0,0.083333,20,12,12,2.4,0,0,27,10,false,false,true,0.625,0.375
290,371,-81,24.166667,33.727273,-81,1415,1361,54,0,1,0,0.090909,13,12,11,2.384615,0,0,12,18,false,false,false,0,1
141,141,0,17.625,20.142857,0,668,771,-103,0,0,0,0,49,8,7,0.816327,0,0,10,20,false,false,false,0.133,0.867
213,284,-71,14.2,18.933333,-71,714,892,-178,0,2,0,0.133333,5,15,15,8.4,0,0,14,12,false,false,false,0.036,0.964
139,94,45,23.166667,18.8,45,785,892,-107,0,0,0,0,60,6,5,0.616667,0,0,13,11,false,false,true,0.857,0.143
239,258,-19,19.916667,23.454545,-19,1063,1134,-71,1,0,0.083333,0,31,12,11,1.419355,0,0,10,20,false,false,false,0.084,0.916
145,188,-43,16.111111,23.5,-43,736,791,-55,0,0,0,0,43,9,8,0.883721,0,0,7,7,false,false,false,0.104,0.896
269,296,-27,14.157895,16.444444,-27,595,538,57,0,0,0,0,-17,19,18,-2.235294,0,0,1,1,false,false,false,0.034,0.966
304,479,-175,19,31.933333,-175,1368,1452,-84,1,2,0.0625,0.133333,-10,16,15,-3.2,0,0,2,1,false,false,false,0,1
288,346,-58,18,23.066667,-58,1633,1556,77,1,0,0.0625,0,-19,16,15,-1.736842,0,1,1,2,false,false,false,0,1
66,80,-14,13.2,20,-14,278,1,277,0,0,0,0,62,5,4,0.596774,0,0,20,9,false,false,false,0.401,0.599
289,300,-11,20.642857,23.076923,-11,1341,1606,-265,1,0,0.071429,0,-2,14,13,-16.5,0,0,22,9,false,false,false,0.187,0.813
76,116,-40,19,29,-40,1422,1583,-161,0,1,0,0.25,68,4,4,0.602941,0,0,17,11,false,false,false,0.119,0.881
160,202,-42,12.307692,16.833333,-42,226,361,-135,0,0,0,0,13,13,12,3.384615,0,0,9,8,false,false,false,0.04,0.96
12,0,12,12,0,12,1636,1796,-160,0,0,0,0,97,1,0,0.278351,0,0,19,0,false,false,false,0.259,0.741
237,193,44,21.545455,19.3,44,1341,1606,-265,1,0,0.090909,0,21,11,10,1.571429,0,0,13,8,false,false,true,0.786,0.214
62,83,-21,12.4,16.6,-21,542,605,-63,0,0,0,0,63,5,5,0.571429,1,1,12,6,false,false,false,0.302,0.698
369,395,-26,28.384615,32.916667,-26,1761,1770,-9,1,1,0.076923,0.083333,-11,13,12,-2.363636,0,0,2,2,false,false,false,0.01,0.99
287,367,-80,13.666667,17.47619,-80,1101,1130,-29,1,1,0.047619,0.047619,-19,21,21,-2.368421,0,1,3,1,false,false,false,0.001,0.999
268,218,50,26.8,21.8,50,1373,1334,39,1,1,0.1,0.1,31,10,10,1.032258,0,1,16,15,false,false,true,0.748,0.252
73,89,-16,14.6,22.25,-16,1045,1082,-37,0,0,0,0,70,5,4,0.642857,1,0,20,9,false,false,false,0.391,0.609
192,240,-48,21.333333,26.666667,-48,689,804,-115,0,0,0,0,31,9,9,1.129032,0,0,13,14,false,false,false,0.084,0.916
289,332,-43,14.45,17.473684,-43,889,855,34,0,1,0,0.052632,-22,20,19,-1.818182,0,0,1,1,false,false,false,0.005,0.995
77,98,-21,19.25,24.5,-21,1777,1500,277,0,0,0,0,67,4,4,0.41791,1,1,6,12,false,false,false,0.071,0.929
10,0,10,10,0,10,724,398,326,0,0,0,0,98,1,0,0.397959,0,0,14,0,false,false,true,0.536,0.464
247,308,-61,19,23.692308,-61,954,939,15,1,0,0.076923,0,5,13,13,7.2,0,1,8,11,false,false,false,0.004,0.996
7,54,-47,2.333333,18,-47,1793,1869,-76,0,0,0,0,86,3,3,0.348837,0,0,8,9,false,false,false,0.233,0.767
141,180,-39,20.142857,25.714286,-39,1305,1194,111,0,0,0,0,49,7,7,0.673469,0,0,14,11,false,false,false,0.137,0.863
278,380,-102,15.444444,22.352941,-102,595,733,-138,1,1,0.055556,0.058824,-18,18,17,-2.166667,0,1,21,3,false,false,false,0.005,0.995
66,85,-19,16.5,28.333333,-19,1253,1324,-71,0,0,0,0,74,4,3,0.391892,0,0,17,13,false,false,false,0.11,0.89
83,69,14,16.6,17.25,14,1161,1176,-15,0,0,0,0,69,5,4,0.550725,0,0,10,7,false,false,false,0.36,0.64
94,107,-13,23.5,26.75,-13,450,624,-174,0,0,0,0,70,4,4,0.471429,1,0,8,14,false,false,false,0.331,0.669
40,5,35,20,5,35,1422,1583,-161,0,0,0,0,87,2,1,0.471264,0,0,16,9,false,false,false,0.448,0.552
267,428,-161,22.25,35.666667,-161,1633,1680,-47,0,2,0,0.166667,-3,12,12,-9.333333,1,0,9,12,false,false,false,0.002,0.998
263,328,-65,15.470588,20.5,-65,1078,1095,-17,1,1,0.058824,0.0625,-6,17,16,-6.166667,0,0,9,11,false,false,false,0.03,0.97
258,337,-79,15.176471,19.823529,-79,1432,1452,-20,0,1,0,0.058824,-15,17,17,-2.4,1,0,1,9,false,false,false,0.001,0.999
34,35,-1,17,17.5,-1,805,918,-113,0,0,0,0,85,2,2,0.423529,0,1,29,9,false,false,true,0.512,0.488
291,271,20,15.315789,15.055556,20,796,800,-4,1,0,0.052632,0,-3,19,18,-16,0,1,12,6,false,false,false,0.17,0.83
24,14,10,24,14,10,1227,1189,38,0,0,0,0,90,1,1,0.388889,0,0,12,10,false,false,true,0.523,0.477
89,125,-36,17.8,31.25,-36,473,683,-210,0,0,0,0,68,5,4,0.558824,0,0,12,22,false,false,false,0.105,0.895
276,370,-94,18.4,26.428571,-94,967,856,111,0,1,0,0.071429,1,15,14,33,0,1,13,5,false,false,false,0,1
169,236,-67,18.777778,26.222222,-67,1205,1216,-11,0,0,0,0,38,9,9,0.868421,1,0,7,11,false,false,false,0.11,0.89
268,344,-76,12.181818,15.636364,-76,813,698,115,1,0,0.045455,0,-27,22,22,-1.777778,0,0,1,4,false,false,false,0.032,0.968
280,343,-63,17.5,22.866667,-63,503,527,-24,0,1,0,0.066667,-20,16,15,-1.65,0,0,1,3,false,false,false,0.011,0.989
291,344,-53,15.315789,19.111111,-53,1305,1307,-2,0,1,0,0.055556,-19,19,18,-2.157895,0,1,3,5,false,false,false,0,1
112,109,3,16,15.571429,3,797,796,1,0,0,0,0,60,7,7,0.816667,0,0,11,11,false,false,false,0.463,0.537
274,248,26,27.4,27.555556,26,714,820,-106,1,0,0.1,0,32,10,9,0.96875,0,0,10,7,false,false,true,0.73,0.27
55,135,-80,9.166667,22.5,-80,1368,1452,-84,0,0,0,0,65,6,6,0.492308,1,0,14,19,false,false,false,0.107,0.893
288,353,-65,16.941176,22.0625,-65,1055,1019,36,0,0,0,0,-19,17,16,-1.736842,0,0,2,1,true,false,false,0.005,0.995
175,309,-134,14.583333,25.75,-134,915,971,-56,0,0,0,0,12,12,12,2.75,0,0,11,16,false,false,false,0.005,0.995
129,147,-18,32.25,36.75,-18,801,679,122,1,0,0.25,0,63,4,4,0.460317,0,0,10,9,false,false,false,0.294,0.706
235,389,-154,14.6875,24.3125,-154,1422,1510,-88,0,2,0,0.125,4,16,16,9.75,0,0,10,10,false,false,false,0.001,0.999
111,183,-72,12.333333,20.333333,-72,595,540,55,0,0,0,0,40,9,9,1.075,0,0,16,17,false,false,false,0.043,0.957
52,117,-65,17.333333,39,-65,1408,1539,-131,0,1,0,0.333333,73,3,3,0.465753,0,0,13,12,false,false,false,0.107,0.893
302,309,-7,18.875,20.6,-7,1037,913,124,2,1,0.125,0.066667,3,16,15,12.666667,0,0,7,10,false,false,false,0.338,0.662
59,49,10,19.666667,24.5,10,842,926,-84,0,0,0,0,79,3,2,0.379747,0,0,15,10,false,false,false,0.354,0.646
12,0,12,12,0,12,595,662,-67,0,0,0,0,96,1,0,0.458333,0,0,16,0,false,false,true,0.515,0.485
254,260,-6,23.090909,23.636364,-6,1397,1405,-8,1,0,0.090909,0,16,11,11,1.8125,1,1,10,6,false,false,false,0.458,0.542
133,94,39,26.6,23.5,39,786,885,-99,1,0,0.2,0,69,5,4,0.492754,0,1,9,13,false,false,false,0.001,0.999
208,192,16,20.8,21.333333,16,1633,1739,-106,1,0,0.1,0,35,10,9,0.971429,0,0,7,18,false,false,false,0.112,0.888
0,0,0,0,0,0,786,885,-99,0,0,0,0,100,1,0,0.34,0,0,13,0,false,false,false,0.263,0.737
66,55,11,13.2,11,11,670,576,94,0,0,0,0,63,5,5,0.650794,0,0,19,10,false,false,true,0.712,0.288
102,115,-13,20.4,23,-13,939,969,-30,0,0,0,0,59,5,5,0.559322,0,0,10,8,false,false,false,0.267,0.733
221,384,-163,12.277778,22.588235,-163,948,998,-50,0,0,0,0,-20,18,17,-1.85,0,0,2,1,false,false,false,0.005,0.995
233,288,-55,19.416667,26.181818,-55,1047,1253,-206,1,1,0.083333,0.090909,25,12,11,1.48,1,0,9,7,false,false,false,0.006,0.994
292,339,-47,16.222222,18.833333,-47,758,791,-33,0,0,0,0,-22,18,18,-1.772727,0,0,3,1,false,false,false,0.011,0.989
191,260,-69,21.222222,32.5,-69,1436,1489,-53,1,1,0.111111,0.125,44,9,8,0.840909,0,0,11,9,false,false,false,0.007,0.993
153,190,-37,30.6,38,-37,1761,1770,-9,0,1,0,0.2,56,5,5,0.464286,0,0,11,10,false,false,false,0.07,0.93
299,345,-46,14.95,17.25,-46,344,315,29,1,1,0.05,0.05,-36,20,20,-1.111111,0,0,1,3,true,false,false,0.122,0.878
132,95,37,22,19,37,615,542,73,0,0,0,0,66,6,5,0.636364,0,0,7,15,false,false,true,0.75,0.25
120,109,11,20,18.166667,11,991,1063,-72,0,0,0,0,61,6,6,0.622951,0,0,16,17,false,false,false,0.424,0.576
68,111,-43,22.666667,37,-43,1645,1636,9,0,1,0,0.333333,73,3,3,0.452055,0,0,17,16,false,false,false,0.205,0.795
120,411,-291,7.5,27.4,-291,1164,1149,15,0,2,0,0.133333,28,16,15,1.678571,0,0,12,8,false,false,false,0.066,0.934
305,329,-24,17.941176,20.5625,-24,952,870,82,0,0,0,0,-13,17,16,-2.846154,0,0,5,8,false,false,false,0.038,0.962
93,138,-45,15.5,27.6,-45,1253,1324,-71,0,0,0,0,61,6,5,0.47541,0,0,16,11,false,false,false,0.106,0.894
132,222,-90,18.857143,37,-90,1576,1556,20,0,1,0,0.166667,47,7,6,0.638298,0,0,19,7,false,false,false,0.04,0.96
22,10,12,11,10,12,795,786,9,0,0,0,0,95,2,1,0.4,0,0,7,19,false,false,false,0.162,0.838
111,98,13,27.75,32.666667,13,1636,1727,-91,0,1,0,0.333333,72,4,3,0.416667,0,0,8,8,false,false,false,0.486,0.514
257,277,-20,18.357143,21.307692,-20,1302,1351,-49,0,0,0,0,11,14,13,3.363636,0,0,11,12,false,false,false,0.108,0.892
148,190,-42,29.6,47.5,-42,1164,1261,-97,0,1,0,0.25,65,5,4,0.646154,0,0,25,10,false,false,false,0.246,0.754
320,330,-10,16,17.368421,-10,561,688,-127,0,0,0,0,-13,20,19,-3.538462,0,0,1,9,false,false,false,0.084,0.916
196,256,-60,16.333333,21.333333,-60,620,698,-78,1,0,0.083333,0,22,12,12,1.863636,0,0,21,14,false,false,false,0.025,0.975
231,238,-7,19.25,21.636364,-7,1270,1261,9,1,0,0.083333,0,31,12,11,1.193548,0,0,9,8,false,false,false,0.286,0.714
189,210,-21,18.9,23.333333,-21,620,698,-78,1,0,0.1,0,39,10,9,1.051282,0,0,21,7,false,false,false,0.383,0.617
122,217,-95,9.384615,18.083333,-95,651,996,-345,0,1,0,0.083333,16,13,12,2.8125,0,2,26,5,false,false,false,0.001,0.999
352,357,-5,23.466667,25.5,-5,169,306,-137,2,1,0.133333,0.071429,-17,15,14,-1.823529,0,0,1,3,false,false,false,0.071,0.929
161,131,30,23,21.833333,30,1269,1477,-208,1,0,0.142857,0,53,7,6,0.660377,0,1,8,9,false,false,false,0.244,0.756
301,402,-101,18.8125,25.125,-101,726,818,-92,0,1,0,0.0625,-10,16,16,-3.5,0,0,9,2,false,false,false,0.01,0.99
314,311,3,19.625,20.733333,3,939,969,-30,0,0,0,0,-15,16,15,-2.2,0,0,2,1,false,false,false,0.497,0.503
349,380,-31,19.388889,21.111111,-31,1237,1265,-28,1,0,0.055556,0,-28,18,18,-1.285714,0,0,2,2,true,false,false,0.034,0.966
110,107,3,22,26.75,3,450,624,-174,0,0,0,0,66,5,4,0.5,0,0,7,14,false,false,false,0.155,0.845
141,212,-71,15.666667,23.555556,-71,822,845,-23,0,0,0,0,42,9,9,0.833333,1,0,21,8,false,false,false,0.101,0.899
173,140,33,21.625,20,33,786,885,-99,1,0,0.125,0,54,8,7,0.62963,0,1,15,6,false,false,false,0.062,0.938
87,160,-73,10.875,22.857143,-73,632,603,29,0,0,0,0,48,8,7,0.791667,1,0,6,14,false,false,false,0.102,0.898
207,200,7,29.571429,28.571429,7,824,830,-6,1,0,0.142857,0,50,7,7,0.88,0,0,8,14,false,false,true,0.731,0.269
213,232,-19,16.384615,17.846154,-19,306,468,-162,0,0,0,0,22,13,13,1.681818,0,0,11,9,false,false,false,0.319,0.681
272,323,-51,13.6,16.15,-51,925,1000,-75,0,0,0,0,-23,20,20,-1.913043,0,0,6,1,false,false,false,0.008,0.992
223,289,-66,13.9375,18.0625,-66,1071,1000,71,0,0,0,0,2,16,16,23.5,0,0,16,12,false,false,false,0.006,0.994
149,135,14,21.285714,19.285714,14,1043,1003,40,0,0,0,0,49,7,7,0.77551,0,0,16,15,false,false,true,0.645,0.355
303,469,-166,16.833333,27.588235,-166,1003,1004,-1,0,2,0,0.117647,-15,18,17,-2.333333,0,0,1,2,true,false,false,0,1
45,44,1,15,14.666667,1,361,413,-52,0,0,0,0,77,3,3,0.532468,0,0,26,11,false,false,true,0.59,0.41
14,0,14,14,0,14,736,791,-55,0,0,0,0,96,1,0,0.395833,1,0,9,0,false,false,true,0.53,0.47
266,443,-177,16.625,27.6875,-177,1399,1210,189,0,1,0,0.0625,-10,16,16,-3.5,0,0,4,2,false,false,false,0.066,0.934
112,143,-31,12.444444,17.875,-31,1075,1189,-114,0,0,0,0,45,9,8,0.888889,0,0,11,15,false,false,false,0.106,0.894
77,71,6,19.25,17.75,6,1203,1270,-67,0,0,0,0,77,4,4,0.571429,1,0,6,18,false,false,true,0.507,0.493
242,279,-37,20.166667,23.25,-37,1428,1361,67,0,0,0,0,11,12,12,3,1,0,8,10,false,false,false,0.128,0.872
41,25,16,20.5,12.5,16,1652,1473,179,0,0,0,0,82,2,2,0.365854,0,0,12,9,false,false,true,0.533,0.467
290,353,-63,18.125,23.533333,-63,566,742,-176,0,1,0,0.066667,-11,16,15,-2.909091,0,0,2,1,false,false,false,0.01,0.99
39,61,-22,13,20.333333,-22,1063,1134,-71,0,0,0,0,80,3,3,0.55,0,0,13,27,false,false,false,0.109,0.891
209,220,-11,29.857143,31.428571,-11,1086,926,160,0,1,0,0.142857,43,7,7,0.651163,0,0,9,12,false,false,false,0.175,0.825
304,315,-11,25.333333,28.636364,-11,691,695,-4,1,0,0.083333,0,12,12,11,2.666667,0,0,7,12,false,false,false,0.108,0.892
248,279,-31,19.076923,23.25,-31,1055,1019,36,0,0,0,0,5,13,12,6.6,1,0,7,16,false,false,false,0.106,0.894
74,75,-1,18.5,18.75,-1,1232,1448,-216,0,0,0,0,67,4,4,0.522388,0,0,16,19,false,false,false,0.128,0.872
121,290,-169,13.444444,32.222222,-169,940,947,-7,0,2,0,0.222222,32,9,9,1.09375,0,0,7,16,false,false,false,0,1
289,312,-23,11.56,13,-23,542,390,152,1,0,0.04,0,-25,25,24,-2,0,0,2,6,false,false,false,0.186,0.814
20,26,-6,20,26,-6,360,371,-11,0,0,0,0,91,1,1,0.406593,0,0,11,11,false,false,false,0.304,0.696
307,397,-90,16.157895,22.055556,-90,1094,1159,-65,0,0,0,0,-26,19,18,-1.461538,0,0,1,1,false,false,false,0.005,0.995
165,98,67,20.625,14,67,1065,948,117,0,0,0,0,53,8,7,0.735849,0,0,15,9,false,false,true,0.92,0.08
135,130,5,16.875,18.571429,5,1094,1041,53,0,0,0,0,44,8,7,0.863636,1,0,16,16,false,false,false,0.498,0.502
47,40,7,15.666667,20,7,595,412,183,0,0,0,0,83,3,2,0.626506,0,0,7,19,false,false,false,0.296,0.704
204,143,61,17,13,61,670,576,94,0,0,0,0,25,12,11,1.64,1,1,8,8,false,false,true,0.928,0.072
70,64,6,17.5,21.333333,6,694,658,36,0,0,0,0,75,4,3,0.493333,0,0,26,8,false,false,false,0.383,0.617
314,333,-19,14.272727,15.136364,-19,1000,960,40,0,0,0,0,-27,22,22,-1.666667,0,0,1,1,false,false,false,0.11,0.89
309,272,37,22.071429,19.428571,37,1331,1374,-43,0,0,0,0,-3,14,14,-11,0,0,14,6,false,false,true,0.902,0.098
145,115,30,29,28.75,30,1237,1265,-28,1,0,0.2,0,57,5,4,0.631579,0,0,27,10,false,false,false,0.383,0.617
175,276,-101,21.875,34.5,-101,1633,1680,-47,0,1,0,0.125,29,8,8,0.965517,0,0,21,16,false,false,false,0.034,0.966
173,223,-50,15.727273,22.3,-50,1484,1556,-72,0,1,0,0.1,20,11,10,1.55,1,0,15,11,false,false,false,0.107,0.893
232,280,-48,16.571429,21.538462,-48,1037,1016,21,1,0,0.071429,0,22,14,13,2.636364,1,0,19,7,false,false,false,0.007,0.993
237,284,-47,13.941176,16.705882,-47,278,1,277,0,0,0,0,-12,17,17,-3.083333,0,0,9,1,false,false,false,0.015,0.985
236,269,-33,12.421053,14.944444,-33,668,363,305,0,0,0,0,-4,19,18,-11.75,0,1,14,6,false,false,false,0.005,0.995
86,81,5,17.2,20.25,5,1168,1062,106,0,0,0,0,71,5,4,0.605634,0,1,10,10,false,false,false,0.267,0.733
266,370,-104,16.625,23.125,-104,595,733,-138,1,1,0.0625,0.0625,-12,16,16,-3.25,0,1,23,6,false,false,false,0.006,0.994
194,196,-2,17.636364,19.6,-2,599,448,151,0,0,0,0,28,11,10,1.285714,0,0,10,9,false,false,true,0.676,0.324
250,383,-133,13.888889,21.277778,-133,450,427,23,1,1,0.055556,0.055556,-25,18,18,-1.48,0,0,1,5,false,false,false,0.008,0.992
304,323,-19,20.266667,21.533333,-19,1341,1606,-265,1,0,0.066667,0,-11,15,15,-3,0,0,8,1,false,false,false,0.108,0.892
257,428,-171,15.117647,25.176471,-171,926,973,-47,0,0,0,0,-12,17,17,-2.916667,0,0,2,1,false,false,false,0.005,0.995
184,226,-42,23,32.285714,-42,1266,1339,-73,0,1,0,0.142857,49,8,7,0.714286,0,0,10,21,false,false,false,0.107,0.893
215,279,-64,16.538462,21.461538,-64,1257,1176,81,1,0,0.076923,0,19,13,13,1.789474,1,0,6,15,false,false,false,0.008,0.992
30,21,9,15,21,9,1488,1403,85,0,0,0,0,90,2,1,0.377778,0,1,17,8,false,false,false,0.332,0.668
27,15,12,13.5,15,12,848,976,-128,0,0,0,0,89,2,1,0.449438,0,0,14,9,false,false,false,0.395,0.605
175,153,22,14.583333,13.909091,22,808,749,59,0,0,0,0,17,12,11,2.470588,0,0,7,10,false,false,true,0.652,0.348
201,230,-29,14.357143,16.428571,-29,830,787,43,0,0,0,0,10,14,14,3.8,0,1,7,10,false,false,false,0.098,0.902
230,279,-49,13.529412,17.4375,-49,830,787,43,0,0,0,0,-11,17,16,-3.454545,0,0,4,7,false,false,false,0.008,0.992
360,338,22,27.692308,28.166667,22,1047,1127,-80,0,1,0,0.083333,-6,13,12,-4.5,0,0,9,6,false,false,true,0.988,0.012
177,294,-117,12.642857,21,-117,632,603,29,0,1,0,0.071429,-3,14,14,-12.666667,0,0,11,12,false,false,false,0.005,0.995
80,97,-17,13.333333,16.166667,-17,361,413,-52,0,0,0,0,58,6,6,0.706897,0,0,23,7,false,false,false,0.405,0.595
124,269,-145,10.333333,24.454545,-145,530,683,-153,0,1,0,0.090909,33,12,11,1.212121,0,0,18,10,false,false,false,0.005,0.995
135,120,15,19.285714,17.142857,15,991,1063,-72,0,0,0,0,54,7,7,0.703704,0,1,16,15,false,false,false,0.303,0.697
293,336,-43,18.3125,22.4,-43,668,771,-103,0,0,0,0,1,16,15,40,0,1,4,9,false,false,false,0.005,0.995
330,368,-38,18.333333,20.444444,-38,1473,1500,-27,1,2,0.055556,0.111111,-25,18,18,-1.56,1,0,1,1,false,false,false,0.006,0.994
215,222,-7,26.875,31.714286,-7,1164,1161,3,0,1,0,0.142857,28,8,7,0.821429,0,0,11,10,false,false,false,0.445,0.555
288,289,-1,16.941176,18.0625,-1,1161,1030,131,0,1,0,0.0625,-16,17,16,-2.375,0,1,4,10,false,false,false,0.023,0.977
36,17,19,18,17,19,1040,1364,-324,0,0,0,0,89,2,1,0.404494,0,0,11,13,false,false,false,0.244,0.756
232,250,-18,12.210526,13.888889,-18,342,53,289,0,0,0,0,-24,19,18,-1.708333,0,0,3,4,false,false,false,0.012,0.988
186,172,14,18.6,19.111111,14,527,954,-427,0,0,0,0,40,10,9,0.875,0,2,26,12,false,false,false,0,1
208,312,-104,18.909091,31.2,-104,1606,1593,13,0,1,0,0.1,20,11,10,1.45,0,0,7,10,false,false,false,0,1
78,139,-61,15.6,27.8,-61,1633,1620,13,0,0,0,0,65,5,5,0.553846,0,0,13,10,false,false,false,0.106,0.894
90,64,26,18,16,26,1047,1127,-80,0,0,0,0,69,5,4,0.391304,1,1,6,6,false,false,false,0.301,0.699
169,231,-62,21.125,28.875,-62,1636,1702,-66,0,1,0,0.125,44,8,8,0.659091,0,0,17,11,false,false,false,0.106,0.894
6,9,-3,6,9,-3,1176,1133,43,0,0,0,0,94,1,1,0.361702,1,0,9,25,false,false,true,0.51,0.49
185,244,-59,13.214286,17.428571,-59,1278,1101,177,0,1,0,0.071429,18,14,14,2.055556,0,0,22,9,false,false,true,0.666,0.334
174,252,-78,15.818182,22.909091,-78,1493,1453,40,0,0,0,0,25,11,11,1.4,0,0,15,8,false,false,false,0.094,0.906
190,252,-62,23.75,36,-62,1925,1885,40,1,1,0.125,0.142857,31,8,7,0.806452,1,1,8,7,false,false,false,0.007,0.993
59,145,-86,11.8,29,-86,430,542,-112,0,1,0,0.2,64,5,5,0.75,0,0,27,10,false,false,false,0.094,0.906
185,285,-100,16.818182,25.909091,-100,1270,1424,-154,0,2,0,0.181818,29,11,11,1.206897,0,0,26,19,false,false,false,0.007,0.993
233,262,-29,15.533333,18.714286,-29,1312,1334,-22,0,0,0,0,-1,15,14,-39,0,0,13,9,false,false,false,0.106,0.894
37,101,-64,12.333333,33.666667,-64,1219,1216,3,0,1,0,0.333333,75,3,3,0.36,0,0,18,10,false,false,false,0.152,0.848
316,365,-49,26.333333,30.416667,-49,1344,1208,136,1,1,0.083333,0.083333,10,12,12,3,1,0,12,7,false,false,false,0.013,0.987
40,38,2,13.333333,19,2,775,786,-11,0,0,0,0,83,3,2,0.518072,0,0,7,18,false,false,false,0.136,0.864
263,328,-65,16.4375,20.5,-65,1078,1095,-17,1,1,0.0625,0.0625,-6,16,16,-6.166667,0,0,9,11,false,false,false,0.035,0.965
60,39,21,30,19.5,21,500,532,-32,0,0,0,0,83,2,2,0.493976,0,0,7,12,false,false,true,0.84,0.16
60,46,14,15,15.333333,14,814,830,-16,0,0,0,0,75,4,3,0.546667,0,0,10,12,false,false,false,0.4,0.6
83,146,-63,16.6,29.2,-63,1193,1177,16,0,0,0,0,67,5,5,0.522388,0,0,10,11,false,false,false,0.106,0.894
46,39,7,23,39,7,835,786,49,0,0,0,0,92,2,1,0.369565,0,0,9,9,false,false,false,0.304,0.696
265,302,-37,24.090909,30.2,-37,1495,1597,-102,0,1,0,0.1,21,11,10,1.52381,0,0,8,11,false,false,false,0.101,0.899
145,372,-227,12.083333,33.818182,-227,1093,1100,-7,0,2,0,0.181818,27,12,11,1.296296,0,0,8,12,false,false,false,0.001,0.999
83,93,-10,11.857143,15.5,-10,808,749,59,0,0,0,0,52,7,6,0.807692,0,0,7,10,false,false,false,0.14,0.86
36,69,-33,12,23,-33,595,540,55,0,0,0,0,78,3,3,0.551282,0,0,12,7,false,false,false,0.244,0.756
25,15,10,12.5,15,10,1045,948,97,0,0,0,0,85,2,1,0.4,0,0,17,13,false,false,false,0.477,0.523
266,239,27,26.6,26.555556,27,804,1074,-270,0,0,0,0,24,10,9,1.333333,0,0,8,12,false,false,true,0.632,0.368
25,74,-49,8.333333,24.666667,-49,935,995,-60,0,0,0,0,81,3,3,0.481481,2,0,20,16,false,false,true,0.739,0.261
234,315,-81,29.25,45,-81,1689,1777,-88,1,1,0.125,0.142857,31,8,7,0.967742,0,0,19,11,false,false,false,0.006,0.994
84,103,-19,21,25.75,-19,1539,1891,-352,0,1,0,0.25,65,4,4,0.384615,0,0,16,12,false,false,false,0.197,0.803
53,91,-38,13.25,30.333333,-38,518,414,104,0,1,0,0.333333,74,4,3,0.513514,0,0,16,7,false,false,false,0.294,0.706
80,74,6,26.666667,24.666667,6,450,624,-174,0,0,0,0,76,3,3,0.434211,1,0,10,14,false,false,true,0.519,0.481
365,394,-29,28.076923,30.307692,-29,1793,1957,-164,1,2,0.076923,0.153846,-2,13,13,-14.5,0,0,7,3,false,false,false,0.058,0.942
46,89,-43,23,89,-43,1331,1432,-101,0,0,0,0,81,2,1,0.333333,0,0,15,13,false,false,false,0.049,0.951
276,291,-15,25.090909,26.454545,-15,1793,1869,-76,0,1,0,0.090909,15,11,11,2,1,0,15,7,false,false,true,0.742,0.258
163,226,-63,16.3,25.111111,-63,1493,1453,40,0,0,0,0,34,10,9,1.029412,0,0,15,8,false,false,false,0.105,0.895
313,352,-39,18.411765,20.705882,-39,727,820,-93,0,1,0,0.058824,-16,17,17,-2.1875,0,1,3,2,false,false,false,0.012,0.988
233,340,-107,15.533333,22.666667,-107,848,976,-128,0,1,0,0.066667,7,15,15,5.714286,0,0,13,10,false,false,false,0.006,0.994
236,317,-81,15.733333,21.133333,-81,95,453,-358,0,0,0,0,-2,15,15,-19.5,0,0,12,8,false,false,false,0.006,0.994
48,54,-6,16,27,-6,341,416,-75,0,0,0,0,83,3,2,0.46988,0,0,16,20,false,false,false,0.247,0.753
20,24,-4,20,24,-4,999,1165,-166,0,0,0,0,93,1,1,0.494624,0,0,15,10,false,false,false,0.397,0.603
223,236,-13,18.583333,21.454545,-13,917,856,61,0,1,0,0.090909,22,12,11,1.5,0,1,7,19,false,false,false,0.011,0.989
210,267,-57,14,17.8,-57,813,698,115,1,0,0.066667,0,13,15,15,3.692308,0,0,12,10,false,false,false,0.033,0.967
147,241,-94,14.7,24.1,-94,952,826,126,0,1,0,0.1,43,10,10,1,0,1,13,6,false,false,false,0,1
344,380,-36,20.235294,22.352941,-36,1237,1265,-28,1,0,0.058824,0,-25,17,17,-1.44,0,0,2,2,false,false,false,0.027,0.973
231,315,-84,16.5,22.5,-84,1493,1453,40,0,0,0,0,4,14,14,8.75,0,2,12,5,false,false,false,0,1
155,146,9,22.142857,20.857143,9,785,892,-107,0,0,0,0,49,7,7,0.755102,0,0,10,10,false,false,true,0.533,0.467
133,181,-48,19,30.166667,-48,1110,1399,-289,0,1,0,0.166667,50,7,6,0.68,0,0,29,10,false,false,false,0.107,0.893
154,152,2,19.25,21.714286,2,1407,1473,-66,0,1,0,0.142857,47,8,7,0.659574,0,0,7,8,false,false,false,0.184,0.816
284,317,-33,16.705882,19.8125,-33,758,791,-33,0,0,0,0,-14,17,16,-2.785714,0,0,5,7,false,false,false,0.011,0.989
221,382,-161,20.090909,38.2,-161,1556,1656,-100,0,2,0,0.2,10,11,10,3,1,0,17,18,false,false,false,0.002,0.998
74,98,-24,37,49,-24,1431,1399,32,0,1,0,0.5,82,2,2,0.304878,0,0,9,8,false,false,false,0.075,0.925
149,167,-18,13.545455,15.181818,-18,306,302,4,0,0,0,0,29,11,11,1.413793,0,0,8,22,false,false,false,0.444,0.556
49,48,1,12.25,16,1,526,502,24,0,0,0,0,78,4,3,0.641026,0,0,18,17,false,false,false,0.28,0.72
281,427,-146,16.529412,25.117647,-146,1045,1100,-55,0,1,0,0.058824,-14,17,17,-2.428571,0,0,2,4,true,false,false,0.003,0.997
13,82,-69,6.5,41,-69,518,414,104,0,1,0,0.5,84,2,2,0.452381,0,0,20,7,false,false,false,0.291,0.709
172,323,-151,7.818182,14.681818,-151,651,567,84,0,0,0,0,-12,22,22,-4.583333,0,0,7,11,false,false,false,0.005,0.995
171,120,51,21.375,17.142857,51,991,1063,-72,0,0,0,0,51,8,7,0.745098,0,1,11,15,false,false,false,0.471,0.529
141,123,18,35.25,41,18,1354,1210,144,0,1,0,0.333333,71,4,3,0.464789,0,1,12,13,false,false,false,0.122,0.878
151,151,0,18.875,18.875,0,742,868,-126,0,0,0,0,45,8,8,0.733333,0,0,13,18,false,false,false,0.376,0.624
69,98,-29,11.5,16.333333,-29,503,668,-165,0,0,0,0,61,6,6,0.606557,0,0,7,9,false,false,false,0.109,0.891
87,96,-9,14.5,19.2,-9,278,1,277,0,0,0,0,57,6,5,0.649123,0,0,17,7,false,false,true,0.58,0.42
230,206,24,23,20.6,24,1093,1173,-80,0,0,0,0,35,10,10,1.228571,0,0,17,14,false,false,true,0.718,0.282
264,298,-34,17.6,19.866667,-34,944,1095,-151,0,1,0,0.066667,11,15,15,3.545455,0,2,9,8,false,false,false,0.003,0.997
248,345,-97,15.5,23,-97,1064,1397,-333,0,2,0,0.133333,10,16,15,4.3,1,1,8,9,false,false,false,0.005,0.995
149,175,-26,14.9,17.5,-26,714,892,-178,0,0,0,0,42,10,10,1,0,1,13,6,false,false,false,0.172,0.828
305,296,9,17.941176,18.5,9,540,498,42,1,0,0.058824,0,-12,17,16,-3.833333,0,0,7,16,false,false,false,0.432,0.568
320,340,-20,14.545455,15.454545,-20,561,688,-127,0,0,0,0,-19,22,22,-2.421053,0,0,1,4,false,false,false,0.06,0.94
270,323,-53,19.285714,24.846154,-53,980,965,15,0,0,0,0,8,14,13,4.75,0,0,19,11,false,false,false,0.007,0.993
265,369,-104,17.666667,26.357143,-104,1229,1220,9,0,1,0,0.071429,4,15,14,9.25,0,0,9,9,false,false,false,0.002,0.998
213,275,-62,16.384615,22.916667,-62,1159,1131,28,0,2,0,0.166667,15,13,12,2.466667,0,0,7,22,false,false,false,0.001,0.999
181,284,-103,22.625,40.571429,-103,1556,1616,-60,0,0,0,0,38,8,7,0.763158,0,0,17,10,false,false,false,0.007,0.993
105,135,-30,15,22.5,-30,1161,1030,131,0,1,0,0.166667,54,7,6,0.703704,0,0,14,13,false,false,false,0.121,0.879
124,228,-104,8.857143,16.285714,-104,651,996,-345,0,1,0,0.071429,12,14,14,3.75,0,2,33,5,false,false,false,0.004,0.996
171,151,20,21.375,21.571429,20,566,742,-176,0,1,0,0.142857,42,8,7,0.761905,0,0,7,16,false,false,true,0.7,0.3
233,222,11,23.3,24.666667,11,1245,1148,97,0,0,0,0,32,10,9,1.09375,0,0,17,10,false,false,true,0.635,0.365
63,126,-63,15.75,31.5,-63,1349,1203,146,0,1,0,0.25,69,4,4,0.463768,0,0,9,13,false,false,false,0.012,0.988
129,74,55,18.428571,12.333333,55,1040,1091,-51,0,0,0,0,57,7,6,0.824561,0,1,8,18,false,false,false,0.395,0.605
252,273,-21,16.8,19.5,-21,599,448,151,0,0,0,0,5,15,14,7.2,0,0,11,15,false,false,false,0.081,0.919
187,279,-92,18.7,31,-92,653,1004,-351,0,0,0,0,27,10,9,1.074074,0,0,7,8,false,false,false,0.005,0.995
119,124,-5,17,17.714286,-5,1229,1220,9,0,0,0,0,54,7,7,0.685185,0,1,20,10,false,false,false,0.284,0.716
104,97,7,26,32.333333,7,1554,1685,-131,0,1,0,0.333333,75,4,3,0.426667,0,0,10,9,false,false,false,0.4,0.6
0,34,-34,0,34,-34,935,995,-60,0,0,0,0,95,1,1,0.410526,1,0,14,15,false,false,false,0.189,0.811
160,126,34,16,12.6,34,670,576,94,0,0,0,0,34,10,10,1.205882,1,0,13,10,false,false,true,0.908,0.092
131,130,1,26.2,32.5,1,724,398,326,1,0,0.2,0,69,5,4,0.565217,0,0,23,14,false,false,true,0.723,0.277
95,220,-125,11.875,27.5,-125,1368,1452,-84,0,0,0,0,50,8,8,0.64,1,0,10,7,false,false,false,0.035,0.965
176,175,1,17.6,17.5,1,803,786,17,0,0,0,0,38,10,10,0.842105,0,0,13,14,false,false,true,0.604,0.396
24,0,24,24,0,24,1197,1156,41,0,0,0,0,94,1,0,0.37234,0,0,14,0,false,false,true,0.523,0.477
4,14,-10,4,14,-10,1045,1082,-37,0,0,0,0,95,1,1,0.473684,0,1,17,11,false,false,false,0.261,0.739
116,127,-11,16.571429,21.166667,-11,599,448,151,0,0,0,0,53,7,6,0.679245,0,1,16,6,false,false,false,0.309,0.691
275,283,-8,17.1875,18.866667,-8,1161,1030,131,0,1,0,0.066667,-10,16,15,-3.8,0,1,8,12,false,false,false,0.011,0.989
132,286,-154,14.666667,35.75,-154,1399,1210,189,0,1,0,0.125,43,9,8,0.813953,0,0,17,13,false,false,false,0.065,0.935
16,21,-5,16,21,-5,830,787,43,0,0,0,0,93,1,1,0.408602,0,0,14,19,false,false,false,0.283,0.717
142,144,-2,17.75,18,-2,995,965,30,0,0,0,0,44,8,8,0.909091,0,1,25,10,false,false,false,0.425,0.575
282,299,-17,21.692308,24.916667,-17,1473,1500,-27,0,2,0,0.166667,12,13,12,3.25,1,0,10,8,false,false,false,0.13,0.87
70,0,70,70,0,70,801,679,122,1,0,1,0,93,1,0,0.311828,0,0,9,0,false,false,true,0.568,0.432
281,430,-149,17.5625,28.666667,-149,976,995,-19,1,2,0.0625,0.133333,-7,16,15,-5.428571,1,0,6,8,false,false,false,0,1
65,55,10,16.25,13.75,10,889,855,34,0,0,0,0,76,4,4,0.526316,0,0,18,11,false,false,true,0.584,0.416
308,423,-115,11.407407,16.269231,-115,1037,1016,21,1,0,0.037037,0,-24,27,26,-2.416667,1,0,1,5,false,false,false,0.006,0.994
98,124,-26,16.333333,20.666667,-26,874,868,6,0,0,0,0,54,6,6,0.611111,0,0,16,17,false,false,false,0.199,0.801
134,180,-46,19.142857,25.714286,-46,1606,1890,-284,0,0,0,0,48,7,7,0.583333,1,0,16,13,false,false,false,0.291,0.709
30,72,-42,6,14.4,-42,1078,983,95,0,0,0,0,74,5,5,0.648649,1,0,7,16,false,false,false,0.241,0.759
126,110,16,25.2,27.5,16,1003,1004,-1,0,0,0,0,72,5,4,0.486111,0,0,15,8,false,false,false,0.422,0.578
12,0,12,12,0,12,278,1,277,0,0,0,0,95,1,0,0.389474,0,0,11,0,false,false,true,0.635,0.365
203,317,-114,12.6875,19.8125,-114,1305,1307,-2,0,1,0,0.0625,-4,16,16,-10.25,0,1,13,15,false,false,false,0,1
202,281,-79,14.428571,20.071429,-79,642,952,-310,0,0,0,0,13,14,14,3.384615,0,0,16,11,false,false,false,0.005,0.995
168,176,-8,14,16,-8,361,413,-52,0,0,0,0,25,12,11,1.64,2,0,11,10,false,false,true,0.794,0.206
227,401,-174,13.352941,23.588235,-174,913,1037,-124,0,3,0,0.176471,-1,17,17,-41,0,0,17,13,false,false,false,0.001,0.999
105,91,14,15,15.166667,14,805,918,-113,0,0,0,0,54,7,6,0.666667,0,1,17,6,false,false,false,0.274,0.726
290,319,-29,20.714286,24.538462,-29,1495,1531,-36,0,1,0,0.076923,10,14,13,3.7,0,0,7,10,false,false,false,0.112,0.888
288,380,-92,18,25.333333,-92,967,856,111,0,1,0,0.066667,-5,16,15,-6.6,0,1,5,2,false,false,false,0,1
113,125,-12,18.833333,25,-12,653,820,-167,0,0,0,0,56,6,5,0.678571,0,0,7,20,false,false,false,0.108,0.892
208,102,106,34.666667,20.4,106,1777,1689,88,1,0,0.166667,0,51,6,5,0.529412,0,0,19,8,false,false,true,0.954,0.046
257,282,-25,25.7,28.2,-25,1188,1334,-146,1,1,0.1,0.1,18,10,10,1.666667,1,0,7,13,false,false,false,0.27,0.73
142,154,-12,20.285714,25.666667,-12,1227,1189,38,0,0,0,0,50,7,6,0.7,0,0,11,16,false,false,false,0.123,0.877
7,31,-24,2.333333,15.5,-24,1793,1869,-76,0,0,0,0,90,3,2,0.333333,0,0,8,11,false,false,false,0.244,0.756
237,307,-70,13.941176,19.1875,-70,306,361,-55,0,0,0,0,-19,17,16,-1.894737,0,0,1,10,false,false,false,0.005,0.995
77,108,-31,15.4,21.6,-31,1003,1018,-15,0,0,0,0,64,5,5,0.578125,0,1,15,13,false,false,false,0.11,0.89
22,0,22,22,0,22,804,1080,-276,0,0,0,0,94,1,0,0.361702,1,0,7,0,false,false,false,0.419,0.581
249,308,-59,16.6,20.533333,-59,1040,1364,-324,0,0,0,0,-6,15,15,-6,0,0,10,14,false,false,false,0.008,0.992
88,157,-69,22,39.25,-69,1632,2020,-388,0,0,0,0,67,4,4,0.462687,0,0,8,9,false,false,false,0.106,0.894
147,193,-46,16.333333,21.444444,-46,889,895,-6,0,1,0,0.111111,37,9,9,1,0,1,17,13,false,false,false,0.101,0.899
43,107,-64,8.6,21.4,-64,1368,1452,-84,0,0,0,0,71,5,5,0.450704,1,0,14,26,false,false,false,0.115,0.885
102,96,6,10.2,10.666667,6,925,1000,-75,0,0,0,0,40,10,9,1.1,0,1,10,20,false,false,false,0.164,0.836
290,379,-89,15.263158,21.055556,-89,952,826,126,0,1,0,0.055556,-8,19,18,-5.375,0,0,8,6,false,false,false,0.003,0.997
218,219,-1,15.571429,16.846154,-1,999,1165,-166,0,0,0,0,20,14,13,2.3,1,1,15,11,false,false,false,0.245,0.755
101,169,-68,16.833333,33.8,-68,971,800,171,0,1,0,0.2,44,6,5,0.659091,1,0,13,8,false,false,false,0.024,0.976
41,20,21,20.5,20,21,1652,1473,179,0,0,0,0,86,2,1,0.348837,0,0,12,9,false,false,true,0.537,0.463
146,122,24,20.857143,20.333333,24,1078,1095,-17,1,0,0.142857,0,56,7,6,0.660714,0,1,20,12,false,false,false,0.418,0.582
228,361,-133,16.285714,25.785714,-133,915,971,-56,0,0,0,0,0,14,14,0,1,0,11,11,false,false,false,0.005,0.995
0,65,-65,0,16.25,-65,1334,1439,-105,0,0,0,0,92,4,4,0.391304,2,0,12,13,false,false,true,0.644,0.356
327,472,-145,20.4375,29.5,-145,1554,1685,-131,0,2,0,0.125,-11,16,16,-2.909091,0,0,1,2,true,false,false,0,1
215,275,-60,30.714286,45.833333,-60,1885,1908,-23,1,3,0.142857,0.5,32,7,6,0.71875,0,0,10,20,false,false,false,0.02,0.98
122,226,-104,17.428571,32.285714,-104,1232,1281,-49,0,2,0,0.285714,39,7,7,0.794872,0,0,12,16,false,false,false,0.012,0.988
101,200,-99,25.25,50,-99,1925,1885,40,1,1,0.25,0.25,59,4,4,0.423729,0,0,11,14,false,false,false,0.008,0.992
92,170,-78,23,42.5,-78,1556,1616,-60,0,0,0,0,72,4,4,0.402778,0,2,11,9,false,false,false,0,1
154,156,-2,25.666667,26,-2,1047,1127,-80,0,1,0,0.166667,48,6,6,0.5625,0,0,11,16,false,false,true,0.677,0.323
155,178,-23,22.142857,29.666667,-23,1388,1366,22,0,1,0,0.166667,48,7,6,0.666667,0,0,12,9,false,false,false,0.147,0.853
87,74,13,14.5,14.8,13,1452,1388,64,0,0,0,0,65,6,5,0.538462,0,0,15,20,false,false,false,0.148,0.852
345,325,20,19.166667,18.055556,20,907,910,-3,0,1,0,0.055556,-5,18,18,-8.6,0,0,7,9,false,false,true,0.876,0.124
220,353,-133,12.941176,20.764706,-133,542,605,-63,0,0,0,0,-14,17,17,-2.571429,0,0,5,5,false,false,false,0.005,0.995
14,12,2,14,12,2,163,346,-183,0,0,0,0,91,1,1,0.428571,0,1,13,6,false,false,false,0.001,0.999
244,310,-66,17.428571,22.142857,-66,1691,1551,140,0,0,0,0,9,14,14,4.111111,1,0,7,15,false,false,false,0.012,0.988
277,351,-74,15.388889,19.5,-74,1064,1397,-333,0,2,0,0.111111,-1,18,18,-43,1,1,9,8,false,false,false,0.005,0.995
318,347,-29,22.714286,24.785714,-29,1305,1211,94,2,0,0.142857,0,3,14,14,11,0,1,17,9,false,false,false,0.021,0.979
83,114,-31,20.75,38,-31,1315,1331,-16,0,0,0,0,72,4,3,0.458333,1,0,14,19,false,false,false,0.425,0.575
105,157,-52,21,31.4,-52,1315,1334,-19,0,1,0,0.2,62,5,5,0.580645,0,0,12,11,false,false,false,0.115,0.885
227,392,-165,13.352941,24.5,-165,913,1037,-124,0,3,0,0.1875,1,17,16,41,0,0,17,13,false,false,false,0.001,0.999
105,94,11,21,23.5,11,921,1045,-124,0,0,0,0,70,5,4,0.5,0,0,11,11,false,false,false,0.161,0.839
25,62,-37,12.5,31,-37,1102,1245,-143,0,0,0,0,83,2,2,0.349398,0,0,9,16,false,false,false,0.106,0.894
145,120,25,18.125,15,25,1168,1216,-48,0,0,0,0,58,8,8,0.568966,0,0,18,14,false,false,true,0.808,0.192
282,291,-9,14.1,15.315789,-9,797,796,1,0,0,0,0,-11,20,19,-4.454545,0,0,8,7,false,false,false,0.086,0.914
294,291,3,18.375,19.4,3,742,594,148,0,0,0,0,-2,16,15,-19.5,1,0,7,10,false,false,true,0.576,0.424
275,353,-78,16.176471,22.0625,-78,889,895,-6,0,1,0,0.0625,-8,17,16,-4.625,0,1,8,13,false,false,false,0,1
167,153,14,20.875,21.857143,14,999,1283,-284,0,0,0,0,51,8,7,0.647059,0,1,10,10,false,false,false,0.205,0.795
150,162,-12,16.666667,18,-12,1310,1477,-167,0,0,0,0,32,9,9,1.125,1,0,7,11,false,false,false,0.249,0.751
90,100,-10,22.5,25,-10,689,804,-115,0,0,0,0,67,4,4,0.522388,1,0,12,17,false,false,false,0.356,0.644
273,403,-130,18.2,26.866667,-130,1656,1649,7,0,0,0,0,-9,15,15,-3.555556,0,0,1,4,false,false,false,0.003,0.997
260,382,-122,23.636364,34.727273,-122,1689,1777,-88,1,1,0.090909,0.090909,8,11,11,3.75,0,0,19,16,false,false,false,0.005,0.995
72,117,-45,24,39,-45,1164,1161,3,0,1,0,0.333333,73,3,3,0.315068,0,0,7,26,false,false,false,0.17,0.83
159,186,-27,22.714286,26.571429,-27,689,804,-115,0,0,0,0,44,7,7,0.795455,0,0,7,18,false,false,false,0.124,0.876
69,130,-61,13.8,26,-61,1030,1014,16,0,0,0,0,70,5,5,0.471429,1,0,6,11,false,false,false,0.127,0.873
107,104,3,17.833333,17.333333,3,897,996,-99,0,0,0,0,62,6,6,0.629032,0,0,10,7,false,false,false,0.347,0.653
277,349,-72,15.388889,20.529412,-72,1064,1397,-333,0,2,0,0.117647,1,18,17,43,1,1,9,8,false,false,false,0.005,0.995
284,362,-78,15.777778,20.111111,-78,1159,1131,28,0,2,0,0.111111,-17,18,18,-2.176471,0,0,1,2,false,false,false,0.002,0.998
210,259,-49,14,18.5,-49,775,786,-11,0,0,0,0,12,15,14,3.583333,1,0,10,25,false,false,false,0.011,0.989
218,307,-89,16.769231,23.615385,-89,736,791,-55,0,0,0,0,5,13,13,7.6,0,0,8,8,false,false,false,0.005,0.995
16,2,14,16,2,14,1315,1334,-19,0,0,0,0,92,1,1,0.391304,0,0,7,18,false,false,false,0.411,0.589
107,102,5,13.375,14.571429,5,999,1071,-72,0,0,0,0,48,8,7,0.833333,1,0,9,12,false,false,false,0.275,0.725
58,63,-5,14.5,15.75,-5,758,791,-33,0,0,0,0,72,4,4,0.541667,0,0,13,10,false,false,false,0.404,0.596
204,251,-47,13.6,17.928571,-47,1071,1000,71,0,0,0,0,11,15,14,4.272727,0,0,7,14,false,false,false,0.039,0.961
33,48,-15,8.25,16,-15,95,453,-358,0,0,0,0,85,4,3,0.458824,0,0,7,13,false,false,false,0.089,0.911
84,98,-14,12,16.333333,-14,503,668,-165,0,0,0,0,59,7,6,0.627119,0,0,7,9,false,false,false,0.11,0.89
339,432,-93,30.818182,43.2,-93,2010,2219,-209,1,1,0.090909,0.1,8,11,10,3.25,0,0,19,7,false,false,false,0.008,0.992
217,208,9,19.727273,20.8,9,1422,1583,-161,0,1,0,0.1,30,11,10,1.366667,1,1,6,22,false,false,false,0.173,0.827
89,160,-71,14.833333,32,-71,1195,1397,-202,0,1,0,0.2,60,6,5,0.666667,0,0,11,9,false,false,false,0.106,0.894
54,106,-52,18,35.333333,-52,594,648,-54,0,1,0,0.333333,78,3,3,0.512821,0,1,13,11,false,false,false,0.132,0.868
87,104,-17,17.4,20.8,-17,1161,1030,131,0,0,0,0,69,5,5,0.550725,0,0,7,12,false,false,false,0.167,0.833
313,331,-18,26.083333,27.583333,-18,1331,1432,-101,0,0,0,0,3,12,12,9,0,1,15,7,false,false,false,0.11,0.89
162,138,24,18,17.25,24,1633,1556,77,0,0,0,0,35,9,8,0.942857,0,0,22,18,false,false,false,0.296,0.704
206,249,-43,14.714286,17.785714,-43,797,796,1,0,0,0,0,21,14,14,2.333333,1,0,12,15,false,false,false,0.075,0.925
31,35,-4,15.5,35,-4,1302,1351,-49,0,0,0,0,89,2,1,0.41573,1,0,6,9,false,false,false,0.456,0.544
54,47,7,27,23.5,7,892,856,36,0,0,0,0,85,2,2,0.411765,0,0,13,10,false,false,true,0.526,0.474
208,133,75,29.714286,19,75,1563,1539,24,0,0,0,0,45,7,7,0.777778,0,2,7,7,false,false,true,0.749,0.251
373,448,-75,20.722222,24.888889,-75,724,398,326,1,1,0.055556,0.055556,-20,18,18,-1.95,0,0,7,5,false,false,false,0.013,0.987
26,32,-6,13,16,-6,632,603,29,0,0,0,0,82,2,2,0.463415,1,0,6,21,false,false,false,0.489,0.511
234,275,-41,23.4,30.555556,-41,1436,1489,-53,1,1,0.1,0.111111,34,10,9,1.088235,0,0,14,7,false,false,false,0.052,0.948
125,101,24,20.833333,20.2,24,1488,1428,60,1,0,0.166667,0,59,6,5,0.627119,0,0,20,18,false,false,false,0.3,0.7
278,333,-55,21.384615,25.615385,-55,1266,1339,-73,0,1,0,0.076923,12,13,13,2.916667,0,0,7,11,false,false,false,0.014,0.986
52,51,1,13,17,1,727,820,-93,0,1,0,0.333333,73,4,3,0.479452,0,0,11,18,false,false,false,0.376,0.624
46,14,32,46,14,32,1274,1394,-120,0,0,0,0,92,1,1,0.326087,0,0,10,11,false,false,true,0.764,0.236
102,138,-36,20.4,27.6,-36,1645,1636,9,0,1,0,0.2,56,5,5,0.589286,0,1,17,13,false,false,false,0.012,0.988
76,181,-105,12.666667,36.2,-105,595,412,183,0,1,0,0.2,63,6,5,0.825397,0,1,15,8,false,false,false,0,1
251,417,-166,20.916667,34.75,-166,1003,1004,-1,0,2,0,0.166667,14,12,12,2.5,0,0,7,10,false,false,false,0,1
266,296,-30,19,21.142857,-30,758,904,-146,1,0,0.071429,0,-4,14,14,-8.5,0,1,8,12,false,false,false,0,1
229,325,-96,9.541667,14.130435,-96,818,826,-8,0,0,0,0,-31,24,23,-1.709677,0,0,5,10,false,false,false,0.005,0.995
211,200,11,30.142857,28.571429,11,1699,1580,119,2,0,0.285714,0,43,7,7,0.697674,0,0,11,9,false,false,false,0.472,0.528
202,382,-180,20.2,38.2,-180,1556,1656,-100,0,2,0,0.2,14,10,10,2.142857,0,0,9,18,false,false,false,0,1
194,195,-1,21.555556,24.375,-1,1270,1261,9,1,0,0.111111,0,46,9,8,0.804348,0,0,10,16,false,false,false,0.179,0.821
282,364,-82,17.625,22.75,-82,691,704,-13,0,1,0,0.0625,-9,16,16,-4.222222,0,0,5,6,false,false,false,0.025,0.975
221,386,-165,12.277778,21.444444,-165,948,998,-50,0,0,0,0,-22,18,18,-1.681818,0,0,2,1,false,false,false,0.005,0.995
215,311,-96,30.714286,44.428571,-96,1885,1908,-23,1,3,0.142857,0.428571,27,7,7,0.851852,0,0,10,9,false,false,false,0.002,0.998
114,141,-27,19,28.2,-27,594,648,-54,1,1,0.166667,0.2,58,6,5,0.689655,0,1,10,16,false,false,false,0.001,0.999
44,21,23,44,21,23,1563,1539,24,0,0,0,0,92,1,1,0.380435,0,0,9,10,false,false,true,0.542,0.458
285,406,-121,16.764706,23.882353,-121,965,1078,-113,1,1,0.058824,0.058824,-15,17,17,-2.466667,1,0,1,1,false,false,false,0.005,0.995
243,271,-28,18.692308,22.583333,-28,1110,1123,-13,0,1,0,0.083333,13,13,12,2.538462,1,1,9,11,false,false,false,0.015,0.985
107,118,-11,35.666667,59,-11,1699,1580,119,1,0,0.333333,0,75,3,2,0.4,0,0,8,19,false,false,false,0.025,0.975
47,60,-13,15.666667,20,-13,1331,1374,-43,0,0,0,0,74,3,3,0.445946,0,0,11,10,false,false,false,0.295,0.705
293,355,-62,19.533333,23.666667,-62,1126,1277,-151,0,0,0,0,-14,15,15,-2.5,0,0,2,8,false,false,false,0.006,0.994
147,107,40,18.375,13.375,40,671,638,33,0,0,0,0,42,8,8,1.166667,0,0,16,25,false,false,true,0.741,0.259
192,155,37,16,14.090909,37,1030,998,32,0,0,0,0,26,12,11,1.423077,0,0,8,15,false,false,true,0.693,0.307
12,20,-8,12,20,-8,642,952,-310,0,0,0,0,93,1,1,0.473118,0,0,12,11,false,false,false,0.167,0.833
251,219,32,20.916667,19.909091,32,1168,1062,106,0,0,0,0,31,12,11,1.387097,1,0,7,9,false,false,true,0.844,0.156
34,29,5,34,29,5,1055,840,215,0,0,0,0,91,1,1,0.395604,0,1,13,15,false,false,false,0.341,0.659
75,55,20,18.75,13.75,20,306,468,-162,0,0,0,0,80,4,4,0.4625,0,0,13,15,false,false,true,0.759,0.241
263,344,-81,15.470588,20.235294,-81,1078,1095,-17,1,1,0.058824,0.058824,-11,17,17,-3.363636,0,0,9,4,false,false,false,0.027,0.973
38,64,-26,38,64,-26,1164,1261,-97,0,1,0,1,88,1,1,0.477273,0,1,20,24,false,false,false,0.06,0.94
59,56,3,11.8,14,3,808,749,59,0,0,0,0,66,5,4,0.636364,0,1,9,16,false,false,false,0.2,0.8
16,53,-37,8,26.5,-37,1131,1030,101,0,0,0,0,86,2,2,0.348837,0,0,10,12,false,false,false,0.123,0.877
67,25,42,22.333333,12.5,42,1305,1254,51,0,0,0,0,86,3,2,0.372093,0,1,11,6,false,false,true,0.567,0.433
324,376,-52,18,22.117647,-52,1266,1339,-73,0,1,0,0.058824,-8,18,17,-4.375,0,0,1,2,true,false,false,0.005,0.995
286,290,-4,22,22.307692,-4,1561,1495,66,1,0,0.076923,0,-2,13,13,-16.5,0,0,10,8,false,false,true,0.637,0.363
20,24,-4,20,24,-4,1539,1891,-352,0,0,0,0,94,1,1,0.265957,0,0,12,17,false,false,false,0.183,0.817
117,189,-72,16.714286,31.5,-72,971,800,171,0,1,0,0.166667,36,7,6,0.805556,1,0,13,16,false,false,false,0.02,0.98
169,153,16,33.8,38.25,16,1354,1210,144,0,1,0,0.25,63,5,4,0.52381,0,0,15,13,false,false,false,0.161,0.839
248,235,13,17.714286,18.076923,13,1203,1270,-67,1,0,0.071429,0,22,14,13,2,1,0,6,15,false,false,true,0.528,0.472
89,121,-32,14.833333,24.2,-32,518,414,104,0,1,0,0.2,62,6,5,0.612903,0,0,7,13,false,false,false,0.233,0.767
276,292,-16,19.714286,22.461538,-16,689,804,-115,0,0,0,0,6,14,13,5.833333,0,1,7,11,false,false,false,0.018,0.982
264,275,-11,22,25,-11,1354,1210,144,0,1,0,0.090909,16,12,11,2.0625,0,0,20,9,false,false,false,0.189,0.811
47,47,0,15.666667,15.666667,0,1195,1397,-202,0,0,0,0,82,3,3,0.487805,0,1,7,6,false,false,false,0.245,0.755
77,32,45,15.4,8,45,491,651,-160,0,0,0,0,73,5,4,0.410959,0,1,12,11,false,false,false,0.383,0.617
331,354,-23,22.066667,25.285714,-23,1656,1580,76,1,1,0.066667,0.071429,-2,15,14,-16.5,0,0,6,6,false,false,false,0.004,0.996
8,0,8,8,0,8,500,509,-9,0,0,0,0,96,1,0,0.427083,0,0,9,0,false,false,false,0.495,0.505
145,203,-58,13.181818,20.3,-58,1071,1000,71,0,0,0,0,38,11,10,1.236842,0,1,16,13,false,false,false,0.074,0.926
16,0,16,8,0,16,530,683,-153,0,0,0,0,94,2,1,0.425532,0,1,9,16,false,false,false,0.216,0.784
213,248,-35,15.214286,19.076923,-35,1195,1397,-202,0,1,0,0.076923,19,14,13,2.105263,0,0,11,7,false,false,false,0.105,0.895
185,209,-24,15.416667,19,-24,1075,878,197,0,0,0,0,30,12,11,1.1,0,1,10,8,false,false,false,0.008,0.992
97,150,-53,12.125,21.428571,-53,95,453,-358,0,0,0,0,59,8,7,0.661017,0,0,11,10,false,false,false,0.035,0.965
215,227,-12,19.545455,20.636364,-12,758,904,-146,1,0,0.090909,0,16,11,11,2.125,0,1,9,9,false,false,false,0.002,0.998
189,233,-44,17.181818,23.3,-44,452,698,-246,0,1,0,0.1,27,11,10,1.518519,0,0,15,11,false,false,false,0.048,0.952
312,350,-38,16.421053,19.444444,-38,952,870,82,0,0,0,0,-26,19,18,-1.423077,0,0,4,3,true,false,false,0.005,0.995
171,237,-66,21.375,29.625,-66,991,1063,-72,0,1,0,0.125,44,8,8,0.863636,0,0,11,11,false,false,false,0.079,0.921
60,172,-112,8.571429,24.571429,-112,1037,913,124,0,1,0,0.142857,64,7,7,0.59375,1,0,8,14,false,false,false,0.04,0.96
185,252,-67,11.5625,16.8,-67,226,361,-135,0,0,0,0,-7,16,15,-6.285714,1,0,10,9,false,false,false,0.006,0.994
32,17,15,16,17,15,725,668,57,0,0,0,0,90,2,1,0.388889,0,0,14,18,false,false,false,0.296,0.704
245,401,-156,22.272727,36.454545,-156,2143,2219,-76,0,0,0,0,15,11,11,2.066667,1,0,8,7,false,false,false,0.027,0.973
247,219,28,19,18.25,28,952,870,82,0,0,0,0,11,13,12,3.363636,0,0,11,23,false,false,true,0.716,0.284
247,287,-40,13.722222,16.882353,-40,813,698,115,1,0,0.055556,0,-1,18,17,-48,0,0,7,22,false,false,false,0.037,0.963
60,54,6,20,18,6,664,786,-122,0,0,0,0,84,3,3,0.392857,0,0,19,11,false,false,true,0.53,0.47
363,403,-40,24.2,28.785714,-40,1793,1869,-76,1,1,0.066667,0.071429,-8,15,14,-3.75,0,0,1,3,false,false,false,0.007,0.993
206,221,-15,18.727273,22.1,-15,1161,1030,131,0,1,0,0.1,25,11,10,1.52,0,0,23,13,false,false,true,0.587,0.413
314,344,-30,19.625,22.933333,-30,742,868,-126,0,1,0,0.066667,-8,16,15,-4.125,0,0,2,5,false,false,false,0.037,0.963
120,141,-21,17.142857,20.142857,-21,1452,1388,64,0,0,0,0,54,7,7,0.648148,0,2,18,5,false,false,false,0.1,0.9
215,176,39,17.916667,14.666667,39,897,996,-99,0,0,0,0,28,12,12,1.392857,0,0,10,9,false,false,true,0.869,0.131
121,110,11,20.166667,22,11,566,742,-176,0,0,0,0,61,6,5,0.52459,1,0,12,17,false,false,false,0.34,0.66
318,330,-12,22.714286,25.384615,-12,1305,1211,94,2,0,0.142857,0,6,14,13,5.5,0,1,17,7,false,false,false,0.027,0.973
166,163,3,20.75,20.375,3,1257,1176,81,1,0,0.125,0,50,8,8,0.68,1,0,14,21,false,false,true,0.613,0.387
114,141,-27,14.25,17.625,-27,848,976,-128,0,0,0,0,50,8,8,0.8,0,0,19,10,false,false,false,0.11,0.89
16,23,-7,8,23,-7,206,346,-140,0,0,0,0,90,2,1,0.477778,0,0,16,17,false,false,false,0.186,0.814
195,286,-91,15,22,-91,595,412,183,0,1,0,0.076923,19,13,13,2.736842,0,0,14,12,false,false,false,0.005,0.995
82,38,44,27.333333,19,44,1556,1513,43,0,0,0,0,79,3,2,0.392405,1,0,7,13,false,false,true,0.86,0.14
55,55,0,13.75,18.333333,0,700,820,-120,0,0,0,0,77,4,3,0.493506,0,0,18,9,false,false,false,0.232,0.768
252,281,-29,22.909091,25.545455,-29,1452,1388,64,0,1,0,0.090909,19,11,11,1.842105,0,0,8,14,false,false,false,0.074,0.926
8,0,8,8,0,8,1037,1009,28,0,0,0,0,96,1,0,0.458333,0,0,11,0,false,false,false,0.439,0.561
202,360,-158,9.619048,17.142857,-158,651,996,-345,0,2,0,0.095238,-28,21,21,-1.607143,0,0,5,2,false,false,false,0.005,0.995
10,0,10,10,0,10,805,918,-113,0,0,0,0,96,1,0,0.375,0,0,23,0,false,false,true,0.508,0.492
287,371,-84,13.045455,16.863636,-84,1101,1130,-29,1,1,0.045455,0.045455,-22,22,22,-2.045455,0,1,3,1,false,false,false,0.001,0.999
238,314,-76,21.636364,28.545455,-76,1770,1745,25,1,0,0.090909,0,25,11,11,1.32,1,0,6,7,false,false,false,0.099,0.901
239,223,16,21.727273,22.3,16,1227,1189,38,0,0,0,0,22,11,10,1.590909,0,1,9,15,false,false,false,0.128,0.872
297,343,-46,15.631579,19.055556,-46,1037,1009,28,0,0,0,0,-6,19,18,-7.333333,0,0,2,4,false,false,false,0.009,0.991
343,358,-15,18.052632,18.842105,-15,804,766,38,0,1,0,0.052632,-13,19,19,-3.153846,0,0,4,1,false,false,false,0.123,0.877
258,207,51,18.428571,14.785714,51,1030,998,32,0,0,0,0,10,14,14,3.7,0,0,14,13,false,false,true,0.971,0.029
115,114,1,16.428571,16.285714,1,1344,1208,136,0,0,0,0,57,7,7,0.526316,0,0,18,8,false,false,true,0.517,0.483
237,238,-1,18.230769,18.307692,-1,1037,1009,28,0,0,0,0,23,13,13,1.913043,1,1,10,8,false,false,false,0.249,0.751
107,212,-105,9.727273,19.272727,-105,651,996,-345,0,1,0,0.090909,22,11,11,2.045455,0,2,22,5,false,false,false,0,1
194,213,-19,14.923077,16.384615,-19,526,502,24,0,0,0,0,25,13,13,2,0,0,13,10,false,false,false,0.437,0.563
42,39,3,14,19.5,3,671,638,33,0,0,0,0,81,3,2,0.604938,0,0,15,10,false,false,false,0.346,0.654
164,158,6,18.222222,19.75,6,615,542,73,0,0,0,0,47,9,8,0.893617,0,0,12,11,false,false,true,0.652,0.348
115,151,-36,16.428571,21.571429,-36,1123,1062,61,0,0,0,0,51,7,7,0.862745,0,0,12,15,false,false,false,0.112,0.888
34,20,14,17,20,14,1632,2020,-388,0,0,0,0,89,2,1,0.348315,1,0,12,28,false,false,true,0.617,0.383
44,14,30,22,14,30,1388,1366,22,0,0,0,0,90,2,1,0.355556,0,0,8,9,false,false,false,0.491,0.509
262,326,-64,21.833333,29.636364,-64,1699,1803,-104,1,1,0.083333,0.090909,28,12,11,1.25,0,0,21,22,false,false,false,0.007,0.993
312,354,-42,22.285714,27.230769,-42,1439,1314,125,0,0,0,0,-4,14,13,-7,0,1,3,3,false,false,false,0.001,0.999
89,152,-63,17.8,30.4,-63,473,683,-210,0,0,0,0,63,5,5,0.603175,0,0,12,23,false,false,false,0.09,0.91
270,325,-55,22.5,29.545455,-55,1422,1798,-376,0,2,0,0.181818,15,12,11,2.133333,0,0,10,21,false,false,false,0.008,0.992
99,103,-4,12.375,14.714286,-4,542,390,152,0,0,0,0,65,8,7,0.769231,0,0,13,16,false,false,false,0.418,0.582
127,97,30,25.4,24.25,30,1055,1019,36,0,0,0,0,62,5,4,0.532258,0,0,8,16,false,false,false,0.349,0.651
205,233,-28,18.636364,21.181818,-28,518,461,57,0,0,0,0,23,11,11,1.565217,0,1,10,6,false,false,false,0.106,0.894
330,346,-16,20.625,21.625,-16,1645,1636,9,0,1,0,0.0625,-23,16,16,-1.434783,0,0,1,3,false,false,false,0.036,0.964
185,271,-86,11.5625,18.066667,-86,651,700,-49,0,0,0,0,1,16,15,56,1,0,7,14,false,false,false,0.005,0.995
227,416,-189,17.461538,34.666667,-189,1334,1486,-152,2,1,0.153846,0.083333,14,13,12,2.071429,0,0,11,11,false,false,false,0.005,0.995
198,196,2,19.8,21.777778,2,758,904,-146,1,0,0.1,0,25,10,9,1.36,0,0,9,14,false,false,false,0.365,0.635
77,54,23,15.4,13.5,23,1030,998,32,0,0,0,0,64,5,4,0.578125,0,0,9,7,false,false,true,0.509,0.491
209,472,-263,19,47.2,-263,1632,2020,-388,0,2,0,0.2,15,11,10,2.066667,0,0,24,12,false,false,false,0.005,0.995
0,0,0,0,0,0,1397,1309,88,0,0,0,0,100,1,0,0.36,1,0,18,0,false,false,true,0.523,0.477
165,112,53,27.5,18.666667,53,1156,1279,-123,1,0,0.166667,0,56,6,6,0.714286,1,0,6,13,false,false,true,0.834,0.166
65,72,-7,16.25,18,-7,1331,1374,-43,0,0,0,0,66,4,4,0.5,0,0,11,15,false,false,false,0.197,0.803
87,118,-31,14.5,19.666667,-31,402,448,-46,0,0,0,0,60,6,6,0.616667,0,1,16,9,false,false,false,0.088,0.912
132,126,6,22,25.2,6,1176,1133,43,1,0,0.166667,0,65,6,5,0.523077,0,0,14,18,false,false,false,0.266,0.734
111,122,-11,15.857143,20.333333,-11,603,721,-118,0,0,0,0,59,7,6,0.728814,0,0,12,19,false,false,false,0.11,0.89
120,69,51,24,17.25,51,1070,814,256,1,1,0.2,0.25,63,5,4,0.52381,0,0,10,10,false,false,true,0.972,0.028
276,261,15,23,21.75,15,1691,1510,181,0,1,0,0.083333,12,12,12,2.5,1,0,6,22,false,false,false,0.498,0.502
164,172,-8,20.5,21.5,-8,1495,1531,-36,0,0,0,0,52,8,8,0.711538,0,0,8,10,false,false,false,0.132,0.868
58,38,20,14.5,12.666667,20,758,791,-33,0,0,0,0,76,4,3,0.513158,0,0,13,10,false,false,true,0.5,0.5
128,128,0,21.333333,25.6,0,804,766,38,0,1,0,0.2,65,6,5,0.630769,0,1,8,13,false,false,false,0.154,0.846
99,161,-62,9,14.636364,-62,1045,1082,-37,0,0,0,0,31,11,11,1.451613,1,0,26,20,false,false,false,0.106,0.894
20,0,20,20,0,20,711,746,-35,0,0,0,0,96,1,0,0.395833,0,0,23,0,false,false,true,0.553,0.447
138,211,-73,15.333333,26.375,-73,480,739,-259,0,0,0,0,43,9,8,0.906977,0,0,8,7,false,false,false,0.008,0.992
316,378,-62,18.588235,23.625,-62,771,668,103,2,0,0.117647,0,-21,17,16,-1.809524,0,0,2,8,false,false,false,0.033,0.967
121,113,8,20.166667,18.833333,8,1043,1003,40,0,0,0,0,58,6,6,0.655172,0,0,22,12,false,false,true,0.58,0.42
178,119,59,35.6,23.8,59,691,695,-4,1,0,0.2,0,61,5,5,0.52459,0,0,8,19,false,false,true,0.739,0.261
262,523,-261,17.466667,37.357143,-261,1632,2020,-388,0,3,0,0.214286,-17,15,14,-1.823529,0,0,4,2,false,false,false,0.001,0.999
242,250,-8,17.285714,19.230769,-8,1040,1364,-324,0,0,0,0,4,14,13,9,0,1,7,19,false,false,false,0.107,0.893
59,56,3,14.75,18.666667,3,1037,1009,28,0,0,0,0,76,4,3,0.578947,0,0,28,12,false,false,false,0.319,0.681
179,210,-31,16.272727,21,-31,804,766,38,0,1,0,0.1,43,11,10,0.953488,0,1,17,13,false,false,false,0.078,0.922
308,306,2,19.25,19.125,2,1168,1062,106,0,0,0,0,4,16,16,10.75,1,0,7,13,false,false,true,0.653,0.347
281,448,-167,11.708333,19.478261,-167,1078,983,95,1,0,0.041667,0,-35,24,23,-1.371429,0,0,1,1,false,false,false,0.001,0.999
221,256,-35,24.555556,32,-35,1388,1455,-67,0,0,0,0,28,9,8,1,1,1,13,10,false,false,false,0.11,0.89
178,167,11,25.428571,23.857143,11,1245,1148,97,0,0,0,0,49,7,7,0.714286,0,0,22,22,false,false,true,0.72,0.28
110,159,-49,22,31.8,-49,1554,1685,-131,0,1,0,0.2,65,5,5,0.492308,0,0,12,9,false,false,false,0.106,0.894
209,290,-81,17.416667,26.363636,-81,1305,1254,51,0,1,0,0.090909,14,12,11,2.285714,0,0,7,10,false,false,false,0.001,0.999
264,279,-15,15.529412,17.4375,-15,430,542,-112,0,1,0,0.0625,1,17,16,48,0,0,16,12,false,false,false,0.054,0.946
87,149,-62,14.5,24.833333,-62,563,523,40,0,0,0,0,61,6,6,0.606557,0,0,8,11,false,false,false,0.104,0.896
275,289,-14,17.1875,18.0625,-14,1161,1030,131,0,1,0,0.0625,-13,16,16,-2.923077,0,1,8,10,false,false,false,0.021,0.979
295,306,-11,21.071429,21.857143,-11,1043,1003,40,0,1,0,0.071429,5,14,14,7.6,0,0,10,9,false,false,true,0.523,0.477
208,221,-13,20.8,24.555556,-13,1110,1123,-13,0,1,0,0.111111,29,10,9,1.137931,0,0,8,22,false,false,false,0.325,0.675
334,370,-36,15.181818,16.818182,-36,540,498,42,1,0,0.045455,0,-39,22,22,-1.179487,0,0,2,1,false,false,false,0.074,0.926
317,305,12,21.133333,21.785714,12,1561,1495,66,1,0,0.066667,0,-10,15,14,-3.3,0,0,5,5,false,false,true,0.637,0.363
6,0,6,6,0,6,1580,1629,-49,0,0,0,0,97,1,0,0.381443,0,0,12,0,false,false,false,0.252,0.748
83,115,-32,8.3,12.777778,-32,288,359,-71,0,0,0,0,53,10,9,0.509434,0,0,14,17,false,false,false,0.117,0.883
236,242,-6,16.857143,18.615385,-6,796,800,-4,1,0,0.071429,0,18,14,13,2.666667,0,0,13,10,false,false,false,0.26,0.74
235,230,5,14.6875,14.375,5,306,302,4,0,0,0,0,-5,16,16,-8.2,0,0,7,16,false,false,true,0.593,0.407
201,260,-59,25.125,37.142857,-59,1554,1685,-131,0,1,0,0.142857,42,8,7,0.761905,0,0,16,14,false,false,false,0.103,0.897
56,55,1,18.666667,18.333333,1,1168,1062,106,0,0,0,0,80,3,3,0.5375,0,1,7,14,false,false,false,0.344,0.656
20,18,2,20,18,2,1065,948,117,0,0,0,0,92,1,1,0.423913,1,0,8,14,false,false,true,0.8,0.2
287,320,-33,16.882353,18.823529,-33,1000,960,40,0,0,0,0,-10,17,17,-4.5,1,0,12,6,false,false,false,0.092,0.908
17,27,-10,8.5,13.5,-10,1047,1253,-206,0,0,0,0,89,2,2,0.41573,1,0,13,14,false,false,false,0.26,0.74
202,212,-10,22.444444,26.5,-10,1176,1133,43,1,0,0.111111,0,48,9,8,0.708333,0,0,7,16,false,false,false,0.184,0.816
198,235,-37,22,29.375,-37,1454,1479,-25,1,0,0.111111,0,34,9,8,0.911765,0,0,14,18,false,false,false,0.1,0.9
287,314,-27,20.5,22.428571,-27,1428,1361,67,0,0,0,0,1,14,14,33,1,0,9,10,false,false,false,0.202,0.798
65,95,-30,21.666667,31.666667,-30,1334,1486,-152,0,0,0,0,83,3,3,0.349398,0,1,11,15,false,false,false,0.107,0.893
218,300,-82,18.166667,27.272727,-82,1315,1334,-19,0,1,0,0.090909,20,12,11,1.8,0,1,11,15,false,false,false,0,1
307,356,-49,18.058824,20.941176,-49,804,1080,-276,1,0,0.058824,0,-15,17,17,-2.266667,0,0,4,2,true,false,false,0.006,0.994
78,90,-12,26,30,-12,1227,1189,38,0,0,0,0,75,3,3,0.466667,0,0,13,19,false,false,false,0.27,0.73
248,273,-25,19.076923,21,-25,1270,1261,9,1,0,0.076923,0,22,13,13,1.681818,0,0,15,7,false,false,false,0.296,0.704
225,309,-84,14.0625,19.3125,-84,714,892,-178,0,2,0,0.125,0,16,16,0,0,0,15,10,false,false,false,0.036,0.964
14,8,6,14,8,6,970,1030,-60,0,0,0,0,93,1,1,0.430108,0,1,23,10,false,false,false,0.492,0.508
217,242,-25,19.727273,22,-25,1422,1583,-161,0,1,0,0.090909,26,11,11,1.576923,1,1,6,14,false,false,false,0.206,0.794
250,303,-53,15.625,20.2,-53,889,855,34,0,1,0,0.066667,1,16,15,40,0,1,11,6,false,false,false,0,1
158,70,88,31.6,17.5,88,1770,1751,19,0,0,0,0,58,5,4,0.5,0,1,14,9,false,false,true,0.952,0.048
283,277,6,15.722222,16.294118,6,1045,1082,-37,0,0,0,0,-10,18,17,-4.5,0,0,7,14,false,false,false,0.479,0.521
233,288,-55,15.533333,20.571429,-55,837,844,-7,0,0,0,0,14,15,14,2.928571,1,0,14,16,false,false,false,0.007,0.993
199,183,16,22.111111,20.333333,16,1093,1173,-80,0,0,0,0,41,9,9,1.04878,0,0,17,19,false,false,true,0.678,0.322
314,367,-53,18.470588,22.9375,-53,742,868,-126,0,1,0,0.0625,-11,17,16,-3,0,0,2,5,true,false,false,0.006,0.994
18,26,-8,18,26,-8,1691,1510,181,0,0,0,0,92,1,1,0.326087,0,0,13,12,false,false,true,0.65,0.35
96,114,-18,12,16.285714,-18,391,542,-151,1,0,0.125,0,47,8,7,0.978723,0,0,7,8,false,false,false,0.108,0.892
273,409,-136,16.058824,25.5625,-136,1572,1777,-205,0,2,0,0.125,-24,17,16,-1.375,0,0,15,2,true,false,false,0.002,0.998
391,454,-63,30.076923,34.923077,-63,1777,1500,277,2,2,0.153846,0.153846,-9,13,13,-3.111111,0,0,1,4,false,false,true,0.614,0.386
56,10,46,28,10,46,1126,1277,-151,0,0,0,0,87,2,1,0.402299,0,0,13,7,false,false,true,0.536,0.464
338,387,-49,16.095238,19.35,-49,1164,1261,-97,0,1,0,0.05,-19,21,20,-2.210526,0,0,6,4,false,false,false,0.035,0.965
122,113,9,24.4,22.6,9,1417,1482,-65,0,0,0,0,66,5,5,0.5,0,0,23,9,false,false,true,0.502,0.498
248,377,-129,19.076923,29,-129,1656,1649,7,0,0,0,0,6,13,13,5.333333,0,0,11,9,false,false,false,0.005,0.995
103,205,-102,9.363636,18.636364,-102,1078,983,95,0,0,0,0,40,11,11,1.2,1,1,7,17,false,false,false,0.006,0.994
329,364,-35,16.45,19.157895,-35,1439,1428,11,0,0,0,0,-18,20,19,-2.222222,1,0,2,1,false,false,false,0.051,0.949
55,13,42,27.5,13,42,651,700,-49,0,0,0,0,90,2,1,0.622222,0,0,7,15,false,false,true,0.828,0.172
38,51,-13,12.666667,25.5,-13,500,509,-9,0,0,0,0,83,3,2,0.493976,0,0,9,22,false,false,false,0.132,0.868
286,341,-55,26,31,-55,1344,1208,136,1,1,0.090909,0.090909,16,11,11,1.875,1,0,15,10,false,false,false,0.018,0.982
108,165,-57,18,33,-57,1408,1539,-131,0,1,0,0.2,56,6,5,0.607143,0,0,13,9,false,false,false,0.106,0.894
186,282,-96,31,47,-96,1689,1777,-88,1,1,0.166667,0.166667,40,6,6,0.75,0,0,22,15,false,false,false,0.007,0.993
107,200,-93,9.727273,20,-93,651,996,-345,0,1,0,0.1,26,11,10,1.730769,0,1,22,6,false,false,false,0.006,0.994
14,20,-6,7,20,-6,343,570,-227,0,0,0,0,89,2,1,0.404494,0,0,7,16,false,false,false,0.107,0.893
141,143,-2,15.666667,17.875,-2,889,855,34,0,0,0,0,47,9,8,0.851064,0,1,25,7,false,false,false,0.256,0.744
255,303,-48,17,21.642857,-48,795,786,9,1,0,0.066667,0,13,15,14,2.923077,1,0,10,14,false,false,false,0.006,0.994
132,87,45,26.4,17.4,45,1552,1803,-251,1,0,0.2,0,66,5,5,0.5,1,0,9,18,false,false,true,0.829,0.171
287,353,-66,15.105263,18.578947,-66,1422,1583,-161,0,1,0,0.052632,-10,19,19,-4.1,1,0,2,13,false,false,false,0.006,0.994
181,235,-54,18.1,26.111111,-54,1055,840,215,0,1,0,0.111111,33,10,9,1.090909,1,0,8,7,false,false,false,0.009,0.991
133,244,-111,14.777778,27.111111,-111,595,412,183,0,1,0,0.111111,40,9,9,1.3,0,0,8,12,false,false,false,0.001,0.999
289,294,-5,14.45,14.7,-5,361,413,-52,0,0,0,0,-32,20,20,-1.28125,0,0,2,2,false,false,false,0.448,0.552
14,17,-3,14,17,-3,1063,1134,-71,0,0,0,0,94,1,1,0.468085,0,0,10,15,false,false,false,0.273,0.727
20,29,-9,10,14.5,-9,1305,1307,-2,0,0,0,0,86,2,2,0.476744,0,1,7,6,false,false,false,0.248,0.752
242,272,-30,11.52381,13.6,-30,1220,1202,18,0,0,0,0,-14,21,20,-3.571429,0,1,26,12,false,false,false,0.007,0.993
283,303,-20,21.769231,25.25,-20,1407,1473,-66,1,2,0.076923,0.166667,4,13,12,7.75,0,0,26,17,false,false,false,0.252,0.748
285,314,-29,15,17.444444,-29,360,371,-11,0,0,0,0,-29,19,18,-1.275862,0,0,1,1,true,false,false,0.008,0.992
235,219,16,21.363636,19.909091,16,1493,1413,80,0,0,0,0,27,11,11,1.333333,0,1,8,8,false,false,false,0.176,0.824
86,85,1,17.2,21.25,1,1493,1453,40,0,0,0,0,69,5,4,0.507246,0,0,10,24,false,false,false,0.109,0.891
25,23,2,12.5,23,2,480,739,-259,0,0,0,0,88,2,1,0.443182,0,0,10,15,false,false,false,0.113,0.887
205,236,-31,18.636364,21.454545,-31,1257,1176,81,1,0,0.090909,0,31,11,11,1.096774,1,0,9,10,false,false,false,0.183,0.817
18,0,18,18,0,18,341,416,-75,0,0,0,0,96,1,0,0.40625,0,0,11,0,false,false,true,0.546,0.454
189,297,-108,15.75,27,-108,935,995,-60,1,1,0.083333,0.090909,24,12,11,1.625,0,0,8,16,false,false,false,0.005,0.995
53,69,-16,17.666667,23,-16,999,1283,-284,0,0,0,0,79,3,3,0.417722,0,1,21,15,false,false,false,0.119,0.881
336,337,-1,16.8,17.736842,-1,206,346,-140,1,0,0.05,0,-28,20,19,-1.535714,0,0,11,2,false,false,false,0.102,0.898
218,226,-8,27.25,32.285714,-8,1331,1432,-101,0,0,0,0,34,8,7,0.794118,0,0,11,13,false,false,false,0.133,0.867
278,301,-23,25.272727,27.363636,-23,1556,1513,43,0,0,0,0,14,11,11,2.214286,0,0,12,11,false,false,false,0.153,0.847
76,101,-25,19,25.25,-25,954,939,15,0,0,0,0,71,4,4,0.507042,0,0,9,12,false,false,false,0.156,0.844
10,0,10,10,0,10,1164,1149,15,0,0,0,0,97,1,0,0.484536,0,0,19,0,false,false,false,0.499,0.501
186,180,6,15.5,16.363636,6,889,855,34,0,0,0,0,29,12,11,1.37931,0,1,23,9,false,false,false,0.207,0.793
114,171,-57,14.25,21.375,-57,542,605,-63,0,0,0,0,44,8,8,0.818182,0,0,8,13,false,false,false,0.101,0.899
276,276,0,16.235294,17.25,0,1203,1270,-67,1,0,0.058824,0,1,17,16,44,1,0,11,10,false,false,true,0.638,0.362
260,281,-21,20,23.416667,-21,566,742,-176,0,1,0,0.083333,8,13,12,4,0,0,7,22,false,false,false,0.061,0.939
152,124,28,25.333333,24.8,28,1245,1148,97,0,0,0,0,58,6,5,0.603448,0,0,26,14,false,false,true,0.672,0.328
267,343,-76,19.071429,24.5,-76,566,742,-176,0,1,0,0.071429,-2,14,14,-16,0,0,4,3,false,false,false,0.012,0.988
184,277,-93,12.266667,19.785714,-93,977,1100,-123,0,1,0,0.071429,17,15,14,2.411765,0,1,9,17,false,false,false,0.005,0.995
160,235,-75,17.777778,26.111111,-75,1408,1539,-131,0,1,0,0.111111,30,9,9,1.133333,0,0,10,10,false,false,false,0.103,0.897
124,129,-5,11.272727,11.727273,-5,925,1000,-75,0,0,0,0,32,11,11,1.375,0,0,16,19,false,false,false,0.139,0.861
273,359,-86,18.2,23.933333,-86,710,758,-48,1,1,0.066667,0.066667,4,15,15,9.25,0,0,11,10,false,false,false,0.036,0.964
121,234,-113,15.125,29.25,-113,595,412,183,0,1,0,0.125,47,8,8,1.106383,0,0,7,9,false,false,false,0.001,0.999
190,274,-84,11.875,18.266667,-84,1078,983,95,1,0,0.0625,0,13,16,15,3.692308,0,1,10,10,false,false,false,0.004,0.996
174,120,54,19.333333,15,54,1168,1216,-48,0,0,0,0,55,9,8,0.6,0,0,15,14,false,false,true,0.852,0.148
102,260,-158,20.4,52,-158,1219,1216,3,0,3,0,0.6,54,5,5,0.5,0,0,8,8,false,false,false,0.001,0.999
194,223,-29,13.857143,15.928571,-29,995,965,30,0,0,0,0,13,14,14,3.076923,1,0,18,10,false,false,false,0.261,0.739
107,80,27,17.833333,16,27,897,996,-99,0,0,0,0,65,6,5,0.6,0,1,10,8,false,false,false,0.264,0.736
46,26,20,15.333333,13,20,804,766,38,0,0,0,0,85,3,2,0.482353,0,1,17,10,false,false,false,0.486,0.514
256,321,-65,16,20.0625,-65,995,965,30,0,1,0,0.0625,-5,16,16,-8,0,0,14,7,false,false,false,0.025,0.975
224,131,93,22.4,14.555556,93,1652,1473,179,1,0,0.1,0,30,10,9,1,0,1,7,15,false,false,true,1,0
30,14,16,30,14,16,921,1045,-124,0,0,0,0,93,1,1,0.376344,0,0,11,18,false,false,false,0.5,0.5
41,33,8,20.5,16.5,8,971,800,171,0,0,0,0,81,2,2,0.358025,0,1,13,9,false,false,true,0.584,0.416
10,16,-6,10,16,-6,1408,1539,-131,0,0,0,0,92,1,1,0.369565,0,0,17,11,false,false,false,0.285,0.715
258,342,-84,21.5,28.5,-84,732,868,-136,0,1,0,0.083333,8,12,12,4,0,0,12,20,false,false,false,0.01,0.99
32,37,-5,16,18.5,-5,840,1055,-215,0,0,0,0,85,2,2,0.411765,0,0,8,16,false,false,false,0.123,0.877
39,14,25,19.5,14,25,1349,1203,146,0,0,0,0,88,2,1,0.363636,0,1,8,9,false,false,true,0.525,0.475
106,60,46,35.333333,30,46,801,679,122,1,0,0.333333,0,81,3,2,0.358025,0,1,9,8,false,false,false,0.01,0.99
0,0,0,0,0,0,1586,1633,-47,0,0,0,0,100,1,1,0.34,0,0,8,0,false,false,false,0.247,0.753
72,45,27,18,15,27,671,638,33,0,0,0,0,74,4,3,0.662162,0,0,11,10,false,false,true,0.596,0.404
154,323,-169,8.105263,17.944444,-169,651,567,84,0,0,0,0,-3,19,18,-18.333333,0,0,10,11,false,false,false,0.005,0.995
198,216,-18,28.285714,36,-18,1761,1770,-9,0,1,0,0.166667,44,7,6,0.590909,0,0,9,12,false,false,false,0.039,0.961
181,180,1,22.625,25.714286,1,1439,1314,125,0,0,0,0,46,8,7,0.608696,0,0,13,8,false,false,false,0.236,0.764
101,190,-89,14.428571,27.142857,-89,952,826,126,0,1,0,0.142857,58,7,7,0.741379,0,0,14,7,false,false,false,0.057,0.943
167,233,-66,18.555556,29.125,-66,1583,1403,180,0,0,0,0,35,9,8,0.914286,0,1,12,6,false,false,false,0.031,0.969
39,26,13,13,13,13,568,570,-2,0,0,0,0,85,3,2,0.435294,0,0,10,18,false,false,false,0.25,0.75
194,192,2,21.555556,21.333333,2,1633,1739,-106,1,0,0.111111,0,39,9,9,0.871795,0,0,9,18,false,false,false,0.117,0.883
12,20,-8,12,20,-8,1305,1307,-2,0,0,0,0,92,1,1,0.445652,0,1,7,9,false,false,false,0.252,0.748
147,156,-9,12.25,14.181818,-9,999,1071,-72,0,0,0,0,25,12,11,1.6,1,0,15,24,false,false,false,0.111,0.889
214,222,-8,15.285714,17.076923,-8,848,976,-128,0,0,0,0,19,14,13,2.105263,1,1,14,9,false,false,false,0.245,0.755
280,332,-52,12.173913,15.090909,-52,1040,1091,-51,0,0,0,0,-30,23,22,-1.566667,0,0,6,1,false,false,false,0.006,0.994
220,294,-74,24.444444,36.75,-74,1556,1616,-60,0,0,0,0,30,9,8,0.966667,0,0,13,13,false,false,false,0.038,0.962
316,314,2,19.75,20.933333,2,1473,1500,-27,1,2,0.0625,0.133333,-8,16,15,-4.875,1,0,7,10,false,false,true,0.528,0.472
220,344,-124,12.222222,19.111111,-124,1305,1307,-2,0,1,0,0.055556,-14,18,18,-2.928571,0,1,17,5,false,false,false,0,1
367,415,-48,33.363636,37.727273,-48,1699,1580,119,3,2,0.272727,0.181818,9,11,11,3.333333,0,0,17,16,false,false,false,0.01,0.99
14,75,-61,3.5,18.75,-61,1793,1869,-76,0,0,0,0,80,4,4,0.375,0,0,9,9,false,false,false,0.166,0.834
181,169,12,15.083333,15.363636,12,913,1037,-124,0,1,0,0.090909,41,12,11,1,0,0,18,7,false,false,true,0.645,0.355
162,197,-35,16.2,19.7,-35,430,542,-112,0,1,0,0.1,33,10,10,1.454545,0,0,19,11,false,false,true,0.518,0.482
54,56,-2,18,18.666667,-2,785,892,-107,0,0,0,0,77,3,3,0.480519,1,0,12,9,false,false,true,0.517,0.483
263,254,9,16.4375,16.933333,9,480,518,-38,0,0,0,0,-4,16,15,-10,0,1,11,9,false,false,false,0.404,0.596
54,35,19,18,17.5,19,621,786,-165,0,0,0,0,77,3,2,0.38961,0,1,22,6,false,false,false,0.499,0.501
33,30,3,11,10,3,808,749,59,0,0,0,0,76,3,3,0.552632,0,1,9,19,false,false,false,0.405,0.595
223,326,-103,24.777778,36.222222,-103,1415,1361,54,0,1,0,0.111111,28,9,9,1.107143,0,0,12,14,false,false,false,0,1
258,317,-59,17.2,21.133333,-59,1422,1583,-161,0,1,0,0.066667,5,15,15,8.2,1,0,8,13,false,false,false,0.026,0.974
209,286,-77,20.9,28.6,-77,1110,1399,-289,0,1,0,0.1,34,10,10,1,0,0,15,7,false,false,false,0.008,0.992
308,340,-32,23.692308,28.333333,-32,691,695,-4,1,0,0.076923,0,3,13,12,10.666667,0,0,5,7,false,false,false,0.046,0.954
329,409,-80,18.277778,24.058824,-80,527,954,-427,0,1,0,0.058824,-13,18,17,-2.692308,0,0,3,4,true,false,false,0.005,0.995
299,428,-129,18.6875,28.533333,-129,732,868,-136,0,1,0,0.066667,-13,16,15,-2.461538,0,0,2,2,false,false,false,0.005,0.995
190,169,21,23.75,24.142857,21,1633,1739,-106,1,0,0.125,0,50,8,7,0.68,0,0,7,17,false,false,false,0.115,0.885
26,76,-50,8.666667,25.333333,-50,803,786,17,0,0,0,0,78,3,3,0.410256,0,0,21,7,false,false,false,0.162,0.838
171,281,-110,19,31.222222,-110,1232,1281,-49,0,2,0,0.222222,27,9,9,1.148148,1,0,9,12,false,false,false,0.001,0.999
216,204,12,16.615385,17,12,450,503,-53,0,0,0,0,18,13,12,2.166667,1,0,11,10,false,false,true,0.64,0.36
136,221,-85,15.111111,24.555556,-85,700,820,-120,0,1,0,0.111111,36,9,9,1.055556,0,0,18,10,false,false,false,0.009,0.991
321,387,-66,21.4,27.642857,-66,1422,1798,-376,0,2,0,0.142857,-3,15,14,-10.666667,0,0,2,7,false,false,false,0.006,0.994
222,278,-56,18.5,25.272727,-56,1495,1531,-36,0,1,0,0.090909,24,12,11,1.541667,1,0,8,13,false,false,false,0.12,0.88
243,253,-10,22.090909,25.3,-10,1176,1133,43,1,0,0.090909,0,33,11,10,1.030303,0,0,10,19,false,false,false,0.366,0.634
300,335,-35,20,23.928571,-35,1305,1254,51,1,1,0.066667,0.071429,-11,15,14,-2.909091,0,0,1,11,false,false,false,0.009,0.991
117,109,8,23.4,21.8,8,1071,1181,-110,0,0,0,0,69,5,5,0.492754,0,0,7,10,false,false,false,0.289,0.711
65,100,-35,16.25,25,-35,1193,1177,16,0,0,0,0,74,4,4,0.472973,0,0,8,18,false,false,false,0.107,0.893
229,243,-14,20.818182,24.3,-14,1063,1134,-71,1,0,0.090909,0,37,11,10,1.189189,0,0,7,17,false,false,false,0.215,0.785
55,71,-16,18.333333,35.5,-16,1407,1473,-66,0,1,0,0.5,80,3,2,0.3875,0,0,11,10,false,false,false,0.427,0.573
292,331,-39,16.222222,19.470588,-39,758,791,-33,0,0,0,0,-19,18,17,-2.052632,0,0,3,2,false,false,false,0.007,0.993
74,75,-1,18.5,25,-1,939,969,-30,0,0,0,0,72,4,3,0.458333,0,0,9,7,false,false,false,0.275,0.725
299,463,-164,18.6875,30.866667,-164,1003,1004,-1,0,2,0,0.133333,-8,16,15,-4.375,0,0,2,3,false,false,false,0,1
167,159,8,18.555556,17.666667,8,704,523,181,0,0,0,0,32,9,9,1.09375,0,0,9,10,false,false,true,0.734,0.266
256,370,-114,14.222222,20.555556,-114,1037,1016,21,1,0,0.055556,0,0,18,18,0,1,0,18,10,false,false,false,0.005,0.995
257,294,-37,18.357143,21,-37,1302,1351,-49,0,0,0,0,7,14,14,5.285714,0,0,11,14,false,false,false,0.092,0.908
48,16,32,24,16,32,796,800,-4,0,0,0,0,91,2,1,0.527473,0,0,21,14,false,false,true,0.764,0.236
308,414,-106,23.692308,31.846154,-106,1537,1539,-2,0,1,0,0.076923,1,13,13,34,0,1,7,9,false,false,false,0,1
115,140,-25,16.428571,20,-25,306,361,-55,0,0,0,0,49,7,7,0.734694,0,2,9,8,false,false,false,0.003,0.997
376,341,35,26.857143,26.230769,35,1552,1803,-251,3,0,0.214286,0,-3,14,13,-11,0,0,8,9,false,false,true,0.962,0.038
120,398,-278,10,33.166667,-278,1164,1149,15,0,2,0,0.166667,37,12,12,1.27027,0,0,12,7,false,false,false,0.066,0.934
329,397,-68,19.352941,24.8125,-68,527,954,-427,0,1,0,0.0625,-10,17,16,-3.5,0,0,3,4,false,false,false,0.015,0.985
120,222,-102,20,37,-102,1576,1556,20,0,1,0,0.166667,51,6,6,0.588235,0,0,18,7,false,false,false,0.054,0.946
258,325,-67,15.176471,20.3125,-67,620,698,-78,1,0,0.058824,0,-7,17,16,-5.857143,0,0,18,8,false,false,false,0.026,0.974
284,308,-24,17.75,20.533333,-24,1302,1351,-49,0,0,0,0,-4,16,15,-9.25,0,0,5,7,false,false,false,0.095,0.905
56,56,0,14,14,0,1220,1185,35,0,0,0,0,73,4,4,0.643836,0,1,26,9,false,false,false,0.489,0.511
168,136,32,21,17,32,1281,1268,13,0,0,0,0,47,8,8,0.893617,0,0,9,10,false,false,true,0.804,0.196
81,60,21,16.2,15,21,651,700,-49,0,0,0,0,72,5,4,0.777778,0,0,7,16,false,false,false,0.238,0.762
145,101,44,29,25.25,44,1770,1745,25,1,0,0.2,0,70,5,4,0.471429,0,0,7,19,false,false,false,0.326,0.674
187,315,-128,12.466667,21,-128,632,603,29,0,1,0,0.066667,-9,15,15,-4.222222,0,0,11,12,false,false,false,0.005,0.995
233,270,-37,17.923077,20.769231,-37,1488,1403,85,0,1,0,0.076923,2,13,13,17,0,0,24,21,false,false,false,0.191,0.809
0,22,-22,0,11,-22,907,878,29,0,0,0,0,94,2,2,0.457447,0,0,20,10,false,false,false,0.279,0.721
164,179,-15,20.5,22.375,-15,1331,1374,-43,0,0,0,0,39,8,8,0.846154,0,0,22,8,false,false,false,0.242,0.758
50,100,-50,12.5,33.333333,-50,1633,1739,-106,0,0,0,0,81,4,3,0.419753,0,0,17,7,false,false,false,0.106,0.894
191,279,-88,21.222222,34.875,-88,1334,1486,-152,2,1,0.222222,0.125,39,9,8,0.74359,0,0,9,17,false,false,false,0.005,0.995
288,376,-88,20.571429,26.857143,-88,732,868,-136,0,1,0,0.071429,-5,14,14,-6.4,0,0,5,11,false,false,false,0.007,0.993
294,310,-16,17.294118,19.375,-16,343,570,-227,0,0,0,0,-18,17,16,-2,0,0,1,2,false,false,false,0.054,0.946
83,26,57,41.5,26,57,1173,1256,-83,1,0,0.5,0,88,2,1,0.352273,0,0,13,20,false,false,false,0.312,0.688
155,117,38,22.142857,19.5,38,785,892,-107,0,0,0,0,53,7,6,0.698113,0,0,10,9,false,false,true,0.818,0.182
174,127,47,24.857143,21.166667,47,1070,814,256,1,1,0.142857,0.166667,48,7,6,0.6875,0,0,13,16,false,false,true,0.817,0.183
120,147,-27,17.142857,21,-27,451,448,3,0,0,0,0,54,7,7,0.685185,0,1,10,19,false,false,false,0.063,0.937
47,38,9,11.75,12.666667,9,1452,1388,64,0,0,0,0,79,4,3,0.443038,0,0,10,18,false,false,false,0.214,0.786
97,100,-3,13.857143,16.666667,-3,542,605,-63,0,0,0,0,53,7,6,0.679245,0,0,10,28,false,false,false,0.12,0.88
192,254,-62,21.333333,28.222222,-62,1126,1277,-151,0,0,0,0,26,9,9,1.346154,1,0,11,16,false,false,false,0.108,0.892
269,249,20,24.454545,24.9,20,1093,1100,-7,2,0,0.181818,0,30,11,10,1.033333,0,0,13,14,false,false,true,0.69,0.31
289,375,-86,18.0625,23.4375,-86,1315,1331,-16,0,0,0,0,-11,16,16,-3,0,0,2,2,false,false,false,0.005,0.995
196,206,-10,17.818182,18.727273,-10,387,683,-296,0,0,0,0,13,11,11,2.615385,1,0,8,22,false,false,false,0.125,0.875
0,0,0,0,0,0,1078,983,95,0,0,0,0,100,1,0,0.48,1,0,9,0,false,false,false,0.43,0.57
133,209,-76,19,29.857143,-76,1397,1309,88,1,0,0.142857,0,58,7,7,0.62069,0,1,7,9,false,false,false,0.012,0.988
322,355,-33,18.941176,20.882353,-33,1473,1500,-27,1,2,0.058824,0.117647,-19,17,17,-2.052632,1,0,3,7,false,false,false,0.011,0.989
299,391,-92,18.6875,24.4375,-92,1269,1477,-208,1,0,0.0625,0,-6,16,16,-5.833333,0,0,5,1,false,false,false,0.005,0.995
175,203,-28,15.909091,18.454545,-28,1094,1041,53,0,0,0,0,24,11,11,1.583333,1,1,8,9,false,false,false,0.235,0.765
120,118,2,17.142857,16.857143,2,952,870,82,0,0,0,0,48,7,7,0.770833,0,0,15,33,false,false,true,0.517,0.483
303,321,-18,15.947368,17.833333,-18,1161,1030,131,0,1,0,0.055556,-24,19,18,-1.583333,0,0,2,1,false,false,false,0.015,0.985
6,13,-7,6,13,-7,917,856,61,0,0,0,0,92,1,1,0.358696,0,1,14,9,false,false,false,0.405,0.595
115,49,66,28.75,16.333333,66,1563,1539,24,0,0,0,0,71,4,3,0.492958,0,0,12,10,false,false,true,0.641,0.359
162,149,13,18,18.625,13,599,448,151,0,0,0,0,39,9,8,0.923077,0,1,14,9,false,false,true,0.669,0.331
156,198,-42,22.285714,28.285714,-42,1126,1277,-151,0,0,0,0,43,7,7,0.813953,0,0,7,15,false,false,false,0.106,0.894
260,298,-38,12.380952,14.9,-38,500,532,-32,0,0,0,0,-25,21,20,-1.64,0,1,16,1,true,false,false,0.008,0.992
90,101,-11,15,16.833333,-11,889,855,34,0,0,0,0,64,6,6,0.625,0,0,23,8,false,false,false,0.406,0.594
177,182,-5,22.125,22.75,-5,576,602,-26,0,0,0,0,50,8,8,0.84,0,0,10,13,false,false,true,0.655,0.345
135,136,-1,19.285714,22.666667,-1,480,518,-38,0,0,0,0,52,7,6,0.769231,0,1,16,7,false,false,false,0.203,0.797
89,153,-64,22.25,51,-64,1388,1455,-67,0,0,0,0,64,4,3,0.4375,0,0,16,16,false,false,false,0.106,0.894
352,364,-12,22,24.266667,-12,169,306,-137,2,1,0.125,0.066667,-21,16,15,-1.47619,0,0,1,3,true,false,true,0.77,0.23
47,55,-8,15.666667,18.333333,-8,700,820,-120,0,0,0,0,81,3,3,0.469136,0,0,17,9,false,false,false,0.352,0.648
247,295,-48,15.4375,18.4375,-48,615,542,73,0,0,0,0,1,16,16,42,0,0,7,7,false,false,false,0.025,0.975
264,199,65,22,18.090909,65,540,498,42,1,0,0.083333,0,19,12,11,2.421053,0,1,7,15,false,false,true,0.97,0.03
155,167,-12,19.375,20.875,-12,480,518,-38,0,0,0,0,40,8,8,1,0,1,13,8,false,false,false,0.2,0.8
140,133,7,20,22.166667,7,1071,1181,-110,0,0,0,0,60,7,6,0.566667,0,0,7,9,false,false,false,0.136,0.864
185,199,-14,14.230769,16.583333,-14,361,413,-52,0,0,0,0,19,13,12,2.157895,2,0,11,7,false,false,true,0.743,0.257
327,350,-23,21.8,23.333333,-23,804,1074,-270,0,0,0,0,-12,15,15,-2.666667,0,0,1,1,false,false,false,0.107,0.893
180,226,-46,22.5,32.285714,-46,1127,995,132,0,1,0,0.142857,41,8,7,0.804878,0,0,7,17,false,false,false,0.009,0.991
53,114,-61,10.6,22.8,-61,341,416,-75,0,0,0,0,72,5,5,0.541667,0,0,16,8,false,false,false,0.105,0.895
229,332,-103,9.541667,13.833333,-103,818,826,-8,0,0,0,0,-34,24,24,-1.558824,0,0,5,6,false,false,false,0.005,0.995
332,359,-27,19.529412,22.4375,-27,721,757,-36,0,2,0,0.125,-8,17,16,-4.75,0,0,2,6,false,false,false,0.019,0.981
113,81,32,14.125,11.571429,32,1193,1220,-27,0,0,0,0,47,8,7,0.914894,1,1,12,22,false,false,false,0.298,0.702
195,188,7,17.727273,17.090909,7,1037,1009,28,0,0,0,0,36,11,11,1.222222,1,1,8,7,false,false,false,0.259,0.741
98,140,-42,16.333333,28,-42,1182,1075,107,0,1,0,0.2,59,6,5,0.661017,0,1,22,8,false,false,false,0.009,0.991
160,329,-169,16,32.9,-169,1045,1100,-55,0,1,0,0.1,31,10,10,1.096774,0,0,19,10,false,false,false,0.005,0.995
172,220,-48,19.111111,24.444444,-48,804,1080,-276,0,0,0,0,37,9,9,0.918919,1,0,11,8,false,false,false,0.11,0.89
146,149,-3,14.6,16.555556,-3,995,965,30,0,0,0,0,38,10,9,1.052632,0,1,25,10,false,false,false,0.181,0.819
303,399,-96,21.642857,30.692308,-96,724,398,326,1,1,0.071429,0.076923,12,14,13,3.25,0,0,13,7,false,false,false,0.106,0.894
34,42,-8,17,21,-8,897,996,-99,0,0,0,0,83,2,2,0.46988,0,0,14,10,false,false,false,0.381,0.619
93,94,-1,15.5,15.666667,-1,542,390,152,0,0,0,0,72,6,6,0.694444,0,0,11,11,false,false,true,0.742,0.258
28,39,-11,14,19.5,-11,671,638,33,0,0,0,0,85,2,2,0.576471,0,0,10,10,false,false,false,0.355,0.645
119,113,6,14.875,16.142857,6,613,525,88,0,0,0,0,50,8,7,0.84,0,1,10,16,false,false,false,0.138,0.862
174,241,-67,12.428571,18.538462,-67,951,976,-25,0,0,0,0,20,14,13,2.2,0,0,9,10,false,false,false,0.009,0.991
290,217,73,17.058824,13.5625,73,1065,948,117,0,0,0,0,9,17,16,4.333333,0,1,11,10,false,false,true,0.975,0.025
228,289,-61,12.666667,16.055556,-61,226,361,-135,0,0,0,0,-23,18,18,-1.913043,0,0,15,11,false,false,false,0.023,0.977
297,428,-131,19.8,28.533333,-131,1636,1727,-91,0,2,0,0.133333,-12,15,15,-2.5,0,0,2,6,true,false,false,0,1
278,349,-71,16.352941,21.8125,-71,594,648,-54,1,1,0.058824,0.0625,0,17,16,0,0,0,6,6,false,false,false,0.036,0.964
200,278,-78,13.333333,18.533333,-78,613,525,88,0,0,0,0,9,15,15,4.666667,0,1,26,6,false,false,false,0.005,0.995
176,176,0,19.555556,22,0,1493,1413,80,0,0,0,0,43,9,8,0.837209,0,1,16,12,false,false,false,0.102,0.898
26,42,-16,6.5,14,-16,917,856,61,0,0,0,0,79,4,3,0.417722,0,1,15,15,false,false,false,0.157,0.843
138,165,-27,34.5,55,-27,1398,1431,-33,0,0,0,0,62,4,3,0.451613,0,0,10,10,false,false,false,0.181,0.819
296,349,-53,14.8,18.368421,-53,452,698,-246,0,1,0,0.052632,-18,20,19,-2.277778,0,0,4,2,false,false,false,0.036,0.964
140,244,-104,12.727273,22.181818,-104,1075,1189,-114,0,0,0,0,25,11,11,1.6,0,0,8,16,false,false,false,0.006,0.994
216,262,-46,18,21.833333,-46,785,892,-107,0,0,0,0,20,12,12,1.85,0,0,9,7,false,false,false,0.055,0.945
211,282,-71,14.066667,18.8,-71,306,361,-55,0,0,0,0,-9,15,15,-4,0,0,12,18,false,false,false,0.007,0.993
152,230,-78,15.2,23,-78,341,416,-75,0,0,0,0,38,10,10,1.026316,0,0,8,13,false,false,false,0.006,0.994
313,317,-4,26.083333,28.818182,-4,1331,1432,-101,0,0,0,0,6,12,11,4.5,0,0,15,8,false,false,false,0.189,0.811
162,191,-29,20.25,23.875,-29,1210,1162,48,0,0,0,0,44,8,8,0.727273,0,0,10,16,false,false,false,0.113,0.887
254,230,24,23.090909,20.909091,24,1691,1510,181,0,1,0,0.090909,19,11,11,1.578947,1,0,9,14,false,false,true,0.731,0.269
107,88,19,15.285714,14.666667,19,1312,1334,-22,0,0,0,0,55,7,6,0.709091,0,1,23,19,false,false,false,0.23,0.77
0,14,-14,0,14,-14,288,359,-71,0,0,0,0,96,1,1,0.28125,0,0,0,10,false,false,false,0.163,0.837
160,412,-252,12.307692,31.692308,-252,1093,1100,-7,0,2,0,0.153846,18,13,13,1.944444,0,0,9,13,false,false,false,0.006,0.994
241,238,3,21.909091,23.8,3,1245,1148,97,0,0,0,0,26,11,10,1.346154,0,0,17,10,false,false,true,0.534,0.466
286,328,-42,15.888889,18.222222,-42,561,688,-127,0,0,0,0,-6,18,18,-7.666667,0,0,15,10,false,false,false,0.036,0.964
148,216,-68,29.6,43.2,-68,1164,1261,-97,0,1,0,0.2,62,5,5,0.677419,0,0,25,13,false,false,false,0.164,0.836
309,320,-11,20.6,22.857143,-11,742,868,-126,0,1,0,0.071429,-1,15,14,-33,0,0,5,17,false,false,true,0.645,0.355
91,87,4,18.2,21.75,4,1127,995,132,0,1,0,0.25,68,5,4,0.485294,0,0,22,18,false,false,true,0.649,0.351
182,157,25,18.2,17.444444,25,387,683,-296,0,0,0,0,27,10,9,1.259259,1,0,11,13,false,false,false,0.473,0.527
175,222,-47,19.444444,27.75,-47,1428,1361,67,0,0,0,0,35,9,8,0.942857,0,0,16,10,false,false,false,0.106,0.894
108,137,-29,15.428571,19.571429,-29,306,468,-162,0,0,0,0,62,7,7,0.596774,1,0,9,12,false,false,false,0.147,0.853
147,190,-43,13.363636,19,-43,278,1,277,0,0,0,0,24,11,10,1.541667,0,0,25,16,false,false,false,0.433,0.567
176,293,-117,16,29.3,-117,1193,1177,16,0,1,0,0.1,29,11,10,1.206897,0,0,17,18,false,false,false,0.005,0.995
46,21,25,23,21,25,691,704,-13,0,0,0,0,89,2,1,0.426966,1,0,16,8,false,false,true,0.581,0.419
246,347,-101,14.470588,20.411765,-101,837,844,-7,0,0,0,0,-1,17,17,-41,1,0,10,7,false,false,false,0.005,0.995
153,140,13,19.125,17.5,13,387,683,-296,0,0,0,0,38,8,8,0.894737,1,0,10,8,false,false,true,0.52,0.48
250,286,-36,20.833333,26,-36,1110,1399,-289,0,1,0,0.090909,29,12,11,1.172414,0,0,10,13,false,false,false,0.05,0.95
154,323,-169,8.105263,17,-169,651,567,84,0,0,0,0,-3,19,19,-18.333333,0,0,10,11,false,false,false,0.005,0.995
274,334,-60,24.909091,33.4,-60,1556,1616,-60,0,0,0,0,15,11,10,1.933333,0,0,7,10,false,false,false,0.032,0.968
334,362,-28,20.875,24.133333,-28,1331,1347,-16,1,1,0.0625,0.066667,-25,16,15,-1.28,0,0,2,1,false,false,false,0.031,0.969
276,304,-28,19.714286,21.714286,-28,689,804,-115,0,0,0,0,4,14,14,8.75,0,1,7,10,false,false,false,0.009,0.991
263,248,15,21.916667,20.666667,15,1197,1156,41,0,1,0,0.083333,19,12,12,1.842105,1,0,10,7,false,false,true,0.964,0.036
241,164,77,40.166667,32.8,77,169,306,-137,2,1,0.333333,0.2,42,6,5,0.738095,1,0,9,12,false,false,false,0.186,0.814
145,197,-52,20.714286,32.833333,-52,1583,1403,180,0,0,0,0,47,7,6,0.680851,0,0,15,17,false,false,false,0.023,0.977
260,340,-80,16.25,22.666667,-80,848,976,-128,0,1,0,0.066667,5,16,15,8,0,0,13,10,false,false,false,0.008,0.992
40,49,-9,20,24.5,-9,480,518,-38,0,0,0,0,84,2,2,0.47619,0,1,14,13,false,false,false,0.071,0.929
124,119,5,17.714286,19.833333,5,1232,1448,-216,0,0,0,0,56,7,6,0.625,0,0,13,7,false,false,false,0.225,0.775
49,14,35,24.5,14,35,1227,1189,38,0,0,0,0,86,2,1,0.406977,0,0,11,10,false,false,true,0.525,0.475
316,341,-25,26.333333,31,-25,1344,1208,136,1,1,0.083333,0.090909,12,12,11,2.5,1,0,12,10,false,false,false,0.045,0.955
273,399,-126,11.375,16.625,-126,1248,1220,28,0,1,0,0.041667,-26,24,24,-2,0,0,2,4,false,false,false,0.017,0.983
257,328,-71,17.133333,23.428571,-71,452,698,-246,0,1,0,0.071429,2,15,14,20.5,0,0,13,7,false,false,false,0.014,0.986
28,73,-45,28,73,-45,976,995,-19,0,1,0,1,90,1,1,0.422222,0,0,10,14,false,false,false,0.064,0.936
16,0,16,16,0,16,727,820,-93,0,0,0,0,96,1,0,0.364583,0,0,8,0,false,false,false,0.452,0.548
96,126,-30,16,21,-30,341,416,-75,0,0,0,0,64,6,6,0.609375,0,0,12,7,false,false,false,0.145,0.855
77,107,-30,19.25,35.666667,-30,452,698,-246,0,1,0,0.333333,76,4,3,0.539474,0,0,22,7,false,false,false,0.249,0.751
145,153,-8,16.111111,19.125,-8,603,721,-118,0,0,0,0,45,9,8,0.955556,0,0,10,24,false,false,false,0.135,0.865
111,56,55,22.2,14,55,742,594,148,0,0,0,0,66,5,4,0.590909,0,0,28,8,false,false,true,0.887,0.113
88,86,2,29.333333,28.666667,2,1164,1149,15,0,0,0,0,79,3,3,0.594937,0,1,9,9,false,false,false,0.441,0.559
188,201,-13,18.8,20.1,-13,615,542,73,0,0,0,0,38,10,10,1.105263,0,1,19,8,false,false,false,0.293,0.707
69,105,-36,13.8,26.25,-36,1094,1159,-65,0,0,0,0,65,5,4,0.584615,0,0,16,20,false,false,false,0.106,0.894
173,222,-49,17.3,22.2,-49,356,498,-142,0,1,0,0.1,28,10,10,1.25,1,0,6,19,false,false,false,0.072,0.928
278,334,-56,18.533333,23.857143,-56,1397,1309,88,2,0,0.133333,0,7,15,14,5.142857,0,0,9,9,false,false,false,0.014,0.986
24,136,-112,8,45.333333,-112,760,976,-216,0,1,0,0.333333,77,3,3,0.467532,0,0,15,10,false,false,false,0.072,0.928
163,284,-121,23.285714,40.571429,-121,1556,1616,-60,0,0,0,0,43,7,7,0.674419,0,0,20,10,false,false,false,0.006,0.994
301,315,-14,16.722222,17.5,-14,343,570,-227,0,0,0,0,-22,18,18,-1.636364,0,0,1,1,true,false,false,0.077,0.923
50,87,-37,8.333333,14.5,-37,917,856,61,0,0,0,0,68,6,6,0.485294,0,1,23,6,false,false,false,0.242,0.758
240,180,60,21.818182,18,60,1043,1003,40,0,0,0,0,27,11,10,1.407407,0,0,9,15,false,false,true,0.83,0.17
8,5,3,8,5,3,540,498,42,0,0,0,0,94,1,1,0.489362,0,1,17,13,false,false,true,0.508,0.492
186,333,-147,14.307692,25.615385,-147,760,976,-216,0,1,0,0.076923,6,13,13,6,0,1,13,20,false,false,false,0.005,0.995
243,204,39,27,25.5,39,1563,1539,24,0,1,0,0.125,27,9,8,1.296296,0,0,19,21,false,false,true,0.727,0.273
337,338,-1,16.85,16.9,-1,1193,1220,-27,1,0,0.05,0,-22,20,20,-1.954545,0,0,7,1,false,false,false,0.252,0.748
46,50,-4,15.333333,25,-4,1253,1324,-71,0,0,0,0,80,3,2,0.3625,0,0,7,21,false,false,false,0.107,0.893
229,193,36,19.083333,17.545455,36,1281,1268,13,0,0,0,0,29,12,11,1.448276,0,0,10,11,false,false,true,0.682,0.318
82,172,-90,16.4,43,-90,1656,1649,7,0,0,0,0,60,5,4,0.533333,0,0,15,13,false,false,false,0.103,0.897
251,426,-175,15.6875,26.625,-175,926,973,-47,0,0,0,0,-7,16,16,-5,0,0,3,1,false,false,false,0.005,0.995
314,311,3,17.444444,18.294118,3,1270,1261,9,1,0,0.055556,0,-4,18,17,-9.25,0,0,3,3,false,false,false,0.253,0.747
86,65,21,17.2,16.25,21,1334,1439,-105,1,0,0.2,0,85,5,4,0.423529,0,0,13,13,false,false,false,0.234,0.766
125,194,-69,25,48.5,-69,1633,1680,-47,0,1,0,0.25,53,5,4,0.528302,0,0,8,11,false,false,false,0.014,0.986
153,238,-85,9.5625,15.866667,-85,818,826,-8,0,0,0,0,18,16,15,2.944444,0,0,7,24,false,false,false,0.005,0.995
113,101,12,18.833333,20.2,12,1493,1413,80,0,0,0,0,65,6,5,0.553846,0,0,23,9,false,false,false,0.484,0.516
87,79,8,21.75,19.75,8,1161,1030,131,0,0,0,0,73,4,4,0.520548,0,1,10,13,false,false,true,0.511,0.489
221,263,-42,24.555556,29.222222,-42,1388,1455,-67,0,0,0,0,26,9,9,1.076923,1,1,13,10,false,false,false,0.122,0.878
41,70,-29,10.25,17.5,-29,822,845,-23,0,0,0,0,79,4,4,0.443038,1,0,17,21,false,false,false,0.154,0.846
41,18,23,20.5,18,23,603,721,-118,0,0,0,0,91,2,1,0.472527,0,0,19,13,false,false,false,0.478,0.522
196,221,-25,19.6,22.1,-25,1210,1162,48,0,0,0,0,31,10,10,1.032258,1,1,6,18,false,false,false,0.122,0.878
282,458,-176,18.8,30.533333,-176,842,926,-84,0,1,0,0.066667,-14,15,15,-2.142857,0,0,3,2,true,false,false,0.005,0.995
177,135,42,16.090909,13.5,42,1040,1091,-51,0,0,0,0,34,11,10,1.382353,0,1,12,18,false,false,false,0.265,0.735
315,363,-48,19.6875,22.6875,-48,1452,1388,64,0,1,0,0.0625,-9,16,16,-3.888889,0,0,8,1,false,false,false,0.003,0.997
75,183,-108,18.75,45.75,-108,1219,1216,3,0,2,0,0.5,65,4,4,0.415385,0,2,12,8,false,false,false,0.006,0.994
301,368,-67,13.681818,17.52381,-67,603,721,-118,0,0,0,0,-27,22,21,-1.592593,1,0,1,1,true,false,false,0.005,0.995
226,226,0,16.142857,16.142857,0,480,518,-38,0,0,0,0,6,14,14,6.666667,0,0,17,19,false,false,true,0.64,0.36
57,117,-60,14.25,29.25,-60,1803,1658,145,0,0,0,0,66,4,4,0.5,2,0,15,10,false,false,true,0.698,0.302
116,232,-116,10.545455,21.090909,-116,632,603,29,0,0,0,0,22,11,11,1.727273,0,0,17,13,false,false,false,0.005,0.995
112,108,4,12.444444,13.5,4,999,1071,-72,0,0,0,0,43,9,8,0.930233,1,0,9,17,false,false,false,0.255,0.745
216,287,-71,19.636364,28.7,-71,874,868,6,0,0,0,0,18,11,10,1.833333,0,0,10,21,false,false,false,0.006,0.994
36,21,15,18,10.5,15,1552,1803,-251,0,0,0,0,88,2,2,0.375,0,0,7,15,false,false,false,0.246,0.754
100,138,-38,33.333333,46,-38,1761,1770,-9,0,1,0,0.333333,74,3,3,0.351351,0,0,8,12,false,false,false,0.021,0.979
283,355,-72,15.722222,19.722222,-72,736,791,-55,0,0,0,0,-21,18,18,-1.809524,0,0,4,2,false,false,false,0.006,0.994
41,22,19,13.666667,11,19,163,346,-183,0,0,0,0,77,3,2,0.506494,0,1,11,8,false,false,false,0.002,0.998
360,429,-69,25.714286,30.642857,-69,1253,1324,-71,0,2,0,0.142857,-7,14,14,-4.142857,0,0,1,1,false,false,false,0.002,0.998
38,83,-45,9.5,27.666667,-45,343,570,-227,0,0,0,0,68,4,3,0.529412,0,0,10,9,false,false,false,0.106,0.894
87,84,3,17.4,21,3,926,973,-47,0,0,0,0,65,5,4,0.538462,0,0,7,12,false,false,false,0.147,0.853
247,306,-59,16.466667,21.857143,-59,1037,1016,21,1,0,0.066667,0,18,15,14,3.222222,1,0,16,8,false,false,false,0.005,0.995
14,36,-22,7,36,-22,1305,1211,94,0,0,0,0,94,2,1,0.351064,0,0,12,28,false,false,false,0.107,0.893
182,193,-11,14,14.846154,-11,808,749,59,0,0,0,0,9,13,13,4.666667,0,0,7,11,false,false,false,0.224,0.776
354,273,81,23.6,19.5,81,1305,1194,111,1,0,0.066667,0,-3,15,14,-11,0,1,10,6,false,false,true,1,0
155,260,-105,19.375,32.5,-105,842,926,-84,0,0,0,0,32,8,8,0.9375,0,0,10,14,false,false,false,0.006,0.994
18,27,-9,18,27,-9,1572,1777,-205,0,0,0,0,91,1,1,0.362637,0,1,8,6,false,false,false,0.245,0.755
265,207,58,17.666667,13.8,58,1030,998,32,0,0,0,0,7,15,15,5.285714,0,1,17,9,false,false,true,0.984,0.016
104,59,45,17.333333,11.8,45,1040,1091,-51,0,0,0,0,62,6,5,0.758065,1,0,14,19,false,false,true,0.63,0.37
132,307,-175,14.666667,34.111111,-175,1399,1210,189,0,1,0,0.111111,40,9,9,0.875,0,0,17,7,false,false,false,0.066,0.934
21,43,-22,10.5,21.5,-22,1078,1095,-17,0,0,0,0,86,2,2,0.430233,0,0,7,19,false,false,false,0.11,0.89
234,427,-193,21.272727,42.7,-193,1539,1891,-352,0,2,0,0.2,5,11,10,5,1,1,7,11,false,false,false,0.001,0.999
20,27,-7,20,27,-7,995,965,30,0,0,0,0,91,1,1,0.43956,0,0,16,11,false,false,false,0.378,0.622
52,0,52,26,0,52,742,594,148,0,0,0,0,91,2,1,0.428571,0,0,12,7,false,false,true,0.889,0.111
291,304,-13,12.652174,13.818182,-13,797,796,1,0,0,0,0,-24,23,22,-2.041667,0,0,5,4,false,false,false,0.08,0.92
80,106,-26,13.333333,21.2,-26,948,998,-50,0,0,0,0,60,6,5,0.616667,1,1,10,9,false,false,false,0.245,0.755
132,154,-22,22,25.666667,-22,1176,1133,43,1,0,0.166667,0,63,6,6,0.539683,0,0,14,17,false,false,false,0.204,0.796
147,217,-70,16.333333,24.111111,-70,452,698,-246,0,1,0,0.111111,40,9,9,1.025,0,0,20,8,false,false,false,0.015,0.985
104,74,30,17.333333,12.333333,30,1040,1091,-51,0,0,0,0,60,6,6,0.783333,1,1,14,18,false,false,true,0.502,0.498
263,316,-53,18.785714,24.307692,-53,721,757,-36,0,2,0,0.153846,7,14,13,5.428571,0,0,10,19,false,false,false,0.029,0.971
42,79,-37,14,26.333333,-37,561,688,-127,0,0,0,0,77,3,3,0.597403,0,1,8,9,false,false,false,0.009,0.991
12,0,12,12,0,12,1495,1597,-102,0,0,0,0,96,1,1,0.333333,0,0,24,11,false,false,false,0.461,0.539
121,179,-58,17.285714,25.571429,-58,822,845,-23,0,0,0,0,55,7,7,0.636364,0,0,23,10,false,false,false,0.109,0.891
151,221,-70,15.1,24.555556,-70,1195,1397,-202,0,1,0,0.111111,39,10,9,1.025641,0,0,11,10,false,false,false,0.083,0.917
93,144,-51,13.285714,20.571429,-51,500,509,-9,0,0,0,0,53,7,7,0.773585,0,0,14,10,false,false,false,0.11,0.89
97,65,32,32.333333,21.666667,32,1488,1428,60,1,0,0.333333,0,76,3,3,0.486842,0,0,9,11,false,false,true,0.524,0.476
195,234,-39,13.928571,18,-39,1071,1000,71,0,0,0,0,17,14,13,2.764706,0,1,8,12,false,false,false,0.044,0.956
215,245,-30,17.916667,20.416667,-30,1123,1062,61,0,0,0,0,22,12,12,2,0,0,11,11,false,false,false,0.13,0.87
331,352,-21,18.388889,20.705882,-21,1227,1189,38,0,0,0,0,-18,18,17,-1.944444,0,0,2,2,true,false,false,0.018,0.982
105,95,10,15,15.833333,10,1030,998,32,0,0,0,0,51,7,6,0.72549,0,0,7,16,false,false,false,0.158,0.842
120,170,-50,15,21.25,-50,430,542,-112,0,1,0,0.125,46,8,8,1.043478,0,0,20,12,false,false,false,0.377,0.623
202,259,-57,14.428571,19.923077,-57,642,952,-310,0,0,0,0,15,14,13,2.933333,0,0,16,10,false,false,false,0.006,0.994
202,249,-47,20.2,27.666667,-47,999,1283,-284,0,1,0,0.111111,35,10,9,0.942857,0,0,10,9,false,false,false,0.085,0.915
164,212,-48,12.615385,17.666667,-48,668,363,305,0,0,0,0,26,13,12,1.807692,1,0,9,16,false,false,false,0.014,0.986
93,125,-32,11.625,15.625,-32,1045,1082,-37,0,0,0,0,51,8,8,0.882353,1,0,17,7,false,false,false,0.257,0.743
19,54,-35,9.5,27,-35,999,1283,-284,0,0,0,0,86,2,2,0.383721,1,1,19,16,false,false,false,0.23,0.77
253,366,-113,21.083333,30.5,-113,1636,1702,-66,0,1,0,0.083333,11,12,12,2.636364,0,0,11,19,false,false,false,0.004,0.996
178,224,-46,16.181818,20.363636,-46,595,538,57,0,0,0,0,23,11,11,1.652174,0,1,17,7,false,false,false,0.064,0.936
278,352,-74,16.352941,20.705882,-74,594,648,-54,1,1,0.058824,0.058824,-3,17,17,-13.333333,0,0,6,5,false,false,false,0.036,0.964
50,57,-7,16.666667,28.5,-7,1633,1739,-106,0,0,0,0,84,3,2,0.404762,0,0,8,14,false,false,false,0.129,0.871
191,226,-35,17.363636,22.6,-35,1123,1062,61,0,0,0,0,30,11,10,1.466667,0,0,15,15,false,false,false,0.105,0.895
212,170,42,23.555556,21.25,42,540,498,42,1,0,0.111111,0,39,9,8,1.179487,0,0,11,20,false,false,true,0.74,0.26
23,61,-38,11.5,30.5,-38,561,688,-127,0,0,0,0,83,2,2,0.554217,1,1,11,8,false,false,false,0.001,0.999
163,191,-28,18.111111,23.875,-28,1305,1194,111,0,0,0,0,39,9,8,0.846154,0,0,10,10,false,false,false,0.107,0.893
143,146,-3,35.75,36.5,-3,1885,1908,-23,0,2,0,0.5,61,4,4,0.377049,0,0,10,12,false,false,false,0.184,0.816
254,332,-78,19.538462,25.538462,-78,1127,995,132,0,1,0,0.076923,8,13,13,4.125,0,0,7,9,false,false,false,0,1
212,273,-61,17.666667,24.818182,-61,721,757,-36,0,2,0,0.181818,21,12,11,1.809524,1,0,10,14,false,false,false,0.006,0.994
115,152,-37,19.166667,30.4,-37,1021,897,124,0,1,0,0.2,58,6,5,0.637931,1,0,7,7,false,false,false,0.226,0.774
102,183,-81,20.4,45.75,-81,1219,1216,3,0,2,0,0.5,61,5,4,0.442623,0,2,8,8,false,false,false,0.007,0.993
185,225,-40,20.555556,28.125,-40,980,965,15,0,0,0,0,40,9,8,0.95,0,0,10,9,false,false,false,0.104,0.896
6,8,-2,6,8,-2,889,895,-6,0,0,0,0,91,1,1,0.406593,0,0,14,10,false,false,true,0.5,0.5
93,74,19,31,24.666667,19,595,733,-138,1,0,0.333333,0,74,3,3,0.527027,0,0,18,7,false,false,false,0.396,0.604
342,364,-22,19,21.411765,-22,1043,1003,40,0,1,0,0.058824,-13,18,17,-2.923077,0,0,2,3,false,false,false,0.008,0.992
99,190,-91,14.142857,27.142857,-91,480,739,-259,0,0,0,0,52,7,7,0.75,0,0,11,16,false,false,false,0.007,0.993
291,340,-49,22.384615,26.153846,-49,1656,1580,76,1,1,0.076923,0.076923,7,13,13,4.714286,0,0,16,17,false,false,false,0.016,0.984
281,228,53,25.545455,20.727273,53,1373,1334,39,1,1,0.090909,0.090909,24,11,11,1.333333,0,1,8,19,false,false,true,0.73,0.27
16,12,4,16,12,4,742,868,-126,0,0,0,0,91,1,1,0.362637,0,0,19,14,false,false,false,0.45,0.55
138,178,-40,9.857143,13.692308,-40,925,1000,-75,0,0,0,0,18,14,13,2.444444,0,0,19,21,false,false,false,0.104,0.896
301,332,-31,23.153846,25.538462,-31,1188,1334,-146,1,1,0.076923,0.076923,2,13,13,15,1,0,9,12,false,false,false,0.027,0.973
211,242,-31,19.181818,24.2,-31,1131,1030,101,0,0,0,0,25,11,10,1.2,1,1,7,9,false,false,false,0.039,0.961
74,186,-112,10.571429,26.571429,-112,1699,1803,-104,0,0,0,0,67,7,7,0.522388,0,0,7,9,false,false,false,0.094,0.906
336,368,-32,17.684211,20.444444,-32,1473,1500,-27,1,2,0.052632,0.111111,-29,19,18,-1.344828,0,0,1,1,false,false,false,0.01,0.99
64,79,-15,21.333333,26.333333,-15,1161,1030,131,0,0,0,0,76,3,3,0.5,0,0,11,7,false,false,false,0.42,0.58
148,162,-14,18.5,23.142857,-14,1205,1216,-11,0,0,0,0,50,8,7,0.66,0,0,9,18,false,false,false,0.106,0.894
169,266,-97,16.9,26.6,-97,1572,1777,-205,0,1,0,0.1,22,10,10,1.5,0,1,16,6,false,false,false,0.035,0.965
270,353,-83,22.5,29.416667,-83,1422,1798,-376,0,2,0,0.166667,11,12,12,2.909091,0,0,10,15,false,false,false,0.006,0.994
42,89,-47,10.5,22.25,-47,803,786,17,0,0,0,0,73,4,4,0.438356,0,0,17,7,false,false,false,0.125,0.875
118,221,-103,11.8,24.555556,-103,1305,1307,-2,0,1,0,0.111111,31,10,9,1.322581,0,0,12,21,false,false,false,0.009,0.991
105,119,-14,15,17,-14,805,918,-113,0,0,0,0,49,7,7,0.734694,0,1,17,19,false,false,false,0.109,0.891
115,85,30,38.333333,28.333333,30,824,830,-6,1,0,0.333333,0,75,3,3,0.586667,1,0,19,17,false,false,true,0.843,0.157
235,239,-4,18.076923,19.916667,-4,518,461,57,0,0,0,0,11,13,12,3.272727,0,1,7,9,false,false,false,0.192,0.808
254,227,27,25.4,25.222222,27,1354,1210,144,0,1,0,0.111111,31,10,9,1.064516,0,0,17,8,false,false,false,0.292,0.708
216,284,-68,13.5,17.75,-68,1248,1220,28,0,1,0,0.0625,12,16,16,4.333333,1,0,6,16,false,false,false,0.004,0.996
0,16,-16,0,16,-16,907,878,29,0,0,0,0,97,1,1,0.443299,0,0,21,7,false,false,false,0.47,0.53
226,351,-125,20.545455,31.909091,-125,1003,1004,-1,0,1,0,0.090909,24,11,11,1.458333,0,1,13,7,false,false,false,0,1
77,99,-22,15.4,19.8,-22,595,538,57,0,0,0,0,63,5,5,0.603175,0,0,12,8,false,false,false,0.278,0.722
27,32,-5,13.5,32,-5,1310,1477,-167,0,0,0,0,89,2,1,0.404494,0,0,7,7,false,false,false,0.234,0.766
275,324,-49,16.176471,19.058824,-49,1040,1364,-324,0,0,0,0,-17,17,17,-2.117647,0,0,1,9,false,false,false,0.009,0.991
14,64,-50,7,32,-50,1305,1211,94,0,0,0,0,89,2,2,0.370787,0,0,12,27,false,false,false,0.106,0.894
12,17,-5,12,17,-5,1636,1796,-160,0,0,0,0,93,1,1,0.290323,0,0,19,22,false,false,false,0.121,0.879
54,61,-7,10.8,15.25,-7,805,918,-113,0,0,0,0,68,5,4,0.529412,0,1,32,8,false,false,false,0.308,0.692
242,200,42,30.25,28.571429,42,1699,1580,119,2,0,0.25,0,40,8,7,0.75,0,0,10,9,false,false,true,0.737,0.263
196,230,-34,14,16.428571,-34,913,1037,-124,0,1,0,0.071429,23,14,14,1.782609,0,1,22,8,false,false,false,0.099,0.901
173,188,-15,17.3,20.888889,-15,1176,1211,-35,0,0,0,0,23,10,9,1.434783,1,0,7,10,false,false,false,0.249,0.751
66,76,-10,22,38,-10,576,602,-26,0,0,0,0,83,3,2,0.506024,0,0,13,17,false,false,false,0.243,0.757
152,173,-21,15.2,19.222222,-21,341,416,-75,0,0,0,0,42,10,9,0.928571,0,0,8,12,false,false,false,0.163,0.837
54,138,-84,27,69,-84,1398,1431,-33,0,0,0,0,75,2,2,0.373333,0,0,12,10,false,false,false,0.071,0.929
347,419,-72,18.263158,23.277778,-72,991,1063,-72,0,1,0,0.055556,-21,19,18,-1.809524,0,0,1,4,false,false,false,0.014,0.986
290,233,57,26.363636,23.3,57,1552,1803,-251,2,0,0.181818,0,22,11,10,1.5,0,1,8,7,false,false,false,0.391,0.609
224,280,-56,20.363636,28,-56,835,786,49,0,0,0,0,12,11,10,2.833333,0,0,7,17,false,false,false,0.01,0.99
133,137,-4,16.625,19.571429,-4,402,448,-46,0,0,0,0,50,8,7,0.74,0,1,7,14,false,false,false,0.061,0.939
223,251,-28,15.928571,19.307692,-28,1123,1062,61,0,0,0,0,17,14,13,2.588235,0,1,13,7,false,false,false,0.078,0.922
278,328,-50,18.533333,23.428571,-50,1055,1019,36,0,0,0,0,-13,15,14,-2.538462,1,0,3,3,false,false,false,0.054,0.946
176,202,-26,17.6,22.444444,-26,805,918,-113,0,0,0,0,27,10,9,1.333333,0,0,12,16,false,false,false,0.106,0.894
38,94,-56,12.666667,31.333333,-56,1397,1309,88,0,0,0,0,83,3,3,0.433735,1,1,6,22,false,false,false,0.07,0.93
82,88,-6,16.4,22,-6,842,926,-84,0,0,0,0,65,5,4,0.461538,0,0,15,10,false,false,false,0.163,0.837
247,356,-109,15.4375,23.733333,-109,1003,1018,-15,0,0,0,0,-20,16,15,-1.85,0,0,8,8,false,false,false,0.005,0.995
320,349,-29,22.857143,24.928571,-29,1070,814,256,1,1,0.071429,0.071429,-4,14,14,-8.25,0,0,8,3,false,false,false,0.009,0.991
202,246,-44,18.363636,22.363636,-44,805,918,-113,0,0,0,0,16,11,11,2.25,0,0,10,24,false,false,false,0.079,0.921
130,124,6,18.571429,20.666667,6,874,868,6,0,0,0,0,48,7,6,0.6875,0,0,15,17,false,false,false,0.281,0.719
338,384,-46,17.789474,21.333333,-46,1164,1261,-97,0,1,0,0.055556,-16,19,18,-2.625,0,0,6,5,false,false,false,0.032,0.968
342,376,-34,28.5,31.333333,-34,1793,1957,-164,1,2,0.083333,0.166667,4,12,12,7.25,0,0,10,12,false,false,false,0.058,0.942
46,12,34,23,12,34,1164,1161,3,0,0,0,0,86,2,1,0.267442,0,0,10,11,false,false,true,0.522,0.478
179,130,49,29.833333,26,49,1556,1513,43,0,0,0,0,50,6,5,0.62,0,0,17,14,false,false,true,0.637,0.363
308,325,-17,20.533333,21.666667,-17,1691,1510,181,0,1,0,0.066667,-9,15,15,-3.333333,1,0,2,7,true,false,false,0.075,0.925
134,103,31,33.5,34.333333,31,714,820,-106,1,0,0.25,0,72,4,3,0.430556,0,0,11,18,false,false,true,0.559,0.441
90,124,-34,22.5,41.333333,-34,1045,1100,-55,0,0,0,0,73,4,3,0.465753,0,1,10,14,false,false,false,0.104,0.896
102,126,-24,17,21,-24,727,820,-93,0,1,0,0.166667,54,6,6,0.648148,0,0,16,10,false,false,false,0.409,0.591
257,428,-171,14.277778,25.176471,-171,926,973,-47,0,0,0,0,-12,18,17,-2.916667,0,0,2,1,true,false,false,0.005,0.995
163,244,-81,14.818182,22.181818,-81,1195,1397,-202,0,1,0,0.090909,33,11,11,1.212121,0,0,11,7,false,false,false,0.024,0.976
42,41,1,10.5,13.666667,1,391,542,-151,0,0,0,0,80,4,3,0.575,1,1,9,16,false,false,false,0.001,0.999
206,202,4,29.428571,28.857143,4,714,820,-106,1,0,0.142857,0,48,7,7,0.645833,0,0,11,12,false,false,true,0.728,0.272
167,205,-38,18.555556,22.777778,-38,796,800,-4,1,0,0.111111,0,37,9,9,1.297297,0,0,8,9,false,false,false,0.112,0.888
282,344,-62,16.588235,20.235294,-62,1633,1620,13,0,0,0,0,-22,17,17,-1.636364,0,0,1,1,false,false,false,0.026,0.974
10,0,10,10,0,10,1606,1593,13,0,0,0,0,97,1,0,0.298969,0,0,20,0,false,false,false,0.414,0.586
331,388,-57,16.55,19.4,-57,824,830,-6,1,0,0.05,0,-19,20,20,-2.315789,0,0,4,3,false,false,false,0.036,0.964
205,181,24,29.285714,30.166667,24,1556,1513,43,0,0,0,0,44,7,6,0.704545,0,0,11,16,false,false,false,0.299,0.701
295,428,-133,19.666667,28.533333,-133,732,868,-136,0,1,0,0.066667,-11,15,15,-2.909091,0,0,2,2,false,false,false,0.005,0.995
267,383,-116,14.833333,22.529412,-116,530,683,-153,0,1,0,0.058824,-3,18,17,-13.333333,0,0,10,12,false,false,false,0.008,0.992
173,118,55,11.533333,7.866667,55,491,651,-160,0,0,0,0,20,15,15,1.5,0,1,29,6,true,false,true,0.929,0.071
210,328,-118,19.090909,29.818182,-118,1232,1448,-216,0,2,0,0.181818,20,11,11,1.75,0,0,12,12,false,false,false,0.005,0.995
78,116,-38,19.5,29,-38,1232,1281,-49,0,1,0,0.25,63,4,4,0.492063,0,1,12,7,false,false,false,0.247,0.753
112,182,-70,14,26,-70,1220,1202,18,0,0,0,0,49,8,7,1.020408,0,0,26,7,false,false,false,0.105,0.895
243,283,-40,17.357143,21.769231,-40,1422,1583,-161,0,1,0,0.076923,14,14,13,2.928571,1,0,8,16,false,false,false,0.101,0.899
258,299,-41,12.285714,14.238095,-41,683,859,-176,0,0,0,0,-2,21,21,-22.5,0,0,9,17,false,false,false,0.036,0.964
285,331,-46,15,18.388889,-46,306,468,-162,1,0,0.052632,0,-11,19,18,-3.363636,0,0,7,2,true,false,false,0.013,0.987
155,272,-117,17.222222,30.222222,-117,473,683,-210,0,0,0,0,34,9,9,1.117647,0,0,8,7,false,false,false,0.005,0.995
64,95,-31,12.8,19,-31,758,904,-146,0,0,0,0,64,5,5,0.53125,1,0,7,12,false,false,false,0.245,0.755
43,83,-40,10.75,20.75,-40,651,996,-345,0,0,0,0,72,4,4,0.625,0,0,9,17,false,false,false,0.106,0.894
281,390,-109,16.529412,22.941176,-109,563,523,40,0,0,0,0,-12,17,17,-3.083333,0,0,4,1,false,false,false,0.005,0.995
197,294,-97,15.153846,22.615385,-97,1493,1453,40,0,0,0,0,9,13,13,3.888889,0,2,15,9,false,false,false,0,1
181,294,-113,22.625,36.75,-113,1556,1616,-60,0,0,0,0,33,8,8,0.878788,0,0,17,13,false,false,false,0.006,0.994
203,204,-1,25.375,29.142857,-1,801,679,122,1,0,0.125,0,35,8,7,0.828571,0,0,15,7,false,false,true,0.692,0.308
111,126,-15,18.5,21,-15,1075,878,197,0,0,0,0,61,6,6,0.540984,0,1,9,16,false,false,false,0.036,0.964
166,241,-75,20.75,30.125,-75,1110,1399,-289,0,1,0,0.125,41,8,8,0.829268,0,0,27,9,false,false,false,0.079,0.921
151,244,-93,15.1,24.4,-93,1195,1397,-202,0,1,0,0.1,37,10,10,1.081081,0,0,11,9,false,false,false,0.011,0.989
333,272,61,25.615385,20.923077,61,1156,1279,-123,2,0,0.153846,0,9,13,13,4.444444,0,1,7,24,false,false,true,0.5,0.5
10,0,10,10,0,10,965,1078,-113,0,0,0,0,97,1,0,0.381443,0,0,25,0,false,false,false,0.5,0.5
252,257,-5,22.909091,25.7,-5,1452,1388,64,0,1,0,0.1,22,11,10,1.590909,0,0,8,12,false,false,false,0.115,0.885
16,28,-12,8,14,-12,1606,1890,-284,0,0,0,0,86,2,2,0.325581,1,0,9,11,false,false,false,0.249,0.751
249,365,-116,14.647059,22.8125,-116,530,683,-153,0,1,0,0.0625,4,17,16,10,0,0,17,11,false,false,false,0.007,0.993
297,467,-170,19.8,33.357143,-170,1368,1452,-84,1,2,0.066667,0.142857,-5,15,14,-6.4,0,0,2,3,false,false,false,0,1
153,253,-100,11.769231,19.461538,-100,388,542,-154,0,0,0,0,11,13,13,3.363636,0,1,7,9,false,false,false,0.001,0.999
264,287,-23,15.529412,16.882353,-23,430,542,-112,0,1,0,0.058824,-1,17,17,-48,0,0,16,13,false,false,false,0.048,0.952
93,167,-74,10.333333,20.875,-74,818,826,-8,0,0,0,0,59,9,8,0.898305,1,0,8,13,false,false,false,0.097,0.903
65,62,3,10.833333,12.4,3,808,749,59,0,0,0,0,60,6,5,0.7,0,1,9,16,false,false,false,0.21,0.79
220,318,-98,24.444444,35.333333,-98,1556,1616,-60,0,0,0,0,28,9,9,1.035714,0,0,13,8,false,false,false,0.008,0.992
356,347,9,23.733333,24.785714,9,1305,1211,94,2,0,0.133333,0,0,15,14,0,0,1,10,9,false,false,false,0.028,0.972
86,165,-79,10.75,20.625,-79,651,567,84,0,0,0,0,44,8,8,1.25,0,0,9,9,false,false,false,0.088,0.912
62,36,26,20.666667,12,26,1203,1270,-67,0,0,0,0,84,3,3,0.52381,1,0,6,14,false,false,true,0.666,0.334
206,330,-124,18.727273,33,-124,1368,1452,-84,1,1,0.090909,0.1,29,11,10,1.103448,0,1,9,11,false,false,false,0.003,0.997
146,91,55,29.2,18.2,55,1156,1279,-123,1,0,0.2,0,60,5,5,0.666667,1,0,7,17,false,false,true,0.814,0.186
130,121,9,21.666667,20.166667,9,1432,1452,-20,0,0,0,0,58,6,6,0.62069,1,0,6,9,false,false,true,0.707,0.293
181,186,-5,15.083333,15.5,-5,995,965,30,0,0,0,0,23,12,12,1.73913,0,0,19,8,false,false,true,0.572,0.428
206,296,-90,12.875,18.5,-90,388,542,-154,0,0,0,0,-4,16,16,-9.25,0,1,8,6,false,false,false,0.004,0.996
245,236,9,20.416667,21.454545,9,939,969,-30,0,0,0,0,13,12,11,2.538462,0,0,20,7,false,false,true,0.68,0.32
26,0,26,26,0,26,1652,1473,179,0,0,0,0,95,1,0,0.315789,0,0,8,0,false,false,true,0.551,0.449
14,0,14,14,0,14,700,820,-120,0,0,0,0,96,1,0,0.395833,0,0,20,0,false,false,true,0.515,0.485
331,342,-11,18.388889,19,-11,804,766,38,0,1,0,0.055556,-7,18,18,-5.857143,0,0,7,4,false,false,false,0.135,0.865
221,326,-105,15.785714,23.285714,-105,1075,878,197,0,1,0,0.071429,7,14,14,4.714286,0,0,17,10,false,false,false,0.014,0.986
368,386,-18,20.444444,22.705882,-18,1093,1173,-80,1,1,0.055556,0.058824,-13,18,17,-3.307692,0,0,4,10,false,false,false,0.066,0.934
349,390,-41,19.388889,21.666667,-41,700,820,-120,0,1,0,0.055556,-24,18,18,-1.583333,0,0,2,3,false,false,false,0.043,0.957
258,352,-94,19.846154,29.333333,-94,1232,1448,-216,0,2,0,0.166667,11,13,12,3.181818,0,0,7,12,false,false,false,0.005,0.995
208,170,38,34.666667,28.333333,38,1777,1689,88,1,1,0.166667,0.166667,44,6,6,0.613636,0,0,19,19,false,false,true,0.733,0.267
185,275,-90,30.833333,45.833333,-90,1885,1908,-23,1,3,0.166667,0.5,38,6,6,0.605263,0,0,9,20,false,false,false,0.007,0.993
160,201,-41,16,22.333333,-41,804,766,38,0,1,0,0.111111,49,10,9,0.836735,0,1,17,10,false,false,false,0.064,0.936
195,242,-47,19.5,26.888889,-47,1315,1331,-16,0,0,0,0,31,10,9,1.064516,0,0,10,14,false,false,false,0.104,0.896
92,153,-61,13.142857,25.5,-61,342,263,79,0,0,0,0,50,7,6,0.68,0,0,7,9,false,false,false,0.086,0.914
302,362,-60,20.133333,24.133333,-60,1164,1261,-97,0,1,0,0.066667,6,15,15,7,0,0,14,7,false,false,false,0.033,0.967
197,283,-86,16.416667,23.583333,-86,594,648,-54,1,1,0.083333,0.083333,25,12,12,1.6,0,0,17,8,false,false,false,0.033,0.967
24,48,-24,12,24,-24,915,971,-56,0,0,0,0,86,2,2,0.383721,0,0,8,30,false,false,false,0.108,0.892
53,65,-12,13.25,21.666667,-12,563,523,40,0,0,0,0,76,4,3,0.486842,0,0,11,20,false,false,false,0.166,0.834
128,133,-5,16,16.625,-5,797,796,1,0,0,0,0,54,8,8,0.907407,0,0,12,7,false,false,false,0.413,0.587
222,285,-63,10.571429,14.25,-63,595,540,55,0,0,0,0,-10,21,20,-4.3,0,0,7,15,false,false,false,0.021,0.979
296,367,-71,18.5,22.9375,-71,1205,1216,-11,0,0,0,0,-10,16,16,-3.3,0,0,3,5,false,false,false,0.005,0.995
105,153,-48,15,21.857143,-48,1161,1030,131,0,1,0,0.142857,50,7,7,0.76,0,0,14,10,false,false,false,0.125,0.875
63,52,11,15.75,17.333333,11,742,868,-126,0,0,0,0,75,4,3,0.44,0,0,8,11,false,false,false,0.237,0.763
86,105,-19,17.2,26.25,-19,518,461,57,0,0,0,0,70,5,4,0.514286,0,0,15,13,false,false,false,0.237,0.763
140,173,-33,15.555556,19.222222,-33,450,427,23,0,1,0,0.111111,37,9,9,1,0,0,11,18,false,false,true,0.603,0.397
114,140,-26,12.666667,15.555556,-26,391,542,-151,1,0,0.111111,0,39,9,9,1.179487,0,0,7,10,false,false,false,0.128,0.872
231,259,-28,17.769231,19.923077,-28,1161,1030,131,0,1,0,0.076923,5,13,13,7.6,0,0,16,7,false,false,false,0.219,0.781
146,94,52,20.857143,15.666667,52,206,346,-140,1,0,0.142857,0,55,7,6,0.781818,0,0,15,16,false,false,true,0.741,0.259
68,20,48,68,20,48,1167,1245,-78,1,0,1,0,88,1,1,0.318182,0,0,16,13,false,false,true,0.515,0.485
54,90,-36,18,45,-36,594,648,-54,0,1,0,0.5,81,3,2,0.493827,0,0,13,10,false,false,false,0.285,0.715
99,130,-31,14.142857,18.571429,-31,360,371,-11,0,0,0,0,47,7,7,0.787234,0,0,20,10,false,false,false,0.312,0.688
93,175,-82,10.333333,19.444444,-82,818,826,-8,0,0,0,0,56,9,9,0.946429,1,0,8,20,false,false,false,0.081,0.919
209,298,-89,16.076923,22.923077,-89,594,648,-54,1,1,0.076923,0.076923,20,13,13,2,0,0,20,8,false,false,false,0.035,0.965
65,50,15,13,12.5,15,226,361,-135,0,0,0,0,67,5,4,0.656716,0,1,16,8,false,false,false,0.195,0.805
138,80,58,27.6,16,58,1341,1606,-265,1,0,0.2,0,56,5,5,0.589286,0,0,11,16,false,false,true,0.627,0.373
292,239,53,22.461538,19.916667,53,1331,1374,-43,0,0,0,0,6,13,12,5.5,0,0,22,7,false,false,true,0.876,0.124
199,268,-69,22.111111,29.777778,-69,1071,1065,6,0,0,0,0,26,9,9,1.192308,0,0,17,16,false,false,false,0.039,0.961
201,251,-50,20.1,27.888889,-50,1101,1115,-14,0,0,0,0,31,10,9,0.967742,0,1,9,13,false,false,false,0.063,0.937
227,240,-13,14.1875,15,-13,361,413,-52,0,0,0,0,-10,16,16,-4.1,0,0,13,7,false,false,false,0.469,0.531
291,324,-33,20.785714,24.923077,-33,561,633,-72,0,1,0,0.076923,9,14,13,3.888889,0,0,7,7,false,false,false,0.036,0.964
229,345,-116,16.357143,24.642857,-116,563,523,40,0,0,0,0,4,14,14,9.25,0,0,10,17,false,false,false,0.005,0.995
218,299,-81,16.769231,23,-81,344,315,29,1,1,0.076923,0.076923,-4,13,13,-10,0,0,19,7,false,false,false,0.095,0.905
302,333,-31,15.1,16.65,-31,1045,1082,-37,0,0,0,0,-23,20,20,-1.956522,0,0,3,2,false,false,false,0.034,0.966
256,370,-114,13.473684,20.555556,-114,1037,1016,21,1,0,0.052632,0,0,19,18,0,1,0,18,10,false,false,false,0.005,0.995
283,297,-14,23.583333,27,-14,1167,1245,-78,1,0,0.083333,0,6,12,11,4.666667,1,0,7,12,false,false,false,0.197,0.803
93,38,55,31,19,55,595,733,-138,1,0,0.333333,0,79,3,2,0.493671,0,1,18,9,false,false,false,0.001,0.999
189,215,-26,14.538462,16.538462,-26,1580,1629,-49,0,0,0,0,17,13,13,2.176471,0,1,17,9,false,false,false,0.215,0.785
181,271,-90,12.066667,18.066667,-90,651,700,-49,0,0,0,0,3,15,15,18.666667,1,0,6,14,false,false,false,0.006,0.994
74,0,74,74,0,74,1156,1279,-123,1,0,1,0,93,1,0,0.430108,0,0,12,0,false,false,true,0.529,0.471
139,160,-21,23.166667,32,-21,1305,1194,111,0,0,0,0,57,6,5,0.578947,0,0,14,9,false,false,false,0.195,0.805
87,182,-95,9.666667,22.75,-95,632,603,29,0,0,0,0,44,9,8,0.863636,1,0,10,24,false,false,false,0.01,0.99
210,162,48,19.090909,14.727273,48,897,996,-99,0,0,0,0,34,11,11,1.147059,0,0,8,10,false,false,true,0.904,0.096
307,346,-39,13.954545,15.727273,-39,1045,1082,-37,0,0,0,0,-35,22,22,-1.285714,0,0,1,1,false,false,false,0.019,0.981
110,117,-7,13.75,14.625,-7,808,749,59,0,0,0,0,41,8,8,1.02439,0,0,8,9,false,false,false,0.36,0.64
65,61,4,21.666667,20.333333,4,500,532,-32,0,0,0,0,77,3,3,0.532468,0,0,9,11,false,false,false,0.423,0.577
284,403,-119,17.75,25.1875,-119,1656,1649,7,0,0,0,0,-13,16,16,-2.461538,0,0,1,4,true,false,false,0.002,0.998
140,151,-11,17.5,21.571429,-11,1071,1181,-110,0,0,0,0,58,8,7,0.586207,0,0,7,7,false,false,false,0.117,0.883
282,297,-15,14.1,14.85,-15,797,796,1,0,0,0,0,-15,20,20,-3.266667,0,0,8,5,false,false,false,0.105,0.895
302,328,-26,16.777778,19.294118,-26,1302,1351,-49,0,0,0,0,-17,18,17,-2.176471,0,0,1,1,false,false,false,0.067,0.933
116,114,2,23.2,22.8,2,1305,1254,51,0,0,0,0,60,5,5,0.533333,0,0,10,11,false,false,false,0.37,0.63
310,375,-65,15.5,18.75,-65,1064,1397,-333,0,2,0,0.1,-14,20,20,-3.071429,1,0,7,2,false,false,false,0.037,0.963
323,346,-23,20.1875,23.066667,-23,721,757,-36,0,2,0,0.133333,-4,16,15,-9.5,0,0,3,10,false,false,false,0.02,0.98
130,188,-58,13,20.888889,-58,1220,1202,18,0,0,0,0,36,10,9,1.388889,0,0,28,7,false,false,false,0.106,0.894
143,372,-229,13,33.818182,-229,1093,1100,-7,0,2,0,0.181818,29,11,11,1.206897,0,0,8,12,false,false,false,0.001,0.999
182,236,-54,16.545455,23.6,-54,594,648,-54,1,1,0.090909,0.1,35,11,10,1.142857,0,0,10,17,false,false,false,0.033,0.967
159,275,-116,12.230769,22.916667,-116,1075,1189,-114,0,0,0,0,17,13,12,2.352941,0,0,9,15,false,false,false,0.005,0.995
199,212,-13,28.428571,35.333333,-13,1164,1161,3,0,1,0,0.166667,37,7,6,0.621622,0,0,10,9,false,false,false,0.331,0.669
247,314,-67,13,16.526316,-67,651,700,-49,0,0,0,0,-17,19,19,-3.294118,0,1,12,10,false,false,false,0.005,0.995
309,368,-59,19.3125,24.533333,-59,771,668,103,2,0,0.125,0,-16,16,15,-2.375,0,0,3,13,false,false,false,0.032,0.968
242,270,-28,17.285714,20.769231,-28,822,845,-23,0,0,0,0,13,14,13,2.692308,0,0,10,9,false,false,false,0.079,0.921
231,252,-21,19.25,21,-21,1270,1261,9,1,0,0.083333,0,28,12,12,1.321429,0,0,9,16,false,false,false,0.345,0.655
300,321,-21,17.647059,18.882353,-21,451,448,3,0,0,0,0,-13,17,17,-2.846154,0,0,9,1,false,false,false,0.046,0.954
174,252,-78,11.6,16.8,-78,226,361,-135,0,0,0,0,-4,15,15,-11,1,0,9,9,false,false,false,0.006,0.994
136,92,44,34,30.666667,44,2010,2219,-209,1,0,0.25,0,73,4,3,0.356164,0,1,12,10,false,false,false,0.27,0.73
147,219,-72,16.333333,24.333333,-72,1699,1803,-104,1,0,0.111111,0,51,9,9,0.686275,0,0,12,8,false,false,false,0.086,0.914
31,16,15,15.5,16,15,1037,1009,28,0,0,0,0,90,2,1,0.488889,0,0,7,8,false,false,false,0.452,0.548
12,10,2,12,10,2,939,969,-30,0,0,0,0,91,1,1,0.362637,0,0,8,10,false,false,false,0.469,0.531
115,85,30,14.375,12.142857,30,721,757,-36,0,0,0,0,55,8,7,0.690909,0,1,13,15,false,false,false,0.275,0.725
74,79,-5,14.8,19.75,-5,1699,1803,-104,0,0,0,0,78,5,4,0.448718,0,2,7,7,false,false,false,0.273,0.727
145,151,-6,20.714286,21.571429,-6,1488,1428,60,1,0,0.142857,0,50,7,7,0.74,0,0,22,15,false,false,false,0.299,0.701
300,386,-86,15.789474,21.444444,-86,691,704,-13,0,1,0,0.055556,-24,19,18,-1.583333,0,0,1,1,false,false,false,0.006,0.994
133,174,-41,26.6,43.5,-41,1331,1432,-101,0,0,0,0,53,5,4,0.509434,0,0,13,13,false,false,false,0.109,0.891
93,181,-88,13.285714,30.166667,-88,1454,1479,-25,0,0,0,0,54,7,6,0.574074,1,0,6,9,false,false,false,0.107,0.893
365,378,-13,22.8125,23.625,-13,1305,1211,94,2,0,0.125,0,-11,16,16,-3,0,1,5,4,false,false,false,0.018,0.982
242,241,1,18.615385,18.538462,1,1000,960,40,0,0,0,0,16,13,13,2.8125,0,0,9,8,false,false,true,0.518,0.482
336,340,-4,17.684211,17.894737,-4,1168,1062,106,0,0,0,0,-11,19,19,-3.909091,0,0,2,2,false,false,false,0.298,0.702
105,107,-2,17.5,21.4,-2,1493,1453,40,0,0,0,0,61,6,5,0.57377,0,0,15,19,false,false,false,0.118,0.882
161,176,-15,20.125,22,-15,1493,1413,80,0,0,0,0,46,8,8,0.782609,0,1,18,12,false,false,false,0.115,0.885
260,208,52,28.888889,23.111111,52,1552,1803,-251,2,0,0.222222,0,31,9,9,1.064516,0,1,21,11,false,false,true,0.77,0.23
245,232,13,35,33.142857,13,820,718,102,0,2,0,0.285714,35,7,7,0.8,0,0,11,16,false,false,false,0.153,0.847
34,18,16,17,18,16,1065,948,117,0,0,0,0,88,2,1,0.443182,1,0,15,14,false,false,true,0.796,0.204
43,72,-29,10.75,18,-29,651,567,84,0,0,0,0,72,4,4,0.763889,0,0,9,28,false,false,false,0.137,0.863
72,66,6,18,16.5,6,785,892,-107,0,0,0,0,71,4,4,0.521127,1,0,25,14,false,false,true,0.536,0.464
221,164,57,31.571429,27.333333,57,1373,1334,39,1,1,0.142857,0.166667,51,7,6,0.627451,0,0,10,21,false,false,true,0.773,0.227
40,14,26,20,14,26,1045,1082,-37,0,0,0,0,91,2,1,0.494505,0,1,16,11,false,false,false,0.431,0.569
168,180,-12,15.272727,16.363636,-12,889,855,34,0,0,0,0,33,11,11,1.212121,0,1,23,9,false,false,false,0.182,0.818
286,305,-19,14.3,16.052632,-19,1123,1062,61,0,0,0,0,-17,20,19,-2.588235,0,0,3,11,false,false,false,0.068,0.932
280,310,-30,17.5,19.375,-30,343,570,-227,0,0,0,0,-15,16,16,-2.4,0,0,4,2,false,false,false,0.035,0.965
234,353,-119,13,19.611111,-119,542,605,-63,0,0,0,0,-18,18,18,-2,0,0,5,5,true,false,false,0.005,0.995
34,0,34,34,0,34,1398,1431,-33,0,0,0,0,95,1,0,0.294737,0,0,22,0,false,false,true,0.539,0.461
5,50,-45,2.5,25,-45,1078,983,95,0,0,0,0,89,2,2,0.539326,1,0,8,9,false,false,false,0.262,0.738
193,316,-123,21.444444,35.111111,-123,1633,1680,-47,0,1,0,0.111111,21,9,9,1.333333,0,0,18,9,false,false,false,0.004,0.996
50,70,-20,12.5,17.5,-20,999,1071,-72,0,0,0,0,72,4,4,0.555556,0,0,8,12,false,false,false,0.128,0.872
256,273,-17,16,18.2,-17,1123,1062,61,0,0,0,0,4,16,15,11,0,0,9,17,false,false,false,0.208,0.792
343,419,-76,19.055556,23.277778,-76,991,1063,-72,0,1,0,0.055556,-19,18,18,-2,0,0,1,4,false,false,false,0.025,0.975
226,272,-46,17.384615,22.666667,-46,917,856,61,0,1,0,0.083333,18,13,12,1.833333,0,0,7,13,false,false,false,0.025,0.975
75,55,20,18.75,18.333333,20,306,468,-162,0,0,0,0,80,4,3,0.4625,0,0,13,14,false,false,true,0.55,0.45
84,128,-44,21,32,-44,835,786,49,0,0,0,0,68,4,4,0.5,0,0,22,11,false,false,false,0.274,0.726
286,335,-49,16.823529,20.9375,-49,1071,1181,-110,0,0,0,0,-5,17,16,-6.8,0,1,5,5,false,false,false,0.006,0.994
189,218,-29,18.9,24.222222,-29,595,733,-138,1,1,0.1,0.111111,29,10,9,1.344828,0,1,22,13,false,false,false,0.017,0.983
66,43,23,22,21.5,23,1793,1957,-164,0,0,0,0,83,3,2,0.349398,0,1,8,18,false,false,false,0.246,0.754
124,101,23,41.333333,50.5,23,1086,926,160,0,1,0,0.5,75,3,2,0.373333,1,0,13,17,false,false,false,0.295,0.705
65,138,-73,16.25,46,-73,1583,1403,180,0,0,0,0,66,4,3,0.484848,0,0,11,16,false,false,false,0.014,0.986
80,147,-67,11.428571,24.5,-67,1270,1424,-154,0,1,0,0.166667,61,7,6,0.57377,0,0,18,8,false,false,false,0.106,0.894
281,427,-146,17.5625,28.466667,-146,1315,1334,-19,0,2,0,0.133333,-13,16,15,-2.769231,0,0,2,4,false,false,false,0,1
100,112,-12,14.285714,18.666667,-12,278,1,277,0,0,0,0,48,7,6,0.770833,0,0,20,10,false,false,true,0.651,0.349
24,13,11,24,13,11,1188,1334,-146,0,0,0,0,91,1,1,0.32967,0,0,10,11,false,false,false,0.448,0.552
42,34,8,14,11.333333,8,542,390,152,0,0,0,0,88,3,3,0.568182,0,0,11,18,false,false,true,0.653,0.347
285,225,60,17.8125,14.0625,60,1030,998,32,0,0,0,0,2,16,16,18.5,0,1,18,8,false,false,true,0.98,0.02
260,292,-32,13.684211,15.368421,-32,500,532,-32,0,0,0,0,-23,19,19,-1.782609,0,1,16,1,false,false,false,0.012,0.988
320,353,-33,20,23.533333,-33,980,965,15,0,0,0,0,-4,16,15,-9.5,0,0,8,10,false,false,false,0.022,0.978
63,73,-10,15.75,18.25,-10,742,868,-126,0,0,0,0,72,4,4,0.458333,0,0,8,19,false,false,false,0.119,0.881
309,476,-167,22.071429,34,-167,786,848,-62,0,2,0,0.142857,-2,14,14,-15.5,0,0,6,2,false,false,false,0,1
118,115,3,19.666667,23,3,939,969,-30,0,0,0,0,56,6,5,0.589286,0,0,16,8,false,false,false,0.284,0.716
231,239,-8,19.25,19.916667,-8,206,346,-140,1,0,0.083333,0,15,12,12,2.866667,0,0,16,10,false,false,false,0.235,0.765
312,355,-43,18.352941,20.882353,-43,1063,1134,-71,1,0,0.058824,0,3,17,17,14.666667,0,0,13,11,false,false,false,0.036,0.964
32,33,-1,16,16.5,-1,1063,1134,-71,0,0,0,0,88,2,2,0.5,0,0,7,19,false,false,false,0.14,0.86
264,392,-128,18.857143,28,-128,1572,1777,-205,0,2,0,0.142857,-9,14,14,-3.666667,0,0,17,4,false,false,false,0.005,0.995
284,323,-39,16.705882,20.1875,-39,1422,1583,-161,0,1,0,0.0625,-3,17,16,-13.666667,1,0,3,22,false,false,false,0.023,0.977
323,327,-4,19,20.4375,-4,1341,1606,-265,1,0,0.058824,0,-15,17,16,-2.2,0,0,3,1,true,false,false,0.116,0.884
184,250,-66,14.153846,20.833333,-66,1101,1130,-29,1,1,0.076923,0.083333,26,13,12,1.730769,0,1,20,17,false,false,false,0.005,0.995
57,135,-78,14.25,33.75,-78,1572,1777,-205,0,1,0,0.25,66,4,4,0.5,0,0,15,9,false,false,false,0.106,0.894
122,113,9,15.25,16.142857,9,1312,1334,-22,0,0,0,0,48,8,7,0.8125,0,0,23,10,false,false,false,0.349,0.651
191,247,-56,21.222222,27.444444,-56,835,786,49,0,0,0,0,25,9,9,1.36,0,0,16,16,false,false,false,0.118,0.882
280,330,-50,12.727273,15.714286,-50,1040,1091,-51,0,0,0,0,-28,22,21,-1.678571,0,0,6,2,false,false,false,0.006,0.994
283,205,78,35.375,29.285714,78,1777,1689,88,1,1,0.125,0.142857,32,8,7,0.84375,0,0,12,13,false,false,true,0.928,0.072
96,109,-13,19.2,27.25,-13,1407,1473,-66,0,1,0,0.25,68,5,4,0.455882,0,0,10,12,false,false,false,0.144,0.856
115,76,39,28.75,19,39,1563,1539,24,0,0,0,0,69,4,4,0.507246,0,0,12,7,false,false,true,0.571,0.429
215,305,-90,15.357143,21.785714,-90,341,416,-75,0,0,0,0,8,14,14,4.875,0,0,10,19,false,false,false,0.006,0.994
12,14,-2,6,14,-2,1454,1479,-25,0,0,0,0,90,2,1,0.344444,1,1,6,6,false,false,false,0.246,0.754
125,135,-10,17.857143,22.5,-10,1803,1658,145,0,0,0,0,50,7,6,0.66,2,0,8,7,false,false,true,0.759,0.241
121,198,-77,15.125,28.285714,-77,595,412,183,0,1,0,0.142857,50,8,7,1.04,0,1,7,15,false,false,false,0,1
145,94,51,24.166667,18.8,51,1495,1531,-36,0,0,0,0,66,6,5,0.560606,0,0,7,17,false,false,true,0.505,0.495
312,328,-16,16.421053,18.222222,-16,561,688,-127,0,0,0,0,-9,19,18,-5.111111,0,0,3,10,false,false,false,0.043,0.957
236,211,25,21.454545,19.181818,25,664,786,-122,0,0,0,0,25,11,11,1.32,1,0,11,7,false,false,true,0.821,0.179
145,132,13,18.125,18.857143,13,1439,1428,11,0,0,0,0,56,8,7,0.714286,0,0,9,17,false,false,false,0.113,0.887
58,69,-11,11.6,13.8,-11,771,668,103,0,0,0,0,62,5,5,0.612903,0,0,9,10,false,false,false,0.412,0.588
181,278,-97,9.05,14.631579,-97,818,826,-8,0,0,0,0,-8,20,19,-6.625,0,0,9,19,false,false,false,0.005,0.995
186,181,5,16.909091,16.454545,5,1000,960,40,0,0,0,0,27,11,11,1.666667,0,0,18,17,false,false,true,0.68,0.32
333,374,-41,20.8125,23.375,-41,1237,1265,-28,1,0,0.0625,0,-20,16,16,-1.8,0,0,4,5,false,false,false,0.016,0.984
249,336,-87,16.6,22.4,-87,805,918,-113,0,0,0,0,-5,15,15,-7.2,0,0,6,9,false,false,false,0.005,0.995
199,278,-79,13.266667,18.533333,-79,683,859,-176,0,0,0,0,16,15,15,2.8125,0,0,12,17,false,false,false,0.006,0.994
46,40,6,11.5,13.333333,6,970,1030,-60,0,0,0,0,74,4,3,0.540541,0,1,25,14,false,false,false,0.313,0.687
166,195,-29,16.6,21.666667,-29,965,1078,-113,0,0,0,0,38,10,9,0.973684,0,0,14,8,false,false,false,0.106,0.894
215,275,-60,16.538462,21.153846,-60,603,721,-118,0,0,0,0,18,13,13,2.388889,0,0,8,10,false,false,false,0.006,0.994
279,309,-30,13.95,16.263158,-30,670,576,94,0,0,0,0,-17,20,19,-2.411765,0,0,2,1,false,false,false,0.034,0.966
222,204,18,27.75,25.5,18,1563,1539,24,0,1,0,0.125,33,8,8,1.060606,0,0,17,21,false,false,true,0.724,0.276
235,264,-29,16.785714,18.857143,-29,704,523,181,0,0,0,0,-7,14,14,-5,0,0,16,12,false,false,true,0.654,0.346
57,172,-115,9.5,34.4,-115,1305,1307,-2,0,1,0,0.2,62,6,5,0.66129,0,0,11,14,false,false,false,0.045,0.955
148,165,-17,18.5,23.571429,-17,653,820,-167,0,0,0,0,39,8,7,0.974359,0,0,8,20,false,false,false,0.107,0.893
12,33,-21,12,33,-21,952,826,126,0,0,0,0,94,1,1,0.457447,1,0,11,13,false,false,true,0.73,0.27
0,16,-16,0,16,-16,907,878,29,0,0,0,0,97,2,1,0.443299,0,0,20,7,false,false,false,0.247,0.753
79,128,-49,13.166667,21.333333,-49,840,1055,-215,0,0,0,0,61,6,6,0.57377,0,1,13,8,false,false,false,0.109,0.891
121,197,-76,20.166667,32.833333,-76,1583,1403,180,0,0,0,0,50,6,6,0.64,0,0,11,17,false,false,false,0.019,0.981
83,96,-13,13.833333,19.2,-13,1045,1082,-37,0,0,0,0,64,6,5,0.703125,1,0,20,8,false,false,false,0.362,0.638
280,353,-73,16.470588,22.0625,-73,1159,1131,28,0,2,0,0.125,-10,17,16,-3.7,0,0,2,5,false,false,false,0.001,0.999
132,202,-70,11,16.833333,-70,226,361,-135,0,0,0,0,17,12,12,2.588235,0,0,11,8,false,false,false,0.009,0.991
242,295,-53,13.444444,17.352941,-53,951,976,-25,0,0,0,0,-6,18,17,-7.333333,0,0,7,9,false,false,false,0.006,0.994
74,122,-48,10.571429,20.333333,-48,632,603,29,0,0,0,0,55,7,6,0.690909,1,0,6,23,false,false,false,0.106,0.894
208,128,80,29.714286,21.333333,80,1563,1539,24,0,0,0,0,48,7,6,0.729167,0,2,7,5,false,false,true,0.689,0.311
229,220,9,19.083333,18.333333,9,1281,1268,13,0,0,0,0,26,12,12,1.615385,0,0,10,11,false,false,false,0.453,0.547
221,283,-62,15.785714,21.769231,-62,1161,1176,-15,1,1,0.071429,0.076923,4,14,13,9.5,0,0,10,18,false,false,false,0.007,0.993
121,210,-89,17.285714,30,-89,1101,1115,-14,0,0,0,0,50,7,7,0.6,0,1,7,12,false,false,false,0.032,0.968
225,218,7,22.5,24.222222,7,1176,1133,43,1,0,0.1,0,41,10,9,0.829268,0,0,8,26,false,false,false,0.492,0.508
130,135,-5,26,27,-5,1331,1347,-16,1,0,0.2,0,56,5,5,0.571429,0,0,11,14,false,false,false,0.28,0.72
269,237,32,20.692308,18.230769,32,742,594,148,0,0,0,0,15,13,13,2.6,1,0,8,11,false,false,true,0.98,0.02
310,268,42,34.444444,29.777778,42,1777,1689,88,1,1,0.111111,0.111111,21,9,9,1.285714,0,1,10,13,false,false,false,0.286,0.714
310,297,13,25.833333,27,13,714,820,-106,1,0,0.083333,0,17,12,11,1.823529,0,0,12,12,false,false,false,0.443,0.557
223,208,15,27.875,26,15,824,830,-6,1,0,0.125,0,44,8,8,1,0,0,7,15,false,false,true,0.732,0.268
39,141,-102,13,47,-102,1220,1202,18,0,0,0,0,77,3,3,0.649351,0,0,16,9,false,false,false,0.066,0.934
90,149,-59,18,29.8,-59,1885,1842,43,0,1,0,0.2,60,5,5,0.45,1,0,9,13,false,false,false,0.17,0.83
71,55,16,17.75,18.333333,16,1045,1082,-37,0,0,0,0,76,4,3,0.592105,1,0,17,12,false,false,true,0.583,0.417
158,248,-90,13.166667,22.545455,-90,948,998,-50,0,0,0,0,19,12,11,1.947368,0,0,18,10,false,false,false,0.006,0.994
273,360,-87,14.368421,18.947368,-87,837,844,-7,0,0,0,0,-14,19,19,-2.928571,0,0,4,1,false,false,false,0.006,0.994
74,65,9,24.666667,21.666667,9,967,856,111,0,0,0,0,77,3,3,0.428571,0,0,9,16,false,false,false,0.356,0.644
82,81,1,20.5,20.25,1,599,448,151,0,0,0,0,70,4,4,0.514286,0,0,7,16,false,false,true,0.511,0.489
211,231,-20,21.1,23.1,-20,1270,1261,9,1,0,0.1,0,37,10,10,1,0,0,9,10,false,false,false,0.216,0.784
51,38,13,12.75,12.666667,13,163,346,-183,0,0,0,0,69,4,3,0.565217,0,1,16,9,false,false,false,0.012,0.988
225,254,-29,20.454545,25.4,-29,980,965,15,0,0,0,0,29,11,10,1.310345,1,0,6,7,false,false,false,0.114,0.886
135,146,-11,16.875,18.25,-11,1310,1477,-167,0,0,0,0,41,8,8,0.878049,1,0,10,10,false,false,false,0.255,0.745
239,208,31,23.9,23.111111,31,1102,1245,-143,0,0,0,0,24,10,9,1.208333,0,0,9,16,false,false,false,0.499,0.501
340,372,-32,20,21.882353,-32,1101,1237,-136,1,0,0.058824,0,-9,17,17,-3.777778,0,0,5,2,true,false,false,0.008,0.992
33,18,15,16.5,18,15,653,1004,-351,0,0,0,0,87,2,1,0.333333,0,0,7,12,false,false,false,0.215,0.785
226,242,-16,25.111111,30.25,-16,1495,1597,-102,0,1,0,0.125,35,9,8,0.914286,0,0,10,12,false,false,false,0.115,0.885
312,374,-62,18.352941,22,-62,1493,1413,80,0,1,0,0.058824,-19,17,17,-1.894737,0,0,2,1,false,false,false,0.001,0.999
195,190,5,17.727273,17.272727,5,704,523,181,0,0,0,0,20,11,11,1.75,0,0,11,14,false,false,true,0.732,0.268
215,398,-183,13.4375,24.875,-183,940,947,-7,0,2,0,0.125,-5,16,16,-7,1,0,11,8,false,false,false,0,1
159,90,69,39.75,30,69,1167,1245,-78,1,0,0.25,0,67,4,3,0.41791,0,0,8,19,false,false,true,0.724,0.276
106,35,71,26.5,11.666667,71,1305,1254,51,0,0,0,0,76,4,3,0.421053,0,2,9,6,false,false,true,0.957,0.043
308,382,-74,25.666667,34.727273,-74,1689,1777,-88,1,1,0.083333,0.090909,3,12,11,10,0,0,14,16,false,false,false,0.005,0.995
42,186,-144,14,62,-144,786,848,-62,0,1,0,0.333333,78,3,3,0.397436,2,0,21,7,false,false,false,0.036,0.964
68,22,46,68,22,46,595,733,-138,1,0,1,0,89,1,1,0.438202,0,0,23,10,false,false,false,0.442,0.558
299,194,105,27.181818,19.4,105,1156,1279,-123,2,0,0.181818,0,24,11,10,1.666667,0,1,9,9,false,false,true,0.856,0.144
143,334,-191,14.3,37.111111,-191,1093,1100,-7,0,2,0,0.222222,35,10,9,1,0,0,10,13,false,false,false,0,1
321,335,-14,17.833333,18.611111,-14,206,346,-140,1,0,0.055556,0,-22,18,18,-1.954545,0,0,17,3,false,false,false,0.116,0.884
170,270,-100,17,27,-100,935,995,-60,1,1,0.1,0.1,33,10,10,1.181818,0,0,10,17,false,false,false,0.005,0.995
187,209,-22,14.384615,17.416667,-22,848,976,-128,0,0,0,0,25,13,12,1.6,0,1,18,10,false,false,false,0.104,0.896
248,252,-4,19.076923,21,-4,1270,1261,9,1,0,0.076923,0,24,13,12,1.541667,0,0,15,16,false,false,false,0.424,0.576
346,395,-49,15.727273,17.954545,-49,824,830,-6,1,0,0.045455,0,-27,22,22,-1.62963,0,0,2,2,true,false,false,0.031,0.969
6,17,-11,6,17,-11,1606,1890,-284,0,0,0,0,91,1,1,0.307692,1,0,6,9,false,false,false,0.249,0.751
369,374,-5,19.421053,20.777778,-5,1156,1279,-123,2,0,0.105263,0,-17,19,18,-2.352941,0,0,2,1,false,false,false,0.088,0.912
317,479,-162,21.133333,31.933333,-162,786,848,-62,1,2,0.066667,0.133333,-12,15,15,-2.583333,0,0,2,2,false,false,false,0.003,0.997
169,245,-76,15.363636,22.272727,-76,642,952,-310,0,0,0,0,27,11,11,1.62963,0,0,10,14,false,false,false,0.006,0.994
200,232,-32,16.666667,19.333333,-32,500,532,-32,0,0,0,0,18,12,12,2.277778,0,1,15,9,false,false,false,0.065,0.935
176,224,-48,11.733333,16,-48,814,830,-16,0,0,0,0,5,15,14,8.2,0,1,19,23,false,false,false,0.012,0.988
196,144,52,21.777778,16,52,675,570,105,0,0,0,0,37,9,9,0.945946,0,0,10,21,false,false,true,0.788,0.212
157,107,50,17.444444,13.375,50,671,638,33,0,0,0,0,38,9,8,1.289474,0,0,14,25,false,false,true,0.742,0.258
121,85,36,30.25,28.333333,36,820,718,102,0,1,0,0.333333,71,4,3,0.394366,0,1,11,7,false,false,true,0.9,0.1
236,360,-124,14.75,24,-124,450,427,23,1,1,0.0625,0.066667,-12,16,15,-3.083333,0,0,8,12,false,false,false,0.006,0.994
314,317,-3,19.625,19.8125,-3,939,969,-30,0,0,0,0,-18,16,16,-1.833333,0,0,2,1,false,false,true,0.69,0.31
155,119,36,14.090909,11.9,36,1193,1220,-27,0,0,0,0,31,11,10,1.387097,1,1,6,21,false,false,false,0.249,0.751
134,226,-92,19.142857,32.285714,-92,1127,995,132,0,1,0,0.142857,45,7,7,0.733333,0,0,17,17,false,false,false,0.004,0.996
288,303,-15,20.571429,21.642857,-15,971,800,171,0,1,0,0.071429,-16,14,14,-1.8125,0,0,4,6,false,false,false,0.142,0.858
146,147,-1,18.25,21,-1,1055,840,215,0,0,0,0,48,8,7,0.75,1,0,6,12,false,false,false,0.497,0.503
111,235,-124,18.5,39.166667,-124,1093,1100,-7,0,1,0,0.166667,53,6,6,0.660377,0,0,7,12,false,false,false,0.005,0.995
57,67,-10,14.25,22.333333,-10,480,739,-259,0,0,0,0,76,4,3,0.513158,0,0,7,7,false,false,false,0.117,0.883
159,322,-163,13.25,26.833333,-163,710,758,-48,0,1,0,0.083333,27,12,12,1.37037,0,0,10,11,false,false,false,0.005,0.995
74,79,-5,18.5,26.333333,-5,1699,1803,-104,0,0,0,0,78,4,3,0.448718,0,1,7,9,false,false,false,0.245,0.755
170,157,13,18.888889,17.444444,13,387,683,-296,0,0,0,0,30,9,9,1.133333,1,0,14,13,false,false,true,0.521,0.479
295,387,-92,17.352941,22.764706,-92,1047,1253,-206,1,1,0.058824,0.058824,-13,17,17,-2.846154,1,0,6,3,false,false,false,0.005,0.995
92,123,-31,18.4,30.75,-31,1636,1796,-160,0,0,0,0,68,5,4,0.397059,0,0,15,7,false,false,false,0.109,0.891
73,77,-4,18.25,19.25,-4,451,448,3,0,0,0,0,75,4,4,0.493333,0,1,13,9,false,false,false,0.38,0.62
189,248,-59,17.181818,22.545455,-59,1055,840,215,0,1,0,0.090909,23,11,11,1.565217,1,0,10,16,false,false,false,0.009,0.991
270,427,-157,18,28.466667,-157,1315,1334,-19,0,2,0,0.133333,-11,15,15,-3.272727,0,0,4,4,false,false,false,0,1
119,183,-64,13.222222,22.875,-64,683,859,-176,0,0,0,0,51,9,8,0.882353,1,0,15,12,false,false,false,0.099,0.901
237,310,-73,18.230769,25.833333,-73,1349,1203,146,0,1,0,0.083333,18,13,12,1.777778,0,1,13,9,false,false,false,0.003,0.997
177,235,-58,22.125,29.375,-58,1454,1479,-25,1,0,0.125,0,39,8,8,0.794872,0,0,11,18,false,false,false,0.078,0.922
198,198,0,16.5,18,0,1203,1270,-67,0,0,0,0,34,12,11,1.294118,1,0,8,22,false,false,false,0.115,0.885
285,396,-111,25.909091,36,-111,1164,1161,3,1,2,0.090909,0.181818,-6,11,11,-3.833333,0,1,19,12,false,false,false,0,1
10,27,-17,10,27,-17,1699,1803,-104,0,0,0,0,94,1,1,0.37234,0,1,13,9,false,false,false,0.245,0.755
191,297,-106,15.916667,24.75,-106,1003,1018,-15,0,0,0,0,12,12,12,3.083333,0,0,9,8,false,false,false,0.005,0.995
114,174,-60,19,29,-60,1572,1777,-205,0,1,0,0.166667,48,6,6,0.6875,0,1,8,13,false,false,false,0.106,0.894
276,301,-25,19.714286,21.5,-25,971,635,336,0,0,0,0,-7,14,14,-4.571429,1,0,9,8,false,false,false,0.027,0.973
168,230,-62,14,19.166667,-62,683,859,-176,0,0,0,0,29,12,12,1.551724,1,0,10,15,false,false,false,0.055,0.945
302,332,-30,16.777778,18.444444,-30,1302,1351,-49,0,0,0,0,-20,18,18,-1.85,0,0,1,1,false,false,false,0.076,0.924
137,131,6,19.571429,21.833333,6,1331,1374,-43,0,0,0,0,49,7,6,0.673469,0,0,21,7,false,false,false,0.37,0.63
276,342,-66,11.5,14.25,-66,651,700,-49,0,0,0,0,-37,24,24,-1.513514,0,0,15,11,false,false,false,0.036,0.964
115,223,-108,19.166667,37.166667,-108,1021,897,124,0,2,0,0.333333,51,6,6,0.72549,1,0,7,16,false,false,false,0.007,0.993
58,94,-36,9.666667,15.666667,-36,999,1165,-166,0,0,0,0,63,6,6,0.730159,0,0,18,10,false,false,false,0.112,0.888
37,28,9,12.333333,14,9,889,895,-6,0,0,0,0,82,3,2,0.45122,0,1,15,6,false,false,false,0.332,0.668
42,41,1,14,13.666667,1,391,542,-151,0,0,0,0,80,3,3,0.575,0,1,7,16,false,false,false,0.003,0.997
249,287,-38,19.153846,22.076923,-38,1210,1162,48,0,0,0,0,13,13,13,2.461538,1,0,14,9,false,false,false,0.118,0.882
307,336,-29,16.157895,18.666667,-29,995,965,30,0,1,0,0.055556,-17,19,18,-2.352941,0,0,1,2,false,false,false,0.008,0.992
34,33,1,17,16.5,1,999,1165,-166,0,0,0,0,85,2,2,0.541176,0,0,16,11,false,false,false,0.418,0.582
272,371,-99,14.315789,19.526316,-99,595,412,183,0,1,0,0.052632,-10,19,19,-5.2,0,0,10,11,false,false,false,0.002,0.998
20,30,-10,20,30,-10,954,939,15,0,0,0,0,91,1,1,0.395604,0,0,10,19,false,false,false,0.265,0.735
191,232,-41,17.363636,23.2,-41,1488,1403,85,0,1,0,0.1,22,11,10,1.545455,0,0,11,9,false,false,false,0.011,0.989
325,377,-52,19.117647,23.5625,-52,1021,897,124,0,2,0,0.125,-18,17,16,-2.055556,0,0,10,2,false,false,false,0.004,0.996
240,235,5,24,26.111111,5,1452,1388,64,0,1,0,0.111111,32,10,9,1.09375,0,0,9,13,false,false,false,0.365,0.635
194,309,-115,8.818182,14.714286,-115,818,826,-8,0,0,0,0,-17,22,21,-3.117647,0,0,7,12,false,false,false,0.005,0.995
57,0,57,28.5,0,57,306,468,-162,0,0,0,0,91,2,1,0.406593,0,0,11,20,false,false,true,0.88,0.12
56,14,42,28,14,42,356,498,-142,0,0,0,0,90,2,1,0.388889,0,0,7,12,false,false,true,0.869,0.131
216,268,-52,13.5,17.866667,-52,1248,1220,28,0,1,0,0.066667,15,16,15,3.466667,1,0,6,16,false,false,false,0.015,0.985
294,300,-6,18.375,18.75,-6,742,594,148,0,0,0,0,-4,16,16,-9.75,1,0,7,7,false,false,true,0.857,0.143
195,227,-32,16.25,18.916667,-32,1310,1477,-167,0,0,0,0,11,12,12,3.272727,1,0,9,10,false,false,false,0.231,0.769
167,284,-117,13.916667,25.818182,-117,342,263,79,0,0,0,0,13,12,11,2.615385,0,0,20,11,false,false,false,0.005,0.995
14,7,7,4.666667,2.333333,7,1064,1397,-333,0,0,0,0,96,3,3,0.447917,0,0,22,7,false,false,false,0.246,0.754
174,333,-159,7.25,14.478261,-159,651,567,84,0,0,0,0,-17,24,23,-3.235294,0,0,7,13,false,false,false,0.003,0.997
14,23,-9,4.666667,11.5,-9,1344,1208,136,0,0,0,0,88,3,2,0.340909,0,0,7,21,false,false,false,0.255,0.745
10,0,10,10,0,10,226,361,-135,0,0,0,0,96,1,0,0.458333,0,0,14,0,false,false,true,0.51,0.49
290,291,-1,19.333333,19.4,-1,742,594,148,0,0,0,0,0,15,15,0,1,0,6,10,false,false,true,0.834,0.166
24,28,-4,12,14,-4,1043,1003,40,0,0,0,0,82,2,2,0.463415,1,0,25,12,false,false,true,0.608,0.392
74,24,50,74,24,50,1156,1279,-123,1,0,1,0,89,1,1,0.449438,0,0,12,13,false,false,true,0.513,0.487
276,465,-189,16.235294,29.0625,-189,1093,1100,-7,0,2,0,0.125,-8,17,16,-4.375,0,0,20,8,false,false,false,0.004,0.996
72,135,-63,14.4,27,-63,775,786,-11,0,0,0,0,64,5,5,0.671875,0,0,8,7,false,false,false,0.106,0.894
143,221,-78,20.428571,31.571429,-78,835,786,49,0,0,0,0,38,7,7,0.894737,0,0,24,16,false,false,false,0.067,0.933
38,70,-32,12.666667,35,-32,1397,1309,88,0,0,0,0,86,3,2,0.418605,1,1,6,25,false,false,false,0.045,0.955
106,159,-53,17.666667,26.5,-53,736,791,-55,0,0,0,0,57,6,6,0.666667,1,0,10,10,false,false,false,0.115,0.885
126,195,-69,14,24.375,-69,1195,1397,-202,0,1,0,0.125,45,9,8,0.888889,0,0,13,14,false,false,false,0.101,0.899
311,379,-68,19.4375,23.6875,-68,1495,1531,-36,0,1,0,0.0625,-3,16,16,-12.333333,0,0,5,4,false,false,false,0.002,0.998
172,234,-62,17.2,26,-62,926,973,-47,0,0,0,0,29,10,9,1.206897,0,1,7,10,false,false,false,0.036,0.964
177,163,14,19.666667,20.375,14,939,969,-30,0,0,0,0,34,9,8,0.970588,1,1,9,15,false,false,false,0.346,0.654
167,224,-57,16.7,22.4,-57,1071,1181,-110,0,0,0,0,40,10,10,0.85,0,1,10,9,false,false,false,0.09,0.91
65,94,-29,10.833333,18.8,-29,651,567,84,0,0,0,0,62,6,5,0.887097,0,0,7,25,false,false,false,0.107,0.893
12,0,12,12,0,12,615,542,73,0,0,0,0,96,1,0,0.4375,0,0,11,0,false,false,true,0.523,0.477
94,154,-60,15.666667,25.666667,-60,837,844,-7,0,0,0,0,67,6,6,0.61194,0,1,10,12,false,false,false,0.102,0.898
206,239,-33,14.714286,18.384615,-33,797,796,1,0,0,0,0,24,14,13,2.041667,1,0,12,12,false,false,false,0.099,0.901
304,361,-57,20.266667,25.785714,-57,1349,1203,146,0,1,0,0.071429,6,15,14,5.333333,0,0,3,14,false,false,false,0.002,0.998
53,83,-30,10.6,20.75,-30,651,996,-345,0,0,0,0,69,5,4,0.652174,0,0,10,17,false,false,false,0.106,0.894
26,56,-30,13,28,-30,2143,2219,-76,0,0,0,0,85,2,2,0.364706,0,1,8,9,false,false,false,0.25,0.75
130,118,12,21.666667,19.666667,12,1038,917,121,1,0,0.166667,0,59,6,6,0.59322,0,2,8,7,false,false,false,0.269,0.731
173,281,-108,19.222222,31.222222,-108,842,926,-84,0,0,0,0,24,9,9,1.25,0,0,12,8,false,false,false,0.005,0.995
285,315,-30,14.25,16.578947,-30,450,503,-53,0,0,0,0,-22,20,19,-1.772727,0,0,3,3,true,false,false,0.006,0.994
413,470,-57,31.769231,36.153846,-57,1777,1689,88,1,1,0.076923,0.076923,-11,13,13,-2.454545,0,0,3,1,false,false,false,0.004,0.996
215,290,-75,16.538462,24.166667,-75,944,1095,-151,0,1,0,0.083333,26,13,12,1.5,0,2,16,5,false,false,false,0.002,0.998
248,274,-26,17.714286,19.571429,-26,1310,1477,-167,0,0,0,0,-5,14,14,-7.2,0,0,17,10,false,false,false,0.107,0.893
155,202,-47,17.222222,22.444444,-47,805,918,-113,0,0,0,0,31,9,9,1.16129,0,0,12,16,false,false,false,0.105,0.895
20,0,20,20,0,20,1397,1405,-8,0,0,0,0,94,1,0,0.308511,0,0,7,0,false,false,false,0.425,0.575
112,123,-11,12.444444,13.666667,-11,999,1071,-72,0,0,0,0,41,9,9,0.97561,1,0,9,15,false,false,false,0.258,0.742
191,329,-138,17.363636,32.9,-138,1045,1100,-55,0,1,0,0.1,29,11,10,1.172414,0,0,12,10,false,false,false,0.005,0.995
128,162,-34,14.222222,18,-34,848,976,-128,0,0,0,0,45,9,9,0.888889,0,0,28,12,false,false,false,0.117,0.883
12,16,-4,12,16,-4,683,859,-176,0,0,0,0,92,1,1,0.48913,0,1,9,25,false,false,false,0.063,0.937
14,0,14,14,0,14,760,976,-216,0,0,0,0,95,1,0,0.378947,0,0,14,0,false,false,false,0.369,0.631
117,119,-2,19.5,19.833333,-2,450,503,-53,0,0,0,0,57,6,6,0.684211,0,0,20,13,false,false,true,0.706,0.294
14,0,14,14,0,14,1305,1254,51,0,0,0,0,96,1,1,0.333333,0,0,19,0,false,false,true,0.523,0.477
87,182,-95,10.875,22.75,-95,632,603,29,0,0,0,0,44,8,8,0.863636,1,0,6,24,false,false,false,0.028,0.972
317,389,-72,18.647059,24.3125,-72,1127,995,132,0,1,0,0.0625,-14,17,16,-2.357143,0,0,7,3,true,false,false,0,1
291,317,-26,12.652174,14.409091,-26,796,800,-4,1,0,0.043478,0,-16,23,22,-3,0,0,12,3,false,false,false,0.096,0.904
101,114,-13,14.428571,19,-13,668,771,-103,0,0,0,0,55,7,6,0.727273,0,0,14,20,false,false,false,0.109,0.891
246,258,-12,15.375,16.125,-12,797,796,1,0,0,0,0,13,16,16,3.769231,1,0,8,16,false,false,false,0.378,0.622
136,112,24,22.666667,18.666667,24,995,965,30,0,0,0,0,53,6,6,0.754717,0,1,16,17,false,false,false,0.451,0.549
42,55,-13,10.5,13.75,-13,771,668,103,0,0,0,0,72,4,4,0.527778,1,0,11,14,false,false,true,0.518,0.482
25,58,-33,8.333333,29,-33,935,995,-60,0,0,0,0,84,3,2,0.464286,2,0,20,18,false,false,true,0.725,0.275
236,270,-34,14.75,18,-34,500,532,-32,0,0,0,0,-4,16,15,-10.25,0,2,28,5,false,false,false,0,1
218,250,-32,27.25,31.25,-32,1331,1432,-101,0,0,0,0,32,8,8,0.84375,0,0,11,9,false,false,false,0.121,0.879
223,208,15,17.153846,17.333333,15,704,523,181,0,0,0,0,5,13,12,7,0,0,16,12,false,false,true,0.734,0.266
230,247,-17,17.692308,20.583333,-17,451,448,3,0,0,0,0,15,13,12,2.466667,0,0,11,8,false,false,false,0.341,0.659
108,98,10,21.6,19.6,10,1606,1593,13,0,0,0,0,66,5,5,0.439394,0,0,17,17,false,false,false,0.325,0.675
279,179,100,27.9,19.888889,100,1156,1279,-123,2,0,0.2,0,29,10,9,1.37931,0,1,11,11,false,false,true,0.507,0.493
129,148,-19,21.5,24.666667,-19,965,1078,-113,0,0,0,0,55,6,6,0.672727,0,0,9,14,false,false,false,0.117,0.883
117,167,-50,13,18.555556,-50,668,363,305,0,0,0,0,46,9,9,1.021739,0,0,8,11,false,false,false,0.098,0.902
131,135,-4,16.375,19.285714,-4,595,538,57,0,0,0,0,45,8,7,0.844444,0,0,13,19,false,false,false,0.337,0.663
180,212,-32,18,23.555556,-32,907,910,-3,0,1,0,0.111111,45,10,9,0.955556,0,1,10,18,false,false,false,0.076,0.924
268,386,-118,12.181818,18.380952,-118,907,878,29,0,0,0,0,-17,22,21,-2.529412,0,0,4,5,true,false,false,0.005,0.995
226,229,-3,18.833333,20.818182,-3,576,602,-26,0,0,0,0,26,12,11,1.615385,1,0,6,14,false,false,false,0.123,0.877
100,147,-47,16.666667,29.4,-47,1488,1403,85,0,1,0,0.2,59,6,5,0.576271,0,0,18,10,false,false,false,0.069,0.931
60,28,32,30,14,32,1274,1394,-120,0,0,0,0,87,2,2,0.344828,0,0,10,10,false,false,true,0.536,0.464
204,243,-39,14.571429,18.692308,-39,1064,1397,-333,0,2,0,0.153846,26,14,13,1.653846,1,0,24,7,false,false,false,0.283,0.717
320,325,-5,22.857143,25,-5,1070,814,256,1,1,0.071429,0.076923,0,14,13,0,0,0,8,9,false,false,false,0.014,0.986
81,88,-7,16.2,22,-7,971,635,336,0,0,0,0,66,5,4,0.484848,0,0,13,13,false,false,false,0.158,0.842
330,399,-69,18.333333,22.166667,-69,1495,1531,-36,0,1,0,0.055556,-13,18,18,-2.846154,0,0,1,2,false,false,false,0.001,0.999
313,357,-44,14.227273,17,-44,1037,1009,28,0,0,0,0,-18,22,21,-2.444444,0,0,1,1,false,false,false,0.02,0.98
148,120,28,24.666667,24,28,1093,1173,-80,0,0,0,0,64,6,5,0.671875,0,0,16,14,false,false,false,0.486,0.514
103,114,-11,14.714286,16.285714,-11,830,787,43,0,0,0,0,53,7,7,0.716981,0,0,18,13,false,false,false,0.298,0.702
0,14,-14,0,14,-14,1422,1510,-88,0,0,0,0,97,1,1,0.402062,0,0,12,12,false,false,false,0.242,0.758
354,354,0,25.285714,27.230769,0,1885,1842,43,0,2,0,0.153846,-9,14,13,-3,0,1,7,5,true,false,false,0.068,0.932
136,184,-48,17,23,-48,1123,1062,61,0,0,0,0,45,8,8,0.977778,0,0,12,20,false,false,false,0.106,0.894
10,20,-10,10,20,-10,1331,1374,-43,0,0,0,0,93,1,1,0.354839,0,1,9,8,false,false,false,0.248,0.752
164,212,-48,13.666667,17.666667,-48,306,361,-55,0,0,0,0,13,12,12,2.769231,0,1,16,15,false,false,false,0.015,0.985
16,0,16,8,0,16,95,453,-358,0,0,0,0,97,2,1,0.402062,0,0,10,15,false,false,false,0.189,0.811
135,197,-62,27,49.25,-62,1431,1399,32,0,1,0,0.25,57,5,4,0.438596,0,0,10,10,false,false,false,0.008,0.992
166,203,-37,23.714286,29,-37,1173,1256,-83,1,0,0.142857,0,51,7,7,0.607843,0,1,10,6,false,false,false,0.023,0.977
55,63,-8,27.5,63,-8,1388,1455,-67,0,0,0,0,85,2,1,0.329412,0,0,16,8,false,false,false,0.247,0.753
69,98,-29,13.8,19.6,-29,344,315,29,1,0,0.2,0,56,5,5,0.714286,0,0,9,22,false,false,false,0.278,0.722
30,27,3,15,27,3,995,965,30,0,0,0,0,88,2,1,0.454545,0,0,16,11,false,false,false,0.336,0.664
299,280,19,23,23.333333,19,804,1074,-270,0,0,0,0,8,13,12,4,0,1,10,13,false,false,false,0.204,0.796
233,315,-82,16.642857,22.5,-82,727,820,-93,0,1,0,0.071429,0,14,14,0,0,1,12,9,false,false,false,0.005,0.995
277,294,-17,21.307692,24.5,-17,561,633,-72,0,1,0,0.083333,13,13,12,2.692308,0,0,9,14,false,false,false,0.058,0.942
214,178,36,26.75,25.428571,36,1331,1347,-16,1,0,0.125,0,36,8,7,0.888889,0,0,7,14,false,false,true,0.557,0.443
126,69,57,31.5,23,57,1397,1405,-8,1,0,0.25,0,67,4,3,0.432836,0,0,14,19,false,false,false,0.401,0.599
61,41,20,30.5,20.5,20,1071,1181,-110,0,0,0,0,84,2,2,0.404762,0,0,8,13,false,false,true,0.525,0.475
238,239,-1,26.444444,26.555556,-1,804,1074,-270,0,0,0,0,28,9,9,1.142857,0,0,9,12,false,false,false,0.362,0.638
167,242,-75,12.846154,18.615385,-75,595,662,-67,0,1,0,0.076923,19,13,13,2.315789,0,0,17,13,false,false,false,0.016,0.984
286,367,-81,20.428571,28.230769,-81,1232,1448,-216,0,2,0,0.153846,4,14,13,8.75,0,0,7,9,false,false,false,0.006,0.994
233,263,-30,25.888889,32.875,-30,1253,1324,-71,0,1,0,0.125,33,9,8,0.878788,0,0,24,12,false,false,false,0.419,0.581
16,57,-41,8,28.5,-41,430,542,-112,0,0,0,0,86,2,2,0.55814,0,2,7,8,false,false,false,0,1
19,21,-2,9.5,21,-2,803,786,17,0,0,0,0,91,2,1,0.351648,0,1,17,11,false,false,false,0.287,0.713
22,0,22,22,0,22,1556,1616,-60,0,0,0,0,98,1,0,0.295918,0,0,13,0,false,false,false,0.386,0.614
275,387,-112,19.642857,27.642857,-112,1583,1403,180,0,0,0,0,-4,14,14,-8,0,0,4,2,false,false,false,0.049,0.951
266,417,-151,20.461538,34.75,-151,1003,1004,-1,0,2,0,0.166667,10,13,12,3.5,0,0,7,10,false,false,false,0,1
54,53,1,13.5,17.666667,1,1439,1428,11,0,0,0,0,79,4,3,0.506329,1,0,9,14,false,false,false,0.381,0.619
288,414,-126,20.571429,31.846154,-126,1636,1727,-91,0,2,0,0.153846,-6,14,13,-5,0,0,2,10,false,false,false,0,1
67,76,-9,16.75,19,-9,595,538,57,0,0,0,0,73,4,4,0.520548,0,0,9,8,false,false,false,0.372,0.628
43,86,-43,14.333333,28.666667,-43,473,683,-210,0,0,0,0,79,3,3,0.481013,0,0,12,26,false,false,false,0.106,0.894
172,290,-118,14.333333,24.166667,-118,503,668,-165,0,1,0,0.083333,20,12,12,1.85,1,0,10,14,false,false,false,0.005,0.995
114,139,-25,14.25,19.857143,-25,542,605,-63,0,0,0,0,47,8,7,0.765957,0,0,8,19,false,false,false,0.107,0.893
214,266,-52,19.454545,26.6,-52,1572,1777,-205,0,1,0,0.1,18,11,10,1.833333,0,1,9,6,false,false,false,0.102,0.898
223,318,-95,18.583333,28.909091,-95,724,398,326,1,1,0.083333,0.090909,31,12,11,1.258065,1,1,6,6,false,false,false,0,1
10,24,-14,10,24,-14,1368,1452,-84,0,0,0,0,94,1,1,0.340426,1,0,8,14,false,false,false,0.437,0.563
325,333,-8,20.3125,22.2,-8,786,885,-99,1,1,0.0625,0.066667,-1,16,15,-34,0,0,2,7,false,false,false,0.217,0.783
133,166,-33,14.777778,18.444444,-33,613,525,88,0,0,0,0,42,9,9,1,0,1,8,10,false,false,false,0.108,0.892
46,85,-39,15.333333,28.333333,-39,1253,1324,-71,0,0,0,0,78,3,3,0.371795,0,0,7,13,false,false,false,0.106,0.894
181,186,-5,13.923077,15.5,-5,995,965,30,0,0,0,0,23,13,12,1.73913,0,0,21,8,false,false,false,0.25,0.75
357,438,-81,22.3125,29.2,-81,1699,1803,-104,1,1,0.0625,0.066667,2,16,15,17.5,0,0,8,10,false,false,false,0.007,0.993
145,161,-16,12.083333,13.416667,-16,342,53,289,0,0,0,0,22,12,12,1.863636,0,1,10,10,false,false,false,0.275,0.725
87,127,-40,10.875,15.875,-40,977,1100,-123,0,0,0,0,61,8,8,0.672131,1,0,13,12,false,false,false,0.241,0.759
169,303,-134,13,23.307692,-134,563,523,40,0,0,0,0,12,13,13,3.083333,0,1,18,15,false,false,false,0.005,0.995
117,144,-27,16.714286,24,-27,915,971,-56,0,0,0,0,53,7,6,0.622642,0,0,7,28,false,false,false,0.106,0.894
156,100,56,22.285714,16.666667,56,1652,1473,179,1,0,0.142857,0,48,7,6,0.625,0,0,18,10,false,false,true,0.816,0.184
137,151,-14,22.833333,25.166667,-14,1102,1245,-143,0,0,0,0,48,6,6,0.604167,0,0,11,8,false,false,false,0.172,0.828
36,23,13,18,23,13,1556,1616,-60,0,0,0,0,92,2,1,0.315217,0,0,16,10,false,false,false,0.316,0.684
87,104,-17,17.4,26,-17,1248,1220,28,0,1,0,0.25,70,5,4,0.742857,0,0,17,16,false,false,false,0.198,0.802
17,45,-28,8.5,22.5,-28,563,523,40,0,0,0,0,86,2,2,0.430233,0,0,17,19,false,false,false,0.255,0.745
87,99,-12,10.875,14.142857,-12,977,1100,-123,0,0,0,0,63,8,7,0.650794,1,0,13,15,false,false,false,0.244,0.756
273,273,0,24.818182,24.818182,0,1305,1211,94,2,0,0.181818,0,23,11,11,1.434783,0,0,12,10,false,false,true,0.652,0.348
161,185,-24,17.888889,23.125,-24,668,771,-103,0,0,0,0,44,9,8,0.909091,1,0,15,11,false,false,false,0.116,0.884
119,161,-42,17,23,-42,1210,1162,48,0,0,0,0,50,7,7,0.64,0,0,9,19,false,false,false,0.107,0.893
89,146,-57,14.833333,24.333333,-57,1161,1176,-15,0,1,0,0.166667,57,6,6,0.666667,0,0,10,10,false,false,false,0.107,0.893
117,136,-19,14.625,19.428571,-19,278,1,277,0,0,0,0,40,8,7,0.925,0,0,18,12,false,false,true,0.627,0.373
200,175,25,33.333333,29.166667,25,1167,1245,-78,1,0,0.166667,0,47,6,6,0.595745,0,0,10,15,false,false,true,0.699,0.301
28,0,28,28,0,28,976,995,-19,0,0,0,0,97,1,0,0.391753,0,0,10,0,false,false,true,0.531,0.469
10,0,10,10,0,10,566,742,-176,0,0,0,0,97,1,0,0.329897,0,0,7,0,false,false,false,0.287,0.713
298,308,-10,21.285714,22,-10,1473,1500,-27,0,2,0,0.142857,5,14,14,7.8,1,0,10,8,false,false,false,0.444,0.556
286,307,-21,20.428571,23.615385,-21,892,856,36,1,1,0.071429,0.076923,1,14,13,35,0,0,17,17,false,false,false,0.101,0.899
21,8,13,10.5,8,13,1561,1495,66,0,0,0,0,90,2,1,0.366667,1,0,8,18,false,false,true,0.652,0.348
252,498,-246,19.384615,41.5,-246,1539,1891,-352,0,2,0,0.166667,-9,13,12,-2.777778,1,1,8,8,true,false,false,0,1
181,100,81,36.2,20,81,1373,1334,39,1,0,0.2,0,64,5,5,0.5,0,0,7,8,false,false,true,0.916,0.084
325,388,-63,17.105263,21.555556,-63,1021,897,124,0,2,0,0.111111,-24,19,18,-1.541667,0,0,10,1,true,false,false,0.002,0.998
120,488,-368,7.5,30.5,-368,1164,1149,15,0,3,0,0.1875,21,16,16,2.238095,0,1,12,9,false,false,false,0.066,0.934
300,267,33,14.285714,12.714286,33,671,638,33,0,0,0,0,-28,21,21,-1.75,0,0,3,13,false,false,true,0.998,0.002
199,251,-52,16.583333,22.818182,-52,1071,1181,-110,0,0,0,0,28,12,11,1.214286,0,0,12,7,false,false,false,0.069,0.931
301,315,-14,16.722222,18.529412,-14,343,570,-227,0,0,0,0,-22,18,17,-1.636364,0,0,1,1,false,false,false,0.075,0.925
66,40,26,22,20,26,451,448,3,0,0,0,0,84,3,2,0.440476,0,1,15,9,false,false,false,0.485,0.515
240,274,-34,24,30.444444,-34,1495,1597,-102,0,1,0,0.111111,29,10,9,1.103448,0,0,10,10,false,false,false,0.106,0.894
136,323,-187,8,19,-187,651,567,84,0,0,0,0,4,17,17,13.75,0,0,11,11,false,false,false,0.005,0.995
53,91,-38,13.25,22.75,-38,683,859,-176,0,0,0,0,74,4,4,0.608108,1,0,12,12,false,false,false,0.201,0.799
216,345,-129,14.4,23,-129,1064,1397,-333,0,2,0,0.133333,12,15,15,3.583333,1,1,17,9,false,false,false,0.005,0.995
225,249,-24,15,17.785714,-24,797,796,1,0,0,0,0,18,15,14,2.722222,1,0,8,15,false,false,false,0.099,0.901
57,31,26,19,15.5,26,1003,1004,-1,0,0,0,0,84,3,2,0.416667,0,0,24,19,false,false,false,0.366,0.634
32,41,-9,10.666667,20.5,-9,1101,1115,-14,0,0,0,0,86,3,2,0.348837,0,0,7,16,false,false,false,0.109,0.891
224,236,-12,20.363636,21.454545,-12,939,969,-30,0,0,0,0,16,11,11,2.0625,0,0,17,7,false,false,true,0.52,0.48
318,289,29,19.875,18.0625,29,1488,1428,60,1,0,0.0625,0,-2,16,16,-18.5,0,1,27,6,false,false,true,0.858,0.142
120,122,-2,12,13.555556,-2,1278,1101,177,0,0,0,0,43,10,9,0.860465,1,1,18,6,false,false,false,0.098,0.902
87,70,17,21.75,23.333333,17,642,952,-310,0,0,0,0,74,4,3,0.594595,0,1,7,19,false,false,false,0.001,0.999
26,18,8,26,18,8,1110,1123,-13,0,0,0,0,88,1,1,0.375,0,0,17,7,false,false,true,0.525,0.475
191,170,21,27.285714,24.285714,21,1495,1597,-102,0,0,0,0,48,7,7,0.666667,0,1,10,7,false,false,false,0.323,0.677
140,127,13,15.555556,15.875,13,720,437,283,0,0,0,0,54,9,8,0.777778,0,0,16,7,false,false,true,0.846,0.154
308,359,-51,19.25,22.4375,-51,1305,1254,51,1,1,0.0625,0.0625,-16,16,16,-2,0,0,1,6,true,false,false,0.003,0.997
325,384,-59,19.117647,22.588235,-59,1021,897,124,0,2,0,0.117647,-22,17,17,-1.681818,0,0,10,1,false,false,false,0.006,0.994
275,217,58,17.1875,13.5625,58,1065,948,117,0,0,0,0,11,16,16,3.545455,0,1,8,10,false,false,true,0.973,0.027
329,385,-56,27.416667,32.083333,-56,1431,1399,32,0,2,0,0.166667,-9,12,12,-2.777778,0,0,10,3,false,false,false,0.008,0.992
197,236,-39,21.888889,29.5,-39,724,398,326,1,1,0.111111,0.125,42,9,8,0.928571,1,0,6,14,false,false,false,0.004,0.996
72,128,-56,24,64,-56,1164,1261,-97,0,1,0,0.5,79,3,2,0.531646,0,0,23,12,false,false,false,0.232,0.768
12,0,12,12,0,12,1078,1095,-17,0,0,0,0,96,1,0,0.385417,0,0,7,0,false,false,false,0.359,0.641
240,191,49,20,17.363636,49,952,870,82,0,0,0,0,20,12,11,1.85,0,0,7,32,false,false,true,0.985,0.015
82,77,5,27.333333,25.666667,5,1556,1513,43,0,0,0,0,73,3,3,0.424658,1,0,7,7,false,false,true,0.858,0.142
216,309,-93,16.615385,25.75,-93,915,971,-56,0,0,0,0,10,13,12,3.3,0,0,11,16,false,false,false,0.005,0.995
130,295,-165,8.666667,19.666667,-165,651,567,84,0,0,0,0,14,15,15,3.928571,0,1,7,9,false,false,false,0.001,0.999
297,358,-61,24.75,32.545455,-61,1086,926,160,0,2,0,0.181818,2,12,11,14,0,0,11,7,false,false,false,0.008,0.992
237,253,-16,18.230769,19.461538,-16,206,346,-140,1,0,0.076923,0,10,13,13,4.3,0,0,17,13,false,false,false,0.107,0.893
304,317,-13,17.882353,18.647059,-13,985,1062,-77,0,0,0,0,-14,17,17,-2.642857,1,0,4,3,false,false,false,0.415,0.585
49,54,-5,16.333333,27,-5,1432,1452,-20,0,0,0,0,80,3,2,0.45,0,0,16,11,false,false,false,0.189,0.811
332,333,-1,19.529412,20.8125,-1,1257,1176,81,2,0,0.117647,0,-6,17,16,-5.666667,0,0,3,5,false,false,false,0.061,0.939
156,181,-25,19.5,25.857143,-25,892,856,36,0,1,0,0.142857,45,8,7,0.777778,1,0,11,10,false,false,false,0.266,0.734
303,369,-66,23.307692,30.75,-66,1556,1616,-60,0,0,0,0,-1,13,12,-29,0,0,4,6,false,false,false,0.009,0.991
62,128,-66,20.666667,42.666667,-66,732,868,-136,0,1,0,0.333333,75,3,3,0.426667,0,0,7,24,false,false,false,0.108,0.892
248,302,-54,17.714286,21.571429,-54,758,791,-33,0,0,0,0,0,14,14,0,0,0,10,13,false,false,false,0.008,0.992
74,87,-13,18.5,21.75,-13,1127,995,132,0,1,0,0.25,71,4,4,0.464789,0,0,21,18,false,false,true,0.577,0.423
70,51,19,17.5,17,19,1047,1127,-80,0,0,0,0,74,4,3,0.364865,1,1,9,9,false,false,false,0.317,0.683
211,221,-10,17.583333,20.090909,-10,1021,1094,-73,1,0,0.083333,0,26,12,11,1.423077,1,0,6,11,false,false,false,0.175,0.825
225,273,-48,16.071429,19.5,-48,1176,1211,-35,0,0,0,0,-2,14,14,-16.5,0,0,14,12,false,false,false,0.095,0.905
86,217,-131,9.555556,27.125,-131,1101,1130,-29,0,1,0,0.125,49,9,8,0.918367,0,1,9,7,false,false,false,0.001,0.999
62,67,-5,20.666667,33.5,-5,835,786,49,0,0,0,0,81,3,2,0.419753,1,0,15,11,false,false,true,0.737,0.263
275,333,-58,17.1875,22.2,-58,452,698,-246,0,1,0,0.066667,-5,16,15,-8.2,0,0,11,8,false,false,false,0.032,0.968
34,63,-29,34,63,-29,1093,1100,-7,0,0,0,0,87,1,1,0.402299,0,0,10,12,false,false,false,0.273,0.727
166,319,-153,15.090909,31.9,-153,1399,1210,189,0,1,0,0.1,32,11,10,1.09375,0,0,16,7,false,false,false,0.066,0.934
53,108,-55,17.666667,54,-55,1656,1649,7,0,0,0,0,75,3,2,0.426667,0,0,11,15,false,false,false,0.095,0.905
273,399,-126,10.5,15.346154,-126,1248,1220,28,0,1,0,0.038462,-26,26,26,-2,0,0,2,4,true,false,false,0,1
143,165,-22,15.888889,20.625,-22,727,820,-93,0,1,0,0.125,38,9,8,0.921053,0,0,12,8,false,false,false,0.154,0.846
253,301,-48,21.083333,25.083333,-48,1493,1413,80,0,1,0,0.083333,17,12,12,2.117647,0,0,7,12,false,false,false,0.009,0.991
30,0,30,30,0,30,1556,1656,-100,0,0,0,0,95,1,0,0.315789,0,0,11,0,false,false,false,0.461,0.539
304,314,-10,17.882353,19.625,-10,785,892,-107,0,0,0,0,-7,17,16,-5.285714,0,0,2,4,false,false,false,0.144,0.856
125,155,-30,15.625,19.375,-30,1248,1220,28,0,1,0,0.125,53,8,8,0.981132,1,0,9,17,false,false,false,0.174,0.826
294,342,-48,15.473684,18,-48,758,791,-33,0,0,0,0,-26,19,19,-1.5,0,0,2,1,false,false,false,0.012,0.988
80,89,-9,16,17.8,-9,848,976,-128,0,0,0,0,67,5,5,0.597015,0,0,7,12,false,false,false,0.129,0.871
221,234,-13,15.785714,18,-13,402,448,-46,0,0,0,0,10,14,13,3.7,0,1,18,14,false,false,false,0.061,0.939
75,93,-18,15,23.25,-18,527,954,-427,0,0,0,0,69,5,4,0.507246,0,1,19,9,false,false,false,0,1
54,81,-27,18,27,-27,1193,1177,16,0,0,0,0,79,3,3,0.443038,0,0,8,11,false,false,false,0.122,0.878
142,115,27,23.666667,23,27,1636,1727,-91,0,1,0,0.2,58,6,5,0.517241,0,0,7,8,false,false,false,0.449,0.551
138,98,40,19.714286,14,40,1065,948,117,0,0,0,0,56,7,7,0.696429,0,0,11,9,false,false,true,0.884,0.116
211,317,-106,11.722222,18.647059,-106,1078,983,95,1,0,0.055556,0,3,18,17,16,0,1,9,6,false,false,false,0.002,0.998
16,0,16,16,0,16,1561,1495,66,0,0,0,0,97,1,0,0.340206,1,0,9,0,false,false,true,0.8,0.2
97,127,-30,16.166667,21.166667,-30,599,448,151,0,0,0,0,57,6,6,0.631579,0,1,8,6,false,false,false,0.206,0.794
370,384,-14,21.764706,22.588235,-14,1436,1489,-53,1,1,0.058824,0.058824,-7,17,17,-5.285714,0,0,2,3,false,false,false,0.071,0.929
71,50,21,17.75,16.666667,21,1030,998,32,0,0,0,0,71,4,3,0.521127,0,0,7,7,false,false,true,0.508,0.492
49,33,16,24.5,16.5,16,1227,1189,38,0,0,0,0,81,2,2,0.432099,0,0,11,27,false,false,false,0.29,0.71
80,84,-4,13.333333,14,-4,530,683,-153,0,0,0,0,67,6,6,0.597015,0,1,9,7,false,false,false,0.225,0.775
268,285,-17,17.866667,19,-17,1270,1261,9,1,0,0.066667,0,16,15,15,2.3125,0,0,13,7,false,false,false,0.197,0.803
65,172,-107,9.285714,24.571429,-107,595,662,-67,0,1,0,0.142857,48,7,7,0.916667,0,1,23,6,false,false,false,0.008,0.992
311,388,-77,25.916667,35.272727,-77,1770,1751,19,0,1,0,0.090909,5,12,11,5.8,0,0,11,13,false,false,false,0,1
268,231,37,22.333333,19.25,37,1168,1216,-48,0,0,0,0,31,12,12,1.064516,0,0,7,7,false,false,true,0.799,0.201
36,35,1,18,17.5,1,694,658,36,0,0,0,0,86,2,2,0.430233,0,0,7,11,false,false,false,0.469,0.531
133,154,-21,16.625,19.25,-21,1203,1270,-67,0,0,0,0,54,8,8,0.814815,1,0,12,11,false,false,false,0.253,0.747
297,368,-71,37.125,52.571429,-71,2010,2219,-209,1,1,0.125,0.142857,26,8,7,1,0,0,13,10,false,false,false,0.027,0.973
189,221,-32,17.181818,20.090909,-32,500,509,-9,0,0,0,0,25,11,11,1.64,0,0,17,11,false,false,false,0.458,0.542
240,294,-54,18.461538,24.5,-54,1633,1739,-106,1,0,0.076923,0,12,13,12,2.833333,1,0,6,16,false,false,false,0.055,0.945
0,18,-18,0,18,-18,2143,2219,-76,0,0,0,0,95,1,1,0.326316,0,1,14,21,false,false,true,1,0
83,81,2,13.833333,13.5,2,306,302,4,0,0,0,0,62,6,6,0.66129,0,0,13,7,false,false,true,0.812,0.188
125,166,-41,17.857143,23.714286,-41,1094,1159,-65,0,0,0,0,47,7,7,0.808511,0,0,18,19,false,false,false,0.109,0.891
187,194,-7,17,19.4,-7,1633,1556,77,0,0,0,0,23,11,10,1.434783,0,0,18,12,false,false,false,0.117,0.883
114,163,-49,16.285714,27.166667,-49,1488,1403,85,0,1,0,0.166667,54,7,6,0.62963,0,0,17,8,false,false,false,0.072,0.928
98,123,-25,19.6,30.75,-25,1484,1556,-72,0,1,0,0.25,61,5,4,0.508197,1,0,20,7,false,false,true,0.813,0.187
366,433,-67,26.142857,33.307692,-67,1388,1455,-67,0,0,0,0,-10,14,13,-2.8,0,0,3,3,false,false,false,0.005,0.995
276,338,-62,18.4,24.142857,-62,721,757,-36,0,2,0,0.142857,2,15,14,19,0,0,13,12,false,false,false,0.032,0.968
126,144,-18,25.2,28.8,-18,1126,1277,-151,0,0,0,0,58,5,5,0.603448,0,0,11,10,false,false,false,0.14,0.86
36,44,-8,18,22,-8,1556,1616,-60,0,0,0,0,88,2,2,0.329545,0,0,16,16,false,false,false,0.182,0.818
137,166,-29,17.125,23.714286,-29,1094,1159,-65,0,0,0,0,43,8,7,0.883721,0,0,16,19,false,false,false,0.106,0.894
331,356,-25,23.642857,27.384615,-25,1173,1256,-83,2,0,0.142857,0,4,14,13,7.75,0,1,7,6,false,false,false,0,1
150,261,-111,21.428571,37.285714,-111,1003,1004,-1,0,1,0,0.142857,48,7,7,0.729167,0,0,15,17,false,false,false,0.005,0.995
290,308,-18,16.111111,18.117647,-18,1310,1477,-167,0,0,0,0,-27,18,17,-1.333333,0,0,3,2,false,false,false,0.117,0.883
191,236,-45,12.733333,15.733333,-45,668,363,305,0,0,0,0,16,15,15,2.9375,1,1,9,10,false,false,false,0.005,0.995
55,62,-7,13.75,20.666667,-7,1030,1014,16,0,0,0,0,81,4,3,0.407407,1,0,6,18,false,false,false,0.258,0.742
333,347,-14,13.875,14.458333,-14,430,542,-112,0,1,0,0.041667,-33,24,24,-1.454545,0,0,1,1,true,false,false,0.411,0.589
354,314,40,23.6,22.428571,40,1156,1279,-123,2,0,0.133333,0,0,15,14,0,0,0,11,16,false,false,true,0.989,0.011
79,88,-9,15.8,17.6,-9,758,791,-33,0,0,0,0,63,5,5,0.619048,0,0,24,11,false,false,false,0.312,0.688
119,183,-64,14.875,22.875,-64,683,859,-176,0,0,0,0,51,8,8,0.882353,1,0,15,12,false,false,false,0.104,0.896
66,96,-30,13.2,19.2,-30,278,1,277,0,0,0,0,59,5,5,0.627119,0,0,20,7,false,false,false,0.435,0.565
18,22,-4,18,22,-4,668,771,-103,0,0,0,0,89,1,1,0.449438,0,0,16,11,false,false,false,0.361,0.639
144,70,74,28.8,17.5,74,1274,1394,-120,0,0,0,0,66,5,4,0.454545,0,0,13,15,false,false,true,0.875,0.125
165,222,-57,13.75,20.181818,-57,1071,1000,71,0,0,0,0,33,12,11,1.424242,0,1,9,10,false,false,false,0.039,0.961
294,318,-24,13.363636,15.142857,-24,526,502,24,0,0,0,0,-26,22,21,-1.923077,1,0,14,15,false,false,false,0.082,0.918
189,315,-126,15.75,26.25,-126,935,995,-60,1,1,0.083333,0.083333,21,12,12,1.857143,0,0,8,14,false,false,false,0.005,0.995
251,284,-33,17.928571,20.285714,-33,1220,1185,35,0,1,0,0.071429,13,14,14,3.615385,0,1,18,21,false,false,false,0.003,0.997
280,344,-64,18.666667,24.571429,-64,1493,1413,80,0,1,0,0.071429,-4,15,14,-9,0,0,10,9,false,false,false,0,1
310,359,-49,20.666667,23.933333,-49,892,856,36,1,1,0.066667,0.066667,-11,15,15,-3.181818,0,0,15,8,false,false,false,0.085,0.915
90,100,-10,22.5,25,-10,1556,1513,43,0,0,0,0,64,4,4,0.484375,1,0,10,17,false,false,true,0.845,0.155
38,47,-9,19,23.5,-9,967,856,111,0,0,0,0,84,2,2,0.392857,0,0,16,19,false,false,false,0.286,0.714
317,326,-9,16.684211,18.111111,-9,785,892,-107,0,0,0,0,-18,19,18,-2.055556,0,0,1,2,true,false,false,0.019,0.981
275,380,-105,15.277778,22.352941,-105,1270,1424,-154,0,2,0,0.117647,-13,18,17,-2.692308,0,0,4,3,true,false,false,0.001,0.999
195,148,47,15,12.333333,47,1040,1091,-51,0,0,0,0,24,13,12,1.958333,0,1,10,25,false,false,false,0.231,0.769
179,221,-42,16.272727,20.090909,-42,1310,1477,-167,0,0,0,0,19,11,11,1.894737,1,0,12,10,false,false,false,0.185,0.815
180,222,-42,22.5,27.75,-42,1606,1890,-284,0,0,0,0,39,8,8,0.717949,0,0,11,10,false,false,false,0.106,0.894
64,75,-11,12.8,15,-11,480,739,-259,0,0,0,0,69,5,5,0.565217,0,1,14,9,false,false,false,0.097,0.903
196,365,-169,14,28.076923,-169,1422,1510,-88,0,2,0,0.153846,21,14,13,1.857143,0,0,15,9,false,false,false,0.003,0.997
204,144,60,20.4,14.4,60,742,594,148,0,0,0,0,37,10,10,1.054054,0,1,20,15,false,false,true,0.993,0.007
193,172,21,32.166667,34.4,21,1086,926,160,0,1,0,0.2,54,6,5,0.518519,0,0,12,10,false,false,false,0.196,0.804
201,221,-20,18.272727,20.090909,-20,1021,1094,-73,1,0,0.090909,0,29,11,11,1.275862,1,0,6,11,false,false,false,0.195,0.805
110,139,-29,15.714286,23.166667,-29,683,859,-176,0,0,0,0,59,7,6,0.762712,1,0,15,10,false,false,false,0.148,0.852
286,332,-46,15.052632,18.444444,-46,889,855,34,0,1,0,0.055556,-19,19,18,-2.105263,0,0,1,1,false,false,false,0.006,0.994
279,278,1,18.6,19.857143,1,985,1062,-77,0,0,0,0,-1,15,14,-37,1,0,12,7,false,false,false,0.159,0.841
110,84,26,27.5,28,26,1055,1019,36,0,0,0,0,68,4,3,0.485294,0,0,9,16,false,false,false,0.311,0.689
196,146,50,19.6,16.222222,50,1432,1452,-20,0,0,0,0,36,10,9,1,1,1,8,10,false,false,false,0.369,0.631
63,113,-50,21,37.666667,-50,971,800,171,0,1,0,0.333333,69,3,3,0.42029,1,0,6,14,false,false,false,0.07,0.93
340,389,-49,22.666667,25.933333,-49,1495,1597,-102,0,1,0,0.066667,-7,15,15,-4.571429,0,0,6,4,false,false,false,0.012,0.988
253,528,-275,16.866667,37.714286,-275,1334,1486,-152,3,1,0.2,0.071429,-5,15,14,-5.8,0,0,7,9,true,false,false,0,1
198,192,6,24.75,24,6,1245,1148,97,0,0,0,0,43,8,8,0.813953,0,0,21,11,false,false,true,0.707,0.293
89,189,-100,22.25,47.25,-100,1388,1455,-67,0,0,0,0,60,4,4,0.466667,0,0,16,7,false,false,false,0.094,0.906
138,114,24,13.8,12.666667,24,1193,1220,-27,0,0,0,0,36,10,9,1.194444,1,1,8,21,false,false,false,0.248,0.752
188,190,-2,14.461538,15.833333,-2,970,1030,-60,0,0,0,0,18,13,12,2.222222,0,0,17,9,false,false,false,0.147,0.853
247,318,-71,13.722222,17.666667,-71,813,698,115,1,0,0.055556,0,-4,18,18,-12,0,0,7,17,false,false,false,0.035,0.965
221,201,20,18.416667,18.272727,20,1220,1185,35,0,0,0,0,32,12,11,1.46875,0,1,18,6,false,false,false,0.271,0.729
86,52,34,21.5,17.333333,34,621,786,-165,0,0,0,0,68,4,3,0.441176,0,0,13,10,false,false,true,0.582,0.418
217,235,-18,16.692308,19.583333,-18,1439,1428,11,0,0,0,0,23,13,12,1.73913,0,0,14,18,false,false,false,0.108,0.892
264,279,-15,13.894737,15.5,-15,1182,1075,107,0,1,0,0.055556,-23,19,18,-1.695652,0,1,12,3,false,false,false,0.008,0.992
250,377,-127,13.888889,22.176471,-127,450,427,23,1,1,0.055556,0.058824,-22,18,17,-1.681818,0,0,1,5,false,false,false,0.006,0.994
345,405,-60,23,27,-60,1454,1479,-25,1,0,0.066667,0,-10,15,15,-3.1,0,0,9,6,false,false,false,0.007,0.993
286,304,-18,13,13.818182,-18,797,796,1,0,0,0,0,-21,22,22,-2.333333,0,0,7,4,false,false,false,0.109,0.891
238,346,-108,19.833333,31.454545,-108,1606,1890,-284,0,1,0,0.090909,11,12,11,2.545455,1,0,13,14,false,false,false,0.008,0.992
224,245,-21,18.666667,20.416667,-21,527,954,-427,0,0,0,0,25,12,12,1.4,0,2,24,5,false,false,false,0,1
155,194,-39,15.5,19.4,-39,1040,1364,-324,0,0,0,0,27,10,10,1.333333,0,0,8,12,false,false,false,0.106,0.894
275,310,-35,15.277778,18.235294,-35,1312,1334,-22,0,0,0,0,-17,18,17,-2.294118,0,0,4,4,false,false,false,0.062,0.938
93,92,1,13.285714,15.333333,1,163,346,-183,0,0,0,0,52,7,6,0.75,0,1,7,11,false,false,false,0,1
299,419,-120,14.95,22.052632,-120,913,1037,-124,0,3,0,0.157895,-17,20,19,-2.411765,0,0,9,6,false,false,false,0.002,0.998
170,145,25,21.25,18.125,25,1078,1095,-17,1,0,0.125,0,46,8,8,0.804348,0,1,18,9,false,false,true,0.606,0.394
39,47,-8,19.5,23.5,-8,689,804,-115,0,0,0,0,83,2,2,0.421687,1,0,8,17,false,false,false,0.486,0.514
329,341,-12,18.277778,20.058824,-12,1197,1156,41,0,1,0,0.058824,-14,18,17,-2.5,0,0,1,1,true,false,false,0.002,0.998
130,189,-59,11.818182,17.181818,-59,668,363,305,0,0,0,0,34,11,11,1.382353,0,0,17,14,false,false,false,0.082,0.918
223,416,-193,18.583333,34.666667,-193,1334,1486,-152,2,1,0.166667,0.083333,16,12,12,1.8125,0,0,8,11,false,false,false,0.005,0.995
207,232,-25,15.923077,19.333333,-25,500,532,-32,0,0,0,0,14,13,12,2.928571,0,1,18,9,false,false,false,0.056,0.944
235,327,-92,15.666667,23.357143,-92,1195,1397,-202,0,2,0,0.142857,8,15,14,5,0,1,18,13,false,false,false,0.003,0.997
316,312,4,19.75,20.8,4,664,786,-122,0,0,0,0,-8,16,15,-4.125,0,0,4,2,false,false,false,0.463,0.537
332,316,16,27.666667,28.727273,16,1047,1127,-80,0,1,0,0.090909,2,12,11,13.5,0,0,21,11,false,false,true,0.733,0.267
152,234,-82,16.888889,26,-82,926,973,-47,0,0,0,0,32,9,9,1.09375,0,1,14,10,false,false,false,0.014,0.986
259,371,-112,12.95,19.526316,-112,907,878,29,0,0,0,0,-7,20,19,-6.142857,0,0,7,6,false,false,false,0.005,0.995
188,206,-18,20.888889,22.888889,-18,921,1045,-124,0,0,0,0,35,9,9,1,0,0,17,12,false,false,false,0.178,0.822
14,11,3,14,11,3,1094,1041,53,0,0,0,0,93,1,1,0.408602,1,0,8,12,false,false,true,0.569,0.431
178,269,-91,14.833333,24.454545,-91,944,1095,-151,0,1,0,0.090909,31,12,11,1.258065,0,1,14,7,false,false,false,0.005,0.995
88,73,15,14.666667,14.6,15,1030,998,32,0,0,0,0,58,6,5,0.637931,0,0,10,11,false,false,false,0.44,0.56
299,320,-21,16.611111,18.823529,-21,1000,960,40,0,0,0,0,-14,18,17,-3.214286,0,0,12,6,false,false,false,0.08,0.92
228,262,-34,17.538462,21.833333,-34,785,892,-107,0,0,0,0,17,13,12,2.176471,0,0,9,7,false,false,false,0.061,0.939
254,359,-105,18.142857,27.615385,-105,1038,917,121,1,2,0.071429,0.153846,-2,14,13,-17.5,0,0,8,9,false,false,false,0.001,0.999
16,0,16,16,0,16,388,542,-154,0,0,0,0,94,1,0,0.393617,0,0,13,0,false,false,true,0.516,0.484
264,283,-19,17.6,18.866667,-19,1161,1030,131,0,1,0,0.066667,-8,15,15,-4.75,0,1,18,12,false,false,false,0.035,0.965
121,152,-31,17.285714,21.714286,-31,1422,1583,-161,0,1,0,0.142857,53,7,7,0.773585,0,0,17,23,false,false,false,0.107,0.893
260,238,22,18.571429,18.307692,22,1037,1009,28,0,0,0,0,21,14,13,2.095238,1,1,7,8,false,false,false,0.255,0.745
282,224,58,23.5,20.363636,58,1331,1374,-43,0,0,0,0,14,12,11,2.357143,0,0,23,7,false,false,true,0.883,0.117
278,280,-2,17.375,18.666667,-2,803,786,17,1,0,0.0625,0,-5,16,15,-6.4,0,0,17,16,false,false,false,0.137,0.863
255,298,-43,19.615385,24.833333,-43,694,658,36,0,1,0,0.083333,18,13,12,2.055556,0,0,13,12,false,false,false,0.037,0.963
50,79,-29,8.333333,15.8,-29,917,856,61,0,0,0,0,71,6,5,0.464789,0,1,23,6,false,false,false,0.234,0.766
275,380,-105,16.176471,22.352941,-105,1270,1424,-154,0,2,0,0.117647,-13,17,17,-2.692308,0,0,4,3,false,false,false,0.002,0.998
136,205,-69,15.111111,25.625,-69,700,820,-120,0,1,0,0.125,41,9,8,0.926829,0,0,18,7,false,false,false,0.042,0.958
98,41,57,49,20.5,57,1397,1405,-8,1,0,0.5,0,78,2,2,0.371795,0,0,16,19,false,false,true,0.505,0.495
156,157,-1,17.333333,17.444444,-1,1037,1009,28,0,0,0,0,46,9,9,0.956522,0,1,18,9,false,false,false,0.266,0.734
93,18,75,46.5,18,75,169,306,-137,1,1,0.5,1,81,2,1,0.382716,0,0,10,13,false,false,true,0.809,0.191
92,98,-6,30.666667,49,-6,1431,1399,32,0,1,0,0.5,76,3,2,0.328947,0,0,14,8,false,false,false,0.102,0.898
44,84,-40,14.666667,42,-40,944,1095,-151,0,1,0,0.5,82,3,2,0.47561,0,0,13,18,false,false,false,0.116,0.884
295,340,-45,16.388889,18.888889,-45,568,570,-2,0,0,0,0,-14,18,18,-2.642857,0,0,1,1,false,false,false,0.033,0.967
199,239,-40,22.111111,26.555556,-40,1101,1237,-136,1,0,0.111111,0,34,9,9,1,0,0,7,8,false,false,false,0.089,0.911
282,301,-19,21.692308,23.153846,-19,1237,1265,-28,1,0,0.076923,0,0,13,13,0,0,0,7,13,false,false,false,0.337,0.663
214,239,-25,21.4,26.555556,-25,1101,1237,-136,1,0,0.1,0,29,10,9,1.172414,1,0,6,8,false,false,false,0.112,0.888
239,266,-27,18.384615,22.166667,-27,1417,1482,-65,0,1,0,0.083333,22,13,12,1.5,0,1,15,13,false,false,false,0.051,0.949
212,189,23,15.142857,14.538462,23,671,638,33,0,0,0,0,12,14,13,4.083333,0,0,13,21,false,false,true,0.584,0.416
343,342,1,18.052632,19,1,804,766,38,0,1,0,0.055556,-10,19,18,-4.1,0,0,4,4,false,false,false,0.143,0.857
132,139,-7,14.666667,17.375,-7,1159,1131,28,0,1,0,0.125,46,9,8,0.804348,0,1,7,7,false,false,false,0.101,0.899
278,270,8,21.384615,22.5,8,964,1003,-39,0,1,0,0.083333,15,13,12,2.6,0,0,10,20,false,false,false,0.494,0.506
234,264,-30,15.6,18.857143,-30,518,414,104,0,1,0,0.071429,8,15,14,4.75,0,0,9,12,false,false,false,0.039,0.961
50,16,34,25,16,34,926,973,-47,0,0,0,0,88,2,1,0.397727,0,1,10,7,false,false,true,0.522,0.478
26,0,26,26,0,26,1633,1680,-47,0,0,0,0,94,1,0,0.297872,0,0,8,0,false,false,false,0.41,0.59
27,48,-21,13.5,24,-21,1310,1477,-167,0,0,0,0,85,2,2,0.423529,0,0,7,10,false,false,false,0.2,0.8
277,327,-50,13.85,16.35,-50,1040,1091,-51,0,0,0,0,-23,20,20,-2.043478,0,0,7,4,false,false,false,0.008,0.992
73,128,-55,10.428571,18.285714,-55,1064,1397,-333,0,1,0,0.142857,73,7,7,0.589041,1,0,16,7,false,false,false,0.245,0.755
193,161,32,17.545455,16.1,32,720,437,283,0,0,0,0,39,11,10,1.076923,1,0,11,9,false,false,true,0.948,0.052
130,88,42,21.666667,17.6,42,1038,917,121,1,0,0.166667,0,64,6,5,0.546875,0,1,8,8,false,false,true,0.553,0.447
265,319,-54,18.928571,24.538462,-54,694,658,36,0,1,0,0.076923,11,14,13,3.363636,0,0,12,10,false,false,false,0.035,0.965
148,214,-66,18.5,26.75,-66,561,633,-72,0,1,0,0.125,46,8,8,0.76087,0,0,13,10,false,false,false,0.047,0.953
298,311,-13,19.866667,20.733333,-13,1803,1658,145,1,0,0.066667,0,-10,15,15,-3.3,0,0,5,3,false,false,false,0.061,0.939
189,314,-125,14.538462,24.153846,-125,530,683,-153,0,1,0,0.076923,19,13,13,2.105263,0,0,17,14,false,false,false,0.006,0.994
276,293,-17,27.6,29.3,-17,1885,1842,43,0,2,0,0.2,15,10,10,1.8,0,1,14,13,false,false,false,0.029,0.971
161,150,11,16.1,16.666667,11,913,1037,-124,0,1,0,0.111111,53,10,9,0.773585,0,0,15,11,false,false,false,0.482,0.518
302,385,-83,20.133333,25.666667,-83,991,1063,-72,0,1,0,0.066667,-3,15,15,-12.666667,0,0,15,10,false,false,false,0.025,0.975
292,362,-70,15.368421,20.111111,-70,594,648,-54,1,1,0.052632,0.055556,-14,19,18,-2.857143,0,0,1,4,false,false,false,0.036,0.964
329,342,-13,19.352941,21.375,-13,1094,1041,53,1,0,0.058824,0,-17,17,16,-2.235294,0,0,5,3,false,false,false,0.049,0.951
42,86,-44,8.4,17.2,-44,632,603,29,0,0,0,0,65,5,5,0.584615,1,0,13,32,false,false,false,0.118,0.882
85,80,5,17,16,5,1633,1556,77,0,0,0,0,62,5,5,0.532258,0,0,24,7,false,false,true,0.522,0.478
284,353,-69,15.777778,19.611111,-69,1422,1583,-161,0,1,0,0.055556,-7,18,18,-5.857143,1,0,3,13,false,false,false,0.006,0.994
266,281,-15,22.166667,25.545455,-15,1452,1388,64,0,1,0,0.090909,15,12,11,2.333333,0,0,11,14,false,false,false,0.087,0.913
265,286,-21,20.384615,22,-21,971,800,171,0,1,0,0.076923,-7,13,13,-4.142857,0,0,13,6,false,false,false,0.144,0.856
300,311,-11,17.647059,18.294118,-11,1270,1261,9,1,0,0.058824,0,0,17,17,0,0,0,6,3,false,false,false,0.152,0.848
85,139,-54,14.166667,23.166667,-54,683,859,-176,0,0,0,0,63,6,6,0.714286,1,0,15,10,false,false,false,0.119,0.881
16,0,16,16,0,16,561,633,-72,0,0,0,0,96,1,0,0.364583,1,0,7,0,false,false,true,0.538,0.462
183,200,-17,15.25,16.666667,-17,1580,1629,-49,0,0,0,0,23,12,12,1.608696,0,0,11,10,false,false,false,0.139,0.861
255,338,-83,13.421053,18.777778,-83,653,820,-167,0,0,0,0,-28,19,18,-1.357143,0,0,1,1,false,false,false,0.005,0.995
248,245,3,16.533333,16.333333,3,670,576,94,0,0,0,0,1,15,15,41,1,0,13,12,false,false,true,0.903,0.097
98,144,-46,16.333333,24,-46,1182,1075,107,0,1,0,0.166667,56,6,6,0.696429,0,1,22,8,false,false,false,0.016,0.984
275,319,-44,15.277778,17.722222,-44,1312,1334,-22,0,0,0,0,-19,18,18,-2.052632,0,0,4,2,false,false,false,0.042,0.958
91,194,-103,13,27.714286,-103,1473,1500,-27,0,2,0,0.285714,50,7,7,0.78,0,0,20,20,false,false,false,0.033,0.967
259,375,-116,12.95,18.75,-116,907,878,29,0,0,0,0,-9,20,20,-4.777778,0,0,7,5,false,false,false,0.005,0.995
179,172,7,35.8,34.4,7,1086,926,160,0,1,0,0.2,58,5,5,0.482759,0,0,12,10,false,false,false,0.203,0.797
269,324,-55,19.214286,24.923077,-55,1493,1413,80,0,1,0,0.076923,7,14,13,5.142857,0,0,7,9,false,false,false,0.001,0.999
240,177,63,18.461538,14.75,63,720,437,283,0,0,0,0,29,13,12,1.448276,0,0,10,18,false,false,true,0.966,0.034
339,284,55,28.25,25.818182,55,1659,1782,-123,1,0,0.083333,0,4,12,11,7.25,0,1,17,11,false,true,true,0.909,0.091
290,274,16,20.714286,19.571429,16,786,847,-61,0,0,0,0,4,14,14,8.5,0,0,10,10,false,true,true,0.68,0.32
298,249,49,22.923077,19.153846,49,948,933,15,1,0,0.076923,0,20,13,13,1.9,0,0,7,11,false,true,true,0.956,0.044
371,279,92,18.55,13.95,92,916,837,79,1,0,0.05,0,-26,20,20,-1.538462,0,0,1,2,true,true,true,1,0
84,77,7,16.8,15.4,7,468,542,-74,0,0,0,0,72,5,5,0.541667,0,0,18,11,false,true,true,0.748,0.252
59,38,21,14.75,12.666667,21,880,952,-72,0,0,0,0,77,4,3,0.532468,0,0,14,7,false,true,false,0.474,0.526
173,170,3,15.727273,15.454545,3,908,859,49,0,0,0,0,29,11,11,1.344828,0,1,22,12,false,true,false,0.323,0.677
243,154,89,17.357143,11.846154,89,872,818,54,0,1,0,0.076923,23,14,13,1.782609,1,0,19,14,false,true,true,0.981,0.019
327,192,135,21.8,13.714286,135,303,342,-39,0,0,0,0,9,15,14,4.222222,0,1,9,8,false,true,true,1,0
16,0,16,16,0,16,704,691,13,0,0,0,0,96,1,0,0.395833,1,0,18,0,false,true,true,0.56,0.44
247,205,42,17.642857,14.642857,42,416,306,110,0,0,0,0,14,14,14,3,0,0,10,10,false,true,true,0.968,0.032
154,129,25,22,18.428571,25,1305,1390,-85,0,0,0,0,51,7,7,0.705882,0,0,7,18,false,true,false,0.267,0.733
184,122,62,30.666667,24.4,62,908,1070,-162,1,0,0.166667,0,57,6,5,0.526316,1,0,14,16,false,true,true,0.86,0.14
210,248,-38,15,17.714286,-38,576,494,82,0,0,0,0,15,14,14,2.933333,0,1,12,8,false,true,false,0.012,0.988
167,178,-11,18.555556,19.777778,-11,1266,1247,19,0,0,0,0,37,9,9,0.864865,0,0,13,11,false,true,false,0.148,0.852
79,110,-31,15.8,22,-31,1659,1782,-123,0,0,0,0,63,5,5,0.460317,0,0,7,8,false,true,false,0.2,0.8
202,100,102,22.444444,12.5,102,786,757,29,1,0,0.111111,0,44,9,8,0.886364,0,0,8,22,false,true,true,0.989,0.011
125,120,5,15.625,15,5,1029,1075,-46,0,0,0,0,50,8,8,0.96,1,0,17,9,false,true,true,0.52,0.48
360,336,24,21.176471,19.764706,24,1177,1214,-37,0,0,0,0,-22,17,17,-1.590909,0,0,1,2,false,true,true,0.992,0.008
118,35,83,39.333333,17.5,83,791,885,-94,1,0,0.333333,0,76,3,2,0.5,0,0,14,16,false,true,true,0.882,0.118
254,86,168,21.166667,7.166667,168,896,818,78,0,0,0,0,36,12,12,1.222222,0,1,7,6,false,true,true,1,0
173,165,8,15.727273,16.5,8,908,859,49,0,0,0,0,32,11,10,1.21875,0,1,22,7,false,true,false,0.298,0.702
291,113,178,18.1875,7.533333,178,859,719,140,0,1,0,0.066667,2,16,15,26.5,0,1,16,16,false,true,true,1,0
303,259,44,16.833333,14.388889,44,1221,1438,-217,0,0,0,0,4,18,18,11.25,0,1,16,7,false,true,true,0.689,0.311
332,266,66,36.888889,29.555556,66,1880,1777,103,1,1,0.111111,0.111111,23,9,9,1.217391,0,1,17,11,false,true,false,0.494,0.506
110,54,56,27.5,18,56,1334,1477,-143,0,0,0,0,72,4,3,0.416667,0,2,12,9,false,true,true,0.9,0.1
122,110,12,30.5,27.5,12,1030,998,32,0,0,0,0,67,4,4,0.567164,0,0,10,7,false,true,true,0.607,0.393
339,306,33,28.25,25.5,33,1659,1782,-123,1,0,0.083333,0,2,12,12,14.5,0,1,17,13,false,true,true,0.666,0.334
297,228,69,27,22.8,69,1302,1234,68,1,1,0.090909,0.1,22,11,10,1.409091,0,0,10,11,false,true,true,0.964,0.036
315,263,52,17.5,15.470588,52,1159,1031,128,1,0,0.055556,0,-20,18,17,-1.95,0,0,5,9,false,true,true,0.999,0.001
332,252,80,17.473684,14,80,695,523,172,0,0,0,0,-17,19,18,-2.176471,0,0,1,7,true,true,true,1,0
405,287,118,28.928571,22.076923,118,1507,1554,-47,1,2,0.071429,0.153846,-9,14,13,-3.222222,0,0,3,4,false,true,true,1,0
284,317,-33,13.52381,15.85,-33,999,1011,-12,0,0,0,0,-27,21,20,-1.703704,1,0,8,5,false,true,false,0.068,0.932
409,275,134,17.041667,11.956522,134,1413,1422,-9,0,0,0,0,-26,24,23,-2.192308,0,0,3,3,false,true,true,1,0
233,169,64,19.416667,15.363636,64,609,620,-11,0,0,0,0,23,12,11,1.608696,0,0,8,16,false,true,true,0.92,0.08
261,188,73,17.4,13.428571,73,620,513,107,0,0,0,0,12,15,14,3.75,1,0,24,7,false,true,true,0.981,0.019
114,145,-31,19,29,-31,1554,1573,-19,0,0,0,0,61,6,5,0.557377,0,0,18,12,false,true,false,0.106,0.894
18,0,18,18,0,18,1334,1270,64,0,0,0,0,97,1,0,0.381443,0,0,8,0,false,true,false,0.472,0.528
311,244,67,19.4375,16.266667,67,880,952,-72,0,0,0,0,-4,16,15,-10.25,0,0,16,11,false,true,true,0.998,0.002
12,0,12,12,0,12,1221,1258,-37,0,0,0,0,97,1,0,0.402062,0,0,9,0,false,true,false,0.313,0.687
236,177,59,19.666667,16.090909,59,1159,1051,108,0,0,0,0,28,12,11,1.428571,0,0,11,11,false,true,true,0.938,0.062
299,298,1,12.458333,12.956522,1,1029,1075,-46,0,0,0,0,-25,24,23,-1.92,0,0,1,1,false,true,true,0.673,0.327
93,114,-21,13.285714,16.285714,-21,416,374,42,0,0,0,0,63,7,7,0.730159,1,0,11,10,false,true,false,0.425,0.575
266,241,25,19,18.538462,25,942,976,-34,0,0,0,0,7,14,13,5.714286,0,0,10,8,false,true,true,0.585,0.415
172,209,-37,15.636364,19,-37,1043,1055,-12,0,0,0,0,29,11,11,1.275862,0,0,19,7,false,true,false,0.11,0.89
161,103,58,20.125,12.875,58,791,774,17,1,0,0.125,0,54,8,8,0.759259,1,0,7,20,false,true,true,0.978,0.022
184,171,13,30.666667,28.5,13,908,1070,-162,1,0,0.166667,0,53,6,6,0.566038,1,0,14,10,false,true,true,0.729,0.271
22,0,22,22,0,22,1394,1118,276,0,0,0,0,95,1,0,0.389474,0,0,10,0,false,true,true,0.772,0.228
281,229,52,18.733333,16.357143,52,468,542,-74,0,0,0,0,4,15,14,9.75,0,0,17,10,false,true,true,0.926,0.074
176,135,41,19.555556,16.875,41,613,502,111,0,0,0,0,43,9,8,1.139535,0,0,7,26,false,true,true,0.734,0.266
151,75,76,25.166667,15,76,1014,948,66,0,0,0,0,65,6,5,0.507692,0,0,11,15,false,true,true,0.894,0.106
20,0,20,20,0,20,771,754,17,0,0,0,0,96,1,0,0.333333,0,0,10,0,false,true,true,0.524,0.476
279,272,7,25.363636,24.727273,7,1554,1716,-162,1,1,0.090909,0.090909,13,11,11,2.692308,0,0,18,15,false,true,true,0.731,0.269
34,34,0,17,34,0,1428,1606,-178,0,0,0,0,87,2,1,0.367816,1,0,6,20,false,true,true,0.546,0.454
283,170,113,25.727273,15.454545,113,1691,1692,-1,0,0,0,0,22,11,11,1.363636,0,0,17,17,false,true,true,1,0
51,47,4,17,15.666667,4,526,370,156,0,0,0,0,80,3,3,0.4375,1,0,11,18,false,true,true,0.526,0.474
162,183,-21,14.727273,18.3,-21,916,876,40,0,0,0,0,22,11,10,1.545455,1,0,12,16,false,true,false,0.129,0.871
172,194,-22,17.2,19.4,-22,1043,1055,-12,0,0,0,0,34,10,10,1.088235,0,0,17,7,false,true,false,0.136,0.864
160,105,55,20,15,55,1037,950,87,1,0,0.125,0,49,8,7,0.632653,0,0,10,16,false,true,true,0.885,0.115
371,254,117,20.611111,14.111111,117,596,595,1,1,0,0.055556,0,-17,18,18,-2.352941,0,0,1,14,false,true,true,1,0
277,256,21,16.294118,16,21,613,549,64,0,0,0,0,-9,17,16,-4.888889,0,0,5,6,false,true,true,0.689,0.311
334,269,65,25.692308,20.692308,65,1302,1234,68,1,1,0.076923,0.076923,3,13,13,10.333333,0,0,14,12,false,true,true,0.988,0.012
324,320,4,18,18.823529,4,491,398,93,0,0,0,0,-13,18,17,-2.769231,1,0,5,6,false,true,true,0.771,0.229
290,178,112,18.125,11.866667,112,871,867,4,0,0,0,0,6,16,15,7.166667,0,1,17,16,false,true,true,1,0
143,136,7,17.875,17,7,872,818,54,0,1,0,0.125,49,8,8,0.836735,0,0,7,8,false,true,true,0.861,0.139
374,383,-9,26.714286,27.357143,-9,1256,1232,24,1,0,0.071429,0,-9,14,14,-3.333333,1,0,2,2,false,true,true,0.822,0.178
332,267,65,13.833333,11.125,65,1016,1037,-21,0,0,0,0,-24,24,24,-2,0,0,1,12,true,true,true,1,0
12,17,-5,12,17,-5,1156,1114,42,0,0,0,0,91,1,1,0.351648,0,0,7,9,false,true,false,0.449,0.551
274,283,-9,19.571429,20.214286,-9,1266,1247,19,0,0,0,0,4,14,14,8,2,0,7,12,false,true,true,0.949,0.051
187,119,68,31.166667,19.833333,68,742,696,46,0,0,0,0,51,6,6,0.627451,0,0,8,7,false,true,true,0.917,0.083
379,287,92,19.947368,15.105263,92,1364,1093,271,0,1,0,0.052632,-18,19,19,-2.111111,0,0,5,1,true,true,true,1,0
420,338,82,26.25,21.125,82,791,885,-94,1,1,0.0625,0.0625,-16,16,16,-2.375,0,0,3,4,false,true,true,0.999,0.001
51,47,4,12.75,15.666667,4,523,480,43,0,0,0,0,75,4,3,0.44,0,0,18,8,false,true,false,0.427,0.573
159,123,36,15.9,12.3,36,584,565,19,0,0,0,0,37,10,10,1.243243,1,0,9,9,false,true,true,0.904,0.096
262,209,53,32.75,26.125,53,1762,1616,146,2,0,0.25,0,31,8,8,0.967742,0,0,9,19,false,true,true,0.979,0.021
95,89,6,15.833333,14.833333,6,921,1072,-151,0,0,0,0,64,6,6,0.59375,1,0,6,10,false,true,false,0.294,0.706
158,90,68,22.571429,15,68,960,1070,-110,1,0,0.142857,0,54,7,6,0.648148,0,0,20,17,false,true,true,0.88,0.12
105,44,61,21,11,61,1550,1546,4,0,0,0,0,70,5,4,0.428571,0,0,14,17,false,true,true,0.587,0.413
244,155,89,30.5,22.142857,89,1762,1582,180,2,1,0.25,0.142857,45,8,7,0.711111,0,0,7,10,false,true,true,0.992,0.008
217,170,47,24.111111,18.888889,47,306,169,137,0,0,0,0,27,9,9,1.259259,0,0,10,12,false,true,true,0.816,0.184
97,63,34,24.25,21,34,746,796,-50,0,1,0,0.333333,69,4,3,0.695652,1,0,7,17,false,true,true,0.734,0.266
342,273,69,20.117647,16.058824,69,539,500,39,0,0,0,0,-17,17,17,-2.352941,0,0,18,9,false,true,true,0.999,0.001
221,225,-4,18.416667,18.75,-4,838,786,52,0,1,0,0.083333,22,12,12,1.454545,1,0,18,10,false,true,true,0.956,0.044
36,41,-5,18,20.5,-5,630,786,-156,0,0,0,0,82,2,2,0.426829,0,0,11,7,false,true,false,0.455,0.545
341,297,44,28.416667,24.75,44,1803,1552,251,1,2,0.083333,0.166667,6,12,12,4.666667,0,0,7,22,false,true,true,0.996,0.004
278,225,53,23.166667,18.75,53,847,952,-105,0,0,0,0,26,12,12,1.384615,0,0,12,12,false,true,true,0.862,0.138
18,0,18,18,0,18,820,822,-2,0,0,0,0,95,1,0,0.410526,0,0,24,0,false,true,true,0.531,0.469
57,78,-21,14.25,19.5,-21,576,494,82,0,0,0,0,75,4,4,0.586667,0,0,7,14,false,true,false,0.211,0.789
171,228,-57,15.545455,20.727273,-57,999,1011,-12,0,0,0,0,27,11,11,1.703704,0,0,13,20,false,true,false,0.081,0.919
0,14,-14,0,14,-14,1176,1076,100,0,0,0,0,96,1,1,0.614583,1,0,15,10,false,true,true,0.529,0.471
386,295,91,27.571429,22.692308,91,1075,1027,48,2,1,0.142857,0.076923,-1,14,13,-37,0,0,17,9,false,true,true,0.999,0.001
16,0,16,16,0,16,1513,1479,34,0,0,0,0,95,1,0,0.357895,0,0,25,0,false,true,true,0.521,0.479
281,240,41,23.416667,20,41,1089,1063,26,1,0,0.083333,0,16,12,12,2.375,1,0,16,19,false,true,true,0.974,0.026
315,286,29,17.5,15.888889,29,1159,1031,128,1,0,0.055556,0,-25,18,18,-1.56,0,0,5,1,false,true,true,0.996,0.004
278,317,-39,13.9,15.85,-39,999,1011,-12,0,0,0,0,-24,20,20,-1.916667,1,0,9,5,false,true,false,0.105,0.895
271,189,82,20.846154,15.75,82,1045,1009,36,1,0,0.076923,0,20,13,12,1.9,1,0,17,19,false,true,true,0.985,0.015
304,265,39,25.333333,24.090909,39,1670,1770,-100,1,1,0.083333,0.090909,14,12,11,2.285714,0,1,8,7,false,true,true,0.713,0.287
70,14,56,35,14,56,1388,1506,-118,1,0,0.5,0,89,2,1,0.382022,0,0,7,28,false,true,true,1,0
184,92,92,15.333333,7.666667,92,859,719,140,0,1,0,0.083333,21,12,12,2.52381,0,2,17,12,false,true,true,0.91,0.09
333,273,60,23.785714,19.5,60,904,668,236,0,0,0,0,-15,14,14,-2.266667,0,0,7,6,false,true,true,1,0
178,133,45,19.777778,14.777778,45,1164,1201,-37,0,0,0,0,39,9,9,1.076923,0,1,18,15,false,true,true,0.657,0.343
363,225,138,22.6875,15,138,1482,1554,-72,1,0,0.0625,0,-3,16,15,-12,0,0,17,7,false,true,true,1,0
142,118,24,17.75,16.857143,24,1220,1261,-41,1,0,0.125,0,56,8,7,0.803571,0,0,12,11,false,true,false,0.434,0.566
174,171,3,19.333333,21.375,3,1077,1094,-17,0,0,0,0,44,9,8,0.954545,0,0,11,10,false,true,false,0.127,0.873
303,290,13,27.545455,26.363636,13,1397,1195,202,1,0,0.090909,0,18,11,11,1.944444,0,0,10,12,false,true,true,0.715,0.285
95,70,25,23.75,23.333333,25,942,976,-34,0,0,0,0,73,4,3,0.547945,1,0,9,17,false,true,true,0.692,0.308
207,214,-7,15.923077,17.833333,-7,361,493,-132,1,0,0.076923,0,8,13,12,5.125,0,0,7,20,false,true,false,0.208,0.792
34,20,14,34,20,14,1428,1452,-24,0,0,0,0,92,1,1,0.336957,0,0,24,10,false,true,true,0.534,0.466
54,20,34,27,20,34,576,532,44,0,0,0,0,86,2,1,0.534884,1,0,8,13,false,true,true,0.549,0.451
388,307,81,27.714286,21.928571,81,1428,1606,-178,1,0,0.071429,0,-6,14,14,-5.333333,0,0,4,3,false,true,true,1,0
247,250,-3,13.722222,13.888889,-3,826,771,55,0,0,0,0,-2,18,18,-22.5,0,0,16,7,false,true,true,0.559,0.441
325,292,33,25,24.333333,33,907,752,155,0,1,0,0.083333,12,13,12,2.75,0,0,7,17,false,true,true,0.702,0.298
326,361,-35,25.076923,30.083333,-35,834,844,-10,1,2,0.076923,0.166667,-1,13,12,-36,0,0,7,19,false,true,false,0.119,0.881
334,270,64,22.266667,19.285714,64,416,282,134,1,0,0.066667,0,-3,15,14,-11.333333,1,0,10,8,false,true,true,1,0
151,244,-93,18.875,30.5,-93,1762,1538,224,0,2,0,0.25,42,8,8,0.809524,1,0,6,8,false,true,true,0.894,0.106
121,62,59,20.166667,10.333333,59,777,830,-53,0,0,0,0,64,6,6,0.640625,1,1,14,15,false,true,true,0.529,0.471
310,293,17,17.222222,17.235294,17,1164,1201,-37,0,0,0,0,-11,18,17,-3.818182,0,0,15,7,false,true,false,0.486,0.514
281,243,38,18.733333,16.2,38,468,542,-74,0,0,0,0,2,15,15,19.5,0,0,17,8,false,true,true,0.954,0.046
91,18,73,45.5,18,73,1510,1583,-73,1,0,0.5,0,82,2,1,0.390244,0,0,13,22,false,true,true,0.568,0.432
300,260,40,21.428571,20,40,1270,1348,-78,0,0,0,0,12,14,13,3.166667,0,0,7,7,false,true,true,0.662,0.338
4,20,-16,4,20,-16,831,830,1,0,0,0,0,93,1,1,0.397849,0,0,7,17,false,true,false,0.135,0.865
36,32,4,18,16,4,1164,1201,-37,0,0,0,0,83,2,2,0.506024,0,1,17,11,false,true,false,0.437,0.563
193,191,2,19.3,19.1,2,349,315,34,0,0,0,0,18,10,10,1.888889,0,0,10,16,false,true,true,0.731,0.269
165,60,105,55,20,105,1349,1302,47,0,0,0,0,73,3,3,0.39726,0,0,14,8,false,true,true,0.998,0.002
91,65,26,22.75,16.25,26,1364,1093,271,0,0,0,0,74,4,4,0.513514,0,1,12,6,false,true,true,0.62,0.38
307,226,81,20.466667,16.142857,81,711,876,-165,0,0,0,0,2,15,14,21.5,0,1,11,9,false,true,true,0.999,0.001
35,57,-22,11.666667,19,-22,926,854,72,0,0,0,0,80,3,3,0.425,0,0,17,16,false,true,false,0.243,0.757
82,13,69,41,13,69,742,696,46,0,0,0,0,87,2,1,0.367816,0,1,11,9,false,true,true,0.993,0.007
294,304,-10,22.615385,23.384615,-10,1344,1325,19,1,0,0.076923,0,-1,13,13,-31,0,1,15,6,false,true,false,0.245,0.755
375,284,91,17.857143,13.52381,91,719,651,68,0,1,0,0.047619,-27,21,21,-1.666667,0,0,2,1,false,true,true,1,0
204,178,26,20.4,19.777778,26,892,788,104,2,0,0.2,0,36,10,9,1.194444,0,0,7,16,false,true,true,0.919,0.081
93,103,-10,11.625,14.714286,-10,1214,1176,38,0,0,0,0,54,8,7,0.666667,1,1,16,13,false,true,false,0.246,0.754
446,380,66,20.272727,18.095238,66,1220,1261,-41,2,0,0.090909,0,-25,22,21,-1.8,0,0,1,1,false,true,true,0.99,0.01
224,202,22,14,13.466667,22,1029,1075,-46,0,0,0,0,14,16,15,3.428571,2,0,7,14,false,true,true,0.832,0.168
158,205,-47,15.8,20.5,-47,95,360,-265,0,1,0,0.1,26,10,10,1.538462,0,0,14,10,false,true,false,0.144,0.856
359,268,91,19.944444,14.888889,91,831,830,1,0,0,0,0,-18,18,18,-2.055556,0,0,8,6,false,true,true,1,0
85,62,23,21.25,20.666667,23,1069,917,152,0,0,0,0,73,4,3,0.465753,0,1,16,9,false,true,true,0.589,0.411
184,234,-50,18.4,23.4,-50,594,605,-11,0,0,0,0,30,10,10,1.233333,0,0,9,8,false,true,false,0.068,0.932
382,288,94,22.470588,18,94,769,527,242,1,0,0.058824,0,-19,17,16,-1.894737,0,0,2,3,false,true,true,1,0
379,285,94,23.6875,19,94,1394,1118,276,0,1,0,0.066667,-6,16,15,-6.166667,0,0,14,3,false,true,true,1,0
290,283,7,16.111111,16.647059,7,1043,1055,-12,0,0,0,0,-15,18,17,-2.466667,0,0,4,3,false,true,true,0.51,0.49
109,69,40,36.333333,23,40,1245,1241,4,1,1,0.333333,0.333333,73,3,3,0.39726,0,0,20,22,false,true,true,0.849,0.151
233,137,96,21.181818,12.454545,96,1586,1782,-196,0,0,0,0,25,11,11,1.6,1,0,9,9,false,true,true,0.963,0.037
129,179,-50,21.5,29.833333,-50,1023,1110,-87,1,1,0.166667,0.166667,44,6,6,0.681818,0,0,12,8,false,true,false,0.238,0.762
104,127,-23,17.333333,21.166667,-23,1261,1349,-88,0,0,0,0,56,6,6,0.232143,1,1,15,18,false,true,false,0.243,0.757
52,49,3,17.333333,24.5,3,921,1072,-151,0,0,0,0,83,3,2,0.457831,0,0,9,9,false,true,false,0.201,0.799
117,193,-76,14.625,24.125,-76,1154,1062,92,0,0,0,0,46,8,8,0.76087,0,0,11,18,false,true,false,0.099,0.901
28,44,-16,14,22,-16,1221,1438,-217,0,0,0,0,88,2,2,0.511364,0,0,19,11,false,true,false,0.178,0.822
93,36,57,23.25,12,57,771,754,17,0,0,0,0,74,4,3,0.432432,0,0,10,8,false,true,true,0.874,0.126
334,255,79,17.578947,13.421053,79,539,632,-93,0,0,0,0,-9,19,19,-5.111111,0,0,11,7,false,true,true,1,0
255,221,34,18.214286,17,34,468,542,-74,0,0,0,0,11,14,13,3.545455,1,0,22,13,false,true,true,0.975,0.025
94,93,1,15.666667,15.5,1,864,808,56,1,0,0.166667,0,51,6,6,0.666667,1,0,9,11,false,true,true,0.564,0.436
182,120,62,26,17.142857,62,1270,1315,-45,0,0,0,0,47,7,7,0.765957,0,0,10,25,false,true,true,0.765,0.235
240,137,103,24,15.222222,103,1004,653,351,0,0,0,0,26,10,9,1.346154,0,0,8,22,false,true,true,1,0
65,76,-11,21.666667,38,-11,1554,1573,-19,0,0,0,0,84,3,2,0.404762,0,0,15,10,false,true,false,0.122,0.878
281,234,47,17.5625,15.6,47,609,620,-11,0,0,0,0,-5,16,15,-7.4,0,1,7,6,false,true,true,0.998,0.002
30,44,-14,15,22,-14,1023,1110,-87,0,0,0,0,83,2,2,0.361446,0,1,10,16,false,true,false,0.155,0.845
291,263,28,18.1875,17.533333,28,942,976,-34,0,0,0,0,-6,16,15,-6.666667,0,0,11,10,false,true,true,0.63,0.37
172,173,-1,21.5,21.625,-1,1364,1093,271,0,1,0,0.125,45,8,8,0.844444,0,0,10,14,false,true,true,0.913,0.087
184,143,41,23,17.875,41,977,976,1,0,0,0,0,48,8,8,0.708333,0,0,16,10,false,true,true,0.881,0.119
441,301,140,29.4,20.066667,140,1439,1353,86,1,0,0.066667,0,-9,15,15,-3.333333,0,0,4,5,true,true,true,1,0
357,262,95,32.454545,23.818182,95,1507,1554,-47,1,2,0.090909,0.181818,8,11,11,3.625,0,0,13,10,false,true,true,0.999,0.001
326,283,43,20.375,18.866667,43,1090,1244,-154,0,0,0,0,-7,16,15,-5.285714,0,1,13,3,false,true,true,0.844,0.156
0,0,0,0,0,0,1519,1782,-263,0,0,0,0,100,1,1,0.33,0,1,15,11,false,true,true,0.513,0.487
370,300,70,21.764706,18.75,70,804,988,-184,2,0,0.117647,0,-17,17,16,-1.941176,0,0,1,3,true,true,true,0.999,0.001
365,263,102,26.071429,20.230769,102,996,1063,-67,1,1,0.071429,0.076923,0,14,13,0,1,0,7,9,false,true,true,1,0
22,12,10,22,12,10,808,812,-4,0,0,0,0,92,1,1,0.402174,0,1,10,6,false,true,true,0.512,0.488
20,0,20,20,0,20,892,768,124,0,0,0,0,98,1,0,0.438776,0,0,19,0,false,true,true,0.545,0.455
59,116,-57,11.8,23.2,-57,1265,1045,220,0,0,0,0,62,5,5,0.677419,0,2,20,6,false,true,false,0.026,0.974
22,14,8,22,14,8,1419,1488,-69,0,0,0,0,92,1,1,0.304348,0,0,12,17,false,true,false,0.421,0.579
143,109,34,23.833333,21.8,34,809,868,-59,1,0,0.166667,0,54,6,5,0.592593,0,0,16,19,false,true,true,0.697,0.303
157,220,-63,14.272727,22,-63,613,611,2,0,0,0,0,22,11,10,1.727273,1,0,16,7,false,true,false,0.089,0.911
129,112,17,18.428571,18.666667,17,416,306,110,0,0,0,0,58,7,6,0.724138,0,1,11,12,false,true,true,0.576,0.424
217,191,26,24.111111,21.222222,26,1210,1252,-42,1,0,0.111111,0,36,9,9,0.888889,0,0,14,17,false,true,true,0.732,0.268
188,154,34,26.857143,22,34,1210,1252,-42,1,0,0.142857,0,47,7,7,0.680851,0,0,9,20,false,true,true,0.726,0.274
347,280,67,23.133333,20,67,1089,1063,26,1,0,0.066667,0,1,15,14,38,0,0,9,10,false,true,true,0.988,0.012
89,66,23,14.833333,11,23,880,952,-72,0,0,0,0,61,6,6,0.672131,0,0,10,18,false,true,false,0.496,0.504
194,194,0,13.857143,13.857143,0,826,771,55,0,0,0,0,22,14,14,2.045455,0,1,17,6,false,true,false,0.434,0.566
405,288,117,28.928571,22.153846,117,1245,1241,4,2,1,0.142857,0.076923,-16,14,13,-1.8125,0,0,1,2,false,true,true,1,0
46,30,16,23,15,16,859,811,48,0,0,0,0,83,2,2,0.433735,0,0,10,12,false,true,true,0.558,0.442
27,58,-31,9,19.333333,-31,1214,1176,38,0,0,0,0,78,3,3,0.461538,0,0,20,9,false,true,false,0.222,0.778
20,12,8,20,12,8,1069,917,152,0,0,0,0,91,1,1,0.373626,0,0,12,17,false,true,false,0.484,0.516
108,119,-11,18,23.8,-11,334,446,-112,0,0,0,0,62,6,5,0.645161,0,0,10,10,false,true,false,0.141,0.859
272,229,43,16,13.470588,43,698,742,-44,1,0,0.058824,0,4,17,17,10.25,0,0,10,13,false,true,true,0.965,0.035
29,15,14,14.5,15,14,1501,1622,-121,0,0,0,0,90,2,1,0.344444,1,0,18,19,false,true,true,0.734,0.266
336,275,61,18.666667,15.277778,61,739,480,259,1,0,0.055556,0,-17,18,18,-2.117647,0,2,11,2,true,true,true,0.997,0.003
115,98,17,28.75,24.5,17,992,1100,-108,1,0,0.25,0,68,4,4,0.5,1,0,6,11,false,true,true,0.541,0.459
268,179,89,16.75,11.933333,89,498,43,455,0,0,0,0,-1,16,15,-37,0,0,7,10,false,true,true,1,0
440,241,199,55,30.125,199,991,996,-5,3,0,0.375,0,31,8,8,0.967742,0,0,7,8,false,true,true,0.996,0.004
340,226,114,26.153846,18.833333,114,1034,1040,-6,1,0,0.076923,0,11,13,12,3.181818,1,0,7,19,false,true,true,1,0
329,196,133,16.45,10.315789,133,1428,1302,126,0,0,0,0,-15,20,19,-3.533333,0,1,14,18,false,true,true,1,0
151,244,-93,18.875,34.857143,-93,1762,1538,224,0,2,0,0.285714,42,8,7,0.809524,1,0,6,8,false,true,true,0.893,0.107
87,73,14,21.75,24.333333,14,1125,1227,-102,0,0,0,0,69,4,3,0.434783,0,0,10,15,false,true,false,0.205,0.795
89,21,68,44.5,21,68,1489,1555,-66,1,0,0.5,0,83,2,1,0.349398,0,0,14,20,false,true,true,0.509,0.491
370,193,177,33.636364,17.545455,177,1513,1482,31,1,0,0.090909,0,13,11,11,2.538462,0,0,9,9,false,true,true,1,0
83,62,21,27.666667,31,21,1431,802,629,0,0,0,0,77,3,2,0.415584,0,1,9,10,false,true,true,0.997,0.003
274,145,129,21.076923,12.083333,129,786,757,29,1,0,0.076923,0,19,13,12,2.052632,0,0,11,14,false,true,true,1,0
191,88,103,31.833333,14.666667,103,1216,1217,-1,1,0,0.166667,0,53,6,6,0.641509,0,0,10,26,false,true,true,0.997,0.003
93,62,31,31,31,31,991,996,-5,0,0,0,0,80,3,2,0.375,0,0,7,10,false,true,true,0.526,0.474
159,124,35,15.9,12.4,35,1128,889,239,0,1,0,0.1,39,10,10,1.205128,0,0,27,20,false,true,true,0.903,0.097
258,177,81,23.454545,16.090909,81,1439,1413,26,0,0,0,0,33,11,11,1.090909,1,0,14,9,false,true,true,0.996,0.004
319,287,32,15.95,14.35,32,480,518,-38,0,0,0,0,-18,20,20,-2.555556,0,0,3,5,false,true,true,0.998,0.002
385,158,227,32.083333,13.166667,227,1054,917,137,2,0,0.166667,0,6,12,12,5.833333,0,0,13,12,false,true,true,1,0
14,0,14,14,0,14,1221,1266,-45,0,0,0,0,96,1,0,0.364583,0,0,12,0,false,true,false,0.397,0.603
56,70,-14,18.666667,23.333333,-14,942,976,-34,0,0,0,0,76,3,3,0.526316,1,0,19,17,false,true,true,0.646,0.354
18,20,-2,18,20,-2,1189,1266,-77,0,0,0,0,90,1,1,0.377778,1,0,13,14,false,true,true,0.742,0.258
382,294,88,29.384615,24.5,88,1156,1184,-28,2,1,0.153846,0.083333,1,13,12,28,0,0,3,20,false,true,true,0.999,0.001
406,335,71,22.555556,19.705882,71,1220,1261,-41,2,0,0.111111,0,-9,18,17,-5,0,0,13,12,false,true,true,0.999,0.001
258,213,45,18.428571,15.214286,45,786,788,-2,0,0,0,0,-3,14,14,-11.333333,1,0,6,19,false,true,true,0.999,0.001
350,336,14,20.588235,19.764706,14,847,952,-105,0,0,0,0,-9,17,17,-4,0,1,2,2,false,true,true,0.993,0.007
233,208,25,23.3,23.111111,25,1344,1325,19,1,0,0.1,0,25,10,9,1.24,0,0,10,10,false,true,true,0.631,0.369
356,282,74,20.941176,16.588235,74,1004,653,351,0,0,0,0,-25,17,17,-1.4,0,0,1,1,false,true,true,1,0
256,218,38,23.272727,19.818182,38,1073,1177,-104,1,0,0.090909,0,20,11,11,1.6,0,0,10,17,false,true,true,0.774,0.226
383,277,106,31.916667,25.181818,106,1684,1320,364,1,0,0.083333,0,0,12,11,0,0,0,12,13,false,true,true,0.999,0.001
157,125,32,22.428571,20.833333,32,1036,1181,-145,0,0,0,0,59,7,6,0.576271,0,0,25,11,false,true,true,0.755,0.245
303,281,22,21.642857,21.615385,22,926,854,72,0,0,0,0,8,14,13,4.25,1,0,10,11,false,true,true,0.755,0.245
277,252,25,16.294118,15.75,25,523,480,43,1,0,0.058824,0,-19,17,16,-1.736842,0,0,3,2,true,true,true,0.951,0.049
327,239,88,18.166667,13.277778,88,758,750,8,0,0,0,0,-23,18,18,-1.608696,0,0,4,1,false,true,true,1,0
14,0,14,14,0,14,1102,1245,-143,0,0,0,0,96,1,0,0.291667,0,0,9,0,false,true,false,0.279,0.721
179,183,-4,22.375,26.142857,-4,942,976,-34,0,0,0,0,44,8,7,0.909091,0,0,15,8,false,true,false,0.229,0.771
403,380,23,19.190476,19,23,1096,1009,87,2,0,0.095238,0,-21,21,20,-2.095238,0,0,1,1,false,true,true,0.921,0.079
44,11,33,22,11,33,771,754,17,0,0,0,0,88,2,1,0.363636,1,0,9,9,false,true,true,0.541,0.459
22,29,-7,11,14.5,-7,1100,1008,92,0,0,0,0,88,2,2,0.409091,0,0,18,9,false,true,true,0.512,0.488
57,49,8,19,16.333333,8,1029,1075,-46,0,0,0,0,80,3,3,0.6,0,0,19,10,false,true,true,0.52,0.48
32,39,-7,16,19.5,-7,758,750,8,0,0,0,0,81,2,2,0.45679,1,0,6,9,false,true,true,0.521,0.479
271,236,35,24.636364,21.454545,35,1519,1782,-263,1,0,0.090909,0,23,11,11,1.434783,0,0,10,13,false,true,true,0.629,0.371
347,260,87,20.411765,15.294118,87,527,503,24,0,0,0,0,-3,17,17,-13.666667,0,0,7,7,false,true,true,1,0
298,250,48,17.529412,15.625,48,1221,1438,-217,0,0,0,0,10,17,16,4.5,0,1,18,7,false,true,true,0.673,0.327
182,96,86,26,13.714286,86,1093,1090,3,1,0,0.142857,0,58,7,7,0.586207,0,0,12,9,false,true,true,0.98,0.02
180,226,-46,12.857143,16.142857,-46,1075,989,86,0,0,0,0,24,14,14,1.625,1,0,19,17,false,true,false,0.106,0.894
42,46,-4,21,23,-4,613,611,2,0,0,0,0,85,2,2,0.447059,0,1,10,13,false,true,false,0.327,0.673
114,57,57,28.5,14.25,57,1210,1253,-43,0,0,0,0,67,4,4,0.507463,0,1,22,8,false,true,true,0.655,0.345
58,45,13,19.333333,15,13,786,788,-2,0,0,0,0,75,3,3,0.453333,0,0,16,21,false,true,false,0.38,0.62
162,122,40,18,15.25,40,1159,1051,108,0,0,0,0,49,9,8,0.816327,0,1,10,10,false,true,true,0.67,0.33
46,28,18,46,28,18,290,416,-126,0,0,0,0,89,1,1,0.382022,0,0,9,16,false,true,true,0.696,0.304
243,242,1,30.375,30.25,1,1875,1793,82,2,1,0.25,0.125,38,8,8,0.789474,0,0,7,16,false,true,true,0.726,0.274
157,133,24,19.625,16.625,24,804,683,121,0,0,0,0,47,8,8,0.957447,0,1,19,8,false,true,true,0.871,0.129
92,65,27,18.4,13,27,498,43,455,0,0,0,0,64,5,5,0.578125,1,0,6,12,false,true,true,0.683,0.317
152,51,101,50.666667,25.5,101,1397,1361,36,1,0,0.333333,0,77,3,2,0.376623,0,0,10,10,false,true,true,0.888,0.112
310,206,104,31,20.6,104,1093,1197,-104,2,0,0.2,0,26,10,10,1.192308,1,0,8,9,false,true,true,1,0
52,90,-38,17.333333,30,-38,1762,1582,180,0,1,0,0.333333,79,3,3,0.405063,0,0,14,15,false,true,true,0.809,0.191
329,230,99,20.5625,15.333333,99,371,336,35,2,0,0.125,0,-20,16,15,-1.9,0,0,3,15,false,true,true,0.999,0.001
128,72,56,25.6,18,56,1388,1477,-89,1,0,0.2,0,67,5,4,0.716418,0,0,11,9,false,true,true,0.554,0.446
402,329,73,26.8,23.5,73,1875,1793,82,2,1,0.133333,0.071429,-10,15,14,-3,0,0,5,2,false,true,true,0.999,0.001
12,0,12,12,0,12,942,976,-34,0,0,0,0,97,1,0,0.412371,0,0,15,0,false,true,false,0.486,0.514
215,250,-35,21.5,25,-35,1305,1242,63,1,1,0.1,0.1,32,10,10,1.0625,0,0,9,12,false,true,false,0.444,0.556
187,107,80,23.375,15.285714,80,1270,1348,-78,0,0,0,0,50,8,7,0.76,0,0,10,16,false,true,true,0.895,0.105
373,336,37,23.3125,21,37,1142,1176,-34,1,0,0.0625,0,-8,16,16,-4.5,1,0,3,3,false,true,true,1,0
335,300,35,22.333333,20,35,960,1070,-110,1,0,0.066667,0,-4,15,15,-8.75,0,0,9,4,false,true,true,0.992,0.008
46,52,-6,15.333333,26,-6,1077,1094,-17,0,0,0,0,80,3,2,0.525,0,0,23,16,false,true,false,0.25,0.75
383,374,9,21.277778,22,9,1320,1339,-19,2,1,0.111111,0.058824,-19,18,17,-2.052632,0,0,2,2,false,true,true,0.803,0.197
401,254,147,26.733333,18.142857,147,1270,1322,-52,1,0,0.066667,0,0,15,14,0,0,0,10,16,false,true,true,1,0
140,126,14,23.333333,25.2,14,290,416,-126,0,0,0,0,60,6,5,0.566667,0,0,13,14,false,true,true,0.711,0.289
252,145,107,36,24.166667,107,1762,1616,146,2,0,0.285714,0,41,7,6,0.731707,0,0,9,12,false,true,true,0.998,0.002
291,296,-5,15.315789,15.578947,-5,316,306,10,0,2,0,0.105263,-20,19,19,-1.9,0,0,1,5,true,true,false,0.205,0.795
109,102,7,10.9,11.333333,7,416,222,194,0,0,0,0,46,10,9,1.195652,1,0,10,17,false,true,true,0.758,0.242
239,213,26,26.555556,26.625,26,1030,1144,-114,0,1,0,0.125,40,9,8,0.875,0,1,12,7,false,true,true,0.644,0.356
268,273,-5,24.363636,27.3,-5,1636,1576,60,0,2,0,0.2,18,11,10,1.888889,0,0,17,9,false,true,false,0.243,0.757
147,76,71,24.5,15.2,71,719,651,68,0,0,0,0,68,6,5,0.661765,0,0,28,8,false,true,true,0.908,0.092
40,23,17,20,23,17,871,867,4,0,0,0,0,87,2,1,0.494253,0,0,21,14,false,true,false,0.335,0.665
223,188,35,31.857143,26.857143,35,908,1070,-162,1,0,0.142857,0,46,7,7,0.652174,0,0,12,12,false,true,true,0.734,0.266
143,119,24,20.428571,17,24,349,315,34,0,0,0,0,45,7,7,0.755556,0,0,12,9,false,true,true,0.804,0.196
335,249,86,30.454545,22.636364,86,1334,1477,-143,2,1,0.181818,0.090909,9,11,11,3.333333,0,0,13,7,false,true,true,0.999,0.001
177,158,19,22.125,22.571429,19,1189,1266,-77,0,0,0,0,47,8,7,0.723404,1,0,6,13,false,true,false,0.414,0.586
365,314,51,22.8125,20.933333,51,834,758,76,0,1,0,0.066667,-13,16,15,-2.769231,0,0,5,9,false,true,true,0.999,0.001
262,207,55,23.818182,20.7,55,1210,1252,-42,1,0,0.090909,0,24,11,10,1.333333,0,0,7,18,false,true,true,0.887,0.113
223,130,93,37.166667,26,93,1645,1777,-132,2,0,0.333333,0,47,6,5,0.531915,0,0,7,17,false,true,true,0.995,0.005
120,143,-23,20,28.6,-23,1125,1227,-102,0,0,0,0,52,6,5,0.576923,1,0,9,18,false,true,false,0.118,0.882
297,210,87,18.5625,14,87,576,532,44,0,0,0,0,3,16,15,15.333333,0,0,9,10,false,true,true,0.999,0.001
133,97,36,22.166667,16.166667,36,1073,1177,-104,0,0,0,0,59,6,6,0.542373,0,0,11,19,false,true,true,0.738,0.262
16,14,2,16,14,2,613,502,111,0,0,0,0,92,1,1,0.532609,0,0,9,13,false,true,false,0.452,0.548
381,273,108,29.307692,21,108,1519,1782,-263,2,0,0.153846,0,7,13,13,4.714286,0,0,18,12,false,true,true,1,0
198,179,19,16.5,16.272727,19,613,461,152,0,1,0,0.090909,14,12,11,2.642857,0,0,11,15,false,true,true,0.855,0.145
332,313,19,18.444444,18.411765,19,1127,1176,-49,0,0,0,0,-13,18,17,-3.230769,0,0,3,4,false,true,true,0.877,0.123
38,48,-10,12.666667,24,-10,1161,1166,-5,0,0,0,0,82,3,2,0.426829,0,0,7,14,false,true,false,0.112,0.888
42,33,9,14,16.5,9,371,435,-64,0,0,0,0,81,3,2,0.54321,1,0,17,11,false,true,true,0.524,0.476
371,258,113,19.526316,13.578947,113,1413,1422,-9,0,0,0,0,-10,19,19,-5.7,0,0,9,7,false,true,true,1,0
255,199,56,23.181818,19.9,56,866,949,-83,0,0,0,0,25,11,10,1.6,1,0,6,15,false,true,true,0.962,0.038
366,316,50,19.263158,16.631579,50,1295,1281,14,0,0,0,0,-10,19,19,-3.8,0,0,15,4,true,true,true,0.995,0.005
350,220,130,16.666667,11,130,871,867,4,0,0,0,0,-18,21,20,-2.388889,0,0,6,9,false,true,true,1,0
111,114,-3,15.857143,16.285714,-3,540,518,22,0,0,0,0,53,7,7,0.754717,0,0,8,13,false,true,false,0.451,0.549
297,224,73,27,20.363636,73,1305,1218,87,1,0,0.090909,0,19,11,11,2,0,0,17,9,false,true,true,0.979,0.021
41,8,33,20.5,8,33,415,518,-103,0,0,0,0,87,2,1,0.436782,0,0,13,26,false,true,true,0.642,0.358
39,22,17,19.5,11,17,939,913,26,0,0,0,0,88,2,2,0.454545,0,0,9,7,false,true,true,0.53,0.47
38,35,3,19,17.5,3,711,876,-165,0,0,0,0,85,2,2,0.505882,0,0,7,23,false,true,false,0.156,0.844
90,128,-38,15,21.333333,-38,1583,1422,161,0,0,0,0,64,6,6,0.796875,1,0,17,7,false,true,true,0.724,0.276
240,224,16,20,18.666667,16,786,847,-61,0,0,0,0,18,12,12,1.888889,0,0,16,13,false,true,true,0.72,0.28
322,248,74,20.125,16.533333,74,695,523,172,0,0,0,0,-11,16,15,-3.363636,0,0,5,8,false,true,true,1,0
389,297,92,24.3125,19.8,92,1556,1591,-35,2,0,0.125,0,-14,16,15,-2.571429,0,0,2,4,false,true,true,1,0
176,150,26,25.142857,25,26,1394,1424,-30,0,1,0,0.166667,53,7,6,0.603774,0,0,18,19,false,true,true,0.725,0.275
26,22,4,13,22,4,611,584,27,0,0,0,0,90,2,1,0.488889,0,0,21,19,false,true,false,0.287,0.713
399,319,80,16.625,13.869565,80,1583,1422,161,1,0,0.041667,0,-18,24,23,-2.833333,0,0,2,7,false,true,true,0.993,0.007
126,90,36,25.2,22.5,36,1501,1622,-121,0,0,0,0,67,5,4,0.462687,1,0,12,21,false,true,true,0.839,0.161
117,115,2,16.714286,19.166667,2,1142,1176,-34,0,0,0,0,52,7,6,0.692308,1,0,7,16,false,true,false,0.283,0.717
201,183,18,20.1,20.333333,18,971,658,313,0,0,0,0,33,10,9,1.090909,0,0,14,14,false,true,false,0.363,0.637
412,323,89,24.235294,20.1875,89,1075,1027,48,2,1,0.117647,0.0625,-20,17,16,-1.85,0,0,4,4,false,true,true,0.999,0.001
333,168,165,25.615385,14,165,1413,1422,-9,0,0,0,0,18,13,12,3.166667,0,0,7,11,false,true,true,1,0
266,213,53,22.166667,17.75,53,719,651,68,0,1,0,0.083333,29,12,12,1.551724,0,0,9,11,false,true,true,0.96,0.04
357,231,126,18.789474,12.157895,126,595,543,52,0,0,0,0,-17,19,19,-2.764706,0,0,10,7,false,true,true,1,0
143,142,1,20.428571,23.666667,1,1161,1166,-5,1,0,0.142857,0,50,7,6,0.7,0,1,11,14,false,true,false,0.128,0.872
472,193,279,36.307692,14.846154,279,1431,825,606,2,1,0.153846,0.076923,7,13,13,4.857143,0,0,16,16,false,true,true,1,0
299,217,82,13.590909,10.333333,82,310,359,-49,0,0,0,0,-40,22,21,-1.225,0,0,12,17,false,true,true,1,0
317,243,74,28.818182,22.090909,74,630,786,-156,1,0,0.090909,0,21,11,11,1.666667,0,0,11,12,false,true,true,0.999,0.001
324,298,26,20.25,19.866667,26,1277,1166,111,0,1,0,0.066667,-7,16,15,-5.142857,0,0,5,9,false,true,true,0.585,0.415
155,119,36,25.833333,19.833333,36,1548,1493,55,1,0,0.166667,0,52,6,6,0.788462,0,0,13,19,false,true,true,0.549,0.451
154,108,46,22,15.428571,46,421,306,115,0,1,0,0.142857,37,7,7,1.189189,0,0,19,10,false,true,true,0.975,0.025
170,118,52,34,29.5,52,1203,1221,-18,1,0,0.2,0,67,5,4,0.522388,1,0,6,12,false,true,true,0.864,0.136
179,192,-13,19.888889,24,-13,869,820,49,0,1,0,0.125,47,9,8,0.787234,0,1,10,8,false,true,false,0.046,0.954
290,257,33,24.166667,23.363636,33,1023,1110,-87,1,1,0.083333,0.090909,6,12,11,5,1,0,13,10,false,true,true,0.965,0.035
337,261,76,22.466667,18.642857,76,1065,1030,35,0,1,0,0.071429,-5,15,14,-6.8,0,0,6,11,false,true,true,0.999,0.001
154,147,7,15.4,16.333333,7,523,480,43,1,0,0.1,0,33,10,9,1,0,0,12,10,false,true,true,0.722,0.278
418,259,159,38,23.545455,159,1571,1554,17,2,1,0.181818,0.090909,9,11,11,3.666667,1,0,13,12,false,true,true,1,0
165,115,50,20.625,14.375,50,871,867,4,0,0,0,0,49,8,8,0.877551,0,0,10,15,false,true,true,0.89,0.11
187,144,43,20.777778,18,43,468,542,-74,0,0,0,0,46,9,8,0.847826,0,1,9,15,false,true,true,0.775,0.225
171,54,117,42.75,18,117,918,619,299,2,0,0.5,0,69,4,3,0.507246,0,0,9,13,false,true,true,0.999,0.001
413,331,82,20.65,16.55,82,995,912,83,2,0,0.1,0,-20,20,20,-2.2,0,0,2,10,false,true,true,0.999,0.001
161,81,80,26.833333,16.2,80,786,757,29,1,0,0.166667,0,60,6,5,0.65,0,0,7,12,false,true,true,0.944,0.056
307,193,114,30.7,21.444444,114,1397,1361,36,1,0,0.1,0,21,10,9,1.380952,0,0,16,10,false,true,true,1,0
24,0,24,24,0,24,1396,1454,-58,0,0,0,0,96,1,0,0.34375,0,0,12,0,false,true,false,0.472,0.528
95,136,-41,15.833333,22.666667,-41,856,897,-41,0,0,0,0,53,6,6,0.660377,1,0,11,17,false,true,false,0.128,0.872
517,310,207,43.083333,25.833333,207,991,996,-5,3,0,0.25,0,3,12,12,10,0,0,11,15,false,true,true,1,0
117,167,-50,14.625,23.857143,-50,1154,1062,92,0,0,0,0,50,8,7,0.7,0,0,11,24,false,true,false,0.105,0.895
120,93,27,24,18.6,27,1036,1181,-145,0,0,0,0,66,5,5,0.515152,0,1,18,13,false,true,false,0.478,0.522
67,98,-31,11.166667,16.333333,-31,523,480,43,0,0,0,0,60,6,6,0.55,0,0,22,7,false,true,false,0.276,0.724
269,177,92,33.625,22.125,92,1203,1221,-18,2,0,0.25,0,45,8,8,0.777778,0,0,13,10,false,true,true,0.983,0.017
328,306,22,16.4,16.105263,22,947,810,137,0,1,0,0.052632,-22,20,19,-1.909091,0,0,2,8,false,true,true,0.763,0.237
250,180,70,27.777778,22.5,70,1142,1095,47,1,0,0.111111,0,33,9,8,1.060606,0,1,18,18,false,true,true,0.796,0.204
139,81,58,23.166667,16.2,58,1489,1445,44,0,0,0,0,59,6,5,0.542373,0,0,14,9,false,true,true,0.67,0.33
209,188,21,23.222222,20.888889,21,315,294,21,0,1,0,0.111111,27,9,9,1.296296,0,0,11,21,false,true,true,0.766,0.234
371,228,143,19.526316,12.666667,143,872,818,54,0,1,0,0.055556,-11,19,18,-3.727273,0,0,6,6,false,true,true,1,0
96,49,47,24,16.333333,47,576,532,44,0,0,0,0,74,4,3,0.621622,1,0,11,9,false,true,true,0.611,0.389
320,230,90,22.857143,17.692308,90,1516,1397,119,0,1,0,0.076923,0,14,13,0,0,1,13,9,false,true,true,0.996,0.004
422,356,66,30.142857,25.428571,66,1684,1320,364,1,0,0.071429,0,-11,14,14,-2.727273,0,0,4,6,false,true,true,1,0
339,216,123,30.818182,19.636364,123,1101,1078,23,1,0,0.090909,0,20,11,11,1.65,0,1,10,16,false,true,true,1,0
312,285,27,24,23.75,27,1305,1242,63,2,1,0.153846,0.083333,10,13,12,3.4,0,0,20,8,false,true,true,0.932,0.068
332,222,110,25.538462,18.5,110,769,527,242,1,0,0.076923,0,5,13,12,7.2,0,0,11,8,false,true,true,1,0
24,48,-24,12,24,-24,1102,1245,-143,0,0,0,0,82,2,2,0.341463,0,0,9,12,false,true,false,0.117,0.883
244,157,87,40.666667,26.166667,87,1203,1221,-18,2,0,0.333333,0,54,6,6,0.648148,0,0,12,9,false,true,true,0.962,0.038
352,306,46,25.142857,23.538462,46,1439,1397,42,1,2,0.071429,0.153846,-5,14,13,-6.8,0,0,6,19,false,true,true,0.985,0.015
109,52,57,54.5,26,57,971,621,350,1,0,0.5,0,82,2,2,0.390244,0,0,15,7,false,true,true,0.868,0.132
163,124,39,20.375,17.714286,39,847,952,-105,0,0,0,0,56,8,7,0.642857,0,1,7,17,false,true,false,0.229,0.771
38,41,-3,19,20.5,-3,1227,1060,167,0,0,0,0,89,2,2,0.449438,0,0,7,10,false,true,true,0.504,0.496
254,193,61,14.111111,11.352941,61,1016,1037,-21,0,0,0,0,6,18,17,8,1,0,8,23,false,true,true,0.98,0.02
200,155,45,22.222222,17.222222,45,804,988,-184,1,0,0.111111,0,37,9,9,0.891892,0,0,10,17,false,true,true,0.76,0.24
136,119,17,17,17,17,691,675,16,0,0,0,0,46,8,7,0.826087,0,0,14,11,false,true,true,0.564,0.436
302,302,0,13.727273,14.380952,0,613,549,64,0,0,0,0,-35,22,21,-1.257143,0,0,1,1,false,true,false,0.5,0.5
365,367,-2,20.277778,20.388889,-2,1439,1413,26,0,1,0,0.055556,-16,18,18,-2.25,0,0,3,2,true,true,false,0.138,0.862
403,344,59,19.190476,17.2,59,892,788,104,3,0,0.142857,0,-22,21,20,-1.954545,0,0,1,1,false,true,true,0.988,0.012
93,100,-7,13.285714,16.666667,-7,416,374,42,0,0,0,0,66,7,6,0.69697,1,0,11,11,false,true,false,0.383,0.617
366,283,83,20.333333,16.647059,83,859,811,48,0,0,0,0,-20,18,17,-1.8,0,1,2,1,false,true,true,1,0
315,165,150,19.6875,11,150,942,1003,-61,0,0,0,0,0,16,15,0,1,1,24,15,false,true,true,1,0
353,334,19,17.65,17.578947,19,825,907,-82,1,0,0.05,0,-24,20,19,-1.666667,0,0,1,9,false,true,true,0.903,0.097
265,206,59,20.384615,17.166667,59,808,639,169,0,0,0,0,18,13,12,2.277778,0,1,11,9,false,true,true,0.989,0.011
375,303,72,23.4375,18.9375,72,1109,1065,44,0,0,0,0,-28,16,16,-1.178571,0,0,1,1,false,true,true,1,0
109,105,4,10.9,10.5,4,416,222,194,0,0,0,0,43,10,10,1.27907,1,0,10,20,false,true,true,0.852,0.148
351,303,48,50.142857,50.5,48,1370,1431,-61,2,1,0.285714,0.166667,36,7,6,0.638889,0,0,12,12,false,true,true,0.998,0.002
24,18,6,24,18,6,1333,1331,2,0,0,0,0,89,1,1,0.337079,0,1,9,22,false,true,false,0.324,0.676
22,0,22,22,0,22,1265,1045,220,0,0,0,0,94,1,0,0.446809,0,0,23,0,false,true,true,0.538,0.462
333,231,102,37,28.875,102,1645,1777,-132,2,0,0.222222,0,17,9,8,1.470588,0,0,13,7,false,true,true,0.999,0.001
162,89,73,32.4,17.8,73,1156,1114,42,1,0,0.2,0,55,5,5,0.581818,0,0,16,10,false,true,true,0.914,0.086
0,0,0,0,0,0,1554,1622,-68,0,0,0,0,100,1,0,0.31,0,0,10,0,false,true,false,0.246,0.754
442,306,136,34,25.5,136,1489,1405,84,3,0,0.230769,0,-1,13,12,-28,0,0,5,7,false,true,true,1,0
327,316,11,18.166667,17.555556,11,1295,1281,14,0,0,0,0,-4,18,18,-9.5,0,0,15,4,false,true,true,0.619,0.381
352,302,50,18.526316,16.777778,50,1434,1493,-59,1,0,0.052632,0,-14,19,18,-2.642857,0,0,6,1,true,true,true,0.999,0.001
76,59,17,12.666667,11.8,17,904,857,47,0,0,0,0,64,6,5,0.640625,0,1,25,15,false,true,false,0.461,0.539
169,159,10,16.9,17.666667,10,628,658,-30,0,0,0,0,39,10,9,1.179487,0,1,16,9,false,true,false,0.192,0.808
146,139,7,18.25,17.375,7,416,306,110,0,0,0,0,48,8,8,0.875,0,0,10,10,false,true,true,0.739,0.261
263,170,93,17.533333,12.142857,93,1586,1782,-196,0,0,0,0,10,15,14,4,1,0,9,17,false,true,true,0.995,0.005
31,17,14,15.5,17,14,1261,1349,-88,0,0,0,0,88,2,1,0.147727,0,0,16,18,false,true,false,0.232,0.768
371,291,80,19.526316,16.166667,80,527,581,-54,0,0,0,0,-26,19,18,-1.615385,0,0,2,6,false,true,true,1,0
341,287,54,22.733333,20.5,54,976,965,11,1,0,0.066667,0,-10,15,14,-3.2,1,0,2,5,false,true,true,1,0
13,23,-10,6.5,11.5,-10,1295,1477,-182,0,0,0,0,90,2,2,0.511111,0,0,7,9,false,true,false,0.245,0.755
336,312,24,18.666667,18.352941,24,594,605,-11,0,0,0,0,-19,18,17,-1.947368,0,0,1,1,false,true,true,0.984,0.016
127,123,4,21.166667,24.6,4,942,976,-34,0,0,0,0,60,6,5,0.666667,1,0,12,19,false,true,false,0.372,0.628
209,231,-22,17.416667,19.25,-22,947,810,137,0,1,0,0.083333,25,12,12,1.68,0,0,15,15,false,true,true,0.514,0.486
6,0,6,6,0,6,1045,1009,36,0,0,0,0,97,1,1,0.391753,0,0,15,0,false,true,true,0.511,0.489
88,70,18,22,23.333333,18,1237,1277,-40,0,0,0,0,70,4,3,0.414286,0,0,19,24,false,true,false,0.275,0.725
70,62,8,17.5,20.666667,8,500,567,-67,0,0,0,0,78,4,3,0.564103,0,0,10,7,false,true,false,0.375,0.625
273,298,-25,27.3,29.8,-25,1125,1227,-102,1,1,0.1,0.1,13,10,10,2.307692,1,0,8,8,false,true,false,0.302,0.698
346,330,16,21.625,20.625,16,1076,1176,-100,0,1,0,0.0625,-11,16,16,-2.909091,0,0,2,3,true,true,true,0.991,0.009
22,14,8,22,14,8,1636,1576,60,0,1,0,1,88,1,1,0.386364,0,1,12,8,false,true,true,0.999,0.001
79,38,41,39.5,19,41,809,868,-59,1,0,0.5,0,81,2,2,0.395062,0,0,16,7,false,true,true,0.531,0.469
187,108,79,23.375,15.428571,79,421,306,115,0,1,0,0.142857,33,8,7,1.333333,0,0,34,10,false,true,true,0.98,0.02
146,129,17,18.25,16.125,17,695,523,172,0,0,0,0,38,8,8,0.973684,0,0,12,19,false,true,true,0.73,0.27
133,159,-26,16.625,19.875,-26,916,876,40,0,0,0,0,38,8,8,0.894737,1,0,14,7,false,true,true,0.504,0.496
346,200,146,18.210526,11.111111,146,896,818,78,0,1,0,0.055556,-4,19,18,-11,1,0,20,8,false,true,true,1,0
172,194,-22,15.636364,19.4,-22,1043,1055,-12,0,0,0,0,34,11,10,1.088235,0,0,19,7,false,true,false,0.109,0.891
339,245,94,19.941176,15.3125,94,691,675,16,0,0,0,0,-9,17,16,-4.111111,0,1,3,7,false,true,true,1,0
413,331,82,19.666667,16.55,82,995,912,83,2,0,0.095238,0,-20,21,20,-2.2,0,0,2,10,false,true,true,0.998,0.002
270,111,159,30,13.875,159,1482,1554,-72,1,0,0.111111,0,38,9,8,0.947368,0,0,19,10,false,true,true,0.999,0.001
8,0,8,8,0,8,95,378,-283,0,0,0,0,97,1,0,0.360825,1,0,6,0,false,true,false,0.349,0.651
289,270,19,22.230769,22.5,19,1406,1454,-48,0,2,0,0.166667,5,13,12,6.8,1,0,19,9,false,true,true,0.972,0.028
201,62,139,20.1,6.2,139,1176,1076,100,0,0,0,0,54,10,10,1.092593,0,1,15,15,false,true,true,0.998,0.002
237,181,56,21.545455,18.1,56,1513,1479,34,0,0,0,0,26,11,10,1.307692,1,0,10,15,false,true,true,0.941,0.059
375,339,36,28.846154,26.076923,36,1153,1065,88,0,1,0,0.076923,-15,13,13,-1.866667,0,0,7,4,false,true,true,0.98,0.02
369,309,60,41,34.333333,60,1983,2020,-37,2,1,0.222222,0.111111,21,9,9,1.238095,0,0,9,12,false,true,true,0.999,0.001
288,228,60,24,19,60,306,169,137,0,0,0,0,5,12,12,6.8,0,0,10,11,false,true,true,0.999,0.001
358,283,75,21.058824,16.647059,75,859,811,48,0,0,0,0,-17,17,17,-2.117647,0,1,2,1,false,true,true,1,0
371,375,-4,30.916667,31.25,-4,1935,2020,-85,0,1,0,0.083333,3,12,12,10.333333,0,0,12,11,false,true,true,0.747,0.253
303,293,10,21.642857,20.928571,10,926,854,72,0,0,0,0,5,14,14,6.8,1,0,10,7,false,true,true,0.887,0.113
418,232,186,22,12.888889,186,1295,1477,-182,3,0,0.157895,0,-9,19,18,-5.111111,0,0,5,10,false,true,true,1,0
400,302,98,25,18.875,98,1550,1466,84,1,0,0.0625,0,-12,16,16,-3.083333,0,0,6,3,false,true,true,1,0
390,226,164,24.375,15.066667,164,954,1078,-124,1,1,0.0625,0.066667,-7,16,15,-5.428571,0,0,7,13,false,true,true,1,0
238,179,59,29.75,22.375,59,1803,1552,251,1,1,0.125,0.125,39,8,8,0.717949,1,0,8,7,false,true,true,0.942,0.058
38,8,30,19,8,30,1181,1069,112,0,0,0,0,89,2,1,0.41573,1,0,11,10,false,true,true,0.776,0.224
326,103,223,19.176471,6.4375,223,896,818,78,0,0,0,0,13,17,16,3.384615,1,1,10,6,false,true,true,1,0
257,221,36,32.125,27.625,36,1633,1580,53,2,0,0.25,0,35,8,8,0.8,0,0,9,18,false,true,true,0.754,0.246
23,38,-15,11.5,19,-15,1128,889,239,0,1,0,0.5,84,2,2,0.559524,1,0,7,7,false,true,false,0.34,0.66
282,197,85,23.5,17.909091,85,960,1070,-110,1,0,0.083333,0,23,12,11,1.521739,0,1,21,6,false,true,true,0.893,0.107
359,297,62,19.944444,16.5,62,941,926,15,1,0,0.055556,0,-16,18,18,-2.375,0,0,4,1,false,true,true,1,0
99,62,37,16.5,10.333333,37,1030,1045,-15,0,0,0,0,66,6,6,0.69697,0,0,10,17,false,true,true,0.819,0.181
112,73,39,18.666667,14.6,39,971,658,313,0,0,0,0,62,6,5,0.580645,0,0,22,7,false,true,true,0.887,0.113
62,20,42,20.666667,10,42,595,543,52,0,0,0,0,83,3,2,0.566265,0,0,10,7,false,true,true,0.843,0.157
77,127,-50,15.4,25.4,-50,719,785,-66,0,1,0,0.2,62,5,5,0.580645,0,0,9,10,false,true,false,0.12,0.88
531,310,221,40.846154,25.833333,221,991,996,-5,3,0,0.230769,0,-1,13,12,-30,0,0,18,15,false,true,true,1,0
109,25,84,36.333333,12.5,84,371,336,35,1,0,0.333333,0,75,3,2,0.506667,0,0,14,10,false,true,true,0.939,0.061
163,50,113,40.75,16.666667,113,925,801,124,1,0,0.25,0,76,4,3,0.526316,1,0,6,9,false,true,true,0.997,0.003
348,273,75,21.75,17.0625,75,1216,1217,-1,1,0,0.0625,0,-13,16,16,-2.615385,0,0,4,2,false,true,true,1,0
238,175,63,21.636364,15.909091,63,505,95,410,0,1,0,0.090909,39,11,11,1.128205,0,1,10,10,false,true,true,0.953,0.047
296,315,-19,16.444444,17.5,-19,1388,1477,-89,1,0,0.055556,0,-9,18,18,-5.333333,1,0,9,13,false,true,false,0.196,0.804
276,241,35,19.714286,17.214286,35,1045,1009,36,1,0,0.071429,0,9,14,14,4.222222,1,0,16,16,false,true,true,0.98,0.02
98,66,32,24.5,16.5,32,719,651,68,0,0,0,0,78,4,4,0.576923,1,0,26,8,false,true,true,0.927,0.073
163,154,9,20.375,19.25,9,349,315,34,0,0,0,0,34,8,8,1,0,0,8,9,false,true,true,0.73,0.27
279,325,-46,23.25,27.083333,-46,1762,1538,224,1,2,0.083333,0.166667,16,12,12,2.125,0,0,21,9,false,true,true,0.718,0.282
377,318,59,34.272727,31.8,59,1880,1777,103,1,1,0.090909,0.1,11,11,10,2.545455,0,0,13,8,false,true,true,0.95,0.05
363,309,54,18.15,16.263158,54,904,783,121,0,0,0,0,-25,20,19,-1.68,1,0,1,4,false,true,true,1,0
207,191,16,20.7,21.222222,16,1782,1512,270,1,1,0.1,0.111111,39,10,9,1.076923,0,0,18,10,false,true,true,0.981,0.019
382,344,38,27.285714,26.461538,38,1454,1531,-77,1,1,0.071429,0.076923,-7,14,13,-4.285714,0,0,3,5,false,true,true,0.997,0.003
204,143,61,34,23.833333,61,1142,1095,47,1,0,0.166667,0,50,6,6,0.7,0,1,16,16,false,true,true,0.884,0.116
284,233,51,21.846154,19.416667,51,820,822,-2,0,0,0,0,13,13,12,3,0,0,22,8,false,true,true,0.817,0.183
117,18,99,23.4,4.5,99,1033,1037,-4,0,0,0,0,71,5,4,0.633803,0,0,13,8,false,true,true,0.977,0.023
381,307,74,20.052632,16.157895,74,1089,1063,26,1,0,0.052632,0,-19,19,19,-2,0,0,1,6,true,true,true,1,0
147,52,95,29.4,13,95,942,1003,-61,0,0,0,0,65,5,4,0.692308,0,0,13,16,false,true,true,0.907,0.093
369,246,123,23.0625,16.4,123,1482,1394,88,2,0,0.125,0,-5,16,15,-7.2,0,0,5,15,false,true,true,1,0
428,256,172,22.526316,13.473684,172,954,1078,-124,1,1,0.052632,0.052632,-24,19,19,-1.583333,0,0,1,2,true,true,true,1,0
349,254,95,20.529412,15.875,95,711,876,-165,0,0,0,0,-7,17,16,-6.142857,0,1,5,3,false,true,true,1,0
99,29,70,33,14.5,70,1572,1550,22,1,0,0.333333,0,80,3,2,0.4875,0,0,11,10,false,true,true,0.538,0.462
209,178,31,20.9,17.8,31,1069,917,152,0,1,0,0.1,34,10,10,1,0,0,17,19,false,true,true,0.891,0.109
238,202,36,17,14.428571,36,371,435,-64,0,0,0,0,5,14,14,8.8,0,0,15,8,false,true,true,0.954,0.046
244,182,62,20.333333,16.545455,62,844,821,23,0,0,0,0,40,12,11,1.05,0,0,19,9,false,true,true,0.962,0.038
93,142,-49,18.6,35.5,-49,1762,1538,224,0,1,0,0.25,65,5,4,0.523077,0,0,11,8,false,true,true,0.653,0.347
387,251,136,19.35,13.210526,136,1011,921,90,1,0,0.05,0,-13,20,19,-3.769231,0,0,6,13,false,true,true,1,0
351,207,144,23.4,14.785714,144,554,342,212,0,0,0,0,-8,15,14,-4.5,0,0,4,19,false,true,true,1,0
316,226,90,19.75,15.066667,90,746,796,-50,0,1,0,0.066667,3,16,15,16,0,1,15,14,false,true,true,0.998,0.002
116,81,35,19.333333,16.2,35,1164,1201,-37,0,0,0,0,62,6,5,0.677419,0,1,20,9,false,true,false,0.48,0.52
93,55,38,18.6,11,38,896,818,78,0,0,0,0,74,5,5,0.594595,0,0,23,16,false,true,true,0.882,0.118
176,156,20,22,22.285714,20,892,788,104,1,0,0.125,0,53,8,7,0.811321,0,0,12,14,false,true,true,0.73,0.27
255,217,38,15,12.764706,38,416,374,42,0,0,0,0,6,17,17,7.666667,0,0,19,7,false,true,true,0.98,0.02
32,0,32,32,0,32,974,995,-21,0,0,0,0,94,1,0,0.351064,0,0,21,0,false,true,true,0.69,0.31
174,57,117,43.5,19,117,1396,1454,-58,1,0,0.25,0,73,4,3,0.452055,1,0,12,10,false,true,true,0.993,0.007
206,185,21,15.846154,15.416667,21,613,502,111,0,0,0,0,17,13,12,2.882353,0,1,10,19,false,true,true,0.563,0.437
383,313,70,25.533333,22.357143,70,1762,1582,180,2,3,0.133333,0.214286,-8,15,14,-4,0,0,1,24,false,true,true,0.988,0.012
385,217,168,55,31,168,991,996,-5,3,0,0.428571,0,38,7,7,0.789474,0,0,10,11,false,true,true,0.855,0.145
344,286,58,19.111111,16.823529,58,1572,1550,22,1,0,0.055556,0,-11,18,17,-3.545455,0,0,8,3,false,true,true,0.998,0.002
14,0,14,14,0,14,1452,1469,-17,0,0,0,0,96,1,0,0.395833,0,0,7,0,false,true,false,0.288,0.712
294,265,29,14.7,13.25,29,371,435,-64,0,0,0,0,-27,20,20,-1.62963,0,0,2,2,false,true,true,0.998,0.002
235,165,70,23.5,16.5,70,960,1070,-110,1,0,0.1,0,33,10,10,1.060606,0,0,11,16,false,true,true,0.97,0.03
264,197,67,26.4,19.7,67,758,796,-38,0,0,0,0,25,10,10,1.52,0,1,11,15,false,true,true,0.999,0.001
340,326,14,21.25,21.733333,14,974,995,-21,0,1,0,0.066667,-9,16,15,-3.666667,0,0,2,1,false,true,true,0.808,0.192
53,72,-19,13.25,24,-19,1221,1266,-45,0,0,0,0,74,4,3,0.472973,0,0,16,7,false,true,false,0.152,0.848
8,0,8,8,0,8,941,926,15,0,0,0,0,96,1,0,0.395833,1,0,7,0,false,true,false,0.496,0.504
324,293,31,24.923077,22.538462,31,1554,1573,-19,1,0,0.076923,0,13,13,13,2.615385,0,1,19,9,false,true,true,0.79,0.21
382,304,78,21.222222,16.888889,78,1305,1218,87,1,1,0.055556,0.055556,-34,18,18,-1.117647,0,0,1,1,false,true,true,0.999,0.001
97,62,35,48.5,31,35,1684,1320,364,1,0,0.5,0,82,2,2,0.365854,0,0,9,14,false,true,true,0.964,0.036
373,211,162,20.722222,12.411765,162,786,757,29,1,0,0.055556,0,-10,18,17,-3.9,0,0,20,14,false,true,true,1,0
54,22,32,18,11,32,1277,1166,111,0,0,0,0,82,3,2,0.439024,0,0,14,14,false,true,true,0.524,0.476
215,176,39,23.888889,19.555556,39,1266,1144,122,0,0,0,0,35,9,9,0.971429,1,0,15,16,false,true,true,0.956,0.044
343,171,172,34.3,17.1,172,1513,1482,31,1,0,0.1,0,19,10,10,1.736842,0,0,10,12,false,true,true,1,0
44,23,21,44,23,21,1270,1315,-45,0,0,0,0,90,1,1,0.4,0,0,14,10,false,true,true,0.636,0.364
342,296,46,16.285714,14.8,46,1077,1094,-17,0,0,0,0,-24,21,20,-1.75,1,0,2,1,false,true,true,0.998,0.002
48,22,26,24,22,26,1036,1181,-145,0,0,0,0,91,2,1,0.373626,0,1,25,8,false,true,false,0.492,0.508
193,116,77,24.125,16.571429,77,746,796,-50,0,1,0,0.142857,40,8,7,1.2,0,0,11,17,false,true,true,0.973,0.027
23,16,7,11.5,16,7,1550,1546,4,0,0,0,0,89,2,1,0.337079,0,0,19,9,false,true,false,0.377,0.623
450,314,136,23.684211,16.526316,136,1167,1216,-49,1,0,0.052632,0,-13,19,19,-3.153846,0,0,1,2,false,true,true,1,0
134,81,53,26.8,16.2,53,554,342,212,0,0,0,0,63,5,5,0.571429,0,0,12,7,false,true,true,0.927,0.073
10,18,-8,10,18,-8,628,658,-30,0,0,0,0,91,1,1,0.505495,0,0,26,9,false,true,false,0.399,0.601
184,204,-20,15.333333,17,-20,1176,1127,49,0,0,0,0,18,12,12,2.055556,1,0,12,23,false,true,false,0.117,0.883
236,123,113,23.6,12.3,113,942,1003,-61,0,0,0,0,30,10,10,1.5,0,1,24,15,false,true,true,0.993,0.007
0,18,-18,0,18,-18,1489,1558,-69,0,0,0,0,94,1,1,0.297872,0,0,0,15,false,true,false,0.221,0.779
224,210,14,16,16.153846,14,908,859,49,0,0,0,0,14,14,13,2.785714,0,1,19,11,false,true,false,0.234,0.766
42,20,22,21,10,22,719,651,68,0,0,0,0,92,2,2,0.48913,1,0,24,13,false,true,true,0.847,0.153
214,157,57,21.4,17.444444,57,1516,1397,119,0,1,0,0.111111,28,10,9,1.178571,0,0,18,8,false,true,true,0.954,0.046
59,49,10,11.8,12.25,10,1265,1045,220,0,0,0,0,65,5,4,0.646154,0,1,20,17,false,true,true,0.511,0.489
165,130,35,16.5,13,35,698,742,-44,0,0,0,0,51,10,10,0.803922,0,0,7,16,false,true,true,0.74,0.26
241,198,43,17.214286,14.142857,43,363,668,-305,0,0,0,0,16,14,14,2.6875,0,1,21,11,false,true,true,0.725,0.275
253,289,-36,21.083333,24.083333,-36,1127,1134,-7,0,1,0,0.083333,9,12,12,3.333333,0,0,10,15,false,true,false,0.342,0.658
187,116,71,23.375,14.5,71,1270,1348,-78,0,0,0,0,47,8,8,0.808511,0,0,10,16,false,true,true,0.907,0.093
261,213,48,17.4,15.214286,48,786,788,-2,0,0,0,0,-6,15,14,-5.666667,1,0,7,19,false,true,true,0.998,0.002
125,155,-30,20.833333,25.833333,-30,1364,1093,271,0,1,0,0.166667,57,6,6,0.666667,0,0,15,7,false,true,true,0.876,0.124
124,82,42,20.666667,16.4,42,1037,950,87,1,0,0.166667,0,61,6,5,0.508197,0,0,14,11,false,true,true,0.837,0.163
240,173,67,21.818182,15.727273,67,527,503,24,0,0,0,0,37,11,11,1.108108,0,0,13,12,false,true,true,0.977,0.023
286,361,-75,23.833333,30.083333,-75,834,844,-10,1,2,0.083333,0.166667,3,12,12,12,0,0,12,19,false,true,false,0.057,0.943
8,0,8,8,0,8,908,859,49,0,0,0,0,96,1,0,0.40625,0,0,20,0,false,true,true,0.52,0.48
372,289,83,26.571429,20.642857,83,1156,1114,42,1,0,0.071429,0,-10,14,14,-3.2,0,0,6,7,false,true,true,1,0
251,207,44,27.888889,25.875,44,1302,1234,68,1,1,0.111111,0.125,35,9,8,0.885714,0,0,13,7,false,true,true,0.855,0.145
165,133,32,20.625,16.625,32,1164,1201,-37,0,0,0,0,45,8,8,0.933333,0,1,10,8,false,true,false,0.477,0.523
154,113,41,25.666667,18.833333,41,1331,1399,-68,0,0,0,0,54,6,6,0.648148,0,0,13,23,false,true,true,0.674,0.326
26,19,7,26,19,7,1302,1082,220,0,0,0,0,91,1,1,0.32967,0,0,9,9,false,true,true,0.526,0.474
281,251,30,21.615385,20.916667,30,290,416,-126,0,0,0,0,12,13,12,2.833333,0,0,8,11,false,true,true,0.759,0.241
99,50,49,19.8,12.5,49,527,581,-54,0,0,0,0,71,5,4,0.591549,1,0,7,13,false,true,true,0.714,0.286
357,327,30,17.85,17.210526,30,1075,989,86,1,0,0.05,0,-17,20,19,-2.294118,0,0,8,6,true,true,true,0.928,0.072
323,307,16,20.1875,20.466667,16,926,854,72,0,0,0,0,-4,16,15,-8.5,0,0,6,3,false,true,true,0.586,0.414
160,82,78,26.666667,16.4,78,1210,1253,-43,0,1,0,0.2,55,6,5,0.636364,0,1,12,15,false,true,true,0.942,0.058
412,320,92,21.684211,16.842105,92,1050,1144,-94,0,1,0,0.052632,-27,19,19,-1.407407,0,0,1,1,true,true,true,1,0
105,114,-9,13.125,14.25,-9,416,374,42,0,0,0,0,60,8,8,0.766667,1,0,12,8,false,true,true,0.514,0.486
60,87,-27,20,29,-27,315,294,21,0,1,0,0.333333,76,3,3,0.460526,1,0,8,29,false,true,false,0.288,0.712
95,87,8,19,17.4,8,1127,1134,-7,0,0,0,0,61,5,5,0.491803,1,0,13,17,false,true,true,0.555,0.445
310,162,148,23.846154,12.461538,148,1033,1037,-4,0,1,0,0.076923,16,13,13,2.8125,0,0,18,9,false,true,true,1,0
363,272,91,22.6875,17,91,1030,998,32,1,0,0.0625,0,-11,16,16,-3.454545,1,0,4,4,false,true,true,1,0
258,198,60,19.846154,15.230769,60,939,913,26,0,1,0,0.076923,14,13,13,2.857143,0,0,19,19,false,true,true,0.951,0.049
321,224,97,35.666667,28,97,1197,1127,70,0,0,0,0,28,9,8,1.071429,0,0,13,11,false,true,true,0.999,0.001
378,338,40,19.894737,17.789474,40,1014,1303,-289,1,0,0.052632,0,-27,19,19,-1.407407,0,0,1,4,true,true,true,0.997,0.003
84,94,-10,16.8,18.8,-10,831,830,1,0,0,0,0,67,5,5,0.552239,1,0,19,12,false,true,true,0.526,0.474
203,217,-14,29,31,-14,1075,1009,66,1,0,0.142857,0,43,7,7,0.744186,0,0,7,7,false,true,false,0.413,0.587
73,23,50,36.5,23,50,1270,1315,-45,0,0,0,0,87,2,1,0.413793,0,0,12,10,false,true,true,0.644,0.356
278,163,115,27.8,18.111111,115,1075,1027,48,2,0,0.2,0,30,10,9,1.233333,0,1,9,9,false,true,true,0.999,0.001
194,120,74,19.4,13.333333,74,1413,1422,-9,0,0,0,0,41,10,9,1.390244,2,0,17,9,false,true,true,0.977,0.023
232,145,87,33.142857,20.714286,87,1237,1277,-40,0,0,0,0,44,7,7,0.659091,1,1,8,9,false,true,true,0.988,0.012
182,154,28,26,22,28,1089,1063,26,1,0,0.142857,0,53,7,7,0.716981,0,0,19,13,false,true,true,0.738,0.262
387,331,56,24.1875,22.066667,56,1203,1221,-18,2,0,0.125,0,-4,16,15,-8.75,0,0,10,3,false,true,true,0.999,0.001
66,54,12,22,18,12,691,675,16,0,0,0,0,79,3,3,0.468354,1,1,18,10,false,true,true,0.52,0.48
370,351,19,16.086957,15.954545,19,1181,1149,32,0,1,0,0.045455,-29,23,22,-1.551724,0,0,3,1,true,true,false,0.369,0.631
209,171,38,23.222222,21.375,38,892,819,73,0,1,0,0.125,39,9,8,0.871795,0,0,10,8,false,true,true,0.85,0.15
204,190,14,17,15.833333,14,859,822,37,0,0,0,0,18,12,12,2.111111,0,0,12,15,false,true,true,0.711,0.289
326,200,126,29.636364,18.181818,126,1270,1322,-52,1,0,0.090909,0,24,11,11,1.583333,0,0,10,19,false,true,true,1,0
240,188,52,24,20.888889,52,892,819,73,0,1,0,0.111111,33,10,9,1.030303,0,0,9,7,false,true,true,0.959,0.041
280,185,95,31.111111,23.125,95,1148,1164,-16,1,1,0.111111,0.125,25,9,8,1,0,0,9,7,false,true,true,0.999,0.001
10,0,10,10,0,10,218,86,132,0,0,0,0,96,1,0,0.416667,0,0,11,0,false,true,true,0.549,0.451
389,263,126,18.52381,13.15,126,1011,921,90,1,0,0.047619,0,-18,21,20,-2.722222,0,0,5,12,false,true,true,1,0
359,291,68,19.944444,17.117647,68,941,926,15,1,0,0.055556,0,-13,18,17,-2.923077,0,0,4,5,false,true,true,1,0
337,294,43,16.85,15.473684,43,1040,925,115,0,0,0,0,-30,20,19,-1.433333,0,0,10,2,false,true,true,0.998,0.002
363,314,49,24.2,20.933333,49,856,897,-41,0,1,0,0.066667,-13,15,15,-2.692308,0,0,9,6,false,true,true,0.999,0.001
78,60,18,19.5,15,18,1051,1030,21,0,0,0,0,69,4,4,0.434783,0,0,11,11,false,true,true,0.534,0.466
167,176,-9,16.7,19.555556,-9,334,446,-112,0,0,0,0,29,10,9,1.37931,0,1,11,6,false,true,false,0.096,0.904
90,100,-10,22.5,25,-10,1406,1454,-48,0,1,0,0.25,63,4,4,0.539683,1,0,14,11,false,true,true,0.818,0.182
18,13,5,18,13,5,698,742,-44,0,0,0,0,94,1,1,0.43617,0,1,26,11,false,true,true,0.521,0.479
298,266,32,24.833333,24.181818,32,1331,1399,-68,0,0,0,0,11,12,11,3.181818,0,0,9,9,false,true,true,0.669,0.331
29,14,15,14.5,14,15,1297,1606,-309,0,0,0,0,88,2,1,0.340909,1,0,6,18,false,true,false,0.249,0.751
20,60,-40,10,30,-40,902,866,36,0,0,0,0,80,2,2,0.4,0,1,12,8,false,true,false,0.133,0.867
164,120,44,18.222222,15,44,1029,1075,-46,0,0,0,0,48,9,8,1,1,0,10,9,false,true,true,0.789,0.211
12,6,6,12,6,6,527,581,-54,0,0,0,0,94,1,1,0.446809,1,0,17,7,false,true,true,0.534,0.466
78,58,20,26,29,20,1364,1093,271,0,0,0,0,80,3,2,0.475,0,0,15,9,false,true,false,0.498,0.502
240,253,-13,18.461538,21.083333,-13,613,611,2,0,0,0,0,7,13,12,5.428571,0,0,9,8,false,true,false,0.319,0.681
184,151,33,23,21.571429,33,1548,1493,55,1,0,0.125,0,44,8,7,0.931818,0,0,13,10,false,true,true,0.57,0.43
26,21,5,13,10.5,5,580,620,-40,0,0,0,0,88,2,2,0.488636,0,0,12,9,false,true,true,0.519,0.481
374,215,159,20.777778,12.647059,159,942,1003,-61,0,0,0,0,-12,18,17,-3.75,1,1,11,13,false,true,true,1,0
309,265,44,14.045455,12.045455,44,371,435,-64,0,0,0,0,-31,22,22,-1.419355,0,0,1,2,true,true,true,1,0
205,107,98,25.625,15.285714,98,778,758,20,0,0,0,0,46,8,7,0.847826,0,0,18,8,false,true,true,0.977,0.023
116,111,5,16.571429,18.5,5,620,513,107,0,0,0,0,54,7,6,0.833333,0,0,8,7,false,true,false,0.393,0.607
350,262,88,26.923077,20.153846,88,1394,1118,276,0,1,0,0.076923,7,13,13,5.285714,0,0,20,10,false,true,true,0.996,0.004
316,292,24,21.066667,20.857143,24,1513,1479,34,0,0,0,0,-1,15,14,-34,1,1,12,6,false,true,false,0.125,0.875
20,0,20,20,0,20,691,675,16,0,0,0,0,97,1,0,0.381443,0,0,19,0,false,true,true,0.557,0.443
260,229,31,21.666667,19.083333,31,784,758,26,0,0,0,0,12,12,12,2.916667,0,0,11,18,false,true,true,0.771,0.229
269,223,46,20.692308,17.153846,46,1221,1258,-37,1,0,0.076923,0,20,13,13,1.95,0,0,7,14,false,true,true,0.939,0.061
247,274,-27,14.529412,16.117647,-27,576,494,82,0,0,0,0,-3,17,17,-14.666667,0,1,9,6,false,true,false,0.022,0.978
47,18,29,23.5,18,29,939,907,32,0,0,0,0,91,2,1,0.43956,0,0,24,15,false,true,true,0.638,0.362
295,216,79,24.583333,19.636364,79,1051,1030,21,0,0,0,0,14,12,11,2.142857,2,0,5,17,false,true,true,1,0
130,65,65,21.666667,13,65,1055,1050,5,0,0,0,0,64,6,5,0.53125,0,0,13,8,false,true,true,0.883,0.117
222,147,75,17.076923,12.25,75,346,231,115,0,0,0,0,1,13,12,41,0,0,11,14,false,true,true,0.982,0.018
122,105,17,30.5,35,17,1489,1558,-69,0,1,0,0.333333,68,4,3,0.411765,0,0,18,20,false,true,false,0.429,0.571
396,247,149,22,13.722222,149,777,830,-53,1,0,0.055556,0,-16,18,18,-2.5625,0,0,7,6,false,true,true,1,0
47,60,-13,11.75,15,-13,826,771,55,0,0,0,0,78,4,4,0.576923,0,0,8,15,false,true,false,0.15,0.85
98,90,8,16.333333,15,8,561,526,35,0,0,0,0,50,6,6,0.7,1,0,16,12,false,true,true,0.544,0.456
240,198,42,20,18,42,786,847,-61,0,0,0,0,22,12,11,1.545455,0,0,16,11,false,true,true,0.754,0.246
286,224,62,19.066667,14.933333,62,1606,1544,62,0,0,0,0,16,15,15,2.8125,0,0,16,10,false,true,true,0.978,0.022
248,319,-71,22.545455,29,-71,1419,1488,-69,0,1,0,0.090909,10,11,11,2.8,1,0,8,16,false,true,false,0.132,0.868
138,89,49,23,17.8,49,1220,1261,-41,1,0,0.166667,0,66,6,5,0.681818,0,0,12,11,false,true,true,0.802,0.198
191,150,41,19.1,15,41,1127,1176,-49,0,0,0,0,34,10,10,1.235294,0,1,11,10,false,true,true,0.522,0.478
236,230,6,18.153846,17.692308,6,1214,1176,38,0,0,0,0,22,13,13,1.636364,0,0,10,11,false,true,false,0.464,0.536
40,40,0,20,20,0,1550,1624,-74,0,0,0,0,85,2,2,0.352941,0,0,31,17,false,true,false,0.347,0.653
357,267,90,23.8,17.8,90,1510,1583,-73,1,0,0.066667,0,-8,15,15,-4,0,0,7,5,false,true,true,1,0
418,247,171,17.416667,10.291667,171,1176,1076,100,0,0,0,0,-13,24,24,-4.538462,0,0,7,16,false,true,true,1,0
366,347,19,17.428571,16.52381,19,901,889,12,0,1,0,0.047619,-32,21,21,-1.34375,0,0,2,1,false,true,true,0.972,0.028
347,305,42,28.916667,25.416667,42,1875,1793,82,2,1,0.166667,0.083333,10,12,12,3,0,0,11,13,false,true,true,0.966,0.034
181,164,17,22.625,23.428571,17,1156,1184,-28,1,0,0.125,0,41,8,7,0.682927,0,0,15,7,false,true,false,0.422,0.578
108,68,40,21.6,17,40,859,786,73,0,0,0,0,68,5,4,0.558824,0,0,23,14,false,true,true,0.835,0.165
211,128,83,16.230769,9.846154,83,1428,1302,126,0,0,0,0,21,13,13,2.52381,0,1,14,16,false,true,true,0.987,0.013
112,89,23,14,11.125,23,1016,1037,-21,0,0,0,0,53,8,8,0.90566,0,0,9,24,false,true,false,0.341,0.659
20,12,8,10,12,8,902,866,36,0,0,0,0,84,2,1,0.380952,0,0,12,17,false,true,false,0.303,0.697
266,256,10,19,18.285714,10,942,976,-34,0,0,0,0,4,14,14,10,0,0,10,10,false,true,true,0.586,0.414
110,59,51,22,11.8,51,1295,1477,-182,1,0,0.2,0,69,5,5,0.666667,1,0,9,9,false,true,true,0.854,0.146
297,264,33,21.214286,20.307692,33,1161,1166,-5,1,0,0.071429,0,0,14,13,0,0,1,8,18,false,true,true,0.961,0.039
83,84,-1,13.833333,14,-1,892,768,124,0,0,0,0,64,6,6,0.671875,0,0,11,16,false,true,false,0.308,0.692
195,223,-28,21.666667,27.875,-28,758,952,-194,0,0,0,0,33,9,8,1.212121,1,0,11,10,false,true,false,0.11,0.89
379,406,-27,29.153846,31.230769,-27,1897,1793,104,2,3,0.153846,0.230769,12,13,13,2.666667,0,0,9,9,false,true,true,0.906,0.094
18,0,18,18,0,18,965,1013,-48,0,0,0,0,96,1,0,0.34375,0,0,8,0,false,true,false,0.463,0.537
322,315,7,26.833333,26.25,7,1102,1245,-143,2,0,0.166667,0,-15,12,12,-1.866667,0,0,7,2,false,true,true,0.971,0.029
388,273,115,27.714286,21,115,1550,1546,4,0,1,0,0.076923,7,14,13,4.285714,1,0,7,7,false,true,true,1,0
180,181,-1,16.363636,16.454545,-1,500,567,-67,0,0,0,0,36,11,11,1.222222,0,0,9,27,false,true,false,0.452,0.548
157,125,32,39.25,31.25,32,1770,1689,81,0,0,0,0,61,4,4,0.42623,0,1,16,11,false,true,false,0.375,0.625
376,246,130,18.8,12.3,130,620,513,107,0,0,0,0,-18,20,20,-2.5,0,0,2,3,false,true,true,1,0
231,182,49,21,16.545455,49,1516,1397,119,0,1,0,0.090909,16,11,11,2.0625,0,0,30,13,false,true,true,0.968,0.032
386,322,64,19.3,16.947368,64,539,500,39,0,0,0,0,-30,20,19,-1.333333,0,0,4,1,false,true,true,1,0
236,233,3,18.153846,19.416667,3,1547,1439,108,1,0,0.076923,0,16,13,12,2.3125,0,0,20,18,false,true,true,0.593,0.407
239,178,61,29.875,25.428571,61,1431,825,606,1,1,0.125,0.142857,39,8,7,0.871795,0,0,9,13,false,true,true,0.999,0.001
359,236,123,22.4375,15.733333,123,526,370,156,0,0,0,0,-12,16,15,-2.916667,0,0,5,7,false,true,true,1,0
339,283,56,19.941176,16.647059,56,880,952,-72,0,0,0,0,-14,17,17,-2.928571,0,0,4,6,false,true,true,1,0
20,8,12,20,8,12,859,719,140,0,0,0,0,91,1,1,0.582418,0,0,15,10,false,true,true,0.562,0.438
385,283,102,29.615385,21.769231,102,1189,1266,-77,1,0,0.076923,0,-1,13,13,-34,0,0,19,4,false,true,true,1,0
204,164,40,22.666667,18.222222,40,844,821,23,0,0,0,0,51,9,9,0.823529,1,0,20,9,false,true,true,0.994,0.006
260,201,59,20,15.461538,59,804,683,121,0,0,0,0,17,13,13,2.647059,0,1,10,12,false,true,true,0.994,0.006
341,302,39,17.947368,16.777778,39,658,817,-159,0,0,0,0,-14,19,18,-2.714286,0,0,2,5,false,true,true,0.995,0.005
0,8,-8,0,8,-8,901,1159,-258,0,0,0,0,96,1,1,0.364583,0,0,10,21,false,true,false,0.11,0.89
87,118,-31,21.75,29.5,-31,1030,1144,-114,0,1,0,0.25,69,4,4,0.507246,0,0,14,14,false,true,false,0.21,0.79
119,96,23,14.875,12,23,498,43,455,0,0,0,0,45,8,8,0.822222,1,0,11,11,false,true,true,0.639,0.361
183,161,22,22.875,23,22,1078,1130,-52,0,1,0,0.142857,47,8,7,0.829787,0,0,9,7,false,true,true,0.81,0.19
187,115,72,23.375,16.428571,72,1075,1152,-77,0,0,0,0,53,8,7,0.754717,0,1,10,7,false,true,true,0.945,0.055
141,106,35,23.5,17.666667,35,1051,1030,21,0,0,0,0,54,6,6,0.555556,0,0,15,7,false,true,true,0.866,0.134
146,61,85,20.857143,8.714286,85,896,818,78,0,0,0,0,65,7,7,0.676923,0,0,17,7,false,true,true,0.981,0.019
352,191,161,16,9.095238,161,421,306,115,0,1,0,0.047619,-20,22,21,-2.2,0,0,8,5,false,true,true,1,0
254,111,143,31.75,13.875,143,1482,1554,-72,1,0,0.125,0,43,8,8,0.837209,0,0,7,10,false,true,true,1,0
334,280,54,22.266667,18.666667,54,416,282,134,1,0,0.066667,0,-6,15,15,-5.666667,1,0,10,6,false,true,true,0.999,0.001
347,291,56,20.411765,18.1875,56,1214,1176,38,0,0,0,0,-3,17,16,-12,0,0,2,7,false,true,true,0.998,0.002
202,108,94,22.444444,12,94,786,757,29,1,0,0.111111,0,42,9,9,0.928571,0,0,8,20,false,true,true,0.987,0.013
312,290,22,20.8,19.333333,22,1027,856,171,1,1,0.066667,0.066667,-17,15,15,-1.941176,0,0,7,3,false,true,true,0.742,0.258
99,67,32,19.8,13.4,32,527,581,-54,0,0,0,0,66,5,5,0.636364,1,0,7,19,false,true,true,0.616,0.384
71,33,38,23.666667,16.5,38,892,819,73,0,1,0,0.5,78,3,2,0.435897,1,0,23,14,false,true,true,0.962,0.038
284,133,151,35.5,19,151,1684,1320,364,1,0,0.125,0,33,8,7,0.909091,0,1,9,13,false,true,true,0.998,0.002
134,76,58,33.5,25.333333,58,1004,840,164,1,0,0.25,0,70,4,3,0.428571,1,0,13,19,false,true,true,0.897,0.103
179,139,40,29.833333,23.166667,40,1550,1466,84,1,0,0.166667,0,53,6,6,0.698113,0,0,18,17,false,true,true,0.738,0.262
202,201,1,15.538462,15.461538,1,613,461,152,0,1,0,0.076923,4,13,13,9.25,0,0,17,15,false,true,true,0.883,0.117
350,264,86,23.333333,18.857143,86,613,569,44,0,0,0,0,-1,15,14,-39,0,0,4,10,false,true,true,1,0
205,125,80,20.5,13.888889,80,609,620,-11,0,0,0,0,38,10,9,0.973684,0,1,9,9,false,true,true,0.994,0.006
73,68,5,18.25,22.666667,5,1659,1782,-123,0,0,0,0,73,4,3,0.39726,0,0,7,17,false,true,false,0.133,0.867
313,304,9,18.411765,17.882353,9,527,514,13,0,0,0,0,-16,17,17,-2.4375,0,0,4,1,false,true,true,0.824,0.176
387,276,111,27.642857,21.230769,111,1331,1399,-68,1,0,0.071429,0,-4,14,13,-8.75,0,0,7,11,false,true,true,1,0
332,245,87,20.75,15.3125,87,844,821,23,0,0,0,0,12,16,16,3.5,0,0,9,7,false,true,true,0.999,0.001
257,208,49,25.7,23.111111,49,1244,1361,-117,2,1,0.2,0.111111,39,10,9,0.974359,0,0,17,21,false,true,true,0.935,0.065
177,119,58,35.4,23.8,58,1142,1095,47,1,0,0.2,0,56,5,5,0.625,0,0,12,19,false,true,true,0.743,0.257
92,125,-33,15.333333,20.833333,-33,1554,1622,-68,1,0,0.166667,0,55,6,6,0.563636,0,1,16,11,false,true,true,0.802,0.198
266,164,102,19,12.615385,102,415,518,-103,0,0,0,0,13,14,13,2.923077,0,0,8,18,false,true,true,1,0
15,25,-10,7.5,12.5,-10,995,912,83,0,0,0,0,89,2,2,0.494382,1,0,9,14,false,true,false,0.487,0.513
207,124,83,25.875,17.714286,83,1482,1394,88,1,0,0.125,0,50,8,7,0.72,1,0,7,16,false,true,true,0.985,0.015
229,190,39,20.818182,17.272727,39,1334,1270,64,1,0,0.090909,0,34,11,11,1.088235,1,0,13,13,false,true,true,0.968,0.032
301,267,34,15.842105,14.052632,34,904,857,47,0,0,0,0,-17,19,19,-2.411765,0,0,9,1,false,true,true,0.969,0.031
191,204,-13,15.916667,17,-13,272,238,34,0,0,0,0,18,12,12,2.222222,0,0,19,7,false,true,true,0.725,0.275
288,217,71,26.181818,21.7,71,1034,1040,-6,1,0,0.090909,0,22,11,10,1.590909,1,0,8,15,false,true,true,0.999,0.001
131,56,75,21.833333,11.2,75,804,683,121,0,0,0,0,61,6,5,0.737705,0,1,19,8,false,true,true,0.993,0.007
252,149,103,28,18.625,103,769,527,242,1,0,0.111111,0,30,9,8,1.2,0,0,13,16,false,true,true,0.997,0.003
279,186,93,16.411765,11.625,93,498,43,455,0,0,0,0,-7,17,16,-5.285714,0,0,6,7,false,true,true,1,0
120,188,-68,20,31.333333,-68,1501,1473,28,0,0,0,0,51,6,6,0.705882,0,0,20,29,false,true,false,0.106,0.894
47,69,-22,9.4,17.25,-22,218,86,132,0,0,0,0,66,5,4,0.606061,0,0,19,11,false,true,false,0.29,0.71
251,187,64,31.375,23.375,64,2219,2106,113,1,0,0.125,0,33,8,8,0.818182,0,0,7,10,false,true,true,0.863,0.137
357,295,62,19.833333,17.352941,62,1547,1439,108,1,0,0.055556,0,-15,18,17,-2.466667,0,0,4,3,false,true,true,1,0
385,313,72,24.0625,20.866667,72,1762,1582,180,2,3,0.125,0.2,-10,16,15,-3.2,0,0,1,24,false,true,true,0.993,0.007
292,194,98,16.222222,11.411765,98,1128,889,239,0,1,0,0.058824,-2,18,17,-23.5,0,1,16,17,false,true,true,1,0
20,0,20,20,0,20,371,435,-64,0,0,0,0,95,1,0,0.463158,1,0,6,0,false,true,true,0.559,0.441
238,200,38,15.866667,13.333333,38,539,632,-93,0,0,0,0,15,15,15,3.066667,0,0,17,11,false,true,true,0.955,0.045
278,179,99,13.9,9.421053,99,310,359,-49,0,0,0,0,-29,20,19,-1.689655,0,0,10,22,false,true,true,1,0
161,151,10,23,21.571429,10,1153,1065,88,0,1,0,0.142857,34,7,7,0.823529,0,0,19,22,false,true,true,0.728,0.272
139,107,32,34.75,26.75,32,1489,1555,-66,1,0,0.25,0,65,4,4,0.446154,0,0,10,12,false,true,false,0.463,0.537
289,169,120,28.9,18.777778,120,1408,1454,-46,1,0,0.1,0,33,10,9,0.969697,0,0,12,19,false,true,true,1,0
87,90,-3,21.75,30,-3,1762,1582,180,0,1,0,0.333333,74,4,3,0.432432,1,0,9,15,false,true,false,0.285,0.715
44,48,-4,14.666667,16,-4,1073,1177,-104,0,0,0,0,81,3,3,0.395062,0,1,13,25,false,true,false,0.111,0.889
334,328,6,20.875,21.866667,6,1100,1008,92,1,0,0.0625,0,-10,16,15,-3.6,0,0,3,4,false,true,false,0.498,0.502
321,208,113,32.1,20.8,113,971,621,350,2,0,0.2,0,21,10,10,1.52381,1,0,14,8,false,true,true,1,0
295,321,-26,26.818182,29.181818,-26,1256,1232,24,1,0,0.090909,0,14,11,11,2.142857,0,0,10,15,false,true,false,0.226,0.774
354,333,21,17.7,17.526316,21,901,889,12,0,1,0,0.052632,-25,20,19,-1.72,0,0,4,4,false,true,true,0.967,0.033
186,124,62,23.25,17.714286,62,1045,1009,36,1,0,0.125,0,49,8,7,0.77551,0,1,9,18,false,true,true,0.857,0.143
80,112,-32,11.428571,18.666667,-32,450,412,38,0,0,0,0,53,7,6,0.716981,1,0,21,13,false,true,false,0.26,0.74
59,45,14,14.75,15,14,786,847,-61,0,0,0,0,78,4,3,0.435897,0,1,10,7,false,true,false,0.263,0.737
318,264,54,17.666667,15.529412,54,1077,1094,-17,0,0,0,0,-6,18,17,-7,1,1,6,7,false,true,true,0.977,0.023
40,23,17,13.333333,11.5,17,1210,1253,-43,0,0,0,0,82,3,2,0.414634,1,0,7,10,false,true,false,0.397,0.603
354,312,42,17.7,16.421053,42,795,830,-35,1,1,0.05,0.052632,-21,20,19,-2,0,0,1,5,false,true,true,0.985,0.015
226,134,92,28.25,19.142857,92,371,336,35,2,0,0.25,0,29,8,7,1.310345,0,0,14,15,false,true,true,0.961,0.039
216,244,-28,24,27.111111,-28,1885,1846,39,1,1,0.111111,0.111111,23,9,9,1.26087,1,0,24,8,false,true,true,0.741,0.259
55,110,-55,18.333333,55,-55,1454,1531,-77,0,1,0,0.5,80,3,2,0.375,1,0,16,11,false,true,true,0.701,0.299
50,22,28,25,11,28,498,43,455,0,0,0,0,85,2,2,0.435294,1,0,7,20,false,true,true,0.922,0.078
341,176,165,17.947368,9.263158,165,421,306,115,0,1,0,0.052632,-13,19,19,-3.384615,0,0,9,9,false,true,true,1,0
212,172,40,17.666667,15.636364,40,864,808,56,1,0,0.083333,0,15,12,11,2.266667,0,1,7,10,false,true,true,0.808,0.192
308,256,52,22,18.285714,52,306,169,137,0,0,0,0,-11,14,14,-3.090909,0,0,12,12,false,true,true,0.999,0.001
232,213,19,29,26.625,19,908,1070,-162,1,0,0.125,0,39,8,8,0.769231,0,0,10,13,false,true,true,0.731,0.269
138,150,-12,13.8,15,-12,611,584,27,0,0,0,0,42,10,10,1.047619,0,0,7,12,false,true,false,0.304,0.696
345,305,40,19.166667,16.944444,40,904,783,121,0,0,0,0,-16,18,18,-2.625,1,0,7,5,false,true,true,0.999,0.001
20,21,-1,10,10.5,-1,1011,921,90,0,0,0,0,87,2,2,0.563218,0,0,7,18,false,true,false,0.321,0.679
113,68,45,22.6,17,45,1245,1232,13,1,0,0.2,0,61,5,4,0.47541,0,0,18,9,false,true,true,0.558,0.442
166,241,-75,16.6,26.777778,-75,1265,1045,220,0,1,0,0.111111,25,10,9,1.68,0,0,20,17,false,true,false,0.009,0.991
289,194,95,26.272727,19.4,95,1216,1228,-12,1,0,0.090909,0,30,11,10,1.1,0,0,8,13,false,true,true,0.999,0.001
249,263,-14,16.6,18.785714,-14,527,514,13,0,0,0,0,-2,15,14,-19.5,0,0,17,8,false,true,false,0.425,0.575
344,240,104,26.461538,20,104,1093,1197,-104,2,0,0.153846,0,13,13,12,2.384615,1,1,11,21,false,true,true,0.545,0.455
202,194,8,15.538462,16.166667,8,613,461,152,0,1,0,0.083333,7,13,12,5.285714,0,0,17,14,false,true,true,0.826,0.174
268,196,72,22.333333,17.818182,72,791,774,17,1,0,0.083333,0,31,12,11,1.322581,0,0,13,12,false,true,true,0.967,0.033
328,307,21,20.5,20.466667,21,594,605,-11,0,0,0,0,-10,16,15,-3.7,0,0,4,3,false,true,true,0.951,0.049
185,176,9,20.555556,19.555556,9,926,854,72,0,0,0,0,41,9,9,0.829268,0,1,17,10,false,true,false,0.489,0.511
326,254,72,20.375,16.933333,72,1045,1009,36,1,0,0.0625,0,-2,16,15,-19,0,0,6,15,false,true,true,0.999,0.001
311,237,74,25.916667,19.75,74,1050,1144,-94,0,1,0,0.083333,18,12,12,2.111111,0,1,11,9,false,true,true,0.998,0.002
363,315,48,27.923077,24.230769,48,1885,1846,39,1,1,0.076923,0.076923,-3,13,13,-9.666667,0,0,10,2,false,true,true,0.996,0.004
114,76,38,16.285714,12.666667,38,1181,1149,32,0,0,0,0,68,7,6,0.661765,1,0,10,9,false,true,true,0.693,0.307
92,87,5,23,29,5,1203,1221,-18,0,0,0,0,78,4,3,0.448718,1,0,9,12,false,true,true,0.797,0.203
145,113,32,20.714286,18.833333,32,1216,1228,-12,0,0,0,0,56,7,6,0.589286,0,0,9,10,false,true,false,0.485,0.515
326,319,7,25.076923,24.538462,7,1636,1576,60,0,2,0,0.153846,3,13,13,11.333333,0,0,11,25,false,true,false,0.288,0.712
365,254,111,24.333333,18.142857,111,769,527,242,1,0,0.066667,0,-8,15,14,-4.5,0,0,9,12,false,true,true,1,0
232,240,-8,15.466667,16,-8,262,306,-44,0,0,0,0,6,15,15,7.666667,0,0,9,13,false,true,false,0.297,0.703
34,14,20,17,14,20,1320,1339,-19,0,0,0,0,88,2,1,0.443182,0,0,7,8,false,true,false,0.378,0.622
256,214,42,16,14.266667,42,371,435,-64,0,0,0,0,-3,16,15,-14.666667,0,0,10,14,false,true,true,0.982,0.018
291,191,100,24.25,17.363636,100,1220,1261,-41,2,0,0.166667,0,30,12,11,1.5,1,0,19,14,false,true,true,0.989,0.011
65,37,28,21.666667,18.5,28,908,859,49,0,0,0,0,80,3,2,0.4875,0,0,8,18,false,true,false,0.346,0.654
334,315,19,19.647059,18.529412,19,926,854,72,0,0,0,0,-9,17,17,-3.777778,0,0,6,2,true,true,true,0.957,0.043
125,67,58,31.25,22.333333,58,1550,1466,84,1,0,0.25,0,71,4,3,0.521127,0,0,11,27,false,true,true,0.884,0.116
76,26,50,25.333333,13,50,1413,1422,-9,0,0,0,0,79,3,2,0.721519,1,0,16,16,false,true,true,0.865,0.135
183,154,29,26.142857,25.666667,29,1793,1897,-104,1,0,0.142857,0,50,7,6,0.6,0,0,12,13,false,true,false,0.257,0.743
403,338,65,21.210526,17.789474,65,892,788,104,3,0,0.157895,0,-20,19,19,-2.15,0,0,1,2,false,true,true,0.991,0.009
397,278,119,28.357143,21.384615,119,1396,1454,-58,2,0,0.142857,0,4,14,13,8.25,0,0,9,11,false,true,true,1,0
172,131,41,24.571429,18.714286,41,901,1159,-258,2,0,0.285714,0,50,7,7,0.7,0,0,12,17,false,true,true,0.652,0.348
253,245,8,16.866667,16.333333,8,859,822,37,0,0,0,0,1,15,15,38,1,0,8,8,false,true,true,0.838,0.162
215,218,-3,13.4375,13.625,-3,826,771,55,0,0,0,0,9,16,16,5,0,0,22,10,false,true,true,0.546,0.454
214,135,79,26.75,16.875,79,526,370,156,0,0,0,0,42,8,8,0.833333,0,0,7,11,false,true,true,0.997,0.003
215,211,4,13.4375,14.066667,4,826,771,55,0,0,0,0,13,16,15,3.461538,0,0,22,10,false,true,false,0.483,0.517
147,59,88,36.75,19.666667,88,1935,2020,-85,0,0,0,0,72,4,3,0.430556,1,0,9,20,false,true,true,0.876,0.124
322,266,56,20.125,17.733333,56,866,949,-83,0,0,0,0,-2,16,15,-20,1,0,6,12,false,true,true,1,0
393,287,106,28.071429,22.076923,106,1051,1030,21,0,0,0,0,-3,14,13,-10,0,0,4,6,false,true,true,1,0
298,200,98,17.529412,12.5,98,218,86,132,0,0,0,0,-14,17,16,-2.857143,0,0,17,7,false,true,true,1,0
247,109,138,30.875,15.571429,138,1439,1353,86,1,0,0.125,0,46,8,7,0.652174,1,0,8,11,false,true,true,1,0
333,254,79,20.8125,15.875,79,1170,1156,14,1,0,0.0625,0,-12,16,16,-3.166667,0,0,7,5,false,true,true,1,0
295,285,10,17.352941,16.764706,10,947,810,137,0,1,0,0.058824,-9,17,17,-4.666667,1,0,12,11,false,true,true,0.754,0.246
62,45,17,20.666667,22.5,17,892,788,104,0,0,0,0,82,3,2,0.52439,1,0,14,22,false,true,true,0.806,0.194
311,237,74,18.294118,13.941176,74,758,750,8,0,0,0,0,-16,17,17,-2.3125,0,0,10,1,false,true,true,1,0
188,147,41,37.6,29.4,41,1302,1349,-47,0,0,0,0,55,5,5,0.509091,0,0,13,9,false,true,true,0.864,0.136
162,157,5,18,17.444444,5,859,786,73,0,0,0,0,38,9,9,1,1,0,23,7,false,true,true,0.599,0.401
326,238,88,17.157895,12.526316,88,913,871,42,0,0,0,0,-19,19,19,-2.263158,0,0,3,2,false,true,true,1,0
55,62,-7,27.5,31,-7,518,448,70,0,0,0,0,86,2,2,0.395349,1,0,6,12,false,true,true,0.601,0.399
69,76,-7,13.8,19,-7,954,1078,-124,0,1,0,0.25,64,5,4,0.59375,1,0,25,10,false,true,true,0.531,0.469
91,64,27,18.2,16,27,1394,1118,276,0,0,0,0,65,5,4,0.569231,1,0,17,7,false,true,true,0.847,0.153
315,278,37,22.5,21.384615,37,1177,1214,-37,0,0,0,0,4,14,13,8.75,0,1,18,6,false,true,true,0.774,0.226
308,260,48,51.333333,52,48,1370,1431,-61,2,1,0.333333,0.2,43,6,5,0.534884,0,0,11,14,false,true,true,0.994,0.006
378,348,30,23.625,23.2,30,1014,948,66,1,0,0.0625,0,-11,16,15,-3,0,0,6,1,false,true,true,0.986,0.014
199,123,76,33.166667,20.5,76,1109,1065,44,0,0,0,0,54,6,6,0.611111,0,0,10,11,false,true,true,0.902,0.098
183,116,67,18.3,11.6,67,595,543,52,0,0,0,0,40,10,10,1.175,1,0,15,8,false,true,true,0.981,0.019
329,294,35,21.933333,21,35,795,830,-35,1,1,0.066667,0.071429,-2,15,14,-21,0,0,13,13,false,true,true,0.995,0.005
211,214,-3,19.181818,21.4,-3,942,976,-34,0,0,0,0,26,11,10,1.538462,0,0,11,7,false,true,false,0.147,0.853
100,89,11,12.5,12.714286,11,892,768,124,0,0,0,0,57,8,7,0.754386,0,0,8,18,false,true,false,0.156,0.844
32,33,-1,16,16.5,-1,371,435,-64,0,0,0,0,84,2,2,0.52381,0,0,19,11,false,true,false,0.38,0.62
360,288,72,27.692308,24,72,1408,1454,-46,1,0,0.076923,0,8,13,12,4,0,0,16,11,false,true,true,0.995,0.005
87,69,18,21.75,23,18,613,569,44,0,0,0,0,71,4,3,0.549296,2,0,7,15,false,true,true,0.886,0.114
71,50,21,23.666667,25,21,1431,825,606,0,0,0,0,80,3,2,0.425,0,1,10,8,false,true,true,0.997,0.003
91,94,-3,22.75,23.5,-3,820,822,-2,0,0,0,0,70,4,4,0.557143,1,1,19,7,false,true,true,0.522,0.478
302,285,17,14.380952,13.571429,17,262,306,-44,1,0,0.047619,0,-35,21,21,-1.314286,0,0,3,4,false,true,true,0.965,0.035
62,19,43,31,19,43,904,668,236,0,0,0,0,89,2,1,0.382022,0,0,17,14,false,true,true,0.878,0.122
343,287,56,19.055556,16.882353,56,1548,1493,55,1,0,0.055556,0,-13,18,17,-3.153846,0,0,4,7,false,true,true,0.999,0.001
403,265,138,31,22.083333,138,1023,1070,-47,2,0,0.153846,0,4,13,12,8,0,0,7,18,false,true,true,0.999,0.001
349,340,9,26.846154,26.153846,9,1265,1237,28,1,0,0.076923,0,-2,13,13,-15,0,0,6,9,false,true,true,0.99,0.01
336,238,98,21,15.866667,98,1055,1050,5,0,0,0,0,-2,16,15,-17,1,0,2,4,false,true,true,1,0
60,49,11,30,24.5,11,1890,2020,-130,0,0,0,0,86,2,2,0.337209,0,0,12,19,false,true,false,0.258,0.742
354,312,42,20.823529,19.5,42,1265,1045,220,0,1,0,0.0625,-13,17,16,-3.230769,0,0,5,10,false,true,true,0.982,0.018
18,11,7,18,11,7,856,897,-41,0,0,0,0,91,1,1,0.384615,1,0,6,10,false,true,true,0.522,0.478
396,288,108,26.4,19.2,108,1489,1445,44,1,0,0.066667,0,-6,15,15,-5.333333,0,0,2,4,false,true,true,1,0
303,300,3,18.9375,20,3,1266,1247,19,0,0,0,0,-8,16,15,-4,2,0,3,7,false,true,true,0.95,0.05
44,22,22,14.666667,11,22,801,925,-124,1,0,0.333333,0,79,3,2,0.443038,1,0,6,11,false,true,false,0.498,0.502
336,244,92,16,12.2,92,576,532,44,0,0,0,0,-27,21,20,-1.703704,1,0,8,17,false,true,true,1,0
41,20,21,20.5,20,21,2219,2029,190,0,0,0,0,91,2,1,0.285714,1,0,8,7,false,true,true,0.995,0.005
94,70,24,15.666667,14,24,1181,1149,32,0,0,0,0,76,6,5,0.592105,0,0,11,7,false,true,false,0.306,0.694
103,99,4,34.333333,33,4,1344,1209,135,0,1,0,0.333333,72,3,3,0.472222,0,0,16,12,false,true,false,0.486,0.514
239,208,31,23.9,20.8,31,306,169,137,0,0,0,0,18,10,10,1.888889,0,1,13,7,false,true,true,0.988,0.012
10,20,-10,10,20,-10,1550,1466,84,0,0,0,0,92,1,1,0.402174,1,0,8,15,false,true,true,0.787,0.213
233,232,1,25.888889,29,1,791,885,-94,1,1,0.111111,0.125,36,9,8,1.055556,1,0,19,7,false,true,true,0.676,0.324
224,177,47,20.363636,16.090909,47,916,837,79,0,0,0,0,33,11,11,1.212121,0,0,9,13,false,true,true,0.92,0.08
403,319,84,21.210526,16.789474,84,1075,1152,-77,0,1,0,0.052632,-23,19,19,-1.73913,0,0,2,3,false,true,true,1,0
209,141,68,26.125,20.142857,68,1029,1227,-198,1,0,0.125,0,39,8,7,0.820513,1,0,15,11,false,true,true,0.875,0.125
225,128,97,16.071429,9.846154,97,1428,1302,126,0,0,0,0,18,14,13,2.944444,0,1,15,16,false,true,true,0.987,0.013
294,258,36,22.615385,21.5,36,1100,1008,92,1,0,0.076923,0,15,13,12,2.4,0,0,9,8,false,true,true,0.781,0.219
28,13,15,28,13,15,916,837,79,0,0,0,0,93,1,1,0.430108,0,0,10,12,false,true,true,0.603,0.397
175,165,10,15.909091,16.5,10,371,435,-64,0,0,0,0,26,11,10,1.692308,0,0,18,10,false,true,true,0.705,0.295
382,316,66,29.384615,24.307692,66,1156,1184,-28,2,1,0.153846,0.076923,-2,13,13,-14,0,0,3,9,false,true,true,0.999,0.001
372,370,2,18.6,18.5,2,1265,1045,220,0,1,0,0.05,-33,20,20,-1.272727,0,0,1,2,false,true,true,0.978,0.022
224,201,23,20.363636,18.272727,23,468,542,-74,0,0,0,0,27,11,11,1.444444,0,0,9,10,false,true,true,0.733,0.267
239,226,13,18.384615,18.833333,13,904,783,121,0,0,0,0,24,13,12,1.75,0,0,13,11,false,true,true,0.588,0.412
320,238,82,21.333333,15.866667,82,1055,1050,5,0,0,0,0,1,15,15,34,1,0,6,4,false,true,true,0.997,0.003
60,71,-11,20,23.666667,-11,1040,925,115,0,0,0,0,76,3,3,0.565789,0,0,21,9,false,true,false,0.344,0.656
273,287,-14,16.058824,16.882353,-14,316,306,10,0,2,0,0.117647,-12,17,17,-3.166667,0,0,4,13,false,true,false,0.174,0.826
399,319,80,15.96,12.76,80,1583,1422,161,1,0,0.04,0,-18,25,25,-2.833333,0,0,2,7,false,true,true,0.995,0.005
211,221,-10,15.071429,17,-10,628,658,-30,0,0,0,0,22,14,13,2.090909,0,0,17,12,false,true,false,0.424,0.576
228,177,51,17.538462,14.75,51,416,306,110,0,0,0,0,26,13,12,1.615385,0,0,10,11,false,true,true,0.954,0.046
347,238,109,20.411765,14.875,109,527,503,24,0,0,0,0,0,17,16,0,0,0,7,14,false,true,true,1,0
156,124,32,39,31,32,416,282,134,1,0,0.25,0,69,4,4,0.492754,0,0,21,12,false,true,true,0.731,0.269
270,206,64,20.769231,17.166667,64,921,1072,-151,1,0,0.076923,0,23,13,12,1.652174,0,1,13,7,false,true,true,0.857,0.143
312,227,85,16.421053,12.611111,85,691,675,16,0,0,0,0,-19,19,18,-2,0,0,1,11,false,true,true,1,0
125,68,57,20.833333,13.6,57,771,754,17,0,0,0,0,61,6,5,0.52459,0,0,11,7,false,true,true,0.883,0.117
36,40,-4,18,20,-4,965,1013,-48,0,0,0,0,86,2,2,0.383721,0,0,16,15,false,true,false,0.289,0.711
368,179,189,40.888889,22.375,189,1571,1554,17,2,1,0.222222,0.125,26,9,8,1.269231,0,0,17,9,false,true,true,1,0
24,10,14,24,10,14,1413,1422,-9,0,0,0,0,92,1,1,0.619565,0,0,15,18,false,true,true,0.512,0.488
233,213,20,19.416667,19.363636,20,349,315,34,0,0,0,0,7,12,11,4.857143,0,0,19,14,false,true,true,0.734,0.266
28,24,4,14,12,4,1110,1039,71,0,0,0,0,88,2,2,0.409091,1,0,24,10,false,true,true,0.812,0.188
151,143,8,18.875,20.428571,8,1394,1230,164,0,1,0,0.142857,46,8,7,0.826087,0,0,10,18,false,true,false,0.096,0.904
333,309,24,19.588235,19.3125,24,518,448,70,0,0,0,0,-15,17,16,-2.266667,0,0,1,1,false,true,true,0.989,0.011
296,210,86,26.909091,21,86,695,671,24,0,0,0,0,17,11,10,1.941176,0,0,14,8,false,true,true,0.997,0.003
393,359,34,24.5625,22.4375,34,1144,1014,130,0,0,0,0,-14,16,16,-2.571429,0,0,3,3,false,true,true,0.997,0.003
138,82,56,19.714286,13.666667,56,971,658,313,0,0,0,0,57,7,6,0.631579,0,0,15,14,false,true,true,0.904,0.096
64,42,22,16,14,22,801,925,-124,1,0,0.25,0,72,4,3,0.486111,1,0,10,12,false,true,true,0.531,0.469
162,54,108,27,10.8,108,1004,653,351,0,0,0,0,57,6,5,0.614035,0,0,12,12,false,true,true,0.999,0.001
54,43,11,27,21.5,11,290,416,-126,0,0,0,0,84,2,2,0.404762,0,0,11,12,false,true,true,0.7,0.3
330,297,33,23.571429,21.214286,33,1397,1422,-25,3,1,0.214286,0.071429,16,14,14,2.25,0,0,13,23,false,true,true,1,0
113,77,36,11.3,8.555556,36,310,359,-49,0,0,0,0,35,10,9,1.4,1,0,6,18,false,true,true,0.863,0.137
158,83,75,22.571429,13.833333,75,834,758,76,0,0,0,0,57,7,6,0.631579,0,1,16,10,false,true,true,0.993,0.007
161,112,49,23,18.666667,49,1153,1065,88,0,1,0,0.166667,45,7,6,0.622222,0,0,19,19,false,true,true,0.8,0.2
313,269,44,13.608696,12.227273,44,613,502,111,0,0,0,0,-30,23,22,-1.633333,0,0,3,15,false,true,true,0.997,0.003
36,18,18,18,18,18,769,527,242,0,0,0,0,86,2,1,0.418605,0,0,12,10,false,true,true,0.525,0.475
270,270,0,18,19.285714,0,1078,1130,-52,0,1,0,0.071429,3,15,14,13,0,0,14,20,false,true,false,0.449,0.551
82,72,10,16.4,14.4,10,1047,1094,-47,0,0,0,0,67,5,5,0.537313,0,1,7,11,false,true,false,0.26,0.74
384,278,106,29.538462,21.384615,106,1396,1454,-58,2,0,0.153846,0,6,13,13,5.5,0,0,13,11,false,true,true,1,0
16,38,-22,16,38,-22,954,1078,-124,0,0,0,0,92,1,1,0.413043,0,0,14,8,false,true,false,0.179,0.821
63,87,-24,10.5,17.4,-24,1221,1258,-37,0,0,0,0,68,6,5,0.573529,1,0,11,10,false,true,false,0.246,0.754
118,82,36,23.6,16.4,36,1029,1227,-198,0,0,0,0,61,5,5,0.52459,0,0,10,25,false,true,false,0.491,0.509
222,199,23,22.2,19.9,23,901,889,12,0,1,0,0.1,35,10,10,1.228571,0,0,19,9,false,true,true,0.836,0.164
182,152,30,20.222222,16.888889,30,784,758,26,0,0,0,0,34,9,9,1.029412,0,0,12,10,false,true,true,0.851,0.149
175,140,35,14.583333,12.727273,35,416,374,42,0,0,0,0,40,12,11,1.15,0,0,10,10,false,true,true,0.862,0.138
317,308,9,21.133333,20.533333,9,1265,1045,220,0,1,0,0.066667,-6,15,15,-7,0,0,15,8,false,true,true,0.686,0.314
411,286,125,27.4,20.428571,125,1189,1266,-77,1,0,0.066667,0,-10,15,14,-3.4,0,0,4,2,false,true,true,1,0
240,162,78,26.666667,18,78,371,336,35,2,0,0.222222,0,17,9,9,2.235294,0,0,12,15,false,true,true,0.995,0.005
233,187,46,17.923077,15.583333,46,864,808,56,1,0,0.076923,0,6,13,12,5.666667,0,1,11,10,false,true,true,0.892,0.108
60,49,11,20,16.333333,11,1266,1144,122,0,0,0,0,73,3,3,0.465753,1,1,9,9,false,true,true,0.521,0.479
85,7,78,42.5,7,78,986,856,130,1,0,0.5,0,87,2,1,0.356322,0,0,18,16,false,true,true,0.891,0.109
224,169,55,28,24.142857,55,1210,1253,-43,0,1,0,0.142857,38,8,7,0.894737,0,0,12,15,false,true,true,0.764,0.236
354,291,63,20.823529,17.117647,63,941,926,15,1,0,0.058824,0,-11,17,17,-3.454545,0,0,8,5,false,true,true,1,0
416,291,125,27.733333,19.4,125,1101,1078,23,1,0,0.066667,0,-8,15,15,-4.125,0,1,4,1,false,true,true,1,0
320,294,26,20,19.6,26,1115,1078,37,0,1,0,0.066667,-5,16,15,-6.8,1,0,3,11,false,true,true,0.994,0.006
68,19,49,68,19,49,795,830,-35,1,0,1,0,88,1,1,0.477273,1,0,8,13,false,true,true,0.86,0.14
339,307,32,18.833333,17.055556,32,1094,1030,64,0,0,0,0,-20,18,18,-1.8,0,0,2,2,true,true,true,1,0
339,272,67,19.941176,16,67,691,675,16,0,0,0,0,-13,17,17,-2.846154,0,0,3,1,false,true,true,1,0
313,282,31,22.357143,20.142857,31,892,819,73,0,1,0,0.071429,1,14,14,34,0,0,14,6,false,true,true,0.954,0.046
73,40,33,14.6,10,33,801,807,-6,0,0,0,0,67,5,4,0.522388,0,0,13,17,false,true,true,0.527,0.473
244,111,133,24.4,12.333333,133,554,342,212,0,0,0,0,30,10,9,1.2,0,0,9,16,false,true,true,1,0
159,174,-15,17.666667,19.333333,-15,361,493,-132,0,0,0,0,34,9,9,1.205882,0,0,15,20,false,true,true,0.558,0.442
408,269,139,19.428571,13.45,139,777,830,-53,1,0,0.047619,0,-27,21,20,-1.518519,0,0,4,2,true,true,true,1,0
232,142,90,33.142857,20.285714,90,971,621,350,2,0,0.285714,0,42,7,7,0.761905,0,0,12,11,false,true,true,0.982,0.018
80,73,7,16,14.6,7,1050,1144,-94,0,0,0,0,67,5,5,0.567164,0,0,16,9,false,true,false,0.453,0.547
179,156,23,19.888889,19.5,23,1161,1166,-5,1,0,0.111111,0,34,9,8,1.029412,0,1,19,14,false,true,false,0.312,0.688
354,299,55,23.6,19.933333,55,1142,1095,47,1,0,0.066667,0,-12,15,15,-2.916667,0,0,13,7,false,true,true,0.999,0.001
571,329,242,40.785714,25.307692,242,991,996,-5,3,0,0.214286,0,-7,14,13,-4.285714,0,0,6,15,false,true,true,1,0
211,144,67,16.230769,12,67,872,818,54,0,1,0,0.083333,30,13,12,1.366667,1,0,11,8,false,true,true,0.981,0.019
278,268,10,23.166667,22.333333,10,1142,1095,47,1,0,0.083333,0,9,12,12,3.888889,0,0,14,11,false,true,true,0.734,0.266
329,291,38,15.666667,13.857143,38,826,771,55,0,0,0,0,-19,21,21,-2.368421,0,0,4,1,false,true,true,0.994,0.006
291,271,20,20.785714,19.357143,20,1027,856,171,1,1,0.071429,0.071429,-9,14,14,-3.666667,0,0,17,4,false,true,true,0.9,0.1
359,310,49,27.615385,23.846154,49,1875,1793,82,2,1,0.153846,0.076923,4,13,13,7.5,0,0,9,11,false,true,true,0.99,0.01
12,4,8,12,4,8,896,818,78,0,0,0,0,94,1,1,0.468085,0,0,14,11,false,true,true,0.524,0.476
60,51,9,20,17,9,1048,1000,48,0,0,0,0,78,3,3,0.512821,0,1,14,12,false,true,true,0.502,0.498
16,0,16,16,0,16,804,988,-184,0,0,0,0,95,1,0,0.347368,0,0,10,0,false,true,false,0.358,0.642
365,326,39,22.8125,20.375,39,834,758,76,0,1,0,0.0625,-16,16,16,-2.25,0,0,5,6,false,true,true,0.999,0.001
228,197,31,17.538462,15.153846,31,416,306,110,0,0,0,0,22,13,13,1.909091,0,0,10,10,false,true,true,0.918,0.082
225,62,163,20.454545,5.636364,163,1176,1076,100,0,0,0,0,52,11,11,1.134615,0,1,12,15,false,true,true,1,0
256,270,-14,19.692308,20.769231,-14,594,605,-11,0,0,0,0,5,13,13,7.4,0,0,14,9,false,true,true,0.666,0.334
81,103,-22,20.25,25.75,-22,965,1013,-48,0,0,0,0,68,4,4,0.485294,1,0,7,9,false,true,false,0.437,0.563
321,262,59,18.882353,16.375,59,885,719,166,0,0,0,0,-7,17,16,-5.428571,0,0,6,15,false,true,true,0.999,0.001
377,344,33,26.928571,24.571429,33,1659,1782,-123,1,0,0.071429,0,-14,14,14,-2.071429,0,0,1,4,false,true,true,0.994,0.006
332,359,-27,20.75,22.4375,-27,1439,1413,26,0,1,0,0.0625,-7,16,16,-5.142857,1,0,7,4,false,true,false,0.046,0.954
14,31,-17,14,31,-17,1102,1245,-143,0,0,0,0,91,1,1,0.307692,0,0,9,10,false,true,false,0.156,0.844
302,172,130,37.75,24.571429,130,1880,1777,103,1,0,0.125,0,37,8,7,0.756757,0,1,13,12,false,true,true,1,0
308,161,147,18.117647,9.470588,147,993,897,96,1,0,0.058824,0,-8,17,17,-5.875,0,1,26,25,false,true,true,1,0
239,109,130,26.555556,12.111111,130,801,925,-124,1,0,0.111111,0,37,9,9,0.945946,1,0,15,23,false,true,true,1,0
384,284,100,21.333333,15.777778,100,1030,998,32,1,0,0.055556,0,-22,18,18,-1.727273,0,0,1,1,false,true,true,1,0
215,121,94,23.888889,13.444444,94,1216,1230,-14,1,0,0.111111,0,44,9,9,0.727273,1,0,15,17,false,true,true,0.991,0.009
143,105,38,14.3,11.666667,38,880,952,-72,0,0,0,0,37,10,9,1.108108,0,0,12,8,false,true,true,0.711,0.289
281,223,58,16.529412,13.9375,58,416,306,110,0,0,0,0,-2,17,16,-21,1,0,15,9,false,true,true,0.99,0.01
26,4,22,13,4,22,450,412,38,0,0,0,0,91,2,1,0.417582,0,1,7,8,false,true,false,0.468,0.532
278,253,25,30.888889,31.625,25,1333,1331,2,1,0,0.111111,0,24,9,8,1.25,0,0,14,7,false,true,true,0.717,0.283
316,294,22,18.588235,18.375,22,1782,1512,270,1,1,0.058824,0.0625,-10,17,16,-4.2,0,0,5,12,false,true,true,0.988,0.012
199,178,21,22.111111,19.777778,21,1227,1060,167,0,1,0,0.111111,39,9,9,1.025641,0,0,12,16,false,true,false,0.461,0.539
232,187,45,21.090909,18.7,45,1078,1130,-52,0,1,0,0.1,29,11,10,1.344828,0,1,11,19,false,true,true,0.616,0.384
152,118,34,19,16.857143,34,468,542,-74,0,0,0,0,53,8,7,0.735849,0,0,16,17,false,true,true,0.728,0.272
22,26,-4,22,26,-4,1014,948,66,0,0,0,0,92,1,1,0.358696,1,0,14,9,false,true,true,0.837,0.163
297,263,34,37.125,32.875,34,1770,1689,81,0,1,0,0.125,26,8,8,1,0,0,10,22,false,true,true,0.943,0.057
280,269,11,14,14.157895,11,361,493,-132,1,0,0.05,0,-36,20,19,-1.138889,0,0,1,1,false,true,true,0.942,0.058
246,118,128,22.363636,11.8,128,925,801,124,1,0,0.090909,0,37,11,10,1.081081,1,0,9,28,false,true,true,1,0
92,79,13,15.333333,13.166667,13,498,43,455,0,0,0,0,60,6,6,0.616667,1,0,10,14,false,true,true,0.551,0.449
142,99,43,28.4,19.8,43,1270,1315,-45,0,0,0,0,62,5,5,0.580645,0,0,10,10,false,true,true,0.828,0.172
222,226,-4,20.181818,20.545455,-4,971,906,65,0,0,0,0,17,11,11,1.882353,0,0,9,11,false,true,true,0.585,0.415
306,265,41,20.4,18.928571,41,1295,1281,14,0,0,0,0,12,15,14,3.166667,0,1,16,8,false,true,true,0.782,0.218
48,42,6,24,21,6,1036,1181,-145,0,0,0,0,88,2,2,0.386364,0,1,25,10,false,true,false,0.477,0.523
161,170,-9,17.888889,18.888889,-9,719,785,-66,0,1,0,0.111111,37,9,9,0.972973,0,0,18,16,false,true,true,0.716,0.284
347,222,125,26.692308,18.5,125,1305,1390,-85,0,1,0,0.083333,6,13,12,6,0,1,10,19,false,true,true,1,0
24,31,-7,12,31,-7,1102,1245,-143,0,0,0,0,88,2,1,0.318182,0,0,9,10,false,true,false,0.136,0.864
22,14,8,11,14,8,786,847,-61,0,0,0,0,90,2,1,0.377778,0,1,11,9,false,true,false,0.26,0.74
216,144,72,36,24,72,1245,1241,4,1,1,0.166667,0.166667,52,6,6,0.557692,0,0,16,12,false,true,true,0.976,0.024
69,147,-78,17.25,36.75,-78,1076,1176,-100,0,1,0,0.25,66,4,4,0.484848,0,1,9,8,false,true,false,0.102,0.898
312,315,-3,24,24.230769,-3,1305,1242,63,2,1,0.153846,0.076923,5,13,13,6.8,0,0,20,8,false,true,false,0.371,0.629
108,23,85,54,23,85,1210,1252,-42,1,0,0.5,0,87,2,1,0.367816,0,0,11,14,false,true,true,0.759,0.241
340,217,123,13.6,9.041667,123,1428,1302,126,0,0,0,0,-29,25,24,-1.827586,0,1,12,11,false,true,true,0.999,0.001
180,186,-6,18,18.6,-6,671,725,-54,0,0,0,0,28,10,10,1.321429,0,0,14,12,false,true,true,0.598,0.402
77,100,-23,12.833333,16.666667,-23,859,822,37,0,0,0,0,55,6,6,0.690909,0,0,29,7,false,true,false,0.315,0.685
168,143,25,16.8,14.3,25,691,675,16,0,0,0,0,31,10,10,1.225806,0,0,12,24,false,true,true,0.731,0.269
266,158,108,29.555556,19.75,108,1245,1232,13,1,0,0.111111,0,25,9,8,1.16,0,0,19,14,false,true,true,0.997,0.003
46,30,16,23,15,16,916,837,79,0,0,0,0,87,2,2,0.45977,0,1,7,12,false,true,true,0.582,0.418
10,27,-17,10,27,-17,1043,1055,-12,0,0,0,0,93,1,1,0.397849,0,0,10,7,false,true,false,0.336,0.664
256,258,-2,19.692308,21.5,-2,594,605,-11,0,0,0,0,8,13,12,4.625,0,0,14,8,false,true,true,0.651,0.349
250,261,-11,17.857143,20.076923,-11,613,611,2,0,0,0,0,0,14,13,0,0,0,12,7,false,true,false,0.452,0.548
30,34,-4,15,34,-4,1304,1040,264,0,0,0,0,87,2,1,0.37931,0,0,13,15,false,true,false,0.156,0.844
274,171,103,22.833333,14.25,103,539,500,39,0,0,0,0,13,12,12,3.076923,0,0,10,10,false,true,true,1,0
135,67,68,27,16.75,68,871,867,4,0,0,0,0,65,5,4,0.661538,0,0,8,9,false,true,true,0.884,0.116
326,319,7,23.285714,24.538462,7,809,868,-59,2,1,0.142857,0.076923,-2,14,13,-16,1,0,1,12,false,true,true,0.976,0.024
161,87,74,26.833333,14.5,74,786,757,29,1,0,0.166667,0,58,6,6,0.672414,0,0,7,12,false,true,true,0.97,0.03
319,276,43,19.9375,18.4,43,1548,1493,55,1,0,0.0625,0,-2,16,15,-20.5,0,0,9,9,false,true,true,0.986,0.014
102,97,5,17,19.4,5,620,513,107,0,0,0,0,62,6,5,0.725806,0,1,10,6,false,true,false,0.484,0.516
348,281,67,38.666667,35.125,67,1348,1331,17,3,0,0.333333,0,18,9,8,1.333333,0,0,10,7,false,true,true,0.988,0.012
94,119,-25,18.8,23.8,-25,965,1013,-48,0,0,0,0,60,5,5,0.55,1,1,6,13,false,true,false,0.252,0.748
327,264,63,15.571429,13.2,63,416,306,110,0,0,0,0,-26,21,20,-1.615385,1,0,1,1,false,true,true,1,0
382,293,89,21.222222,17.235294,89,1305,1218,87,1,0,0.055556,0,-27,18,17,-1.407407,0,0,1,2,false,true,true,1,0
78,45,33,26,22.5,33,576,532,44,0,0,0,0,79,3,2,0.582278,1,0,9,7,false,true,true,0.535,0.465
124,109,15,17.714286,15.571429,15,527,581,-54,0,0,0,0,51,7,7,0.823529,1,0,11,15,false,true,true,0.564,0.436
49,37,12,24.5,18.5,12,971,1180,-209,0,0,0,0,87,2,2,0.367816,1,0,11,14,false,true,true,0.607,0.393
312,213,99,20.8,14.2,99,831,830,1,0,0,0,0,1,15,15,37,0,0,10,11,false,true,true,0.999,0.001
18,72,-54,18,72,-54,1344,1209,135,0,1,0,1,90,1,1,0.377778,1,0,8,7,false,true,false,0.247,0.753
106,87,19,17.666667,14.5,19,620,658,-38,0,0,0,0,57,6,6,0.631579,0,0,18,9,false,true,true,0.856,0.144
217,173,44,19.727273,17.3,44,711,876,-165,0,0,0,0,28,11,10,1.535714,0,0,7,10,false,true,true,0.762,0.238
164,118,46,23.428571,16.857143,46,1014,948,66,0,0,0,0,57,7,7,0.578947,0,0,10,16,false,true,true,0.867,0.133
344,285,59,26.461538,21.923077,59,1210,1253,-43,0,1,0,0.076923,-5,13,13,-6.8,0,0,17,14,false,true,true,0.999,0.001
352,194,158,15.304348,8.434783,158,993,897,96,1,0,0.043478,0,-25,23,23,-1.88,0,0,3,25,false,true,true,1,0
328,248,80,21.866667,17.714286,80,1364,1093,271,0,1,0,0.071429,3,15,14,12.666667,0,0,12,7,false,true,true,0.994,0.006
278,189,89,39.714286,31.5,89,1983,2020,-37,1,0,0.142857,0,41,7,6,0.634146,0,1,9,8,false,true,true,0.993,0.007
233,124,109,23.3,13.777778,109,1075,1152,-77,0,0,0,0,39,10,9,1.025641,0,1,9,10,false,true,true,0.997,0.003
70,49,21,23.333333,24.5,21,971,906,65,0,0,0,0,81,3,2,0.395062,0,1,16,13,false,true,true,0.512,0.488
92,71,21,23,17.75,21,901,1159,-258,1,0,0.25,0,73,4,4,0.479452,1,0,7,19,false,true,false,0.467,0.533
352,302,50,18.526316,16.777778,50,820,822,-2,0,0,0,0,-19,19,18,-2.052632,0,0,1,1,false,true,true,0.999,0.001
38,32,6,12.666667,10.666667,6,1281,1339,-58,0,0,0,0,80,3,3,0.5125,0,0,16,12,false,true,false,0.419,0.581
43,45,-2,10.75,15,-2,613,502,111,0,0,0,0,73,4,3,0.671233,0,0,12,19,false,true,false,0.267,0.733
277,252,25,17.3125,15.75,25,523,480,43,1,0,0.0625,0,-19,16,16,-1.736842,0,0,3,2,false,true,true,0.995,0.005
97,87,10,16.166667,17.4,10,611,584,27,0,0,0,0,69,6,5,0.637681,1,0,11,9,false,true,true,0.512,0.488
104,69,35,17.333333,13.8,35,527,514,13,0,0,0,0,60,6,5,0.65,0,0,7,12,false,true,true,0.818,0.182
12,0,12,12,0,12,1029,1227,-198,0,0,0,0,96,1,0,0.333333,0,0,15,0,false,true,false,0.292,0.708
366,321,45,22.875,20.0625,45,1439,1397,42,1,2,0.0625,0.125,-13,16,16,-2.615385,0,0,1,15,false,true,true,0.984,0.016
14,16,-2,14,16,-2,971,761,210,0,0,0,0,93,1,1,0.322581,0,1,9,9,false,true,true,0.526,0.474
334,315,19,19.647059,19.6875,19,926,854,72,0,0,0,0,-9,17,16,-3.777778,0,0,6,2,false,true,true,0.619,0.381
186,122,64,20.666667,13.555556,64,576,532,44,0,0,0,0,41,9,9,1.121951,1,0,8,16,false,true,true,0.981,0.019
99,102,-3,12.375,12.75,-3,416,222,194,0,0,0,0,48,8,8,1.145833,1,0,9,17,false,true,true,0.627,0.373
113,100,13,11.3,10,13,310,359,-49,0,0,0,0,32,10,10,1.53125,1,0,6,19,false,true,true,0.802,0.198
190,178,12,21.111111,19.777778,12,1094,1030,64,0,0,0,0,37,9,9,0.972973,1,0,10,11,false,true,true,0.575,0.425
37,56,-19,18.5,28,-19,1093,1197,-104,0,0,0,0,86,2,2,0.360465,0,0,17,7,false,true,false,0.281,0.719
225,121,104,25,15.125,104,1439,1413,26,0,0,0,0,48,9,8,0.75,1,0,14,11,false,true,true,0.996,0.004
80,61,19,20,15.25,19,699,448,251,0,0,0,0,75,4,4,0.533333,0,0,7,7,false,true,true,0.867,0.133
58,46,12,29,23,12,1428,1452,-24,0,0,0,0,87,2,2,0.356322,0,0,17,11,false,true,true,0.52,0.48
354,326,28,16.857143,16.3,28,1388,1477,-89,1,0,0.047619,0,-26,21,20,-1.846154,0,0,3,7,false,true,true,0.996,0.004
312,187,125,28.363636,18.7,125,769,527,242,1,0,0.090909,0,16,11,10,2.25,0,0,10,9,false,true,true,1,0
159,155,4,22.714286,22.142857,4,926,854,72,0,0,0,0,55,7,7,0.618182,0,0,8,9,false,true,true,0.637,0.363
16,21,-5,16,21,-5,786,788,-2,0,0,0,0,90,1,1,0.377778,0,0,21,10,false,true,false,0.421,0.579
113,150,-37,16.142857,25,-37,1075,989,86,0,0,0,0,62,7,6,0.629032,0,0,30,14,false,true,false,0.132,0.868
247,211,36,17.642857,16.230769,36,801,807,-6,0,0,0,0,6,14,13,5.833333,1,0,10,18,false,true,true,0.882,0.118
23,46,-23,11.5,23,-23,218,86,132,0,0,0,0,86,2,2,0.465116,0,0,12,10,false,true,false,0.292,0.708
171,141,30,15.545455,12.818182,30,1030,1045,-15,0,0,0,0,40,11,11,1.15,0,0,7,16,false,true,true,0.707,0.293
446,294,152,24.777778,17.294118,152,1167,1216,-49,1,0,0.055556,0,-7,18,17,-5.857143,0,0,2,5,false,true,true,1,0
412,323,89,22.888889,19,89,1075,1027,48,2,1,0.111111,0.058824,-20,18,17,-1.85,0,0,4,4,false,true,true,0.999,0.001
404,314,90,25.25,19.625,90,1331,1399,-68,1,0,0.0625,0,-19,16,16,-1.842105,0,0,3,2,false,true,true,1,0
77,96,-19,15.4,24,-19,416,306,110,0,0,0,0,72,5,4,0.583333,0,1,19,8,false,true,false,0.203,0.797
212,155,57,21.2,17.222222,57,804,988,-184,1,0,0.1,0,33,10,9,1,0,0,8,17,false,true,true,0.774,0.226
355,280,75,25.357143,21.538462,75,1554,1622,-68,2,0,0.142857,0,-6,14,13,-5.166667,0,0,7,14,false,true,true,0.999,0.001
265,253,12,20.384615,21.083333,12,971,906,65,0,0,0,0,8,13,12,4,1,0,9,12,false,true,false,0.437,0.563
226,148,78,28.25,18.5,78,371,336,35,2,0,0.25,0,25,8,8,1.52,0,0,14,16,false,true,true,0.961,0.039
288,257,31,13.714286,12.238095,31,947,909,38,0,0,0,0,-32,21,21,-1.4375,0,0,4,15,false,true,true,0.998,0.002
8,18,-10,8,18,-10,1214,1176,38,0,0,0,0,92,1,1,0.391304,0,0,13,12,false,true,false,0.405,0.595
318,307,11,31.8,30.7,11,1489,1558,-69,0,1,0,0.1,18,10,10,1.555556,0,1,10,6,false,true,false,0.197,0.803
339,267,72,19.941176,15.705882,72,505,95,410,0,1,0,0.058824,0,17,17,0,0,0,7,16,false,true,true,0.999,0.001
300,248,52,23.076923,19.076923,52,1305,1218,87,1,0,0.076923,0,8,13,13,4.75,0,0,17,8,false,true,true,0.972,0.028
256,227,29,17.066667,16.214286,29,527,581,-54,0,0,0,0,3,15,14,14,1,0,16,17,false,true,true,0.944,0.056
347,275,72,18.263158,15.277778,72,1170,1156,14,1,0,0.052632,0,-26,19,18,-1.461538,0,0,1,2,false,true,true,1,0
167,190,-23,15.181818,17.272727,-23,272,238,34,0,0,0,0,26,11,11,1.538462,0,0,10,9,false,true,true,0.574,0.426
20,0,20,20,0,20,1037,950,87,0,0,0,0,96,1,0,0.322917,1,0,7,0,false,true,true,0.57,0.43
70,109,-39,10,15.571429,-39,826,771,55,0,0,0,0,63,7,7,0.714286,0,0,11,12,false,true,false,0.107,0.893
242,195,47,26.888889,21.666667,47,1210,1253,-43,0,1,0,0.111111,27,9,9,1.259259,0,0,10,14,false,true,true,0.828,0.172
307,189,118,30.7,21,118,1101,1078,23,1,0,0.1,0,31,10,9,1.064516,0,1,10,8,false,true,true,1,0
105,105,0,21,21,0,613,569,44,0,0,0,0,62,5,5,0.629032,2,0,7,13,false,true,true,0.908,0.092
200,172,28,20,17.2,28,847,952,-105,0,0,0,0,45,10,10,0.8,0,0,7,11,false,true,true,0.679,0.321
307,193,114,19.1875,12.0625,114,872,818,54,0,1,0,0.0625,9,16,16,4.555556,0,0,20,10,false,true,true,0.99,0.01
137,134,3,27.4,26.8,3,1078,1130,-52,0,1,0,0.2,64,5,5,0.609375,0,0,12,9,false,true,true,0.799,0.201
91,55,36,22.75,18.333333,36,786,757,29,0,0,0,0,73,4,3,0.534247,0,0,7,10,false,true,true,0.67,0.33
314,212,102,22.428571,16.307692,102,580,620,-40,1,0,0.071429,0,13,14,13,3.307692,0,0,9,14,false,true,true,1,0
129,81,48,18.428571,13.5,48,500,567,-67,0,0,0,0,60,7,6,0.733333,0,0,9,15,false,true,true,0.85,0.15
214,232,-18,17.833333,19.333333,-18,491,398,93,0,0,0,0,21,12,12,1.714286,0,0,7,21,false,true,false,0.463,0.537
251,188,63,20.916667,15.666667,63,561,526,35,0,0,0,0,8,12,12,4.375,0,0,10,11,false,true,true,0.991,0.009
362,310,52,16.454545,14.761905,52,725,771,-46,0,1,0,0.047619,-29,22,21,-1.586207,0,0,1,4,false,true,true,0.998,0.002
253,254,-1,19.461538,19.538462,-1,1572,1550,22,1,0,0.076923,0,16,13,13,2.4375,1,1,12,7,false,true,false,0.271,0.729
378,221,157,31.5,20.090909,157,971,621,350,2,0,0.166667,0,7,12,11,4.571429,1,0,13,8,false,true,true,1,0
156,135,21,19.5,16.875,21,1090,1244,-154,0,0,0,0,44,8,8,0.840909,0,0,10,16,false,true,false,0.276,0.724
262,222,40,23.818182,20.181818,40,1210,1252,-42,1,0,0.090909,0,21,11,11,1.52381,0,0,7,16,false,true,true,0.809,0.191
396,266,130,28.285714,19,130,986,856,130,1,0,0.071429,0,-13,14,14,-2.384615,0,0,7,2,false,true,true,1,0
216,182,34,15.428571,13,34,218,86,132,0,0,0,0,4,14,14,10,0,0,19,13,false,true,true,0.944,0.056
212,240,-28,15.142857,17.142857,-28,262,306,-44,0,0,0,0,12,14,14,3.833333,0,0,10,13,false,true,false,0.084,0.916
255,193,62,31.875,24.125,62,1334,1477,-143,0,1,0,0.125,38,8,8,0.789474,0,0,9,8,false,true,true,0.926,0.074
243,205,38,30.375,29.285714,38,1875,1793,82,2,1,0.25,0.142857,43,8,7,0.697674,0,0,7,14,false,true,true,0.779,0.221
103,78,25,20.6,19.5,25,1101,1078,23,0,0,0,0,69,5,4,0.478261,1,1,7,19,false,true,false,0.383,0.617
370,273,97,26.428571,21,97,1556,1591,-35,1,0,0.071429,0,1,14,13,36,0,0,7,7,false,true,true,1,0
94,70,24,18.8,17.5,24,363,668,-305,0,0,0,0,78,5,4,0.551282,1,0,8,12,false,true,false,0.29,0.71
291,264,27,16.166667,14.666667,27,272,238,34,0,1,0,0.055556,-26,18,18,-1.538462,0,0,7,2,false,true,true,0.986,0.014
380,279,101,25.333333,19.928571,101,1556,1591,-35,2,0,0.133333,0,-9,15,14,-4,0,0,5,5,false,true,true,1,0
90,52,38,22.5,13,38,1397,1422,-25,1,0,0.25,0,75,4,4,0.48,0,1,10,11,false,true,true,1,0
81,58,23,27,19.333333,23,306,169,137,0,0,0,0,77,3,3,0.441558,0,0,12,12,false,true,true,0.786,0.214
70,110,-40,10,18.333333,-40,1221,1258,-37,0,0,0,0,62,7,6,0.629032,1,0,11,9,false,true,false,0.244,0.756
78,64,14,26,32,14,1333,1331,2,0,0,0,0,78,3,2,0.384615,1,0,18,14,false,true,true,0.859,0.141
108,130,-22,15.428571,21.666667,-22,1304,1040,264,0,0,0,0,59,7,6,0.559322,1,0,9,14,false,true,false,0.238,0.762
131,218,-87,18.714286,31.142857,-87,1076,1176,-100,0,1,0,0.142857,47,7,7,0.680851,0,0,21,11,false,true,false,0.072,0.928
278,173,105,19.857143,13.307692,105,1281,1339,-58,0,0,0,0,24,14,13,1.708333,0,0,19,10,false,true,true,0.982,0.018
14,32,-18,14,32,-18,1093,1197,-104,0,0,0,0,92,1,1,0.336957,0,0,15,10,false,true,false,0.189,0.811
214,115,99,42.8,28.75,99,991,996,-5,1,0,0.2,0,64,5,4,0.46875,1,0,8,7,false,true,true,0.997,0.003
209,102,107,20.9,11.333333,107,1069,917,152,0,0,0,0,41,10,9,0.829268,0,1,17,7,false,true,true,0.994,0.006
149,94,55,18.625,11.75,55,1050,1144,-94,0,0,0,0,53,8,8,0.716981,0,0,16,8,false,true,true,0.909,0.091
318,263,55,17.666667,14.611111,55,1270,1315,-45,0,0,0,0,-16,18,18,-2.25,0,0,1,18,true,true,true,0.998,0.002
162,129,33,16.2,14.333333,33,758,750,8,0,0,0,0,31,10,9,1.193548,0,1,10,11,false,true,true,0.511,0.489
449,279,170,29.933333,18.6,170,1550,1624,-74,2,0,0.133333,0,-3,15,15,-10,1,0,4,3,true,true,true,1,0
101,164,-63,20.2,32.8,-63,1076,1176,-100,0,1,0,0.2,58,5,5,0.551724,0,1,8,6,false,true,false,0.104,0.896
279,283,-4,19.928571,21.769231,-4,758,952,-194,0,0,0,0,1,14,13,40,0,0,7,7,false,true,false,0.165,0.835
73,45,28,36.5,22.5,28,1270,1315,-45,0,0,0,0,82,2,2,0.439024,0,0,12,8,false,true,true,0.594,0.406
233,225,8,17.923077,17.307692,8,719,785,-66,0,1,0,0.076923,14,13,13,2.571429,0,0,21,12,false,true,true,0.846,0.154
395,243,152,30.384615,18.692308,152,971,621,350,2,0,0.153846,0,-5,13,13,-6.4,1,0,12,17,false,true,true,1,0
410,335,75,27.333333,22.333333,75,1394,1424,-30,1,1,0.066667,0.066667,-6,15,15,-5.333333,0,0,1,6,false,true,true,0.999,0.001
87,63,24,29,21,24,746,796,-50,0,1,0,0.333333,72,3,3,0.666667,0,0,7,17,false,true,true,0.881,0.119
8,0,8,8,0,8,926,854,72,0,0,0,0,96,1,0,0.354167,0,0,9,0,false,true,false,0.481,0.519
314,269,45,12.56,11.208333,45,310,359,-49,0,0,0,0,-54,25,24,-0.907407,0,0,3,2,true,true,true,1,0
149,129,20,16.555556,14.333333,20,947,909,38,0,0,0,0,39,9,9,1.179487,1,0,9,37,false,true,false,0.325,0.675
263,228,35,21.916667,20.727273,35,1161,1166,-5,1,0,0.083333,0,13,12,11,2.692308,0,1,9,13,false,true,false,0.481,0.519
61,44,17,20.333333,22,17,1050,1144,-94,0,0,0,0,81,3,2,0.469136,0,0,7,8,false,true,false,0.37,0.63
318,295,23,13.826087,13.409091,23,871,999,-128,0,0,0,0,-33,23,22,-1.454545,0,0,1,3,false,true,true,0.998,0.002
30,0,30,30,0,30,971,1180,-209,0,0,0,0,97,1,0,0.329897,0,0,10,0,false,true,false,0.464,0.536
24,0,24,24,0,24,1489,1445,44,0,0,0,0,94,1,0,0.340426,0,0,19,0,false,true,true,0.523,0.477
309,281,28,20.6,18.733333,28,901,889,12,0,1,0,0.066667,5,15,15,8.6,0,0,14,8,false,true,true,0.947,0.053
46,81,-35,15.333333,27,-35,1077,1094,-17,0,0,0,0,77,3,3,0.545455,0,0,23,22,false,true,false,0.175,0.825
375,280,95,17.857143,14,95,719,651,68,0,1,0,0.05,-24,21,20,-1.875,0,0,2,3,false,true,true,1,0
264,174,90,29.333333,21.75,90,1030,998,32,1,0,0.111111,0,34,9,8,1.117647,0,0,16,10,false,true,true,0.972,0.028
261,265,-4,21.75,22.083333,-4,1513,1479,34,0,0,0,0,15,12,12,2.266667,1,0,15,9,false,true,true,0.794,0.206
313,268,45,19.5625,16.75,45,1221,1258,-37,1,0,0.0625,0,3,16,16,13,1,0,6,11,false,true,true,0.99,0.01
244,198,46,20.333333,16.5,46,939,913,26,0,1,0,0.083333,17,12,12,2.352941,0,0,10,7,false,true,true,0.98,0.02
275,160,115,22.916667,13.333333,115,1033,1037,-4,0,1,0,0.083333,22,12,12,2.045455,0,0,18,9,false,true,true,0.987,0.013
125,137,-12,15.625,17.125,-12,1176,1127,49,0,0,0,0,42,8,8,0.880952,0,0,13,24,false,true,false,0.142,0.858
162,145,17,18,18.125,17,808,812,-4,0,0,0,0,38,9,8,0.973684,1,0,13,16,false,true,true,0.509,0.491
344,281,63,28.666667,23.416667,63,1735,1770,-35,2,1,0.166667,0.083333,2,12,12,14,0,1,18,7,false,true,true,0.895,0.105
374,351,23,20.777778,20.647059,23,1154,1062,92,2,0,0.111111,0,-12,18,17,-2.916667,0,0,2,1,true,true,true,0.825,0.175
322,316,6,20.125,21.066667,6,786,976,-190,0,0,0,0,-11,16,15,-2.909091,0,0,4,2,false,true,true,0.669,0.331
34,22,12,17,11,12,801,925,-124,1,0,0.5,0,84,2,2,0.416667,1,0,6,11,false,true,false,0.489,0.511
12,0,12,12,0,12,784,758,26,0,0,0,0,96,1,0,0.364583,0,0,19,0,false,true,true,0.523,0.477
298,236,62,18.625,14.75,62,1606,1544,62,0,0,0,0,10,16,16,4.5,0,0,20,8,false,true,true,0.98,0.02
156,109,47,19.5,13.625,47,739,480,259,1,0,0.125,0,45,8,8,0.8,0,0,21,7,false,true,true,0.976,0.024
211,146,65,17.583333,13.272727,65,299,315,-16,0,0,0,0,25,12,11,1.68,0,0,10,11,false,true,true,0.974,0.026
228,226,2,19,18.833333,2,904,783,121,0,0,0,0,26,12,12,1.615385,0,0,13,11,false,true,true,0.689,0.311
81,49,32,20.25,16.333333,32,613,461,152,0,0,0,0,75,4,3,0.493333,0,1,7,13,false,true,true,0.919,0.081
271,283,-12,22.583333,23.583333,-12,1431,802,629,0,0,0,0,7,12,12,4.571429,0,0,11,8,false,true,true,0.992,0.008
258,168,90,17.2,12,90,498,43,455,0,0,0,0,4,15,14,9.25,0,0,7,19,false,true,true,0.999,0.001
156,96,60,19.5,13.714286,60,739,480,259,1,0,0.125,0,48,8,7,0.75,0,0,21,8,false,true,true,0.976,0.024
156,71,85,31.2,17.75,85,901,1159,-258,2,0,0.4,0,66,5,4,0.530303,0,0,10,19,false,true,true,0.869,0.131
234,199,35,21.272727,18.090909,35,1364,1093,271,0,1,0,0.090909,26,11,11,1.461538,1,0,9,12,false,true,true,0.927,0.073
221,233,-12,20.090909,23.3,-12,1181,1149,32,0,1,0,0.1,36,11,10,1.25,1,0,9,16,false,true,false,0.261,0.739
270,246,24,19.285714,18.923077,24,721,689,32,0,0,0,0,-10,14,13,-3.4,0,1,19,10,false,true,true,0.735,0.265
84,66,18,14,11,18,1159,1051,108,0,0,0,0,68,6,6,0.588235,0,0,21,17,false,true,true,0.733,0.267
191,168,23,13.642857,12,23,416,374,42,0,0,0,0,28,14,14,1.642857,0,0,11,12,false,true,true,0.889,0.111
213,163,50,17.75,14.818182,50,801,807,-6,0,0,0,0,17,12,11,2.058824,1,0,10,21,false,true,true,0.899,0.101
158,91,67,22.571429,15.166667,67,1397,1422,-25,1,0,0.142857,0,59,7,6,0.610169,0,1,7,11,false,true,true,0.661,0.339
279,241,38,13.95,12.684211,38,611,584,27,0,0,0,0,-15,20,19,-2.933333,1,0,1,12,false,true,true,0.998,0.002
55,34,21,13.75,11.333333,21,859,719,140,0,1,0,0.333333,71,4,3,0.746479,0,2,12,5,false,true,true,0.62,0.38
135,107,28,22.5,21.4,28,1189,1266,-77,0,0,0,0,62,6,5,0.548387,1,0,6,10,false,true,true,0.561,0.439
137,103,34,17.125,14.714286,34,1606,1544,62,0,0,0,0,60,8,7,0.75,1,0,13,7,false,true,true,0.825,0.175
28,0,28,28,0,28,758,952,-194,0,0,0,0,94,1,0,0.425532,0,0,13,0,false,true,true,0.527,0.473
70,103,-33,14,20.6,-33,1154,1062,92,0,0,0,0,69,5,5,0.507246,0,0,11,20,false,true,false,0.11,0.89
380,353,27,23.75,22.0625,27,1075,1009,66,2,0,0.125,0,-12,16,16,-2.666667,0,0,1,2,true,true,true,0.95,0.05
137,87,50,19.571429,14.5,50,620,658,-38,0,0,0,0,54,7,6,0.666667,0,0,23,9,false,true,true,0.884,0.116
193,170,23,17.545455,17,23,704,691,13,0,0,0,0,31,11,10,1.225806,1,0,9,10,false,true,true,0.705,0.295
143,124,19,23.833333,20.666667,19,809,868,-59,1,0,0.166667,0,50,6,6,0.64,0,0,16,27,false,true,true,0.722,0.278
16,0,16,16,0,16,947,810,137,0,0,0,0,96,1,0,0.4375,0,0,8,0,false,true,true,0.521,0.479
265,145,120,26.5,14.5,120,778,758,20,0,1,0,0.1,22,10,10,1.772727,1,0,8,12,false,true,true,1,0
101,95,6,20.2,19,6,691,473,218,0,0,0,0,62,5,5,0.580645,0,0,17,7,false,true,true,0.821,0.179
332,231,101,20.75,15.4,101,580,620,-40,1,0,0.0625,0,1,16,15,43,0,0,14,14,false,true,true,0.998,0.002
313,203,110,31.3,22.555556,110,1489,1555,-66,1,0,0.1,0,24,10,9,1.208333,0,0,10,14,false,true,true,1,0
131,80,51,18.714286,13.333333,51,1050,1144,-94,0,0,0,0,58,7,6,0.655172,0,0,16,10,false,true,true,0.826,0.174
70,66,4,23.333333,22,4,1075,1009,66,0,0,0,0,78,3,3,0.410256,1,1,8,18,false,true,false,0.499,0.501
410,335,75,31.538462,25.769231,75,1826,1656,170,2,0,0.153846,0,-6,13,13,-4.5,0,0,4,1,false,true,true,1,0
130,70,60,43.333333,23.333333,60,971,1180,-209,1,0,0.333333,0,76,3,3,0.421053,0,0,9,7,false,true,true,0.857,0.143
174,159,15,12.428571,12.230769,15,892,768,124,0,0,0,0,27,14,13,1.592593,0,0,15,21,false,true,false,0.472,0.528
52,0,52,26,0,52,1824,1793,31,0,0,0,0,93,2,1,0.301075,0,0,11,10,false,true,true,0.51,0.49
237,211,26,23.7,21.1,26,1489,1445,44,0,0,0,0,28,10,10,1.142857,1,0,7,16,false,true,true,0.875,0.125
133,110,23,19,18.333333,23,695,523,172,0,0,0,0,49,7,6,0.755102,0,1,9,6,false,true,true,0.936,0.064
240,185,55,18.461538,14.230769,55,739,480,259,1,0,0.076923,0,17,13,13,2.117647,0,1,16,13,false,true,true,0.987,0.013
394,242,152,28.142857,18.615385,152,1270,1322,-52,1,0,0.071429,0,7,14,13,5.428571,0,0,11,16,false,true,true,1,0
323,269,54,20.1875,16.8125,54,939,913,26,0,1,0,0.0625,-5,16,16,-8,1,0,6,10,false,true,true,1,0
38,42,-4,12.666667,14,-4,826,771,55,0,0,0,0,86,3,3,0.523256,0,0,7,13,false,true,false,0.324,0.676
341,176,165,17.947368,9.777778,165,421,306,115,0,1,0,0.055556,-13,19,18,-3.384615,0,0,9,9,false,true,true,1,0
280,249,31,21.538462,19.153846,31,1069,917,152,0,1,0,0.076923,9,13,13,3.777778,0,0,16,10,false,true,true,0.839,0.161
313,282,31,15.65,14.1,31,808,639,169,0,0,0,0,-24,20,20,-1.708333,0,0,3,1,false,true,true,0.995,0.005
36,36,0,9,12,0,450,412,38,0,0,0,0,78,4,3,0.487179,0,1,13,6,false,true,false,0.321,0.679
37,0,37,18.5,0,37,1875,1793,82,0,0,0,0,96,2,1,0.3125,0,0,14,9,false,true,false,0.453,0.547
159,130,29,26.5,26,29,1782,1512,270,1,1,0.166667,0.2,62,6,5,0.677419,0,0,13,10,false,true,true,0.986,0.014
277,204,73,19.785714,14.571429,73,1181,1069,112,0,0,0,0,9,14,14,4.111111,1,0,6,11,false,true,true,0.998,0.002
143,122,21,20.428571,17.428571,21,804,683,121,0,0,0,0,53,7,7,0.849057,0,1,16,6,false,true,true,0.816,0.184
199,163,36,22.111111,20.375,36,941,926,15,1,0,0.111111,0,40,9,8,0.95,1,0,9,8,false,true,true,0.811,0.189
290,301,-11,24.166667,25.083333,-11,1266,1144,122,0,0,0,0,10,12,12,3.4,1,0,7,7,false,true,true,0.681,0.319
160,236,-76,17.777778,29.5,-76,1265,1045,220,0,1,0,0.125,33,9,8,1.272727,0,0,16,7,false,true,false,0.346,0.654
265,174,91,18.928571,13.384615,91,871,867,4,0,0,0,0,14,14,13,3.071429,0,1,20,16,false,true,true,0.993,0.007
323,245,78,20.1875,16.333333,78,539,500,39,0,0,0,0,-9,16,15,-4.444444,0,0,8,13,false,true,true,0.999,0.001
62,36,26,15.5,12,26,1253,1166,87,0,0,0,0,77,4,3,0.558442,0,0,13,16,false,true,false,0.496,0.504
312,250,62,24,20.833333,62,904,668,236,0,0,0,0,-4,13,12,-8.5,0,0,11,10,false,true,true,0.999,0.001
310,233,77,44.285714,33.285714,77,1348,1331,17,2,0,0.285714,0,35,7,7,0.685714,0,0,13,17,false,true,true,0.995,0.005
63,43,20,12.6,10.75,20,310,359,-49,0,0,0,0,69,5,4,0.710145,1,0,6,13,false,true,true,0.543,0.457
244,246,-2,12.842105,12.947368,-2,1029,1075,-46,0,0,0,0,-3,19,19,-16,2,0,9,12,false,true,true,0.696,0.304
18,76,-58,18,76,-58,316,306,10,0,1,0,1,90,1,1,0.422222,1,0,11,11,false,true,false,0.183,0.817
172,150,22,19.111111,18.75,22,1073,1177,-104,0,0,0,0,42,9,8,0.761905,0,0,9,17,false,true,false,0.146,0.854
279,308,-29,23.25,28,-29,1762,1538,224,1,2,0.083333,0.181818,18,12,11,1.888889,0,0,21,11,false,true,true,0.918,0.082
184,179,5,15.333333,16.272727,5,450,412,38,0,0,0,0,19,12,11,2,0,0,11,12,false,true,true,0.639,0.361
14,0,14,14,0,14,1167,1216,-49,0,0,0,0,96,1,0,0.427083,0,0,9,0,false,true,false,0.355,0.645
343,293,50,20.176471,18.3125,50,820,822,-2,0,0,0,0,-9,17,16,-4.333333,0,0,6,4,false,true,true,0.999,0.001
209,210,-1,29.857143,35,-1,2219,2029,190,0,0,0,0,38,7,6,0.684211,0,1,27,6,false,true,true,0.886,0.114
380,319,61,19,16.789474,61,580,620,-40,1,0,0.05,0,-23,20,19,-1.869565,0,0,2,3,false,true,true,0.999,0.001
219,205,14,31.285714,29.285714,14,1875,1793,82,2,1,0.285714,0.142857,46,7,7,0.652174,0,0,12,14,false,true,true,0.764,0.236
177,90,87,29.5,18,87,1216,1230,-14,1,0,0.166667,0,56,6,5,0.571429,1,0,18,13,false,true,true,0.987,0.013
198,99,99,24.75,12.375,99,554,342,212,0,0,0,0,43,8,8,0.837209,0,0,12,18,false,true,true,0.999,0.001
143,149,-6,14.3,14.9,-6,1214,1176,38,0,0,0,0,41,10,10,0.878049,0,0,8,18,false,true,false,0.114,0.886
199,214,-15,19.9,23.777778,-15,869,820,49,0,1,0,0.111111,41,10,9,0.902439,0,1,7,8,false,true,false,0.023,0.977
337,302,35,17.736842,15.894737,35,725,771,-46,0,1,0,0.052632,-17,19,19,-2.705882,0,0,7,7,false,true,true,0.996,0.004
89,44,45,44.5,22,45,1489,1555,-66,1,0,0.5,0,80,2,2,0.3625,0,0,14,17,false,true,false,0.496,0.504
140,120,20,23.333333,24,20,1731,1691,40,0,0,0,0,59,6,5,0.576271,1,0,9,10,false,true,true,0.837,0.163
197,203,-6,19.7,22.555556,-6,942,976,-34,0,0,0,0,31,10,9,1.290323,0,0,14,7,false,true,false,0.156,0.844
285,291,-6,31.666667,32.333333,-6,1935,2020,-85,0,1,0,0.111111,28,9,9,1.107143,1,0,6,9,false,true,true,0.688,0.312
253,251,2,25.3,25.1,2,1096,1009,87,1,0,0.1,0,40,10,10,1.1,0,0,7,12,false,true,true,0.708,0.292
117,210,-93,23.4,42,-93,1636,1576,60,0,2,0,0.4,52,5,5,0.653846,0,0,10,12,false,true,false,0.039,0.961
181,190,-9,22.625,23.75,-9,1406,1454,-48,0,1,0,0.125,33,8,8,1.030303,1,1,6,10,false,true,false,0.163,0.837
49,45,4,24.5,22.5,4,594,605,-11,0,0,0,0,84,2,2,0.440476,0,0,11,19,false,true,false,0.393,0.607
300,211,89,16.666667,11.722222,89,1069,1040,29,0,0,0,0,-17,18,18,-2.588235,0,0,12,1,false,true,true,1,0
238,201,37,19.833333,18.272727,37,468,542,-74,0,0,0,0,24,12,11,1.625,0,0,7,10,false,true,true,0.709,0.291
215,86,129,35.833333,17.2,129,1550,1624,-74,0,0,0,0,61,6,5,0.491803,0,1,11,16,false,true,true,1,0
163,81,82,32.6,20.25,82,1408,1454,-46,1,0,0.2,0,66,5,4,0.484848,0,0,17,19,false,true,true,0.877,0.123
310,267,43,16.315789,14.833333,43,613,461,152,0,1,0,0.055556,-25,19,18,-1.48,0,0,2,1,true,true,true,0.999,0.001
93,37,56,15.5,7.4,56,1281,1339,-58,0,0,0,0,69,6,5,0.594203,1,0,18,13,false,true,true,0.852,0.148
80,89,-9,16,17.8,-9,921,1072,-151,0,0,0,0,68,5,5,0.558824,0,0,8,7,false,true,false,0.238,0.762
153,151,2,17,18.875,2,671,725,-54,0,0,0,0,36,9,8,1.027778,0,0,11,10,false,true,false,0.198,0.802
319,277,42,15.95,14.578947,42,480,518,-38,0,0,0,0,-16,20,19,-2.875,0,0,3,7,false,true,true,0.997,0.003
333,266,67,23.785714,19,67,902,866,36,0,0,0,0,-14,14,14,-2.285714,0,0,9,5,false,true,true,1,0
442,416,26,29.466667,27.733333,26,1897,1793,104,2,3,0.133333,0.2,-1,15,15,-32,0,0,2,3,false,true,true,0.997,0.003
135,134,1,16.875,16.75,1,540,518,22,0,0,0,0,47,8,8,0.851064,0,0,11,12,false,true,true,0.686,0.314
353,256,97,25.214286,18.285714,97,1030,998,32,1,0,0.071429,0,1,14,14,38,0,0,8,16,false,true,true,1,0
334,240,94,27.833333,21.818182,94,1093,1197,-104,2,0,0.166667,0,15,12,11,2.066667,1,0,6,9,false,true,true,1,0
24,0,24,24,0,24,830,907,-77,0,0,0,0,95,1,1,0.410526,0,0,11,0,false,true,true,0.569,0.431
291,252,39,14.55,12.6,39,584,565,19,0,0,0,0,-25,20,20,-1.84,0,0,15,5,false,true,true,0.983,0.017
158,88,70,26.333333,14.666667,70,554,342,212,0,0,0,0,57,6,6,0.631579,0,0,12,7,false,true,true,0.991,0.009
173,71,102,21.625,8.875,102,1413,1422,-9,0,0,0,0,51,8,8,1.117647,2,0,16,18,false,true,true,0.977,0.023
271,148,123,30.111111,18.5,123,996,1063,-67,1,1,0.111111,0.125,30,9,8,1.066667,0,0,12,16,false,true,true,1,0
107,163,-56,21.4,32.6,-56,1305,1218,87,0,0,0,0,57,5,5,0.666667,1,0,11,9,false,true,true,0.506,0.494
92,58,34,18.4,14.5,34,498,43,455,0,0,0,0,68,5,4,0.544118,1,0,6,12,false,true,true,0.528,0.472
53,15,38,17.666667,7.5,38,584,565,19,0,0,0,0,83,3,2,0.554217,0,0,13,19,false,true,true,0.779,0.221
30,37,-7,15,18.5,-7,1334,1256,78,0,0,0,0,87,2,2,0.356322,1,0,10,9,false,true,true,0.772,0.228
289,234,55,19.266667,16.714286,55,1040,925,115,0,0,0,0,-3,15,14,-14.333333,1,0,7,12,false,true,true,0.999,0.001
139,154,-15,23.166667,25.666667,-15,1406,1454,-48,0,1,0,0.166667,48,6,6,0.708333,1,0,15,9,false,true,true,0.823,0.177
323,292,31,17,16.222222,31,908,859,49,0,0,0,0,-17,19,18,-2.294118,0,0,1,2,false,true,true,0.994,0.006
232,130,102,33.142857,21.666667,102,971,621,350,2,0,0.285714,0,45,7,6,0.711111,0,0,12,13,false,true,true,0.982,0.018
90,67,23,22.5,16.75,23,272,288,-16,0,0,0,0,71,4,4,0.732394,1,0,10,13,false,true,true,0.557,0.443
40,25,15,13.333333,8.333333,15,1519,1782,-263,0,0,0,0,84,3,3,0.392857,0,1,12,10,false,true,false,0.246,0.754
118,152,-34,16.857143,21.714286,-34,1100,1008,92,0,0,0,0,56,7,7,0.642857,2,0,9,9,false,true,true,0.793,0.207
157,125,32,17.444444,15.625,32,1027,856,171,1,0,0.111111,0,34,9,8,0.970588,1,1,19,8,false,true,true,0.523,0.477
221,253,-32,18.416667,21.083333,-32,1181,1149,32,0,1,0,0.083333,31,12,12,1.451613,1,0,9,18,false,true,false,0.154,0.846
99,38,61,24.75,12.666667,61,1586,1782,-196,0,0,0,0,75,4,3,0.533333,0,0,17,18,false,true,true,0.514,0.486
61,77,-16,12.2,19.25,-16,778,758,20,0,0,0,0,67,5,4,0.58209,0,0,21,7,false,true,false,0.253,0.747
124,77,47,31,25.666667,47,866,949,-83,0,0,0,0,75,4,3,0.533333,0,1,9,6,false,true,true,0.808,0.192
24,0,24,24,0,24,1127,1134,-7,0,0,0,0,97,1,0,0.309278,0,0,17,0,false,true,true,0.524,0.476
359,291,68,15.608696,13.227273,68,416,374,42,0,0,0,0,-25,23,22,-1.84,0,0,1,1,false,true,true,1,0
12,17,-5,12,17,-5,691,675,16,0,0,0,0,93,1,1,0.408602,0,0,16,14,false,true,false,0.315,0.685
95,67,28,19,13.4,28,1277,1166,111,0,0,0,0,67,5,5,0.537313,0,2,8,8,false,true,true,0.67,0.33
326,238,88,15.52381,11.9,88,913,871,42,0,0,0,0,-19,21,20,-2.263158,0,0,3,2,false,true,true,1,0
159,127,32,17.666667,15.875,32,859,822,37,0,0,0,0,40,9,8,0.95,0,0,16,18,false,true,true,0.718,0.282
203,156,47,15.615385,13,47,947,909,38,0,0,0,0,16,13,12,2.875,0,0,9,32,false,true,true,0.785,0.215
44,13,31,22,13,31,971,658,313,0,0,0,0,90,2,1,0.4,0,0,12,11,false,true,true,0.707,0.293
319,193,126,18.764706,11.352941,126,871,867,4,0,0,0,0,-2,17,17,-21.5,0,1,10,16,false,true,true,1,0
183,169,14,14.076923,14.083333,14,539,632,-93,0,0,0,0,29,13,12,1.586207,0,0,10,7,false,true,true,0.609,0.391
45,11,34,22.5,11,34,820,783,37,0,0,0,0,90,2,1,0.366667,0,0,10,23,false,true,false,0.461,0.539
149,144,5,16.555556,16,5,540,518,22,0,0,0,0,42,9,9,0.952381,0,0,11,12,false,true,true,0.711,0.289
110,177,-67,22,35.4,-67,1075,1009,66,0,0,0,0,59,5,5,0.542373,0,0,10,14,false,true,false,0.108,0.892
94,59,35,15.666667,9.833333,35,801,807,-6,0,0,0,0,58,6,6,0.603448,0,0,14,23,false,true,true,0.746,0.254
98,45,53,24.5,11.25,53,1055,1050,5,0,0,0,0,75,4,4,0.453333,0,0,12,7,false,true,true,0.88,0.12
378,246,132,17.181818,11.714286,132,620,513,107,0,0,0,0,-20,22,21,-2.25,0,0,1,3,false,true,true,1,0
217,196,21,19.727273,17.818182,21,791,774,17,1,0,0.090909,0,35,11,11,1.171429,0,0,11,12,false,true,true,0.766,0.234
35,56,-21,11.666667,18.666667,-21,1065,1030,35,0,0,0,0,80,3,3,0.425,0,0,26,8,false,true,false,0.402,0.598
245,177,68,17.5,13.615385,68,272,288,-16,0,0,0,0,29,14,13,1.793103,0,0,8,16,false,true,true,0.958,0.042
324,175,149,18,9.722222,149,1176,1076,100,0,0,0,0,21,18,18,2.809524,0,0,13,14,false,true,true,1,0
344,259,85,28.666667,23.545455,85,1735,1770,-35,2,1,0.166667,0.090909,5,12,11,5.6,0,1,18,18,false,true,true,0.994,0.006
188,156,32,23.5,19.5,32,1227,1060,167,0,1,0,0.125,48,8,8,0.833333,0,0,14,9,false,true,true,0.891,0.109
206,196,10,20.6,19.6,10,1266,1247,19,0,0,0,0,31,10,10,1.032258,0,0,12,9,false,true,true,0.565,0.435
261,235,26,20.076923,18.076923,26,1548,1493,55,1,0,0.076923,0,11,13,13,3.727273,0,0,7,21,false,true,true,0.748,0.252
175,153,22,14.583333,12.75,22,416,374,42,0,0,0,0,38,12,12,1.210526,0,1,10,9,false,true,true,0.856,0.144
94,53,41,31.333333,17.666667,41,809,868,-59,1,0,0.333333,0,75,3,3,0.426667,0,0,16,9,false,true,true,0.732,0.268
125,135,-10,20.833333,27,-10,1364,1093,271,0,1,0,0.2,61,6,5,0.622951,0,0,15,9,false,true,true,0.876,0.124
171,205,-34,15.545455,20.5,-34,95,360,-265,0,1,0,0.1,22,11,10,1.818182,0,0,14,10,false,true,false,0.186,0.814
110,82,28,27.5,20.5,28,1334,1477,-143,0,0,0,0,69,4,4,0.434783,0,2,12,11,false,true,true,0.791,0.209
193,194,-1,19.3,21.555556,-1,1027,856,171,1,1,0.1,0.111111,24,10,9,1.375,1,0,13,10,false,true,true,0.751,0.249
89,103,-14,14.833333,20.6,-14,1154,1062,92,0,0,0,0,64,6,5,0.546875,0,0,11,20,false,true,false,0.11,0.89
10,0,10,10,0,10,95,360,-265,0,0,0,0,97,1,0,0.412371,0,0,9,0,false,true,false,0.339,0.661
531,329,202,40.846154,25.307692,202,991,996,-5,3,0,0.230769,0,-4,13,13,-7.5,0,0,18,15,false,true,true,1,0
349,302,47,17.45,15.894737,47,725,771,-46,0,1,0,0.052632,-21,20,19,-2.190476,0,0,6,7,false,true,true,0.997,0.003
139,116,23,19.857143,19.333333,23,1516,1397,119,0,1,0,0.166667,51,7,6,0.647059,0,0,16,12,false,true,true,0.705,0.295
280,183,97,18.666667,13.071429,97,1253,1166,87,1,0,0.066667,0,12,15,14,3.583333,0,0,12,17,false,true,true,0.998,0.002
328,211,117,16.4,11.105263,117,1069,1040,29,0,0,0,0,-26,20,19,-1.692308,0,0,2,1,false,true,true,1,0
362,275,87,22.625,18.333333,87,1065,1030,35,0,1,0,0.066667,-12,16,15,-2.833333,0,0,2,5,false,true,true,1,0
199,186,13,24.875,23.25,13,1355,1210,145,0,0,0,0,43,8,8,0.697674,1,0,8,9,false,true,true,0.86,0.14
323,222,101,26.916667,20.181818,101,1305,1390,-85,0,1,0,0.090909,8,12,11,4.5,0,1,13,19,false,true,true,1,0
371,222,149,20.611111,12.333333,149,1033,1037,-4,0,1,0,0.055556,-12,18,18,-3.75,1,1,12,5,false,true,true,1,0
316,303,13,18.588235,17.823529,13,1078,1130,-52,0,1,0,0.058824,-17,17,17,-2.294118,0,0,5,2,false,true,true,0.909,0.091
251,169,82,31.375,24.142857,82,2219,2106,113,1,0,0.125,0,36,8,7,0.75,0,0,7,10,false,true,true,0.874,0.126
46,40,6,11.5,10,6,801,807,-6,0,0,0,0,70,4,4,0.5,0,0,13,17,false,true,false,0.363,0.637
403,303,100,23.705882,18.9375,100,1050,1144,-94,0,1,0,0.0625,-16,17,16,-2.375,0,0,2,7,false,true,true,1,0
364,275,89,21.411765,17.1875,89,613,569,44,0,0,0,0,-11,17,16,-3.545455,0,0,2,4,false,true,true,1,0
334,181,153,18.555556,10.647059,153,896,818,78,0,1,0,0.058824,1,18,17,44,1,0,13,11,false,true,true,1,0
277,175,102,21.307692,13.461538,102,1295,1477,-182,2,0,0.153846,0,20,13,13,2.3,0,0,25,14,false,true,true,0.982,0.018
339,322,17,21.1875,20.125,17,1493,1513,-20,1,0,0.0625,0,-8,16,16,-4.125,0,1,5,4,false,true,true,0.814,0.186
138,74,64,17.25,10.571429,64,859,719,140,0,1,0,0.142857,44,8,7,1.204545,0,2,19,8,false,true,true,0.738,0.262
283,224,59,21.769231,17.230769,59,691,473,218,0,0,0,0,7,13,13,5.142857,1,1,9,7,false,true,true,0.947,0.053
252,224,28,21,20.363636,28,1344,1209,135,1,1,0.083333,0.090909,13,12,11,2.615385,0,0,8,18,false,true,true,0.785,0.215
332,234,98,19.529412,13.764706,98,1281,1339,-58,0,0,0,0,1,17,17,41,0,0,15,5,false,true,true,0.983,0.017
225,151,74,28.125,18.875,74,1501,1622,-121,1,0,0.125,0,42,8,8,0.738095,0,0,9,11,false,true,true,0.925,0.075
377,296,81,20.944444,16.444444,81,1047,1094,-47,1,1,0.055556,0.055556,-14,18,18,-2.571429,1,0,3,3,true,true,true,1,0
244,243,1,15.25,16.2,1,500,567,-67,0,0,0,0,15,16,15,2.933333,0,1,10,10,false,true,false,0.182,0.818
307,265,42,21.928571,20.384615,42,1304,1040,264,1,0,0.071429,0,9,14,13,3.666667,0,0,9,8,false,true,true,0.818,0.182
209,209,0,17.416667,17.416667,0,808,812,-4,0,0,0,0,18,12,12,2.055556,1,0,12,10,false,true,true,0.6,0.4
161,131,30,26.833333,26.2,30,1030,998,32,0,0,0,0,55,6,5,0.690909,0,0,7,15,false,true,false,0.493,0.507
326,281,45,18.111111,16.529412,45,363,668,-305,0,0,0,0,-6,18,17,-7.166667,0,1,8,8,false,true,true,0.984,0.016
108,35,73,21.6,8.75,73,872,818,54,0,0,0,0,70,5,4,0.585714,0,1,7,6,false,true,true,0.969,0.031
259,222,37,21.583333,18.5,37,901,1159,-258,2,0,0.166667,0,17,12,12,2.058824,1,0,7,7,false,true,true,0.964,0.036
362,224,138,30.166667,18.666667,138,1270,1322,-52,1,0,0.083333,0,17,12,12,2.235294,0,0,12,17,false,true,true,1,0
138,47,91,34.5,11.75,91,1014,1303,-289,1,0,0.25,0,68,4,4,0.558824,0,1,12,7,false,true,true,0.589,0.411
262,272,-10,18.714286,19.428571,-10,1181,1149,32,0,1,0,0.071429,18,14,14,2.5,1,0,8,14,false,true,true,0.586,0.414
218,87,131,24.222222,10.875,131,942,1003,-61,0,0,0,0,38,9,8,1.184211,0,1,21,15,false,true,true,0.995,0.005
294,266,28,17.294118,15.647059,28,859,822,37,0,0,0,0,-9,17,17,-4.222222,2,0,7,8,false,true,true,0.981,0.019
148,134,14,29.6,33.5,14,1890,2020,-130,0,1,0,0.25,61,5,4,0.47541,0,0,14,12,false,true,false,0.429,0.571
162,112,50,16.2,11.2,50,498,43,455,0,0,0,0,29,10,10,1.275862,0,0,11,19,false,true,true,0.933,0.067
298,247,51,19.866667,17.642857,51,448,598,-150,0,0,0,0,-4,15,14,-9,0,0,8,11,false,true,true,0.996,0.004
253,229,24,18.071429,16.357143,24,609,620,-11,0,0,0,0,3,14,14,12.333333,0,1,8,8,false,true,true,0.938,0.062
85,102,-17,17,20.4,-17,671,725,-54,0,0,0,0,65,5,5,0.569231,1,0,6,9,false,true,false,0.425,0.575
275,172,103,25,17.2,103,371,336,35,2,0,0.181818,0,6,11,10,6.333333,0,0,11,15,false,true,true,0.999,0.001
238,152,86,23.8,16.888889,86,1439,1294,145,1,0,0.1,0,33,10,9,1.090909,0,0,10,35,false,true,true,1,0
227,246,-19,17.461538,18.923077,-19,721,689,32,0,0,0,0,-6,13,13,-5.666667,0,1,26,10,false,true,false,0.288,0.712
374,310,64,31.166667,28.181818,64,1237,1277,-40,0,0,0,0,2,12,11,14.5,0,0,23,8,false,true,true,0.908,0.092
177,144,33,22.125,20.571429,33,1040,925,115,0,0,0,0,44,8,7,0.977273,0,0,13,7,false,true,true,0.843,0.157
196,199,-3,19.6,19.9,-3,1364,1093,271,0,1,0,0.1,32,10,10,1.1875,0,0,9,7,false,true,true,0.972,0.028
22,0,22,22,0,22,1731,1691,40,0,0,0,0,94,1,0,0.361702,1,0,9,0,false,true,true,0.85,0.15
168,220,-52,18.666667,24.444444,-52,594,605,-11,0,0,0,0,37,9,9,1,0,0,12,7,false,true,false,0.089,0.911
153,128,25,17,14.222222,25,1606,1544,62,0,0,0,0,52,9,9,0.865385,1,0,9,7,false,true,true,0.763,0.237
367,391,-24,30.583333,32.583333,-24,2219,2029,190,0,0,0,0,-11,12,12,-2.363636,0,0,2,11,false,true,true,0.989,0.011
227,198,29,32.428571,33,29,1454,1531,-77,1,1,0.142857,0.166667,44,7,6,0.681818,0,0,12,7,false,true,true,0.737,0.263
74,63,11,18.5,21,11,999,1011,-12,0,0,0,0,73,4,3,0.630137,0,0,11,21,false,true,false,0.211,0.789
273,298,-25,24.818182,29.8,-25,1125,1227,-102,1,1,0.090909,0.1,13,11,10,2.307692,1,0,8,8,false,true,false,0.198,0.802
194,196,-2,16.166667,16.333333,-2,527,514,13,0,0,0,0,15,12,12,2.6,0,0,8,15,false,true,true,0.641,0.359
26,34,-8,13,17,-8,1065,1030,35,0,0,0,0,87,2,2,0.390805,0,0,21,11,false,true,false,0.464,0.536
164,207,-43,20.5,25.875,-43,1302,1234,68,0,1,0,0.125,42,8,8,0.738095,2,0,8,7,false,true,true,0.813,0.187
409,262,147,18.590909,11.909091,147,1413,1422,-9,0,0,0,0,-22,22,22,-2.590909,0,0,3,7,false,true,true,1,0
164,106,58,23.428571,15.142857,58,859,811,48,0,0,0,0,51,7,7,0.705882,0,1,8,10,false,true,true,0.991,0.009
114,92,22,16.285714,15.333333,22,448,598,-150,0,0,0,0,54,7,6,0.666667,1,0,16,9,false,true,true,0.541,0.459
84,87,-3,21,29,-3,315,294,21,0,1,0,0.333333,72,4,3,0.486111,0,0,13,29,false,true,true,0.731,0.269
117,68,49,23.4,17,49,704,691,13,0,0,0,0,67,5,4,0.567164,0,0,15,11,false,true,true,0.879,0.121
67,92,-25,16.75,23,-25,671,725,-54,0,0,0,0,70,4,4,0.528571,1,0,8,10,false,true,false,0.433,0.567
183,57,126,36.6,14.25,126,1075,1027,48,2,0,0.4,0,61,5,4,0.606557,0,0,12,14,false,true,true,0.999,0.001
320,311,9,20,19.4375,9,1115,1078,37,0,1,0,0.0625,-8,16,16,-4.25,1,0,3,5,false,true,true,0.957,0.043
124,92,32,15.5,11.5,32,346,231,115,0,0,0,0,40,8,8,1.025,0,0,7,11,false,true,true,0.894,0.106
232,182,50,23.2,20.222222,50,948,933,15,1,0,0.1,0,41,10,9,0.926829,0,0,9,11,false,true,true,0.805,0.195
84,95,-11,16.8,23.75,-11,1244,1361,-117,0,0,0,0,73,5,4,0.520548,0,0,11,10,false,true,false,0.119,0.881
165,126,39,20.625,15.75,39,830,907,-77,1,0,0.125,0,44,8,8,0.886364,0,0,16,17,false,true,true,0.762,0.238
231,201,30,21,18.272727,30,1040,925,115,0,0,0,0,17,11,11,2.529412,0,0,13,10,false,true,true,0.808,0.192
138,54,84,27.6,10.8,84,1004,653,351,0,0,0,0,59,5,5,0.59322,0,0,14,12,false,true,true,0.998,0.002
282,171,111,31.333333,21.375,111,630,786,-156,1,0,0.111111,0,36,9,8,0.972222,0,0,7,23,false,true,true,0.999,0.001
221,193,28,27.625,24.125,28,416,282,134,1,0,0.125,0,44,8,8,0.772727,0,0,7,12,false,true,true,0.738,0.262
283,223,60,20.214286,15.928571,60,691,675,16,0,0,0,0,7,14,14,5.285714,0,1,20,7,false,true,true,0.991,0.009
195,178,17,11.470588,10.470588,17,416,222,194,0,0,0,0,2,17,17,27.5,0,0,15,25,false,true,true,0.921,0.079
0,12,-12,0,12,-12,1295,1477,-182,0,0,0,0,96,1,1,0.479167,0,0,9,9,false,true,false,0.245,0.755
220,218,2,18.333333,18.166667,2,786,976,-190,0,0,0,0,18,12,12,1.777778,1,0,16,10,false,true,false,0.424,0.576
212,209,3,23.555556,26.125,3,1539,1537,2,0,1,0,0.125,42,9,8,0.761905,0,0,11,10,false,true,false,0.294,0.706
61,73,-12,20.333333,24.333333,-12,1125,1227,-102,0,0,0,0,75,3,3,0.4,0,0,11,15,false,true,false,0.152,0.848
255,262,-7,21.25,21.833333,-7,315,294,21,0,1,0,0.083333,8,12,12,4.375,0,0,17,12,false,true,true,0.662,0.338
182,150,32,16.545455,13.636364,32,416,306,110,0,0,0,0,36,11,11,1.166667,0,0,14,13,false,true,true,0.882,0.118
260,155,105,28.888889,19.375,105,795,830,-35,1,1,0.111111,0.125,31,9,8,1.354839,0,0,8,16,false,true,true,0.999,0.001
241,115,126,26.777778,14.375,126,778,758,20,0,0,0,0,37,9,8,1.054054,2,0,7,8,false,true,true,1,0
57,74,-17,14.25,18.5,-17,825,907,-82,0,0,0,0,75,4,4,0.533333,2,0,12,10,false,true,true,0.846,0.154
400,374,26,30.769231,28.769231,26,1890,2020,-130,1,2,0.076923,0.153846,-11,13,13,-2.636364,0,0,6,1,false,true,true,0.998,0.002
252,154,98,36,25.666667,98,1302,1349,-47,0,0,0,0,41,7,6,0.682927,0,1,13,9,false,true,true,0.999,0.001
326,370,-44,25.076923,28.461538,-44,834,844,-10,1,2,0.076923,0.153846,-5,13,13,-7.2,0,0,7,14,false,true,false,0.083,0.917
151,161,-10,16.777778,17.888889,-10,1176,1127,49,0,0,0,0,35,9,9,1.057143,0,0,10,23,false,true,false,0.132,0.868
80,94,-14,16,23.5,-14,1885,1846,39,0,1,0,0.25,58,5,4,0.5,1,0,17,10,false,true,true,0.802,0.198
177,146,31,25.285714,24.333333,31,1078,1130,-52,0,1,0,0.166667,54,7,6,0.722222,0,0,7,9,false,true,true,0.848,0.152
334,284,50,19.647059,17.75,50,1548,1493,55,1,0,0.058824,0,-8,17,16,-5.125,0,0,5,8,false,true,true,0.999,0.001
68,62,6,22.666667,20.666667,6,290,416,-126,0,0,0,0,77,3,3,0.441558,0,0,14,19,false,true,true,0.677,0.323
15,15,0,7.5,15,0,941,926,15,0,0,0,0,89,2,1,0.426966,1,0,7,16,false,true,false,0.364,0.636
62,42,20,20.666667,14,20,498,43,455,0,0,0,0,79,3,3,0.468354,2,0,5,13,false,true,true,0.948,0.052
38,22,16,19,22,16,711,876,-165,0,0,0,0,89,2,1,0.483146,0,0,7,11,false,true,false,0.316,0.684
316,301,15,21.066667,21.5,15,786,976,-190,0,0,0,0,-4,15,14,-8,0,0,4,6,false,true,true,0.932,0.068
111,87,24,22.2,17.4,24,1051,1030,21,0,0,0,0,60,5,5,0.5,0,0,11,10,false,true,true,0.629,0.371
24,18,6,12,9,6,721,689,32,0,0,0,0,80,2,2,0.425,0,0,16,16,false,true,false,0.403,0.597
147,68,79,24.5,13.6,79,1550,1546,4,0,0,0,0,64,6,5,0.46875,1,0,12,18,false,true,true,0.969,0.031
81,47,34,27,23.5,34,306,169,137,0,0,0,0,81,3,2,0.419753,0,0,12,10,false,true,true,0.813,0.187
279,236,43,17.4375,14.75,43,804,683,121,0,0,0,0,3,16,16,15,1,1,12,11,false,true,true,0.87,0.13
122,126,-4,13.555556,14,-4,904,857,47,0,0,0,0,42,9,9,0.97619,0,0,16,22,false,true,false,0.323,0.677
372,338,34,26.571429,24.142857,34,1762,1616,146,2,0,0.142857,0,-9,14,14,-3.333333,1,0,2,4,false,true,true,1,0
214,178,36,16.461538,14.833333,36,363,668,-305,0,0,0,0,24,13,12,1.791667,0,0,8,15,false,true,false,0.464,0.536
52,14,38,26,14,38,609,620,-11,0,0,0,0,89,2,1,0.41573,0,0,21,12,false,true,true,0.872,0.128
324,331,-7,20.25,22.066667,-7,1210,1252,-42,1,0,0.0625,0,-10,16,15,-3.2,1,0,2,4,false,true,false,0.238,0.762
214,208,6,21.4,23.111111,6,1154,1062,92,1,0,0.1,0,34,10,9,1.029412,1,0,9,15,false,true,false,0.335,0.665
216,135,81,24,15,81,859,811,48,0,0,0,0,37,9,9,0.972973,0,1,17,10,false,true,true,0.994,0.006
86,29,57,21.5,9.666667,57,1516,1397,119,0,0,0,0,76,4,3,0.434211,0,1,19,10,false,true,true,0.626,0.374
282,240,42,21.692308,18.461538,42,791,774,17,1,0,0.076923,0,22,13,13,1.863636,0,0,13,14,false,true,true,0.93,0.07
386,274,112,22.705882,16.117647,112,1651,1691,-40,1,0,0.058824,0,-18,17,17,-1.888889,1,0,3,3,true,true,true,1,0
50,31,19,25,15.5,19,904,783,121,0,0,0,0,84,2,2,0.5,0,0,13,22,false,true,true,0.588,0.412
415,243,172,29.642857,18.692308,172,971,621,350,2,0,0.142857,0,-8,14,13,-4,1,0,8,17,false,true,true,1,0
207,196,11,15.923077,16.333333,11,527,514,13,0,0,0,0,11,13,12,3.545455,0,0,10,15,false,true,true,0.612,0.388
378,246,132,16.434783,11.181818,132,620,513,107,0,0,0,0,-20,23,22,-2.25,0,0,1,3,true,true,true,1,0
286,243,43,22,20.25,43,1047,1094,-47,1,1,0.076923,0.083333,17,13,12,2.117647,0,0,19,9,false,true,true,0.947,0.053
440,326,114,29.333333,21.733333,114,1197,1127,70,0,0,0,0,-15,15,15,-2,0,0,3,5,true,true,true,1,0
299,113,186,17.588235,7.0625,186,859,719,140,0,1,0,0.0625,-1,17,16,-53,0,1,24,16,false,true,true,1,0
107,71,36,26.75,23.666667,36,1036,1181,-145,0,0,0,0,77,4,3,0.441558,0,1,16,6,false,true,false,0.456,0.544
305,283,22,20.333333,18.866667,22,1090,1244,-154,0,0,0,0,-5,15,15,-7.4,0,1,23,3,false,true,true,0.725,0.275
354,264,90,18.631579,14.666667,90,1606,1544,62,0,0,0,0,-6,19,18,-7.5,0,0,6,6,false,true,true,0.999,0.001
257,184,73,19.769231,15.333333,73,831,830,1,0,0,0,0,18,13,12,2.055556,1,0,15,9,false,true,true,0.981,0.019
162,133,29,18,14.777778,29,1221,1438,-217,0,0,0,0,42,9,9,1.071429,0,2,7,8,false,true,true,0.806,0.194
171,139,32,28.5,27.8,32,1004,840,164,1,0,0.166667,0,55,6,5,0.545455,1,0,8,9,false,true,true,0.805,0.195
22,14,8,11,14,8,1100,1008,92,0,0,0,0,91,2,1,0.395604,0,0,18,9,false,true,true,0.51,0.49
283,252,31,20.214286,18,31,719,785,-66,0,1,0,0.071429,7,14,14,5.142857,0,0,17,8,false,true,true,0.946,0.054
157,150,7,26.166667,25,7,1394,1424,-30,0,1,0,0.166667,56,6,6,0.571429,0,0,12,19,false,true,true,0.69,0.31
330,311,19,22,22.214286,19,974,995,-21,0,1,0,0.071429,-2,15,14,-16.5,0,0,11,5,false,true,true,0.802,0.198
36,21,15,18,10.5,15,1030,1045,-15,0,0,0,0,91,2,2,0.505495,0,0,15,13,false,true,true,0.523,0.477
138,77,61,17.25,9.625,61,859,719,140,0,1,0,0.125,41,8,8,1.292683,0,2,19,9,false,true,true,0.874,0.126
75,79,-4,15,19.75,-4,1221,1266,-45,0,0,0,0,66,5,4,0.530303,0,0,9,7,false,true,false,0.243,0.757
71,59,12,23.666667,19.666667,12,784,758,26,0,0,0,0,78,3,3,0.448718,0,0,14,10,false,true,true,0.662,0.338
106,90,16,21.2,18,16,1073,1177,-104,0,0,0,0,67,5,5,0.477612,1,0,12,20,false,true,true,0.662,0.338
277,245,32,17.3125,16.333333,32,523,480,43,1,0,0.0625,0,-16,16,15,-2.0625,0,0,3,2,false,true,true,0.989,0.011
98,84,14,19.6,16.8,14,527,503,24,0,0,0,0,70,5,5,0.585714,0,0,17,8,false,true,true,0.862,0.138
168,186,-18,24,26.571429,-18,1102,1245,-143,1,0,0.142857,0,31,7,7,0.903226,0,0,16,12,false,true,false,0.283,0.717
373,313,60,26.642857,24.076923,60,1762,1582,180,2,3,0.142857,0.230769,-5,14,13,-6.4,0,0,2,24,false,true,true,0.986,0.014
305,215,90,23.461538,17.916667,90,371,336,35,2,0,0.153846,0,-4,13,12,-9.5,0,0,8,20,false,true,true,0.999,0.001
138,89,49,27.6,17.8,49,1220,1261,-41,1,0,0.2,0,66,5,5,0.681818,0,0,12,11,false,true,true,0.869,0.131
348,247,101,21.75,16.466667,101,527,581,-54,0,0,0,0,-5,16,15,-8.4,0,0,7,12,false,true,true,1,0
306,259,47,19.125,17.266667,47,921,1072,-151,1,0,0.0625,0,4,16,15,9.5,0,1,9,16,false,true,true,0.826,0.174
131,151,-20,14.555556,16.777778,-20,908,859,49,0,0,0,0,42,9,9,0.928571,1,1,14,7,false,true,false,0.273,0.727
52,28,24,26,14,24,1803,1552,251,0,0,0,0,87,2,2,0.321839,0,0,19,16,false,true,true,0.977,0.023
266,122,144,22.166667,11.090909,144,925,801,124,1,0,0.083333,0,30,12,11,1.333333,1,0,9,28,false,true,true,1,0
269,180,89,24.454545,18,89,1093,1090,3,1,1,0.090909,0.1,32,11,10,1.0625,0,1,13,11,false,true,true,0.919,0.081
28,77,-49,28,77,-49,1394,1424,-30,0,1,0,1,88,1,1,0.363636,0,0,13,7,false,true,false,0.06,0.94
165,55,110,41.25,18.333333,110,1510,1583,-73,1,0,0.25,0,67,4,3,0.477612,0,0,21,11,false,true,true,0.918,0.082
265,233,32,29.444444,25.888889,32,1397,1195,202,1,0,0.111111,0,33,9,9,1.060606,0,1,18,9,false,true,false,0.499,0.501
174,154,20,21.75,22,20,1302,1082,220,0,0,0,0,35,8,7,0.857143,0,0,22,7,false,true,true,0.516,0.484
90,63,27,18,15.75,27,527,514,13,0,0,0,0,70,5,4,0.557143,0,0,10,10,false,true,true,0.773,0.227
211,224,-13,15.071429,16,-13,628,658,-30,0,0,0,0,19,14,14,2.421053,0,0,17,12,false,true,false,0.441,0.559
18,0,18,18,0,18,1164,1201,-37,0,0,0,0,94,1,0,0.446809,0,0,18,0,false,true,true,0.516,0.484
249,78,171,22.636364,7.8,171,896,818,78,0,0,0,0,43,11,10,1.023256,0,0,8,7,false,true,true,1,0
334,290,44,27.833333,24.166667,44,1075,1009,66,2,0,0.166667,0,9,12,12,3.555556,0,0,18,11,false,true,true,0.924,0.076
88,106,-18,22,26.5,-18,594,605,-11,0,0,0,0,73,4,4,0.506849,0,0,7,15,false,true,false,0.226,0.774
95,112,-17,15.833333,22.4,-17,596,595,1,0,0,0,0,66,6,5,0.606061,1,0,16,16,false,true,false,0.211,0.789
191,98,93,23.875,12.25,93,719,651,68,0,0,0,0,58,8,8,0.775862,0,0,17,8,false,true,true,0.983,0.017
325,259,66,16.25,13.631579,66,416,306,110,0,0,0,0,-20,20,19,-2.1,1,0,1,3,false,true,true,1,0
13,24,-11,6.5,12,-11,904,857,47,0,0,0,0,86,2,2,0.476744,0,0,25,8,false,true,true,0.512,0.488
134,105,29,19.142857,15,29,1037,950,87,1,0,0.142857,0,52,7,7,0.596154,0,0,12,16,false,true,true,0.789,0.211
313,229,84,26.083333,19.083333,84,1394,1118,276,0,1,0,0.083333,15,12,12,2.466667,0,0,10,12,false,true,true,0.998,0.002
93,107,-14,11.625,15.285714,-14,539,632,-93,0,0,0,0,56,8,7,0.821429,0,1,18,13,false,true,false,0.11,0.89
320,285,35,29.090909,25.909091,35,1075,1009,66,2,0,0.181818,0,16,11,11,2,0,0,16,7,false,true,true,0.817,0.183
380,297,83,25.333333,19.8,83,1556,1591,-35,2,0,0.133333,0,-11,15,15,-3.272727,0,0,5,4,false,true,true,1,0
314,309,5,14.272727,14.714286,5,576,494,82,0,0,0,0,-29,22,21,-1.517241,0,0,2,3,false,true,false,0.388,0.612
48,9,39,24,9,39,306,169,137,0,0,0,0,90,2,1,0.377778,0,0,15,19,false,true,true,0.768,0.232
393,298,95,28.071429,21.285714,95,1004,840,164,1,0,0.071429,0,-11,14,14,-2.727273,0,0,3,3,false,true,true,1,0
318,313,5,24.461538,26.083333,5,908,1070,-162,1,0,0.076923,0,5,13,12,6,0,0,8,8,false,true,false,0.377,0.623
99,102,-3,11,11.333333,-3,416,222,194,0,0,0,0,48,9,9,1.145833,1,0,12,17,false,true,true,0.76,0.24
310,225,85,18.235294,14.0625,85,620,513,107,0,0,0,0,0,17,16,0,0,0,16,7,false,true,true,0.994,0.006
320,232,88,24.615385,17.846154,88,1029,1227,-198,1,0,0.076923,0,-5,13,13,-6.4,1,0,6,7,false,true,true,1,0
44,21,23,22,21,23,786,788,-2,0,0,0,0,85,2,1,0.4,0,0,18,10,false,true,true,0.521,0.479
199,163,36,18.090909,14.818182,36,801,807,-6,0,0,0,0,20,11,11,1.75,1,0,11,21,false,true,true,0.882,0.118
63,110,-47,10.5,18.333333,-47,1221,1258,-37,0,0,0,0,65,6,6,0.6,1,0,11,9,false,true,false,0.245,0.755
301,288,13,18.8125,19.2,13,1181,1149,32,0,1,0,0.066667,7,16,15,6.428571,1,0,13,14,false,true,true,0.856,0.144
20,0,20,20,0,20,913,871,42,0,0,0,0,95,1,0,0.452632,0,0,7,0,false,true,true,0.518,0.482
107,64,43,17.833333,12.8,43,1253,1166,87,0,0,0,0,66,6,5,0.651515,1,0,6,18,false,true,true,0.679,0.321
136,80,56,15.111111,10,56,584,565,19,0,0,0,0,45,9,8,1.022222,1,0,12,21,false,true,true,0.907,0.093
382,193,189,31.833333,17.545455,189,1513,1482,31,1,0,0.083333,0,9,12,11,3.666667,0,0,14,9,false,true,true,1,0
216,232,-16,27,29,-16,791,885,-94,1,1,0.125,0.125,39,8,8,0.974359,0,0,24,7,false,true,true,0.722,0.278
83,52,31,20.75,17.333333,31,786,976,-190,0,0,0,0,81,4,3,0.395062,0,0,9,9,false,true,false,0.375,0.625
165,171,-6,20.625,21.375,-6,518,448,70,0,0,0,0,45,8,8,0.755556,0,0,15,9,false,true,true,0.727,0.273
352,302,50,19.555556,16.777778,50,1434,1493,-59,1,0,0.055556,0,-14,18,18,-2.642857,0,0,6,1,false,true,true,0.999,0.001
83,61,22,20.75,20.333333,22,613,549,64,0,0,0,0,71,4,3,0.619718,0,0,11,11,false,true,true,0.508,0.492
323,345,-22,26.916667,28.75,-22,1419,1488,-69,1,1,0.083333,0.083333,1,12,12,28,1,0,9,5,false,true,true,0.541,0.459
333,289,44,17.526316,16.055556,44,866,949,-83,0,0,0,0,-16,19,18,-2.5,1,0,1,5,false,true,true,0.998,0.002
440,326,114,29.333333,23.285714,114,1197,1127,70,0,0,0,0,-15,15,14,-2,0,0,3,5,false,true,true,1,0
277,210,67,23.083333,19.090909,67,1731,1691,40,1,0,0.083333,0,14,12,11,2.428571,0,0,10,9,false,true,true,0.953,0.047
19,22,-3,9.5,11,-3,596,595,1,0,0,0,0,88,2,2,0.454545,0,0,18,14,false,true,false,0.35,0.65
297,142,155,33,15.777778,155,918,619,299,2,0,0.222222,0,36,9,9,0.972222,1,0,6,10,false,true,true,1,0
235,97,138,26.111111,12.125,138,1014,1303,-289,1,0,0.111111,0,39,9,8,0.974359,0,1,8,13,false,true,true,0.999,0.001
309,326,-17,19.3125,20.375,-17,1439,1294,145,1,0,0.0625,0,-16,16,16,-2.25,1,0,3,15,false,true,false,0.397,0.603
22,18,4,11,18,4,1214,1176,38,0,0,0,0,90,2,1,0.4,0,0,10,12,false,true,false,0.305,0.695
308,294,14,20.533333,19.6,14,1115,1078,37,0,1,0,0.066667,-1,15,15,-34,1,0,6,11,false,true,true,0.995,0.005
387,263,124,19.35,13.15,124,1011,921,90,1,0,0.05,0,-16,20,20,-3.0625,0,0,6,12,false,true,true,1,0
80,110,-30,16,22,-30,1885,1846,39,0,1,0,0.2,55,5,5,0.527273,1,0,17,14,false,true,true,0.809,0.191
210,214,-4,19.090909,21.4,-4,1304,1040,264,1,0,0.090909,0,31,11,10,1.064516,0,0,18,12,false,true,true,0.687,0.313
258,147,111,28.666667,18.375,111,742,696,46,0,0,0,0,33,9,8,0.969697,0,0,12,16,false,true,true,1,0
182,114,68,30.333333,19,68,1093,1197,-104,1,0,0.166667,0,58,6,6,0.534483,0,0,11,20,false,true,true,0.814,0.186
253,260,-7,19.461538,20,-7,518,448,70,0,0,0,0,8,13,13,4.25,0,0,14,9,false,true,true,0.715,0.285
179,149,30,17.9,14.9,30,1281,1339,-58,0,0,0,0,44,10,10,0.931818,1,0,14,7,false,true,true,0.8,0.2
312,292,20,19.5,19.466667,20,758,952,-194,0,0,0,0,-11,16,15,-3.636364,0,0,6,7,false,true,true,0.939,0.061
348,305,43,24.857143,21.785714,43,965,1013,-48,1,0,0.071429,0,-6,14,14,-5.5,0,1,7,8,false,true,true,0.998,0.002
26,0,26,26,0,26,1277,1166,111,0,0,0,0,97,1,0,0.371134,0,0,18,0,false,true,true,0.529,0.471
34,21,13,17,10.5,13,310,359,-49,0,0,0,0,86,2,2,0.569767,0,0,10,14,false,true,true,0.672,0.328
156,169,-13,15.6,18.777778,-13,916,876,40,0,0,0,0,29,10,9,1.172414,1,0,12,7,false,true,false,0.403,0.597
372,314,58,20.666667,18.470588,58,1452,1469,-17,1,1,0.055556,0.058824,-20,18,17,-1.9,0,0,1,3,false,true,true,1,0
181,144,37,22.625,18,37,804,988,-184,1,0,0.125,0,42,8,8,0.785714,0,0,12,26,false,true,true,0.734,0.266
50,49,1,12.5,16.333333,1,1037,950,87,0,0,0,0,77,4,3,0.402597,1,0,8,17,false,true,false,0.424,0.576
290,209,81,18.125,13.933333,81,415,518,-103,0,0,0,0,-4,16,15,-9.5,0,0,6,21,false,true,true,0.999,0.001
272,196,76,27.2,19.6,76,1388,1506,-118,2,1,0.2,0.1,30,10,10,1.133333,0,0,7,25,false,true,true,1,0
88,93,-5,22,23.25,-5,1302,1234,68,0,0,0,0,70,4,4,0.442857,1,0,9,8,false,true,true,0.828,0.172
91,73,18,18.2,14.6,18,491,398,93,0,0,0,0,68,5,5,0.529412,0,1,8,13,false,true,true,0.721,0.279
200,203,-3,16.666667,16.916667,-3,695,523,172,0,0,0,0,13,12,12,2.846154,0,0,24,24,false,true,true,0.733,0.267
18,20,-2,18,20,-2,361,493,-132,0,0,0,0,93,1,1,0.44086,0,0,12,8,false,true,false,0.459,0.541
272,181,91,27.2,20.111111,91,1156,1114,42,1,0,0.1,0,22,10,9,1.454545,0,0,15,16,false,true,true,0.995,0.005
102,78,24,14.571429,13,24,719,614,105,0,0,0,0,58,7,6,0.741379,0,2,13,14,false,true,false,0.434,0.566
66,36,30,16.5,12,30,916,876,40,0,0,0,0,74,4,3,0.459459,0,0,15,17,false,true,false,0.483,0.517
148,217,-69,24.666667,36.166667,-69,1419,1488,-69,0,1,0,0.166667,42,6,6,0.666667,1,0,16,11,false,true,true,0.51,0.49
310,279,31,15.5,13.95,31,804,683,121,0,0,0,0,-17,20,20,-2.647059,0,1,14,3,false,true,true,0.888,0.112
79,72,7,19.75,24,7,871,999,-128,0,0,0,0,74,4,3,0.648649,0,0,10,10,false,true,false,0.187,0.813
115,103,12,16.428571,14.714286,12,1606,1544,62,0,0,0,0,63,7,7,0.714286,1,0,12,7,false,true,true,0.731,0.269
50,28,22,25,14,22,1305,1390,-85,0,0,0,0,84,2,2,0.428571,0,0,26,10,false,true,true,0.537,0.463
278,275,3,14.631579,15.277778,3,540,518,22,0,0,0,0,-20,19,18,-2,0,0,1,2,false,true,true,0.508,0.492
8,6,2,8,6,2,699,448,251,0,0,0,0,95,1,1,0.421053,0,0,20,7,false,true,true,0.543,0.457
106,26,80,35.333333,13,80,2219,2106,113,0,0,0,0,82,3,2,0.329268,0,1,10,15,false,true,true,0.879,0.121
202,134,68,28.857143,19.142857,68,371,336,35,2,0,0.285714,0,33,7,7,1.151515,0,0,7,15,false,true,true,0.58,0.42
125,83,42,25,20.75,42,971,906,65,0,0,0,0,64,5,4,0.5,0,0,10,13,false,true,true,0.796,0.204
190,95,95,21.111111,11.875,95,1069,917,152,0,0,0,0,47,9,8,0.723404,0,1,13,8,false,true,true,0.994,0.006
135,126,9,22.5,25.2,9,1355,1210,145,0,0,0,0,60,6,5,0.5,1,0,17,18,false,true,true,0.827,0.173
383,321,62,18.238095,15.285714,62,1551,1550,1,0,0,0,0,-38,21,21,-1.105263,0,0,1,2,true,true,true,1,0
202,119,83,28.857143,19.833333,83,742,696,46,0,0,0,0,48,7,6,0.666667,0,0,10,7,false,true,true,0.93,0.07
76,28,48,25.333333,9.333333,48,901,889,12,0,0,0,0,85,3,3,0.505882,0,1,9,9,false,true,true,0.877,0.123
37,27,10,12.333333,13.5,10,1159,1031,128,0,0,0,0,80,3,2,0.4875,1,0,15,17,false,true,true,0.59,0.41
26,7,19,13,3.5,19,719,614,105,0,0,0,0,89,2,2,0.483146,0,1,14,13,false,true,true,0.528,0.472
75,41,34,15,10.25,34,561,526,35,0,0,0,0,63,5,4,0.555556,1,0,18,19,false,true,true,0.625,0.375
394,293,101,17.130435,13.318182,101,539,632,-93,0,0,0,0,-32,23,22,-1.4375,0,0,1,4,false,true,true,1,0
97,48,49,24.25,16,49,1875,1793,82,1,0,0.25,0,79,4,3,0.379747,1,0,17,10,false,true,true,0.907,0.093
122,108,14,17.428571,18,14,691,675,16,0,0,0,0,54,7,6,0.703704,0,0,16,7,false,true,true,0.594,0.406
135,87,48,33.75,21.75,48,1256,1232,24,1,0,0.25,0,68,4,4,0.441176,0,1,10,11,false,true,true,0.533,0.467
388,238,150,20.421053,13.222222,150,303,342,-39,0,0,0,0,-21,19,18,-1.809524,0,0,1,1,false,true,true,1,0
265,212,53,20.384615,16.307692,53,808,639,169,0,0,0,0,15,13,13,2.733333,0,1,11,6,false,true,true,0.99,0.01
365,367,-2,20.277778,21.588235,-2,1439,1413,26,0,1,0,0.058824,-16,18,17,-2.25,0,0,3,2,false,true,false,0.043,0.957
386,274,112,22.705882,17.125,112,1651,1691,-40,1,0,0.058824,0,-18,17,16,-1.888889,1,0,3,3,false,true,true,1,0
24,20,4,12,20,4,1334,1270,64,0,0,0,0,89,2,1,0.41573,0,0,11,12,false,true,false,0.343,0.657
161,119,42,32.2,29.75,42,2219,2106,113,0,0,0,0,62,5,4,0.435484,0,0,8,9,false,true,true,0.737,0.263
13,76,-63,6.5,38,-63,1554,1573,-19,0,0,0,0,88,2,2,0.386364,0,0,12,10,false,true,false,0.106,0.894
99,57,42,19.8,14.25,42,1489,1445,44,0,0,0,0,65,5,4,0.492308,0,0,23,10,false,true,true,0.537,0.463
236,219,17,23.6,21.9,17,290,416,-126,0,0,0,0,29,10,10,1.172414,0,0,11,15,false,true,true,0.731,0.269
204,209,-5,17,19,-5,613,549,64,0,0,0,0,22,12,11,2,1,0,11,10,false,true,false,0.369,0.631
363,275,88,22.6875,18.333333,88,1731,1691,40,1,0,0.0625,0,-10,16,15,-3.4,0,0,2,15,false,true,true,1,0
365,363,2,21.470588,21.352941,2,1636,1576,60,0,2,0,0.117647,-17,17,17,-2,0,0,1,13,true,true,true,0.91,0.09
106,52,54,21.2,13,54,1397,1422,-25,1,0,0.2,0,72,5,4,0.5,0,1,10,11,false,true,true,0.999,0.001
312,271,41,20.8,19.357143,41,1027,856,171,1,1,0.066667,0.071429,-11,15,14,-3,0,0,7,4,false,true,true,0.846,0.154
276,285,-9,30.666667,31.666667,-9,1489,1558,-69,0,1,0,0.111111,28,9,9,1,0,1,14,9,false,true,false,0.072,0.928
97,61,36,32.333333,20.333333,36,1270,1315,-45,0,0,0,0,75,3,3,0.48,0,1,7,7,false,true,true,0.749,0.251
59,38,21,19.666667,19,21,1735,1770,-35,0,0,0,0,74,3,2,0.378378,0,0,7,7,false,true,false,0.352,0.648
190,132,58,23.75,16.5,58,691,675,16,0,0,0,0,47,8,8,0.787234,0,1,12,14,false,true,true,0.991,0.009
350,216,134,29.166667,19.636364,134,1334,1256,78,2,0,0.166667,0,14,12,11,2.214286,0,0,9,9,false,true,true,1,0
329,248,81,16.45,13.052632,81,272,288,-16,0,0,0,0,-6,20,19,-8.666667,0,0,10,7,false,true,true,1,0
289,188,101,18.0625,12.533333,101,272,288,-16,0,0,0,0,16,16,15,3.25,0,0,10,17,false,true,true,1,0
258,211,47,28.666667,23.444444,47,992,1100,-108,2,0,0.222222,0,30,9,9,1.133333,0,0,11,9,false,true,true,0.798,0.202
396,290,106,23.294118,18.125,106,1305,1390,-85,0,1,0,0.0625,-20,17,16,-1.8,0,2,3,5,false,true,true,0.998,0.002
52,27,25,17.333333,13.5,25,1439,1413,26,0,0,0,0,84,3,2,0.428571,0,0,15,10,false,true,false,0.488,0.512
331,328,3,18.388889,18.222222,3,901,889,12,0,1,0,0.055556,-13,18,18,-3.307692,0,0,10,6,false,true,false,0.495,0.505
305,271,34,25.416667,22.583333,34,791,885,-94,1,1,0.083333,0.083333,16,12,12,2.375,0,0,10,10,false,true,true,0.944,0.056
135,63,72,33.75,15.75,72,742,696,46,0,0,0,0,66,4,4,0.484848,0,1,16,11,false,true,true,0.994,0.006
343,236,107,22.866667,15.733333,107,526,370,156,0,0,0,0,-8,15,15,-4.375,0,0,12,7,false,true,true,1,0
122,145,-23,11.090909,14.5,-23,826,771,55,0,0,0,0,46,11,10,0.978261,0,1,12,11,false,true,false,0.135,0.865
94,43,51,23.5,14.333333,51,415,518,-103,0,0,0,0,75,4,3,0.506667,0,0,13,19,false,true,true,0.766,0.234
271,188,83,20.846154,15.666667,83,830,907,-77,1,0,0.076923,0,18,13,12,2.166667,0,0,11,10,false,true,true,0.989,0.011
408,264,144,21.473684,13.894737,144,777,830,-53,1,0,0.052632,0,-23,19,19,-1.782609,0,0,4,2,false,true,true,1,0
72,52,20,14.4,13,20,580,620,-40,0,0,0,0,70,5,4,0.614286,1,0,18,18,false,true,true,0.53,0.47
211,144,67,19.181818,14.4,67,786,788,-2,0,0,0,0,20,11,10,1.7,1,1,7,13,false,true,true,0.839,0.161
342,296,46,16.285714,14.095238,46,1077,1094,-17,0,0,0,0,-24,21,21,-1.75,1,0,2,1,true,true,true,0.998,0.002
362,299,63,22.625,19.933333,63,1142,1095,47,1,0,0.0625,0,-14,16,15,-2.5,0,0,8,7,false,true,true,0.999,0.001
288,227,61,18,14.1875,61,1048,1000,48,0,0,0,0,4,16,16,10,1,1,9,6,false,true,true,0.932,0.068
347,287,60,24.785714,20.5,60,1142,1095,47,1,0,0.071429,0,-5,14,14,-7,0,0,16,11,false,true,true,0.999,0.001
79,93,-14,26.333333,31,-14,1302,1234,68,0,0,0,0,75,3,3,0.413333,1,0,6,8,false,true,true,0.853,0.147
117,81,36,19.5,13.5,36,500,567,-67,0,0,0,0,63,6,6,0.698413,0,0,11,15,false,true,true,0.851,0.149
273,141,132,30.333333,17.625,132,1408,1454,-46,1,0,0.111111,0,39,9,8,0.820513,0,0,9,19,false,true,true,1,0
271,192,79,24.636364,19.2,79,971,1180,-209,1,0,0.090909,0,28,11,10,1.142857,0,1,8,10,false,true,true,0.974,0.026
109,83,26,18.166667,16.6,26,913,871,42,0,0,0,0,61,6,5,0.704918,0,0,13,12,false,true,true,0.552,0.448
224,203,21,22.4,22.555556,21,1127,1075,52,1,1,0.1,0.111111,28,10,9,1.107143,0,1,7,18,false,true,false,0.474,0.526
74,38,36,18.5,12.666667,36,1670,1770,-100,1,0,0.25,0,75,4,3,0.426667,0,0,28,9,false,true,true,0.525,0.475
106,86,20,21.2,17.2,20,1691,1692,-1,0,0,0,0,60,5,5,0.5,0,0,11,8,false,true,true,0.504,0.496
318,222,96,28.909091,22.2,96,1510,1583,-73,1,0,0.090909,0,16,11,10,2,0,0,11,12,false,true,true,0.999,0.001
216,255,-39,19.636364,25.5,-39,1076,1176,-100,0,1,0,0.1,24,11,10,1.333333,0,1,28,6,false,true,false,0.089,0.911
231,148,83,19.25,13.454545,83,871,867,4,0,0,0,0,25,12,11,1.72,0,1,13,9,false,true,true,0.993,0.007
391,284,107,16.291667,11.833333,107,746,796,-50,0,1,0,0.041667,-30,24,24,-1.6,0,0,1,1,true,true,true,1,0
383,230,153,22.529412,13.529412,153,1295,1477,-182,3,0,0.176471,0,-3,17,17,-15.333333,0,0,21,11,false,true,true,1,0
126,113,13,25.2,22.6,13,1501,1622,-121,0,0,0,0,64,5,5,0.484375,1,0,12,16,false,true,true,0.834,0.166
226,162,64,17.384615,13.5,64,299,315,-16,0,0,0,0,15,13,12,2.8,0,0,10,12,false,true,true,0.973,0.027
188,86,102,31.333333,14.333333,102,1144,1014,130,0,0,0,0,57,6,6,0.631579,0,1,15,9,false,true,true,0.994,0.006
107,62,45,26.75,15.5,45,830,907,-77,1,0,0.25,0,71,4,4,0.549296,0,1,7,8,false,true,false,0.039,0.961
57,52,5,19,26,5,1244,1361,-117,0,0,0,0,85,3,2,0.447059,0,0,14,11,false,true,false,0.201,0.799
170,141,29,24.285714,20.142857,29,1029,1227,-198,1,0,0.142857,0,42,7,7,0.761905,0,0,21,11,false,true,true,0.743,0.257
99,96,3,14.142857,13.714286,3,1159,1051,108,0,0,0,0,59,7,7,0.677966,0,0,27,14,false,true,true,0.569,0.431
405,334,71,33.75,30.363636,71,1880,1777,103,1,1,0.083333,0.090909,3,12,11,9.333333,0,0,9,14,false,true,true,0.994,0.006
204,111,93,34,18.5,93,1075,1027,48,2,0,0.333333,0,53,6,6,0.698113,0,0,9,13,false,true,true,0.984,0.016
110,145,-35,11,16.111111,-35,826,771,55,0,0,0,0,49,10,9,0.918367,0,1,12,8,false,true,false,0.13,0.87
8,0,8,8,0,8,901,889,12,0,0,0,0,96,1,1,0.447917,0,0,17,11,false,true,true,0.517,0.483
347,229,118,26.692308,17.615385,118,695,671,24,0,0,0,0,6,13,13,5.5,0,0,7,16,false,true,true,1,0
165,117,48,33,23.4,48,1507,1554,-47,1,1,0.2,0.2,57,5,5,0.508772,1,0,8,21,false,true,true,0.975,0.025
50,26,24,25,26,24,1014,948,66,0,0,0,0,89,2,1,0.370787,1,0,9,9,false,true,true,0.832,0.168
223,196,27,24.777778,24.5,27,1004,840,164,1,0,0.111111,0,33,9,8,0.909091,1,0,8,9,false,true,true,0.68,0.32
322,197,125,24.769231,15.153846,125,742,696,46,0,0,0,0,1,13,13,32,0,0,12,16,false,true,true,1,0
298,293,5,24.833333,26.636364,5,1762,1582,180,2,3,0.166667,0.272727,9,12,11,3.555556,0,0,8,24,false,true,true,0.528,0.472
237,193,44,13.941176,11.352941,44,1016,1037,-21,0,0,0,0,9,17,17,5.333333,1,0,8,23,false,true,true,0.945,0.055
358,312,46,23.866667,22.285714,46,992,1100,-108,2,0,0.133333,0,-2,15,14,-17,0,0,4,7,false,true,true,0.998,0.002
186,142,44,26.571429,20.285714,44,306,169,137,0,0,0,0,44,7,7,0.772727,0,0,7,7,false,true,true,0.905,0.095
69,40,29,23,20,29,1094,1030,64,0,0,0,0,79,3,2,0.455696,0,0,11,8,false,true,true,0.527,0.473
38,69,-31,9.5,17.25,-31,218,86,132,0,0,0,0,69,4,4,0.57971,0,0,17,11,false,true,false,0.295,0.705
149,142,7,18.625,17.75,7,518,533,-15,1,0,0.125,0,42,8,8,0.833333,0,0,21,8,false,true,true,0.738,0.262
18,0,18,18,0,18,1349,1302,47,0,0,0,0,96,1,0,0.302083,0,0,13,0,false,true,true,0.505,0.495
146,170,-24,16.222222,21.25,-24,334,446,-112,0,0,0,0,36,9,8,1.111111,0,0,8,8,false,true,false,0.111,0.889
195,78,117,27.857143,13,117,1394,1118,276,0,0,0,0,52,7,6,0.711538,0,0,14,7,false,true,true,0.999,0.001
365,221,144,17.380952,11.05,144,896,818,78,0,1,0,0.05,-18,21,20,-2.444444,1,0,5,7,false,true,true,1,0
268,256,12,38.285714,36.571429,12,1885,1793,92,0,0,0,0,34,7,7,0.794118,0,0,13,18,false,true,true,0.664,0.336
111,105,6,22.2,21,6,711,876,-165,0,0,0,0,63,5,5,0.68254,0,0,10,13,false,true,false,0.294,0.706
392,379,13,24.5,23.6875,13,1266,1144,122,0,0,0,0,-18,16,16,-1.888889,0,0,4,4,false,true,true,0.987,0.013
55,38,17,18.333333,19,17,1176,1127,49,0,0,0,0,82,3,2,0.45122,0,0,14,11,false,true,true,0.504,0.496
280,272,8,15.555556,16,8,613,549,64,0,0,0,0,-15,18,17,-2.933333,0,0,4,5,false,true,true,0.514,0.486
378,373,5,19.894737,19.631579,5,1096,1009,87,2,0,0.105263,0,-13,19,19,-3.384615,0,0,7,6,false,true,false,0.449,0.551
92,72,20,18.4,14.4,20,1181,1069,112,0,0,0,0,64,5,5,0.578125,1,0,19,9,false,true,true,0.704,0.296
267,278,-11,14.833333,15.444444,-11,576,494,82,0,0,0,0,-8,18,18,-5.5,0,1,10,6,false,true,false,0.152,0.848
37,11,26,18.5,11,26,527,514,13,0,0,0,0,92,2,1,0.423913,0,0,10,7,false,true,true,0.6,0.4
143,86,57,20.428571,12.285714,57,791,774,17,1,0,0.142857,0,61,7,7,0.672131,0,0,9,20,false,true,true,0.941,0.059
116,152,-36,11.6,15.2,-36,480,518,-38,0,0,0,0,45,10,10,1.022222,0,1,19,9,false,true,false,0.109,0.891
320,235,85,16.842105,13.055556,85,576,532,44,0,0,0,0,-16,19,18,-2.875,0,0,9,20,false,true,true,0.999,0.001
264,254,10,15.529412,15.875,10,262,306,-44,0,0,0,0,-6,17,16,-7.666667,0,0,8,11,false,true,false,0.383,0.617
214,134,80,23.777778,14.888889,80,808,639,169,0,0,0,0,34,9,9,1.205882,0,0,15,13,false,true,true,0.986,0.014
60,43,17,20,21.5,17,1167,1216,-49,0,0,0,0,81,3,2,0.506173,1,0,9,16,false,true,true,0.68,0.32
136,120,16,17,17.142857,16,620,513,107,0,0,0,0,47,8,7,0.957447,0,0,16,9,false,true,true,0.731,0.269
14,0,14,14,0,14,1305,1242,63,0,0,0,0,97,1,0,0.350515,0,0,16,0,false,true,true,0.507,0.493
56,46,10,18.666667,23,10,942,976,-34,0,0,0,0,79,3,2,0.506329,1,0,19,22,false,true,true,0.666,0.334
205,93,112,41,18.6,112,1349,1302,47,0,0,0,0,56,5,5,0.517857,0,0,11,14,false,true,true,1,0
365,304,61,36.5,30.4,61,1890,2020,-130,1,2,0.1,0.2,9,10,10,3.222222,0,1,7,15,false,true,true,0.91,0.09
100,98,2,25,24.5,2,1075,1152,-77,0,0,0,0,69,4,4,0.57971,0,1,18,7,false,true,false,0.472,0.528
380,301,79,18.095238,15.05,79,527,581,-54,0,0,0,0,-35,21,20,-1.2,0,0,1,4,false,true,true,1,0
389,268,121,17.681818,12.761905,121,1011,921,90,1,0,0.045455,0,-20,22,21,-2.45,0,0,5,11,false,true,true,1,0
85,27,58,21.25,9,58,1439,1294,145,0,0,0,0,77,4,3,0.467532,0,1,10,7,false,true,true,0.924,0.076
472,241,231,52.444444,30.125,231,991,996,-5,3,0,0.333333,0,26,9,8,1.153846,0,0,7,8,false,true,true,1,0
268,129,139,22.333333,10.75,139,1067,95,972,1,0,0.083333,0,21,12,12,1.619048,0,0,17,10,false,true,true,1,0
310,244,66,23.846154,18.769231,66,1073,1177,-104,1,0,0.076923,0,3,13,13,10.666667,0,0,18,16,false,true,true,0.992,0.008
325,258,67,16.25,13.578947,67,566,542,24,0,0,0,0,-17,20,19,-2.411765,0,0,1,1,false,true,true,1,0
83,80,3,16.6,20,3,630,786,-156,0,0,0,0,67,5,4,0.522388,1,0,13,14,false,true,false,0.418,0.582
83,51,32,16.6,10.2,32,595,543,52,0,0,0,0,70,5,5,0.671429,0,0,12,12,false,true,true,0.881,0.119
342,186,156,20.117647,10.941176,156,1067,95,972,1,0,0.058824,0,-13,17,17,-2.615385,1,0,2,11,true,true,true,1,0
58,46,12,19.333333,15.333333,12,1501,1473,28,0,0,0,0,77,3,3,0.467532,0,1,14,14,false,true,false,0.391,0.609
264,228,36,26.4,25.333333,36,1302,1234,68,1,1,0.1,0.111111,27,10,9,1.148148,0,0,9,10,false,true,true,0.805,0.195
147,129,18,18.375,16.125,18,527,581,-54,0,0,0,0,45,8,8,0.933333,1,0,18,15,false,true,true,0.636,0.364
379,287,92,19.947368,15.944444,92,1364,1093,271,0,1,0,0.055556,-18,19,18,-2.111111,0,0,5,1,false,true,true,1,0
425,203,222,30.357143,15.615385,222,918,619,299,2,0,0.142857,0,2,14,13,17.5,0,0,14,11,false,true,true,1,0
370,296,74,21.764706,17.411765,74,1036,1181,-145,0,0,0,0,-6,17,17,-5.666667,1,0,5,5,true,true,true,0.999,0.001
148,187,-39,24.666667,37.4,-39,1419,1488,-69,0,1,0,0.2,47,6,5,0.595745,1,0,16,13,false,true,true,0.603,0.397
33,73,-40,11,24.333333,-40,611,584,27,0,0,0,0,80,3,3,0.55,0,0,22,9,false,true,false,0.254,0.746
132,118,14,18.857143,16.857143,14,468,542,-74,0,0,0,0,56,7,7,0.696429,0,0,18,17,false,true,true,0.729,0.271
115,69,46,23,13.8,46,1270,1348,-78,0,0,0,0,69,5,5,0.550725,2,0,10,16,false,true,true,0.976,0.024
45,57,-12,22.5,28.5,-12,1125,1227,-102,0,0,0,0,84,2,2,0.357143,0,0,12,15,false,true,false,0.173,0.827
272,188,84,18.133333,12.533333,84,272,288,-16,0,0,0,0,20,15,15,2.6,0,0,12,17,false,true,true,0.996,0.004
386,278,108,20.315789,14.631579,108,704,691,13,1,0,0.052632,0,-23,19,19,-1.652174,0,0,2,2,true,true,true,1,0
245,207,38,27.222222,25.875,38,1710,1636,74,1,1,0.111111,0.125,37,9,8,0.972973,1,0,9,17,false,true,true,0.972,0.028
248,229,19,27.555556,28.625,19,1428,1606,-178,1,0,0.111111,0,34,9,8,0.941176,1,0,18,7,false,true,true,0.85,0.15
378,276,102,22.235294,17.25,102,801,925,-124,1,0,0.058824,0,-18,17,16,-1.944444,0,0,4,1,false,true,true,1,0
178,97,81,29.666667,19.4,81,746,796,-50,0,1,0,0.2,50,6,5,0.96,0,0,10,10,false,true,true,0.972,0.028
12,12,0,12,12,0,1161,1166,-5,0,0,0,0,93,1,1,0.376344,0,0,12,10,false,true,false,0.464,0.536
179,71,108,29.833333,11.833333,108,925,801,124,1,0,0.166667,0,63,6,6,0.634921,1,0,9,13,false,true,true,0.995,0.005
14,0,14,14,0,14,576,494,82,0,0,0,0,96,1,0,0.458333,0,0,9,0,false,true,true,0.525,0.475
341,260,81,14.826087,11.818182,81,1128,889,239,0,1,0,0.045455,-31,23,22,-1.516129,0,0,3,1,false,true,true,1,0
209,116,93,23.222222,14.5,93,1270,1348,-78,0,0,0,0,43,9,8,0.883721,0,0,11,16,false,true,true,0.952,0.048
131,118,13,21.833333,19.666667,13,1547,1439,108,1,0,0.166667,0,59,6,6,0.627119,0,0,17,18,false,true,false,0.337,0.663
369,233,136,21.705882,13.705882,136,777,830,-53,1,0,0.058824,0,-7,17,17,-5.857143,0,0,13,11,false,true,true,1,0
285,265,20,31.666667,33.125,20,1935,2020,-85,0,1,0,0.125,32,9,8,0.96875,1,0,6,17,false,true,true,0.632,0.368
302,282,20,14.380952,14.1,20,262,306,-44,1,0,0.047619,0,-33,21,20,-1.393939,0,0,3,6,false,true,true,0.931,0.069
367,307,60,21.588235,18.058824,60,1089,1063,26,1,0,0.058824,0,-14,17,17,-2.714286,0,0,3,6,false,true,true,1,0
147,170,-23,13.363636,17,-23,699,448,251,0,0,0,0,36,11,10,1.111111,0,0,15,7,false,true,false,0.298,0.702
213,143,70,23.666667,17.875,70,1036,1181,-145,0,0,0,0,49,9,8,0.693878,0,0,19,10,false,true,true,0.892,0.108
52,30,22,17.333333,15,22,1548,1493,55,0,0,0,0,79,3,2,0.518987,1,0,6,14,false,true,true,0.769,0.231
102,152,-50,25.5,38,-50,1419,1488,-69,0,1,0,0.25,59,4,4,0.474576,0,0,14,13,false,true,false,0.189,0.811
66,61,5,22,30.5,5,1826,1656,170,0,0,0,0,78,3,2,0.346154,0,0,7,8,false,true,false,0.479,0.521
85,140,-55,14.166667,28,-55,1075,989,86,0,0,0,0,66,6,5,0.590909,0,0,33,14,false,true,false,0.119,0.881
155,127,28,25.833333,21.166667,28,1305,1242,63,1,0,0.166667,0,57,6,6,0.596491,0,1,7,22,false,true,true,0.981,0.019
264,152,112,26.4,15.2,112,1144,1014,130,0,0,0,0,31,10,10,1.16129,0,1,14,9,false,true,true,0.998,0.002
183,107,76,20.333333,13.375,76,1033,1037,-4,0,1,0,0.125,43,9,8,1.046512,0,0,26,12,false,true,true,0.981,0.019
247,234,13,24.7,23.4,13,1710,1636,74,1,1,0.1,0.1,28,10,10,1.285714,1,0,9,17,false,true,true,0.948,0.052
238,208,30,19.833333,17.333333,30,1221,1258,-37,1,0,0.083333,0,24,12,12,1.625,0,0,14,7,false,true,true,0.909,0.091
231,188,43,23.1,20.888889,43,856,897,-41,0,0,0,0,24,10,9,1.458333,0,1,26,14,false,true,true,0.703,0.297
79,62,17,19.75,15.5,17,1164,1201,-37,0,0,0,0,72,4,4,0.583333,0,1,11,10,false,true,false,0.384,0.616
366,258,108,19.263158,14.333333,108,746,796,-50,0,1,0,0.055556,-12,19,18,-4,0,0,4,7,false,true,true,1,0
324,286,38,17.052632,15.888889,38,1159,1031,128,1,0,0.052632,0,-27,19,18,-1.444444,0,0,3,1,false,true,true,0.999,0.001
403,268,135,20.15,13.4,135,939,907,32,1,0,0.05,0,-18,20,20,-2.222222,0,0,1,1,true,true,true,1,0
218,213,5,18.166667,17.75,5,719,785,-66,0,1,0,0.083333,20,12,12,1.8,0,0,19,11,false,true,true,0.782,0.218
240,135,105,24,15,105,859,811,48,0,0,0,0,34,10,9,1.058824,0,1,8,10,false,true,true,0.999,0.001
119,62,57,19.833333,10.333333,57,939,913,26,0,0,0,0,69,6,6,0.57971,0,0,11,12,false,true,true,0.91,0.09
243,273,-30,16.2,19.5,-30,316,306,10,0,2,0,0.142857,3,15,14,12.666667,0,0,13,15,false,true,false,0.078,0.922
42,37,5,21,18.5,5,1096,1009,87,0,0,0,0,90,2,2,0.488889,1,0,25,20,false,true,true,0.859,0.141
41,66,-25,20.5,66,-25,1571,1554,17,0,1,0,1,86,2,1,0.383721,0,0,10,13,false,true,false,0.06,0.94
235,204,31,16.785714,15.692308,31,904,857,47,0,0,0,0,12,14,13,3.416667,1,0,13,10,false,true,true,0.878,0.122
291,325,-34,22.384615,27.083333,-34,1762,1538,224,1,2,0.076923,0.166667,12,13,12,2.833333,0,0,21,9,false,true,true,0.736,0.264
175,205,-30,17.5,20.5,-30,721,689,32,0,0,0,0,17,10,10,2,0,0,23,10,false,true,false,0.357,0.643
210,81,129,26.25,11.571429,129,1394,1118,276,0,0,0,0,45,8,7,0.822222,0,0,17,7,false,true,true,0.999,0.001
465,365,100,35.769231,28.076923,100,1824,1793,31,1,0,0.076923,0,-9,13,13,-3.111111,0,0,7,3,false,true,true,1,0
301,266,35,13.086957,12.090909,35,947,909,38,0,0,0,0,-42,23,22,-1.095238,0,0,1,7,false,true,true,0.999,0.001
130,83,47,18.571429,11.857143,47,595,543,52,0,0,0,0,56,7,7,0.839286,0,0,10,15,false,true,true,0.899,0.101
301,283,18,21.5,20.214286,18,315,294,21,0,1,0,0.071429,-10,14,14,-3.5,0,0,14,6,false,true,true,0.933,0.067
196,157,39,21.777778,19.625,39,613,569,44,0,0,0,0,36,9,8,1.083333,2,0,12,7,false,true,true,0.977,0.023
38,13,25,12.666667,6.5,25,1016,1037,-21,0,0,0,0,87,3,2,0.551724,0,0,14,12,false,true,false,0.453,0.547
18,0,18,18,0,18,1189,1266,-77,0,0,0,0,96,1,0,0.354167,1,0,13,0,false,true,true,0.546,0.454
108,110,-2,15.428571,18.333333,-2,361,493,-132,0,0,0,0,53,7,6,0.773585,0,0,15,17,false,true,false,0.207,0.793
18,6,12,18,6,12,965,1013,-48,0,0,0,0,94,1,1,0.351064,0,0,8,15,false,true,false,0.478,0.522
113,62,51,16.142857,10.333333,51,1030,1045,-15,0,0,0,0,63,7,6,0.730159,0,0,17,17,false,true,true,0.867,0.133
255,233,22,19.615385,19.416667,22,349,315,34,0,0,0,0,0,13,12,0,0,1,17,14,false,true,true,0.881,0.119
68,26,42,34,13,42,1144,1014,130,0,0,0,0,85,2,2,0.423529,1,0,18,9,false,true,true,0.884,0.116
243,278,-35,16.2,18.533333,-35,316,306,10,0,2,0,0.133333,0,15,15,0,0,0,13,15,false,true,false,0.154,0.846
144,43,101,36,10.75,101,1507,1554,-47,1,0,0.25,0,68,4,4,0.426471,0,0,12,8,false,true,true,0.975,0.025
105,77,28,21,15.4,28,739,480,259,1,0,0.2,0,61,5,5,0.590164,0,0,10,12,false,true,true,0.842,0.158
323,315,8,20.1875,19.6875,8,926,854,72,0,0,0,0,-6,16,16,-5.666667,0,0,6,2,false,true,true,0.66,0.34
86,36,50,21.5,9,50,1516,1397,119,0,0,0,0,72,4,4,0.458333,0,1,19,9,false,true,true,0.634,0.366
346,256,90,17.3,13.473684,90,1048,1000,48,0,0,0,0,-17,20,19,-2.352941,0,1,1,2,false,true,true,0.999,0.001
221,232,-11,20.090909,21.090909,-11,1270,1348,-78,0,0,0,0,27,11,11,1.407407,0,0,17,7,false,true,false,0.156,0.844
322,244,78,12.88,10.166667,78,416,222,194,0,0,0,0,-35,25,24,-1.571429,0,0,7,5,false,true,true,1,0
146,61,85,20.857143,10.166667,85,896,818,78,0,0,0,0,65,7,6,0.676923,0,0,17,16,false,true,true,0.969,0.031
12,0,12,12,0,12,896,818,78,0,0,0,0,97,1,0,0.453608,0,0,14,0,false,true,true,0.519,0.481
304,182,122,27.636364,16.545455,122,1144,1014,130,0,0,0,0,25,11,11,1.44,0,1,18,18,false,true,true,1,0
87,98,-11,17.4,19.6,-11,518,533,-15,1,0,0.2,0,60,5,5,0.583333,1,0,21,10,false,true,true,0.502,0.498
198,116,82,33,19.333333,82,1270,1322,-52,1,0,0.166667,0,57,6,6,0.666667,0,0,12,20,false,true,true,0.907,0.093
305,251,54,16.052632,13.944444,54,299,315,-16,0,0,0,0,-27,19,18,-1.555556,0,0,3,8,false,true,true,0.999,0.001
337,299,38,15.318182,14.238095,38,1040,925,115,0,0,0,0,-34,22,21,-1.264706,0,0,10,1,true,true,true,0.999,0.001
69,23,46,34.5,23,46,866,949,-83,0,0,0,0,89,2,1,0.449438,0,0,13,10,false,true,true,0.846,0.154
197,161,36,17.909091,14.636364,36,1164,1201,-37,0,0,0,0,30,11,11,1.4,0,1,18,16,false,true,true,0.563,0.437
274,245,29,17.125,15.3125,29,613,461,152,0,1,0,0.0625,-17,16,16,-2.176471,0,0,19,5,false,true,true,0.929,0.071
363,312,51,25.928571,22.285714,51,1093,1090,3,1,2,0.071429,0.142857,6,14,14,5.666667,0,0,9,19,false,true,true,0.999,0.001
268,263,5,14.888889,14.611111,5,361,493,-132,1,0,0.055556,0,-29,18,18,-1.413793,0,0,4,4,false,true,true,0.887,0.113
233,100,133,23.3,10,133,1067,95,972,0,0,0,0,39,10,10,0.871795,0,0,22,9,false,true,true,1,0
239,188,51,26.555556,23.5,51,1189,1266,-77,1,0,0.111111,0,36,9,8,0.944444,0,0,14,10,false,true,true,0.769,0.231
257,193,64,21.416667,16.083333,64,505,95,410,0,1,0,0.083333,34,12,12,1.294118,0,0,7,11,false,true,true,0.994,0.006
219,168,51,21.9,16.8,51,746,796,-50,0,1,0,0.1,25,10,10,1.92,0,0,25,7,false,true,true,0.978,0.022
30,16,14,30,16,14,971,1180,-209,0,0,0,0,94,1,1,0.340426,0,0,10,14,false,true,false,0.454,0.546
206,145,61,29.428571,24.166667,61,992,1100,-108,2,0,0.285714,0,47,7,6,0.723404,0,0,14,10,false,true,true,0.786,0.214
85,140,-55,17,28,-55,1075,989,86,0,0,0,0,66,5,5,0.590909,0,0,27,14,false,true,false,0.185,0.815
8,0,8,8,0,8,613,461,152,0,0,0,0,96,1,0,0.385417,1,0,6,0,false,true,true,0.577,0.423
202,184,18,28.857143,26.285714,18,1826,1656,170,1,0,0.142857,0,42,7,7,0.642857,1,0,8,13,false,true,true,0.849,0.151
10,28,-18,5,14,-18,791,774,17,0,0,0,0,91,2,2,0.450549,0,0,12,14,false,true,false,0.155,0.845
383,265,118,31.916667,22.083333,118,1023,1070,-47,2,0,0.166667,0,8,12,12,4,0,0,10,18,false,true,true,0.999,0.001
153,94,59,25.5,18.8,59,1045,1009,36,1,0,0.166667,0,61,6,5,0.622951,0,0,10,15,false,true,true,0.855,0.145
150,93,57,21.428571,15.5,57,613,502,111,0,0,0,0,51,7,6,0.960784,0,0,7,16,false,true,true,0.841,0.159
185,59,126,30.833333,11.8,126,1295,1477,-182,2,0,0.333333,0,62,6,5,0.741935,0,0,13,9,false,true,true,0.987,0.013
64,39,25,21.333333,13,25,971,658,313,0,0,0,0,77,3,3,0.467532,0,0,11,11,false,true,true,0.835,0.165
154,183,-29,15.4,20.333333,-29,262,306,-44,0,0,0,0,43,10,9,1.069767,0,1,12,6,false,true,false,0.009,0.991
96,105,-9,32,35,-9,1489,1558,-69,0,1,0,0.333333,71,3,3,0.394366,0,0,20,20,false,true,false,0.332,0.668
169,196,-27,15.363636,17.818182,-27,628,658,-30,0,0,0,0,33,11,11,1.393939,0,0,16,11,false,true,false,0.333,0.667
161,80,81,32.2,20,81,908,1070,-162,1,0,0.2,0,64,5,4,0.46875,1,0,13,17,false,true,true,0.947,0.053
409,334,75,24.058824,19.647059,75,1331,1399,-68,1,0,0.058824,0,-24,17,17,-1.458333,0,0,2,2,false,true,true,1,0
282,238,44,14.842105,13.222222,44,871,999,-128,0,0,0,0,-11,19,18,-4.363636,0,0,8,10,false,true,true,0.987,0.013
20,3,17,10,3,17,1394,1230,164,0,0,0,0,89,2,1,0.426966,0,0,11,8,false,true,false,0.5,0.5
348,156,192,29,14.181818,192,918,619,299,2,0,0.166667,0,17,12,11,2.058824,2,0,15,14,false,true,true,1,0
223,126,97,37.166667,25.2,97,1320,1339,-19,2,1,0.333333,0.2,52,6,5,0.75,0,0,11,22,false,true,true,0.982,0.018
117,81,36,19.5,16.2,36,500,567,-67,0,0,0,0,63,6,5,0.698413,0,0,11,7,false,true,true,0.866,0.134
32,22,10,16,11,10,808,812,-4,0,0,0,0,86,2,2,0.430233,0,1,10,8,false,true,false,0.463,0.537
247,224,23,22.454545,22.4,23,1127,1075,52,1,1,0.090909,0.1,22,11,10,1.409091,0,1,11,9,false,true,true,0.578,0.422
245,242,3,27.222222,30.25,3,1875,1793,82,2,1,0.222222,0.125,36,9,8,0.833333,0,0,7,16,false,true,true,0.696,0.304
297,200,97,33,22.222222,97,1167,1216,-49,1,0,0.111111,0,30,9,9,1.366667,0,0,9,11,false,true,true,1,0
196,126,70,28,21,70,1167,1216,-49,1,0,0.142857,0,55,7,6,0.745455,1,0,15,15,false,true,true,0.982,0.018
55,54,1,13.75,13.5,1,698,742,-44,0,0,0,0,80,4,4,0.5125,0,0,20,12,false,true,false,0.465,0.535
148,86,62,37,21.5,62,820,783,37,0,0,0,0,70,4,4,0.471429,0,0,9,11,false,true,true,0.893,0.107
254,213,41,14.111111,12.529412,41,611,584,27,0,0,0,0,-2,18,17,-22,0,0,7,14,false,true,true,0.975,0.025
146,172,-26,18.25,21.5,-26,1277,1166,111,0,1,0,0.125,44,8,8,0.818182,0,0,7,11,false,true,false,0.09,0.91
54,72,-18,10.8,18,-18,1093,1090,3,0,0,0,0,75,5,4,0.453333,1,0,13,10,false,true,false,0.254,0.746
26,16,10,13,16,10,1065,1030,35,0,0,0,0,89,2,1,0.382022,0,0,21,11,false,true,true,0.503,0.497
331,261,70,16.55,13.05,70,892,768,124,0,0,0,0,-11,20,20,-3.909091,0,0,6,4,false,true,true,1,0
169,134,35,21.125,16.75,35,711,876,-165,0,0,0,0,46,8,8,0.934783,0,0,10,17,false,true,true,0.731,0.269
270,254,16,19.285714,18.142857,16,721,689,32,0,0,0,0,-14,14,14,-2.428571,0,1,19,6,false,true,true,0.869,0.131
51,6,45,25.5,6,45,1101,1078,23,0,0,0,0,89,2,1,0.370787,0,0,23,19,false,true,true,0.829,0.171
310,165,145,28.181818,16.5,145,1482,1394,88,2,0,0.181818,0,27,11,10,1.333333,0,0,10,10,false,true,true,1,0
38,22,16,12.666667,7.333333,16,1016,1037,-21,0,0,0,0,83,3,3,0.578313,0,0,14,17,false,true,false,0.489,0.511
153,108,45,25.5,21.6,45,892,819,73,0,1,0,0.2,57,6,5,0.596491,0,0,14,11,false,true,true,0.89,0.11
272,305,-33,15.111111,16.944444,-33,999,1011,-12,0,0,0,0,-15,18,18,-3.066667,1,0,9,7,false,true,false,0.187,0.813
303,276,27,25.25,23,27,1093,1090,3,1,2,0.083333,0.166667,19,12,12,1.789474,0,0,13,15,false,true,true,0.948,0.052
138,201,-63,27.6,50.25,-63,1554,1716,-162,1,1,0.2,0.25,55,5,4,0.636364,0,0,20,7,false,true,false,0.116,0.884
52,15,37,26,15,37,892,819,73,0,1,0,1,85,2,1,0.4,0,0,17,9,false,true,true,0.953,0.047
284,230,54,20.285714,16.428571,54,830,907,-77,1,0,0.071429,0,9,14,14,4.333333,0,0,18,7,false,true,true,0.979,0.021
237,240,-3,19.75,21.818182,-3,869,820,49,0,1,0,0.090909,22,12,11,1.681818,0,1,12,6,false,true,false,0.071,0.929
403,273,130,22.388889,15.166667,130,1110,1039,71,0,0,0,0,-22,18,18,-1.636364,0,0,2,5,true,true,true,1,0
82,28,54,27.333333,14,54,1803,1552,251,0,0,0,0,84,3,2,0.333333,0,0,15,16,false,true,true,0.883,0.117
118,70,48,23.6,17.5,48,1029,1227,-198,0,0,0,0,66,5,4,0.484848,0,0,10,19,false,true,false,0.467,0.533
340,181,159,34,20.111111,159,1684,1320,364,1,0,0.1,0,21,10,9,1.428571,0,1,7,8,false,true,true,0.999,0.001
313,255,58,19.5625,17,58,1221,1258,-37,1,0,0.0625,0,6,16,15,6.5,1,0,6,10,false,true,true,0.994,0.006
397,281,116,20.894737,14.789474,116,778,758,20,0,1,0,0.052632,-26,19,19,-1.5,0,0,1,1,false,true,true,1,0
225,178,47,22.5,19.777778,47,1094,1030,64,0,0,0,0,32,10,9,1.125,0,0,8,11,false,true,true,0.834,0.166
254,86,168,19.538462,7.166667,168,896,818,78,0,0,0,0,36,13,12,1.222222,1,1,10,6,false,true,true,1,0
383,391,-8,29.461538,30.076923,-8,2219,2029,190,0,0,0,0,-13,13,13,-2,0,0,2,11,true,true,true,0.837,0.163
289,187,102,28.9,18.7,102,1408,1454,-46,1,0,0.1,0,31,10,10,1.032258,0,0,12,16,false,true,true,1,0
413,312,101,22.944444,18.352941,101,1550,1466,84,1,0,0.055556,0,-20,18,17,-1.85,0,0,1,1,false,true,true,1,0
329,173,156,19.352941,10.8125,156,595,543,52,0,0,0,0,-2,17,16,-23.5,0,1,7,17,false,true,true,1,0
201,167,34,22.333333,18.555556,34,1513,1479,34,0,0,0,0,37,9,9,0.918919,1,0,7,13,false,true,true,0.882,0.118
288,249,39,16,14.647059,39,371,435,-64,0,0,0,0,-14,18,17,-3.142857,0,0,4,5,false,true,true,0.996,0.004
260,173,87,21.666667,15.727273,87,527,503,24,0,0,0,0,33,12,11,1.242424,0,0,10,12,false,true,true,0.985,0.015
300,229,71,23.076923,17.615385,71,596,595,1,1,0,0.076923,0,12,13,13,3.333333,0,0,7,22,false,true,true,0.999,0.001
245,267,-22,22.272727,24.272727,-22,1142,1176,-34,1,0,0.090909,0,22,11,11,1.636364,1,0,28,7,false,true,false,0.429,0.571
29,17,12,14.5,17,12,1029,1075,-46,0,0,0,0,89,2,1,0.539326,0,0,26,10,false,true,true,0.509,0.491
349,287,62,19.388889,15.944444,62,1045,1009,36,1,0,0.055556,0,-15,18,18,-2.533333,0,0,2,3,false,true,true,1,0
163,265,-102,18.111111,29.444444,-102,1762,1538,224,0,2,0,0.222222,35,9,9,0.971429,1,0,9,11,false,true,true,0.879,0.121
131,53,78,32.75,17.666667,78,1439,1353,86,1,0,0.25,0,69,4,3,0.434783,0,0,11,9,false,true,true,0.824,0.176
219,235,-16,24.333333,26.111111,-16,1096,1009,87,1,0,0.111111,0,48,9,9,0.916667,0,0,11,14,false,true,true,0.626,0.374
73,49,24,18.25,16.333333,24,1090,1244,-154,0,0,0,0,74,4,3,0.5,0,0,12,20,false,true,false,0.155,0.845
274,255,19,27.4,25.5,19,791,885,-94,1,1,0.1,0.1,26,10,10,1.461538,0,0,15,9,false,true,true,0.789,0.211
235,92,143,29.375,11.5,143,925,801,124,1,0,0.125,0,51,8,8,0.784314,1,1,6,16,false,true,true,1,0
50,34,16,16.666667,11.333333,16,960,1070,-110,0,0,0,0,79,3,3,0.443038,0,0,7,17,false,true,false,0.379,0.621
308,320,-12,20.533333,21.333333,-12,971,906,65,0,0,0,0,-10,15,15,-3.2,1,0,3,4,false,true,false,0.471,0.529
149,81,68,24.833333,13.5,68,1270,1348,-78,0,0,0,0,61,6,6,0.622951,0,0,10,17,false,true,true,0.888,0.112
201,62,139,20.1,6.888889,139,1176,1076,100,0,0,0,0,54,10,9,1.092593,0,1,15,15,false,true,true,0.996,0.004
119,105,14,17,17.5,14,1011,921,90,0,0,0,0,59,7,6,0.830508,0,0,7,22,false,true,false,0.168,0.832
405,295,110,28.928571,21.071429,110,1245,1241,4,2,1,0.142857,0.071429,-19,14,14,-1.526316,0,0,1,2,false,true,true,1,0
218,168,50,14.533333,12,50,416,374,42,0,0,0,0,23,15,14,2,0,0,14,12,false,true,true,0.969,0.031
38,19,19,12.666667,9.5,19,1281,1339,-58,0,0,0,0,84,3,2,0.488095,0,0,16,8,false,true,false,0.378,0.622
286,259,27,20.428571,19.923077,27,1277,1166,111,0,1,0,0.076923,4,14,13,9,0,0,13,18,false,true,true,0.508,0.492
345,268,77,28.75,22.333333,77,1245,1232,13,1,0,0.083333,0,-4,12,12,-7.25,0,1,5,2,false,true,true,1,0
54,72,-18,13.5,18,-18,518,533,-15,1,0,0.25,0,69,4,4,0.507246,0,0,19,19,false,true,false,0.284,0.716
298,287,11,19.866667,19.133333,11,1127,1176,-49,0,0,0,0,2,15,15,21,0,0,10,10,false,true,false,0.484,0.516
254,144,110,14.111111,8.470588,110,310,359,-49,0,0,0,0,-16,18,17,-3.0625,0,0,13,17,false,true,true,1,0
246,143,103,27.333333,15.888889,103,1144,1014,130,0,0,0,0,38,9,9,0.947368,0,1,14,9,false,true,true,0.995,0.005
454,344,110,28.375,21.5,110,1216,1230,-14,1,0,0.0625,0,-9,16,16,-3.555556,0,0,3,5,true,true,true,1,0
237,186,51,26.333333,23.25,51,1489,1555,-66,1,0,0.111111,0,36,9,8,0.805556,1,0,10,14,false,true,true,0.922,0.078
112,127,-15,22.4,25.4,-15,1161,1166,-5,1,0,0.2,0,62,5,5,0.564516,0,1,8,17,false,true,false,0.126,0.874
153,91,62,19.125,13,62,1069,917,152,0,0,0,0,54,8,7,0.62963,0,1,20,7,false,true,true,0.981,0.019
165,99,66,23.571429,14.142857,66,1159,1031,128,1,0,0.142857,0,44,7,7,0.886364,0,0,28,7,false,true,true,0.973,0.027
326,295,31,18.111111,17.352941,31,859,786,73,0,0,0,0,-18,18,17,-2.111111,0,0,3,8,false,true,true,0.992,0.008
169,171,-2,15.363636,17.1,-2,576,494,82,0,0,0,0,35,11,10,1.257143,0,0,11,19,false,true,false,0.464,0.536
119,101,18,13.222222,12.625,18,658,817,-159,0,0,0,0,52,9,8,0.730769,0,0,23,14,false,true,false,0.461,0.539
43,5,38,21.5,2.5,38,869,820,49,0,0,0,0,90,2,2,0.411111,0,1,16,6,false,true,true,0.617,0.383
240,244,-4,21.818182,24.4,-4,758,952,-194,0,0,0,0,21,11,10,1.904762,1,0,8,7,false,true,false,0.172,0.828
299,118,181,17.588235,6.941176,181,859,719,140,0,1,0,0.058824,-4,17,17,-13.25,0,1,24,16,false,true,true,1,0
209,188,21,17.416667,17.090909,21,808,812,-4,0,0,0,0,21,12,11,1.761905,1,0,12,11,false,true,true,0.695,0.305
363,271,92,27.923077,20.846154,92,1489,1555,-66,1,0,0.076923,0,2,13,13,14.5,0,0,14,10,false,true,true,1,0
440,249,191,19.130435,10.826087,191,1295,1477,-182,3,0,0.130435,0,-26,23,23,-1.769231,0,0,1,1,true,true,true,1,0
263,239,24,26.3,23.9,24,1320,1339,-19,2,1,0.2,0.1,25,10,10,1.56,0,0,19,13,false,true,true,0.913,0.087
364,342,22,21.411765,20.117647,22,1397,1422,-25,3,1,0.176471,0.058824,-5,17,17,-7.2,0,0,8,14,false,true,true,0.992,0.008
221,190,31,22.1,21.111111,31,1270,1348,-78,0,0,0,0,34,10,9,1.117647,0,0,7,10,false,true,false,0.315,0.685
86,54,32,28.666667,18,32,1530,1550,-20,0,0,0,0,79,3,3,0.43038,0,0,18,7,false,true,true,0.55,0.45
81,72,9,16.2,14.4,9,361,493,-132,0,0,0,0,62,5,5,0.66129,0,1,17,25,false,true,false,0.135,0.865
385,240,145,20.263158,12.631579,145,786,757,29,1,0,0.052632,0,-24,19,19,-1.625,0,0,19,4,false,true,true,1,0
121,100,21,11,10,21,310,359,-49,0,0,0,0,28,11,10,1.75,0,0,9,19,false,true,true,0.539,0.461
315,304,11,16.578947,16.888889,11,527,514,13,0,0,0,0,-18,19,18,-2.166667,0,0,3,1,false,true,false,0.467,0.533
218,164,54,21.8,18.222222,54,468,542,-74,0,0,0,0,39,10,9,1,0,1,10,11,false,true,true,0.977,0.023
122,129,-7,20.333333,21.5,-7,1539,1537,2,0,0,0,0,62,6,6,0.516129,1,1,9,8,false,true,false,0.251,0.749
137,104,33,22.833333,17.333333,33,421,306,115,0,1,0,0.166667,46,6,6,0.956522,0,0,9,9,false,true,true,0.935,0.065
158,37,121,39.5,12.333333,121,539,500,39,0,0,0,0,67,4,3,0.597015,0,1,14,26,false,true,true,1,0
106,108,-2,26.5,27,-2,995,912,83,1,0,0.25,0,75,4,4,0.586667,1,0,6,7,false,true,true,0.67,0.33
324,320,4,18,17.777778,4,491,398,93,0,0,0,0,-13,18,18,-2.769231,1,0,5,6,true,true,true,0.815,0.185
190,155,35,19,17.222222,35,904,783,121,0,0,0,0,40,10,9,1.05,0,0,11,22,false,true,true,0.724,0.276
42,82,-40,10.5,20.5,-40,480,518,-38,0,0,0,0,78,4,4,0.589744,0,0,8,10,false,true,false,0.108,0.892
111,115,-4,22.2,23,-4,804,988,-184,1,0,0.2,0,62,5,5,0.532258,0,0,10,19,false,true,false,0.198,0.802
285,241,44,15.833333,13.388889,44,416,374,42,0,0,0,0,0,18,18,0,0,0,11,7,false,true,true,0.977,0.023
356,346,10,22.25,23.066667,10,1501,1473,28,1,0,0.0625,0,-11,16,15,-3.272727,0,0,4,4,false,true,true,0.774,0.226
246,236,10,17.571429,18.153846,10,1043,1055,-12,0,0,0,0,12,14,13,3.083333,1,0,17,13,false,true,false,0.42,0.58
190,103,87,31.666667,17.166667,87,1408,1454,-46,1,0,0.166667,0,60,6,6,0.533333,0,0,10,11,false,true,true,0.957,0.043
334,312,22,15.904762,14.857143,22,947,810,137,0,1,0,0.047619,-27,21,21,-1.555556,0,0,2,7,true,true,true,0.977,0.023
218,174,44,14.533333,12.428571,44,584,565,19,0,0,0,0,6,15,14,7.666667,0,0,20,17,false,true,true,0.918,0.082
20,0,20,20,0,20,859,719,140,0,0,0,0,95,1,0,0.557895,0,0,15,0,false,true,true,0.534,0.466
251,257,-6,22.818182,25.7,-6,1539,1537,2,0,1,0,0.1,26,11,10,1.230769,0,0,11,8,false,true,false,0.251,0.749
364,354,10,24.266667,23.6,10,1265,1237,28,1,0,0.066667,0,-12,15,15,-2.5,0,0,4,7,true,true,true,0.984,0.016
128,57,71,32,19,71,1220,1261,-41,1,0,0.25,0,77,4,3,0.584416,0,0,10,11,false,true,true,0.848,0.152
300,212,88,16.666667,12.470588,88,566,542,24,0,0,0,0,-6,18,17,-6.833333,0,1,12,14,false,true,true,1,0
356,304,52,29.666667,25.333333,52,1333,1331,2,1,0,0.083333,0,-2,12,12,-15,0,0,10,12,false,true,true,0.994,0.006
291,188,103,26.454545,17.090909,103,1075,1027,48,2,0,0.181818,0,21,11,11,1.761905,0,1,14,10,false,true,true,0.997,0.003
141,119,22,15.666667,13.222222,22,698,742,-44,0,0,0,0,56,9,9,0.732143,0,0,11,16,false,true,true,0.617,0.383
214,198,16,16.461538,15.230769,16,363,668,-305,0,0,0,0,21,13,13,2.047619,0,1,8,12,false,true,false,0.283,0.717
294,269,25,18.375,17.933333,25,95,378,-283,0,0,0,0,-14,16,15,-2.5,0,0,5,6,false,true,true,0.976,0.024
119,69,50,39.666667,23,50,996,1063,-67,1,1,0.333333,0.333333,70,3,3,0.457143,0,0,12,7,false,true,true,0.91,0.09
289,239,50,24.083333,19.916667,50,995,912,83,2,0,0.166667,0,27,12,12,1.62963,0,0,11,14,false,true,true,0.948,0.052
329,256,73,16.45,12.8,73,272,288,-16,0,0,0,0,-10,20,20,-5.2,0,0,10,6,false,true,true,1,0
63,36,27,31.5,18,27,1826,1803,23,0,0,0,0,87,2,2,0.344828,0,0,9,12,false,true,true,0.514,0.486
352,283,69,20.705882,16.647059,69,1364,1093,271,0,1,0,0.058824,-10,17,17,-3.8,0,0,7,3,false,true,true,1,0
67,84,-17,13.4,16.8,-17,892,768,124,0,0,0,0,68,5,5,0.632353,0,0,8,16,false,true,false,0.182,0.818
162,100,62,18,12.5,62,1069,1040,29,0,0,0,0,40,9,8,1.1,0,2,7,5,false,true,true,0.922,0.078
374,269,105,23.375,17.933333,105,801,925,-124,1,0,0.0625,0,-12,16,15,-2.916667,0,0,5,4,false,true,true,1,0
60,49,11,30,49,11,1890,2020,-130,0,0,0,0,86,2,1,0.337209,0,0,12,12,false,true,false,0.194,0.806
220,189,31,31.428571,27,31,1935,2020,-85,0,1,0,0.142857,47,7,7,0.659574,1,0,8,9,false,true,true,0.891,0.109
10,0,10,10,0,10,1110,1039,71,0,0,0,0,97,1,0,0.371134,0,0,23,0,false,true,true,0.522,0.478
73,30,43,18.25,10,43,1428,1302,126,0,0,0,0,76,4,3,0.697368,0,1,7,15,false,true,true,0.629,0.371
97,37,60,48.5,18.5,60,1216,1230,-14,1,0,0.5,0,83,2,2,0.385542,0,0,23,10,false,true,true,0.742,0.258
30,24,6,30,24,6,691,473,218,0,0,0,0,90,1,1,0.4,0,0,19,9,false,true,true,0.826,0.174
105,33,72,52.5,16.5,72,925,801,124,1,0,0.5,0,85,2,2,0.470588,1,0,14,7,false,true,true,0.974,0.026
338,257,81,24.142857,18.357143,81,801,925,-124,1,0,0.071429,0,0,14,14,0,1,0,12,9,false,true,true,1,0
168,62,106,21,7.75,106,1176,1076,100,0,0,0,0,61,8,8,0.967213,0,1,8,15,false,true,true,0.994,0.006
73,64,9,18.25,16,9,1090,1244,-154,0,0,0,0,72,4,4,0.513889,0,0,12,21,false,true,false,0.15,0.85
359,256,103,22.4375,16,103,704,691,13,1,0,0.0625,0,-8,16,16,-4.75,0,0,10,5,false,true,true,1,0
287,302,-15,20.5,21.571429,-15,971,906,65,0,0,0,0,-2,14,14,-16,1,0,9,13,false,true,false,0.261,0.739
58,34,24,19.333333,17,24,808,639,169,0,0,0,0,79,3,2,0.518987,0,0,16,11,false,true,true,0.589,0.411
375,331,44,25,22.066667,44,1203,1221,-18,2,0,0.133333,0,-1,15,15,-35,0,0,15,3,false,true,true,0.998,0.002
170,139,31,18.888889,17.375,31,921,1072,-151,1,0,0.111111,0,46,9,8,0.826087,0,0,9,12,false,true,true,0.617,0.383
8,9,-1,8,9,-1,1516,1397,119,0,0,0,0,92,1,1,0.358696,0,1,14,7,false,true,false,0.427,0.573
270,183,87,19.285714,13.071429,87,1253,1166,87,1,0,0.071429,0,18,14,14,2.388889,0,0,12,17,false,true,true,0.991,0.009
112,77,35,18.666667,15.4,35,468,542,-74,0,0,0,0,67,6,5,0.58209,0,0,20,11,false,true,true,0.843,0.157
347,220,127,18.263158,11.578947,127,871,867,4,0,0,0,0,-15,19,19,-2.866667,0,0,7,9,false,true,true,1,0
211,271,-60,21.1,30.111111,-60,1419,1488,-69,0,1,0,0.111111,21,10,9,1.333333,1,0,13,7,false,true,false,0.139,0.861
179,257,-78,25.571429,36.714286,-78,1489,1558,-69,0,1,0,0.142857,46,7,7,0.608696,0,0,10,12,false,true,false,0.096,0.904
181,143,38,13.923077,11.916667,38,1030,1045,-15,0,0,0,0,32,13,12,1.4375,0,0,7,16,false,true,true,0.71,0.29
402,365,37,22.333333,20.277778,37,1144,1014,130,0,0,0,0,-22,18,18,-1.636364,0,0,1,1,true,true,true,1,0
125,99,26,25,19.8,26,971,906,65,0,0,0,0,59,5,5,0.542373,0,0,10,13,false,true,true,0.78,0.22
352,203,149,27.076923,16.916667,149,1550,1546,4,0,0,0,0,18,13,12,1.666667,1,1,12,8,false,true,true,1,0
191,181,10,21.222222,20.111111,10,1305,1242,63,1,0,0.111111,0,43,9,9,0.790698,0,1,10,7,false,true,false,0.409,0.591
208,257,-49,26,36.714286,-49,1489,1558,-69,0,1,0,0.142857,43,8,7,0.651163,0,0,7,12,false,true,false,0.102,0.898
218,122,96,24.222222,15.25,96,1065,1030,35,0,0,0,0,42,9,8,0.809524,1,0,9,8,false,true,true,0.983,0.017
129,165,-36,21.5,33,-36,1023,1110,-87,1,1,0.166667,0.2,47,6,5,0.638298,0,0,12,10,false,true,false,0.227,0.773
187,238,-51,17,21.636364,-51,1177,1214,-37,0,0,0,0,25,11,11,1.4,1,0,18,9,false,true,false,0.115,0.885
262,179,83,21.833333,14.916667,83,526,370,156,0,0,0,0,12,12,12,2.916667,1,0,20,11,false,true,true,0.983,0.017
315,281,34,18.529412,16.529412,34,1040,925,115,0,0,0,0,-19,17,17,-2.263158,0,0,15,7,false,true,true,0.967,0.033
82,87,-5,16.4,17.4,-5,864,808,56,1,0,0.2,0,58,5,5,0.586207,0,0,9,11,false,true,false,0.3,0.7
209,191,18,20.9,19.1,18,971,906,65,0,0,0,0,23,10,10,1.391304,0,0,7,18,false,true,true,0.716,0.284
343,242,101,18.052632,13.444444,101,620,513,107,0,0,0,0,-12,19,18,-3.75,0,0,3,5,false,true,true,1,0
77,75,2,19.25,18.75,2,1189,1266,-77,0,0,0,0,73,4,4,0.465753,1,0,17,19,false,true,true,0.797,0.203
347,294,53,23.133333,19.6,53,1089,1063,26,1,0,0.066667,0,-4,15,15,-9.5,0,0,9,7,false,true,true,0.999,0.001
262,247,15,20.153846,20.583333,15,771,754,17,0,0,0,0,13,13,12,2.461538,0,1,12,16,false,true,false,0.306,0.694
248,176,72,35.428571,25.142857,72,1735,1770,-35,2,1,0.285714,0.142857,33,7,7,0.848485,0,1,18,9,false,true,true,0.919,0.081
277,154,123,21.307692,12.833333,123,1295,1477,-182,2,0,0.153846,0,23,13,12,2,0,0,25,13,false,true,true,0.983,0.017
445,416,29,27.8125,26,29,1897,1793,104,2,3,0.125,0.1875,-4,16,16,-8,0,0,2,3,true,true,true,0.718,0.282
195,160,35,27.857143,22.857143,35,1550,1466,84,1,0,0.142857,0,48,7,7,0.770833,0,0,18,14,false,true,true,0.759,0.241
256,253,3,15.058824,14.882353,3,361,493,-132,1,0,0.058824,0,-23,17,17,-1.782609,0,0,6,9,false,true,true,0.718,0.282
352,321,31,25.142857,22.928571,31,1439,1397,42,1,2,0.071429,0.142857,-8,14,14,-4.25,0,0,6,15,false,true,true,0.983,0.017
168,149,19,15.272727,14.9,19,1214,1176,38,0,0,0,0,38,11,10,0.947368,0,0,14,18,false,true,false,0.255,0.745
298,235,63,19.866667,15.666667,63,844,821,23,0,0,0,0,17,15,15,2.470588,0,0,14,7,false,true,true,0.981,0.019
238,169,69,21.636364,16.9,69,505,95,410,0,1,0,0.1,41,11,10,1.073171,0,1,10,10,false,true,true,0.937,0.063
182,144,38,18.2,14.4,38,786,788,-2,0,0,0,0,23,10,10,1.478261,1,1,11,13,false,true,true,0.539,0.461
81,111,-30,16.2,22.2,-30,1519,1782,-263,0,0,0,0,68,5,5,0.485294,0,0,9,12,false,true,false,0.113,0.887
286,222,64,26,20.181818,64,613,569,44,0,0,0,0,21,11,11,1.857143,1,0,12,10,false,true,true,0.992,0.008
106,61,45,26.5,15.25,45,838,786,52,0,0,0,0,73,4,4,0.438356,0,0,7,9,false,true,true,0.882,0.118
83,51,32,20.75,17,32,1127,1134,-7,0,0,0,0,71,4,3,0.422535,1,0,15,15,false,true,true,0.693,0.307
30,38,-8,15,38,-8,954,1078,-124,0,0,0,0,87,2,1,0.436782,0,0,26,8,false,true,false,0.266,0.734
71,30,41,23.666667,15,41,1210,1253,-43,0,0,0,0,82,3,2,0.426829,0,0,7,11,false,true,true,0.511,0.489
207,173,34,15.923077,14.416667,34,871,999,-128,0,0,0,0,23,13,12,2.086957,0,0,10,19,false,true,false,0.458,0.542
421,370,51,46.777778,46.25,51,1370,1431,-61,2,1,0.222222,0.125,23,9,8,1,1,0,9,9,false,true,true,1,0
86,27,59,28.666667,13.5,59,1075,1152,-77,0,0,0,0,78,3,2,0.512821,0,1,19,16,false,true,true,0.55,0.45
94,44,50,15.666667,8.8,50,801,807,-6,0,0,0,0,61,6,5,0.57377,0,1,14,15,false,true,true,0.541,0.459
30,19,11,30,19,11,904,668,236,0,0,0,0,93,1,1,0.365591,0,0,20,14,false,true,true,0.823,0.177
309,164,145,16.263158,8.631579,145,859,719,140,0,1,0,0.052632,-19,19,19,-2.789474,0,1,24,11,false,true,true,1,0
120,112,8,20,18.666667,8,977,976,1,0,0,0,0,64,6,6,0.53125,0,0,13,9,false,true,true,0.611,0.389
77,30,47,38.5,30,47,1397,1195,202,0,0,0,0,87,2,1,0.402299,0,0,12,25,false,true,true,0.705,0.295
34,32,2,11.333333,10.666667,2,580,620,-40,0,0,0,0,79,3,3,0.544304,1,0,11,19,false,true,true,0.519,0.481
100,55,45,14.285714,7.857143,45,1016,1037,-21,0,0,0,0,61,7,7,0.786885,0,1,7,13,false,true,false,0.368,0.632
248,220,28,20.666667,18.333333,28,1078,1130,-52,0,1,0,0.083333,19,12,12,2.052632,0,0,8,24,false,true,true,0.818,0.182
360,280,80,22.5,18.666667,80,904,668,236,0,0,0,0,-22,16,15,-1.545455,0,0,2,3,false,true,true,1,0
52,30,22,26,30,22,1050,1144,-94,0,0,0,0,89,2,1,0.426966,0,0,7,9,false,true,false,0.466,0.534
249,130,119,20.75,10.833333,119,595,543,52,0,0,0,0,29,12,12,1.62069,0,0,8,11,false,true,true,1,0
331,221,110,27.583333,20.090909,110,695,671,24,0,0,0,0,12,12,11,2.75,0,0,7,7,false,true,true,1,0
192,188,4,17.454545,17.090909,4,808,812,-4,0,0,0,0,24,11,11,1.541667,1,0,9,11,false,true,true,0.585,0.415
254,88,166,19.538462,6.769231,166,896,818,78,0,0,0,0,34,13,13,1.294118,1,1,10,6,false,true,true,1,0
364,179,185,13.481481,6.884615,185,859,719,140,0,1,0,0.038462,-36,27,26,-1.472222,0,1,11,9,true,true,true,1,0
244,221,23,22.181818,20.090909,23,1493,1513,-20,1,0,0.090909,0,24,11,11,1.375,0,2,15,7,false,true,true,0.693,0.307
101,109,-8,14.428571,15.571429,-8,921,1072,-151,0,0,0,0,58,7,7,0.655172,1,0,6,12,false,true,false,0.25,0.75
288,239,49,18,15.933333,49,1221,1438,-217,0,0,0,0,15,16,15,3,0,1,20,7,false,true,true,0.668,0.332
113,77,36,22.6,15.4,36,885,719,166,0,0,0,0,70,5,5,0.542857,0,1,14,10,false,true,true,0.965,0.035
61,33,28,30.5,16.5,28,838,786,52,0,0,0,0,86,2,2,0.372093,0,0,9,10,false,true,true,0.855,0.145
53,59,-6,17.666667,19.666667,-6,1297,1606,-309,0,0,0,0,80,3,3,0.375,1,0,13,21,false,true,false,0.353,0.647
163,124,39,18.111111,13.777778,39,1048,1000,48,0,0,0,0,44,9,9,0.909091,0,1,8,17,false,true,true,0.67,0.33
313,294,19,22.357143,21,19,1344,1209,135,1,1,0.071429,0.071429,-5,14,14,-6.8,0,0,10,9,false,true,true,0.743,0.257
82,68,14,16.4,17,14,908,859,49,0,0,0,0,67,5,4,0.58209,0,0,8,19,false,true,false,0.233,0.767
267,196,71,24.272727,17.818182,71,596,595,1,1,0,0.090909,0,23,11,11,1.73913,0,0,7,12,false,true,true,0.996,0.004
235,158,77,26.111111,19.75,77,1029,1227,-198,1,0,0.111111,0,32,9,8,1,1,0,9,17,false,true,true,0.991,0.009
236,226,10,15.733333,16.142857,10,1075,989,86,0,0,0,0,18,15,14,2.166667,1,0,6,17,false,true,true,0.514,0.486
360,317,43,18.947368,16.684211,43,1221,1258,-37,1,0,0.052632,0,-21,19,19,-1.857143,1,0,0,5,false,true,true,1,0
384,339,45,27.428571,26.076923,45,1153,1065,88,0,1,0,0.076923,-20,14,13,-1.4,0,0,7,4,false,true,true,0.975,0.025
252,176,76,25.2,19.555556,76,1216,1217,-1,1,0,0.1,0,29,10,9,1.172414,1,0,14,20,false,true,true,0.994,0.006
351,202,149,27,16.833333,149,1691,1692,-1,0,0,0,0,13,13,12,2.307692,1,1,7,20,false,true,true,1,0
195,191,4,15,15.916667,4,450,412,38,0,0,0,0,13,13,12,2.923077,0,0,11,12,false,true,true,0.599,0.401
358,202,156,17.9,10.1,156,1176,1076,100,0,0,0,0,12,20,20,4.916667,0,0,10,16,false,true,true,1,0
293,233,60,20.928571,16.642857,60,859,811,48,0,0,0,0,4,14,14,9,1,1,11,14,false,true,true,0.992,0.008
0,20,-20,0,20,-20,1539,1537,2,0,0,0,0,96,1,1,0.333333,0,0,17,9,false,true,false,0.253,0.747
41,94,-53,13.666667,47,-53,1762,1538,224,0,1,0,0.5,79,3,2,0.43038,0,0,14,17,false,true,true,0.754,0.246
75,88,-13,15,22,-13,316,306,10,0,1,0,0.25,71,5,4,0.535211,0,0,11,9,false,true,true,0.667,0.333
371,333,38,30.916667,30.272727,38,1935,2020,-85,0,1,0,0.090909,8,12,11,3.875,0,0,12,14,false,true,true,0.992,0.008
287,207,80,17.9375,12.9375,80,1164,1201,-37,0,0,0,0,1,16,16,42,0,2,16,8,false,true,true,0.988,0.012
198,246,-48,18,22.363636,-48,594,605,-11,0,0,0,0,23,11,11,1.608696,0,0,25,10,false,true,false,0.176,0.824
284,165,119,40.571429,23.571429,119,1489,1405,84,2,0,0.285714,0,47,7,7,0.595745,0,0,13,10,false,true,true,0.999,0.001
6,0,6,6,0,6,1034,1040,-6,0,0,0,0,97,1,0,0.360825,0,0,25,0,false,true,true,0.513,0.487
84,90,-6,16.8,22.5,-6,808,639,169,0,0,0,0,63,5,4,0.650794,0,0,26,11,false,true,false,0.303,0.697
218,100,118,27.25,14.285714,118,801,925,-124,1,0,0.125,0,41,8,7,0.853659,1,0,20,16,false,true,true,0.985,0.015
278,210,68,21.384615,16.153846,68,527,503,24,0,0,0,0,22,13,13,1.863636,0,0,10,8,false,true,true,0.984,0.016
339,229,110,30.818182,20.818182,110,1826,1803,23,1,0,0.090909,0,14,11,11,2.142857,1,0,18,9,false,true,true,1,0
201,171,30,22.333333,21.375,30,1078,1130,-52,0,1,0,0.125,41,9,8,0.95122,0,0,12,16,false,true,true,0.727,0.273
274,189,85,18.266667,13.5,85,415,518,-103,0,0,0,0,5,15,14,7.6,0,0,8,19,false,true,true,0.999,0.001
400,312,88,26.666667,22.285714,88,971,1180,-209,1,1,0.066667,0.071429,-4,15,14,-8,0,0,3,4,false,true,true,0.999,0.001
225,193,32,22.5,19.3,32,1094,1030,64,0,0,0,0,30,10,10,1.2,0,0,8,14,false,true,true,0.749,0.251
74,14,60,74,14,60,1270,1322,-52,1,0,1,0,90,1,1,0.422222,0,0,16,13,false,true,true,0.528,0.472
173,142,31,21.625,17.75,31,1516,1397,119,0,1,0,0.125,38,8,8,0.868421,0,0,11,10,false,true,true,0.814,0.186
378,226,152,25.2,15.066667,152,954,1078,-124,1,1,0.066667,0.066667,-5,15,15,-7.6,0,0,8,13,false,true,true,1,0
29,48,-19,9.666667,16,-19,448,598,-150,0,0,0,0,82,3,3,0.439024,0,0,8,7,false,true,false,0.192,0.808
338,301,37,14.695652,13.681818,37,480,518,-38,0,0,0,0,-36,23,22,-1.277778,0,0,1,2,false,true,true,0.998,0.002
220,197,23,20,19.7,23,518,448,70,0,0,0,0,28,11,10,1.214286,0,0,12,8,false,true,true,0.735,0.265
50,40,10,16.666667,20,10,1489,1445,44,0,0,0,0,80,3,2,0.4,0,0,24,7,false,true,true,0.517,0.483
336,233,103,19.764706,14.5625,103,830,907,-77,1,0,0.058824,0,-5,17,16,-7.8,0,1,16,6,false,true,true,1,0
327,281,46,18.166667,16.529412,46,1040,925,115,0,0,0,0,-21,18,17,-2.047619,0,0,12,7,false,true,true,0.996,0.004
143,193,-50,13,19.3,-50,1075,989,86,0,0,0,0,40,11,10,0.975,0,0,23,15,false,true,false,0.102,0.898
290,302,-12,14.5,15.1,-12,613,549,64,0,0,0,0,-28,20,20,-1.571429,0,0,2,1,false,true,false,0.199,0.801
33,23,10,16.5,11.5,10,960,1070,-110,0,0,0,0,84,2,2,0.416667,0,0,10,14,false,true,false,0.454,0.546
244,181,63,30.5,22.625,63,1762,1582,180,2,2,0.25,0.25,38,8,8,0.842105,0,0,7,10,false,true,true,0.85,0.15
253,244,9,19.461538,18.769231,9,1078,1130,-52,0,1,0,0.076923,13,13,13,3,0,0,12,29,false,true,true,0.556,0.444
346,256,90,17.3,12.8,90,1048,1000,48,0,0,0,0,-17,20,20,-2.352941,0,1,1,2,true,true,true,1,0
347,297,50,26.692308,24.75,50,1803,1552,251,1,2,0.076923,0.166667,2,13,12,14,0,0,11,22,false,true,true,0.962,0.038
24,0,24,24,0,24,1305,1218,87,0,0,0,0,95,1,0,0.4,0,0,15,0,false,true,true,0.524,0.476
296,276,20,29.6,30.666667,20,1265,1237,28,1,0,0.1,0,19,10,9,1.578947,0,1,9,12,false,true,false,0.36,0.64
352,336,16,23.466667,22.4,16,908,1070,-162,2,0,0.133333,0,-10,15,15,-3,0,0,2,3,true,true,true,0.891,0.109
388,294,94,27.714286,22.615385,94,1428,1606,-178,1,0,0.071429,0,-4,14,13,-8,0,0,4,4,false,true,true,1,0
145,193,-48,14.5,21.444444,-48,316,306,10,0,2,0,0.222222,34,10,9,1.117647,0,0,29,16,false,true,false,0.283,0.717
316,234,82,22.571429,18,82,1004,653,351,0,0,0,0,-5,14,13,-7,0,0,10,17,false,true,true,0.999,0.001
139,69,70,34.75,17.25,70,1334,1256,78,1,0,0.25,0,72,4,4,0.430556,0,0,11,9,false,true,true,0.898,0.102
183,169,14,14.076923,13,14,539,632,-93,0,0,0,0,29,13,13,1.586207,0,0,10,7,false,true,true,0.721,0.279
53,24,29,26.5,24,29,691,473,218,0,0,0,0,87,2,1,0.413793,0,0,16,9,false,true,true,0.844,0.156
404,226,178,20.2,11.894737,178,1033,1037,-4,0,1,0,0.052632,-20,20,19,-2.25,0,1,2,2,false,true,true,1,0
17,44,-27,8.5,22,-27,421,306,115,0,0,0,0,83,2,2,0.53012,0,0,14,11,false,true,false,0.285,0.715
63,88,-25,15.75,29.333333,-25,316,306,10,0,1,0,0.333333,75,4,3,0.506667,0,0,9,9,false,true,false,0.355,0.645
346,248,98,19.222222,13.777778,98,925,801,124,1,0,0.055556,0,-11,18,18,-3.636364,0,0,8,8,false,true,true,1,0
298,262,36,21.285714,18.714286,36,1069,917,152,0,1,0,0.071429,4,14,14,8.5,1,0,8,9,false,true,true,0.863,0.137
372,370,2,26.571429,28.461538,2,1419,1488,-69,1,1,0.071429,0.076923,-10,14,13,-2.8,1,0,3,2,false,true,true,0.944,0.056
336,180,156,21,12,156,1586,1782,-196,0,0,0,0,-1,16,15,-40,1,0,13,10,false,true,true,1,0
114,69,45,19,13.8,45,613,502,111,0,0,0,0,60,6,5,0.816667,0,0,12,19,false,true,true,0.755,0.245
157,129,28,19.625,16.125,28,786,847,-61,0,0,0,0,47,8,8,0.723404,0,0,7,9,false,true,true,0.863,0.137
184,87,97,15.333333,7.909091,97,859,719,140,0,1,0,0.090909,23,12,11,2.304348,0,2,17,13,false,true,true,0.91,0.09
367,279,88,33.363636,27.9,88,1237,1277,-40,0,0,0,0,9,11,10,3.222222,0,0,22,13,false,true,true,0.994,0.006
102,105,-3,17,21,-3,999,1011,-12,0,0,0,0,62,6,5,0.741935,0,0,12,22,false,true,false,0.118,0.882
124,67,57,24.8,16.75,57,1439,1397,42,0,1,0,0.25,65,5,4,0.523077,0,0,11,14,false,true,true,0.904,0.096
153,121,32,19.125,15.125,32,620,658,-38,0,0,0,0,45,8,8,0.8,0,0,37,9,false,true,true,0.858,0.142
286,351,-65,23.833333,31.909091,-65,834,844,-10,1,2,0.083333,0.181818,7,12,11,5.142857,0,0,12,17,false,true,false,0.042,0.958
45,38,7,15,12.666667,7,1550,1546,4,0,0,0,0,79,3,3,0.379747,0,0,19,17,false,true,false,0.461,0.539
115,94,21,23,23.5,21,505,95,410,0,1,0,0.25,75,5,4,0.586667,0,0,8,9,false,true,true,0.584,0.416
102,36,66,34,18,66,1439,1353,86,1,0,0.333333,0,76,3,2,0.394737,0,0,13,9,false,true,true,0.539,0.461
265,256,9,20.384615,21.333333,9,1344,1209,135,1,1,0.076923,0.083333,4,13,12,8.5,0,0,19,14,false,true,true,0.728,0.272
12,0,12,12,0,12,1572,1550,22,0,0,0,0,97,1,0,0.402062,0,0,10,0,false,true,false,0.3,0.7
66,59,7,22,19.666667,7,609,620,-11,0,0,0,0,78,3,3,0.474359,0,0,18,10,false,true,true,0.652,0.348
167,102,65,18.555556,11.333333,65,595,543,52,0,0,0,0,47,9,9,1,1,0,15,10,false,true,true,0.981,0.019
211,162,49,17.583333,13.5,49,299,315,-16,0,0,0,0,21,12,12,2,0,0,10,12,false,true,true,0.963,0.037
324,171,153,18,10.058824,153,1176,1076,100,0,0,0,0,23,18,17,2.565217,0,0,13,14,false,true,true,1,0
238,188,50,17,14.461538,50,620,513,107,0,0,0,0,14,14,13,3.214286,1,0,29,7,false,true,true,0.981,0.019
238,208,30,21.636364,18.909091,30,1210,1253,-43,0,1,0,0.090909,21,11,11,1.666667,1,0,9,17,false,true,true,0.945,0.055
30,43,-13,10,21.5,-13,1388,1477,-89,0,0,0,0,83,3,2,0.578313,1,0,6,9,false,true,false,0.248,0.752
140,86,54,28,21.5,54,1170,1156,14,1,0,0.2,0,69,5,4,0.550725,0,0,10,18,false,true,true,0.726,0.274
159,221,-62,13.25,18.416667,-62,1075,989,86,0,0,0,0,30,12,12,1.3,0,0,21,17,false,true,false,0.068,0.932
326,276,50,17.157895,15.333333,50,468,542,-74,0,0,0,0,-17,19,18,-2.294118,0,0,2,1,false,true,true,0.999,0.001
287,232,55,22.076923,19.333333,55,892,819,73,0,1,0,0.083333,12,13,12,2.833333,0,0,14,13,false,true,true,0.949,0.051
115,80,35,23,16,35,786,788,-2,0,0,0,0,57,5,5,0.596491,0,0,12,17,false,true,true,0.787,0.213
304,196,108,16,10.888889,108,1428,1302,126,0,0,0,0,-11,19,18,-4.818182,0,1,10,18,false,true,true,0.998,0.002
215,120,95,23.888889,15,95,1075,1152,-77,0,0,0,0,45,9,8,0.888889,0,1,11,7,false,true,true,0.993,0.007
93,37,56,23.25,12.333333,56,804,683,121,0,0,0,0,72,4,3,0.625,0,1,19,6,false,true,true,0.953,0.047
54,69,-15,13.5,17.25,-15,566,542,24,0,0,0,0,72,4,4,0.569444,0,1,10,11,false,true,false,0.243,0.757
288,184,104,28.8,20.444444,104,1030,998,32,1,0,0.1,0,26,10,9,1.461538,0,0,13,13,false,true,true,0.999,0.001
156,99,57,22.285714,16.5,57,1388,1477,-89,1,0,0.142857,0,53,7,6,0.90566,0,0,15,9,false,true,true,0.791,0.209
344,296,48,21.5,18.5,48,1452,1469,-17,1,1,0.0625,0.0625,-11,16,16,-3.454545,0,0,5,8,false,true,true,0.999,0.001
144,77,67,36,25.666667,67,1210,1252,-42,1,0,0.25,0,74,4,3,0.432432,0,0,9,11,false,true,true,0.852,0.148
258,198,60,19.846154,16.5,60,939,913,26,0,1,0,0.083333,14,13,12,2.857143,0,0,19,7,false,true,true,0.98,0.02
257,246,11,12.85,12.947368,11,1029,1075,-46,0,0,0,0,-6,20,19,-8,2,0,10,12,false,true,true,0.695,0.305
84,41,43,28,20.5,43,901,1159,-258,1,0,0.333333,0,83,3,2,0.421687,1,0,6,12,false,true,true,0.503,0.497
289,258,31,19.266667,18.428571,31,349,315,34,0,0,0,0,-12,15,14,-2.833333,0,0,3,9,false,true,true,0.993,0.007
206,99,107,41.2,24.75,107,1397,1361,36,1,0,0.2,0,61,5,4,0.47541,0,0,11,12,false,true,true,0.925,0.075
57,20,37,28.5,20,37,786,757,29,0,0,0,0,87,2,1,0.448276,0,0,10,14,false,true,true,0.736,0.264
14,0,14,14,0,14,416,306,110,0,0,0,0,97,1,0,0.43299,0,0,23,0,false,true,true,0.662,0.338
157,90,67,31.4,18,67,1216,1230,-14,1,0,0.2,0,59,5,5,0.542373,0,0,17,13,false,true,true,0.893,0.107
254,144,110,36.285714,24,110,1880,1777,103,1,0,0.142857,0,44,7,6,0.636364,0,1,19,15,false,true,true,0.991,0.009
382,210,172,31.833333,17.5,172,1513,1482,31,1,0,0.083333,0,5,12,12,6.6,0,0,14,17,false,true,true,1,0
336,347,-11,22.4,23.133333,-11,1320,1339,-19,2,1,0.133333,0.066667,-3,15,15,-13,0,0,11,11,false,true,false,0.229,0.771
242,197,45,17.285714,14.071429,45,299,315,-16,0,0,0,0,3,14,14,14,0,0,11,20,false,true,true,0.953,0.047
118,113,5,16.857143,16.142857,5,1094,1030,64,0,0,0,0,57,7,7,0.631579,1,0,13,10,false,true,true,0.536,0.464
299,233,66,23,19.416667,66,1489,1445,44,0,0,0,0,14,13,12,2.285714,1,0,8,7,false,true,true,0.981,0.019
58,71,-13,14.5,17.75,-13,1043,1055,-12,0,0,0,0,70,4,4,0.528571,0,0,16,10,false,true,false,0.344,0.656
402,340,62,26.8,24.285714,62,1093,1197,-104,4,0,0.266667,0,-12,15,14,-2.583333,0,0,1,6,false,true,true,0.986,0.014
263,226,37,17.533333,15.066667,37,916,837,79,0,0,0,0,9,15,15,4.444444,1,0,6,10,false,true,true,0.973,0.027
351,309,42,18.473684,16.263158,42,904,783,121,0,0,0,0,-23,19,19,-1.826087,1,0,3,4,false,true,true,1,0
12,0,12,12,0,12,1439,1413,26,0,0,0,0,96,1,0,0.375,0,0,19,0,false,true,false,0.488,0.512
29,19,10,9.666667,9.5,10,561,526,35,0,0,0,0,80,3,2,0.4375,2,0,15,16,false,true,true,0.957,0.043
282,202,80,18.8,14.428571,80,1048,1000,48,0,0,0,0,15,15,14,2.666667,0,1,10,13,false,true,true,0.996,0.004
63,60,3,15.75,15,3,416,222,194,0,0,0,0,71,4,4,0.774648,1,0,10,7,false,true,true,0.545,0.455
207,190,17,17.25,17.272727,17,95,378,-283,0,0,0,0,17,12,11,2.058824,1,0,7,9,false,true,false,0.425,0.575
96,130,-34,16,21.666667,-34,1304,1040,264,0,0,0,0,62,6,6,0.532258,1,0,7,14,false,true,false,0.383,0.617
199,135,64,18.090909,13.5,64,299,315,-16,0,0,0,0,31,11,10,1.354839,0,0,7,11,false,true,true,0.965,0.035
196,190,6,24.5,23.75,6,1089,1063,26,1,0,0.125,0,47,8,8,0.808511,0,0,18,10,false,true,true,0.73,0.27
363,328,35,22.6875,20.5,35,1014,1303,-289,1,0,0.0625,0,-15,16,16,-2.533333,0,0,5,7,false,true,true,0.994,0.006
20,23,-3,20,23,-3,1554,1716,-162,0,0,0,0,92,1,1,0.380435,1,0,6,13,false,true,true,0.642,0.358
84,42,42,42,21,42,1220,1261,-41,1,0,0.5,0,86,2,2,0.523256,0,0,10,10,false,true,true,0.524,0.476
130,122,8,16.25,17.428571,8,671,725,-54,0,0,0,0,44,8,7,0.840909,1,0,10,14,false,true,false,0.474,0.526
254,162,92,25.4,18,92,371,336,35,2,0,0.2,0,13,10,9,2.923077,0,0,12,15,false,true,true,0.999,0.001
173,58,115,21.625,8.285714,115,1413,1422,-9,0,0,0,0,53,8,7,1.075472,2,0,16,19,false,true,true,0.977,0.023
109,116,-7,27.25,29,-7,1078,1130,-52,0,1,0,0.25,70,4,4,0.557143,0,0,10,11,false,true,true,0.602,0.398
265,195,70,20.384615,15,70,576,532,44,0,0,0,0,19,13,13,2.421053,0,0,12,7,false,true,true,0.983,0.017
293,277,16,13.952381,13.85,16,871,999,-128,0,0,0,0,-23,21,20,-2.086957,0,0,8,8,false,true,true,0.794,0.206
85,87,-2,21.25,21.75,-2,1297,1606,-309,0,0,0,0,73,4,4,0.410959,1,0,10,20,false,true,false,0.423,0.577
107,37,70,35.666667,18.5,70,976,965,11,0,0,0,0,74,3,2,0.432432,0,0,23,25,false,true,true,0.753,0.247
306,142,164,21.857143,10.923077,164,942,1003,-61,0,0,0,0,11,14,13,4.090909,1,1,19,15,false,true,true,1,0
8,0,8,8,0,8,1770,1689,81,0,0,0,0,97,1,0,0.268041,0,0,10,0,false,true,false,0.278,0.722
193,96,97,32.166667,16,97,539,500,39,0,0,0,0,47,6,6,0.851064,0,1,7,15,false,true,true,1,0
151,174,-23,18.875,24.857143,-23,1177,1214,-37,0,0,0,0,48,8,7,0.729167,0,0,16,8,false,true,false,0.108,0.892
232,237,-5,17.846154,18.230769,-5,95,378,-283,0,0,0,0,4,13,13,8.75,0,0,16,10,false,true,true,0.575,0.425
461,308,153,30.733333,20.533333,153,1571,1554,17,2,1,0.133333,0.066667,-18,15,15,-1.833333,1,0,0,2,false,true,true,1,0
409,278,131,16.36,11.583333,131,1413,1422,-9,0,0,0,0,-28,25,24,-2.035714,0,0,3,2,false,true,true,1,0
340,328,12,20,20.5,12,974,995,-21,0,1,0,0.0625,-11,17,16,-3,0,0,2,1,true,true,true,0.854,0.146
142,197,-55,17.75,28.142857,-55,1539,1537,2,0,1,0,0.142857,53,8,7,0.603774,1,0,7,8,false,true,false,0.311,0.689
94,49,45,47,24.5,45,416,282,134,1,0,0.5,0,80,2,2,0.425,0,0,19,14,false,true,true,0.736,0.264
286,255,31,22,19.615385,31,1047,1094,-47,1,1,0.076923,0.076923,13,13,13,2.769231,0,0,19,10,false,true,true,0.947,0.053
141,127,14,28.2,25.4,14,1550,1466,84,1,0,0.2,0,62,5,5,0.596774,1,0,10,20,false,true,true,0.841,0.159
215,159,56,19.545455,15.9,56,831,830,1,0,0,0,0,30,11,10,1.233333,1,0,26,8,false,true,true,0.972,0.028
368,279,89,19.368421,14.684211,89,916,837,79,1,0,0.052632,0,-24,19,19,-1.666667,0,0,1,2,false,true,true,1,0
152,125,27,19,15.625,27,786,976,-190,0,0,0,0,54,8,8,0.592593,0,0,9,8,false,true,true,0.747,0.253
296,238,58,24.666667,19.833333,58,613,569,44,0,0,0,0,14,12,12,2.785714,1,0,12,7,false,true,true,0.988,0.012
322,188,134,26.833333,15.666667,134,1482,1394,88,2,0,0.166667,0,17,12,12,2.117647,0,0,12,18,false,true,true,1,0
111,110,1,15.857143,18.333333,1,272,238,34,0,0,0,0,51,7,6,0.784314,0,0,10,10,false,true,false,0.477,0.523
391,284,107,17,12.347826,107,746,796,-50,0,1,0,0.043478,-30,23,23,-1.6,0,0,1,1,false,true,true,1,0
434,281,153,16.692308,11.24,153,1176,1076,100,0,0,0,0,-21,26,25,-2.809524,0,0,4,7,false,true,true,1,0
22,32,-10,11,16,-10,566,542,24,0,0,0,0,86,2,2,0.476744,0,0,12,18,false,true,false,0.271,0.729
335,257,78,23.928571,19.769231,78,1014,1303,-289,1,0,0.071429,0,4,14,13,9.5,0,0,7,11,false,true,true,0.999,0.001
422,393,29,30.142857,30.230769,29,1935,2020,-85,0,1,0,0.076923,-9,14,13,-3.444444,0,0,3,4,false,true,true,0.976,0.024
311,279,32,16.368421,14.684211,32,808,639,169,0,0,0,0,-20,19,19,-2.05,0,0,4,1,false,true,true,0.994,0.006
400,210,190,30.769231,17.5,190,1513,1482,31,1,0,0.076923,0,2,13,12,16.5,0,0,9,17,false,true,true,1,0
310,267,43,17.222222,14.833333,43,613,461,152,0,1,0,0.055556,-25,18,18,-1.48,0,0,2,1,false,true,true,0.996,0.004
250,146,104,22.727273,14.6,104,1045,1009,36,1,0,0.090909,0,34,11,10,1.117647,1,0,8,16,false,true,true,0.997,0.003
289,213,76,36.125,26.625,76,1507,1554,-47,1,2,0.125,0.25,26,8,8,1.115385,0,0,14,11,false,true,true,0.983,0.017
118,67,51,23.6,13.4,51,960,1070,-110,1,0,0.2,0,65,5,5,0.538462,0,0,22,23,false,true,true,0.752,0.248
311,293,18,16.368421,15.421053,18,1583,1422,161,1,0,0.052632,0,3,19,19,17,0,0,7,17,false,true,true,0.797,0.203
273,271,2,24.818182,24.636364,2,1153,1065,88,0,1,0,0.090909,3,11,11,9.333333,1,0,6,15,false,true,false,0.244,0.756
284,280,4,21.846154,21.538462,4,1554,1622,-68,2,0,0.153846,0,2,13,13,15.5,1,0,6,14,false,true,true,0.708,0.292
369,283,86,19.421053,15.722222,86,613,569,44,0,0,0,0,-19,19,18,-2.052632,0,0,1,1,false,true,true,1,0
204,119,85,34,23.8,85,1142,1095,47,1,0,0.166667,0,53,6,5,0.660377,0,0,16,19,false,true,true,0.778,0.222
197,155,42,24.625,19.375,42,1221,1266,-45,0,0,0,0,38,8,8,0.921053,1,0,6,7,false,true,true,0.707,0.293
327,223,104,29.727273,22.3,104,1489,1555,-66,1,0,0.090909,0,18,11,10,1.611111,0,0,9,7,false,true,true,1,0
405,296,109,28.928571,21.142857,109,1507,1554,-47,1,2,0.071429,0.142857,-12,14,14,-2.416667,0,0,3,4,false,true,true,1,0
153,107,46,30.6,26.75,46,1489,1555,-66,1,0,0.2,0,62,5,4,0.467742,0,0,12,12,false,true,false,0.479,0.521
136,188,-52,13.6,20.888889,-52,1075,989,86,0,0,0,0,48,10,9,0.8125,0,0,23,15,false,true,false,0.102,0.898
115,52,63,23,13,63,1439,1413,26,0,0,0,0,72,5,4,0.5,0,0,18,8,false,true,true,0.808,0.192
360,265,95,27.692308,20.384615,95,1156,1114,42,1,0,0.076923,0,-1,13,13,-32,0,0,8,15,false,true,true,0.999,0.001
106,66,40,26.5,22,40,995,912,83,1,0,0.25,0,77,4,3,0.571429,1,0,6,14,false,true,true,0.694,0.306
357,301,56,23.8,20.066667,56,1216,1228,-12,1,0,0.066667,0,-2,15,15,-16.5,0,0,16,1,false,true,true,0.996,0.004
319,227,92,18.764706,14.1875,92,1048,1000,48,0,0,0,0,0,17,16,0,0,1,8,6,false,true,true,1,0
377,296,81,20.944444,17.411765,81,1047,1094,-47,1,1,0.055556,0.058824,-14,18,17,-2.571429,1,0,3,3,false,true,true,1,0
100,105,-5,16.666667,21,-5,1011,921,90,0,0,0,0,62,6,5,0.790323,0,0,10,10,false,true,false,0.181,0.819
84,85,-1,16.8,17,-1,1606,1544,62,0,0,0,0,75,5,5,0.6,1,0,11,9,false,true,true,0.74,0.26
312,299,13,19.5,18.6875,13,758,952,-194,0,0,0,0,-15,16,16,-2.666667,0,0,6,3,false,true,true,0.896,0.104
177,134,43,17.7,14.888889,43,801,807,-6,0,0,0,0,30,10,9,1.166667,0,0,10,15,false,true,true,0.786,0.214
290,212,78,24.166667,19.272727,78,902,866,36,0,0,0,0,5,12,11,6.4,1,0,11,7,false,true,true,0.999,0.001
32,15,17,16,7.5,17,830,907,-77,0,0,0,0,87,2,2,0.448276,0,0,11,14,false,true,true,0.512,0.488
183,161,22,20.333333,17.888889,22,1305,1390,-85,0,0,0,0,39,9,9,0.923077,0,0,8,18,false,true,false,0.242,0.758
144,97,47,36,24.25,47,1210,1252,-42,1,0,0.25,0,70,4,4,0.457143,0,0,9,23,false,true,true,0.712,0.288
101,98,3,20.2,24.5,3,613,549,64,0,0,0,0,61,5,4,0.721311,0,0,11,13,false,true,false,0.304,0.696
124,89,35,15.5,12.714286,35,1281,1339,-58,0,0,0,0,59,8,7,0.694915,1,1,20,9,false,true,false,0.311,0.689
29,47,-18,9.666667,15.666667,-18,523,480,43,0,0,0,0,80,3,3,0.4125,0,0,25,8,false,true,false,0.333,0.667
177,120,57,22.125,15,57,1091,1078,13,0,0,0,0,54,8,8,0.796296,1,0,8,12,false,true,true,0.941,0.059
82,84,-2,16.4,16.8,-2,95,378,-283,0,0,0,0,62,5,5,0.564516,0,0,17,11,false,true,false,0.499,0.501
156,74,82,39,24.666667,82,416,282,134,1,0,0.25,0,72,4,3,0.472222,0,0,21,22,false,true,true,0.749,0.251
298,240,58,16.555556,14.117647,58,299,315,-16,0,0,0,0,-23,18,17,-1.826087,0,0,4,18,false,true,true,0.999,0.001
242,220,22,22,20,22,926,854,72,0,0,0,0,26,11,11,1.307692,0,1,8,14,false,true,true,0.887,0.113
61,43,18,15.25,14.333333,18,1159,1031,128,0,0,0,0,73,4,3,0.534247,1,0,13,15,false,true,true,0.568,0.432
81,49,32,27,16.333333,32,904,668,236,0,0,0,0,76,3,3,0.447368,0,0,24,18,false,true,true,0.792,0.208
59,32,27,14.75,10.666667,27,310,359,-49,0,0,0,0,77,4,3,0.636364,0,0,7,13,false,true,true,0.663,0.337
184,204,-20,23,29.142857,-20,1434,1493,-59,1,0,0.125,0,40,8,7,0.925,1,1,9,11,false,true,false,0.199,0.801
311,281,30,19.4375,17.5625,30,1176,1127,49,0,0,0,0,-8,16,16,-4.625,0,0,7,4,false,true,true,0.959,0.041
22,0,22,22,0,22,349,315,34,0,0,0,0,96,1,0,0.354167,0,0,13,0,false,true,true,0.774,0.226
332,281,51,19.529412,16.529412,51,1551,1550,1,0,0,0,0,-16,17,17,-2.625,0,1,12,6,false,true,true,0.998,0.002
170,153,17,24.285714,21.857143,17,809,868,-59,1,0,0.142857,0,45,7,7,0.711111,0,0,8,20,false,true,true,0.721,0.279
333,295,38,19.588235,18.4375,38,448,598,-150,0,0,0,0,-15,17,16,-2.4,0,0,4,8,false,true,true,0.99,0.01
141,75,66,35.25,25,66,795,830,-35,1,1,0.25,0.333333,63,4,3,0.666667,2,0,5,8,false,true,true,0.977,0.023
156,131,25,12,10.916667,25,892,768,124,0,0,0,0,33,13,12,1.30303,0,0,10,16,false,true,true,0.67,0.33
14,22,-8,14,22,-8,1501,1473,28,0,0,0,0,92,1,1,0.391304,0,1,21,6,false,true,false,0.389,0.611
279,214,65,25.363636,21.4,65,1109,1065,44,0,0,0,0,12,11,10,2.75,0,0,20,10,false,true,true,0.824,0.176
200,190,10,22.222222,21.111111,10,1334,1270,64,1,0,0.111111,0,39,9,9,0.948718,0,0,17,7,false,true,true,0.767,0.233
293,169,124,48.833333,28.166667,124,991,996,-5,2,0,0.333333,0,48,6,6,0.625,1,0,11,11,false,true,true,1,0
221,221,0,20.090909,20.090909,0,1127,1134,-7,0,0,0,0,20,11,11,1.5,0,1,20,6,false,true,false,0.344,0.656
171,158,13,15.545455,14.363636,13,758,750,8,0,0,0,0,24,11,11,1.541667,0,1,7,8,false,true,false,0.369,0.631
16,0,16,16,0,16,786,788,-2,0,0,0,0,95,1,0,0.357895,0,0,21,0,false,true,true,0.526,0.474
113,94,19,22.6,23.5,19,820,822,-2,0,0,0,0,67,5,4,0.58209,1,1,19,7,false,true,true,0.522,0.478
58,114,-56,19.333333,38,-56,1076,1176,-100,0,1,0,0.333333,72,3,3,0.444444,0,0,10,15,false,true,false,0.123,0.877
160,157,3,26.666667,31.4,3,1428,1606,-178,1,0,0.166667,0,53,6,5,0.603774,1,0,11,11,false,true,true,0.706,0.294
29,15,14,14.5,7.5,14,1091,1078,13,0,0,0,0,87,2,2,0.494253,0,0,11,11,false,true,true,0.511,0.489
130,124,6,26,24.8,6,1210,1253,-43,0,1,0,0.2,57,5,5,0.596491,0,0,19,18,false,true,true,0.711,0.289
12,12,0,12,12,0,1439,1413,26,0,0,0,0,93,1,1,0.387097,0,0,19,8,false,true,true,0.504,0.496
18,0,18,18,0,18,856,897,-41,0,0,0,0,97,1,0,0.360825,1,0,6,0,false,true,true,0.527,0.473
372,277,95,17.714286,13.85,95,527,503,24,0,0,0,0,-22,21,20,-1.863636,0,0,1,2,true,true,true,1,0
386,269,117,24.125,17.933333,117,1305,1390,-85,0,1,0,0.066667,-12,16,15,-3,0,2,9,10,false,true,true,0.998,0.002
300,248,52,20,17.714286,52,921,1072,-151,1,0,0.066667,0,10,15,14,3.8,0,1,9,10,false,true,true,0.786,0.214
180,126,54,20,15.75,54,1037,950,87,1,0,0.111111,0,44,9,8,0.704545,0,0,10,9,false,true,true,0.931,0.069
197,170,27,24.625,24.285714,27,1331,1399,-68,0,0,0,0,43,8,7,0.813953,0,0,20,16,false,true,false,0.472,0.528
310,102,208,44.285714,17,208,1550,1624,-74,1,0,0.142857,0,52,7,6,0.576923,0,1,9,26,false,true,true,1,0
6,6,0,6,6,0,1014,1303,-289,0,0,0,0,93,1,1,0.408602,1,1,8,9,false,true,false,0.245,0.755
22,0,22,22,0,22,1875,1793,82,0,0,0,0,98,1,1,0.306122,0,0,14,9,false,true,true,0.506,0.494
255,266,-11,23.181818,24.181818,-11,1344,1325,19,1,0,0.090909,0,15,11,11,2.066667,0,1,10,13,false,true,false,0.15,0.85
218,169,49,15.571429,13,49,539,632,-93,0,0,0,0,25,14,13,1.84,0,0,11,7,false,true,true,0.925,0.075
371,358,13,26.5,25.571429,13,1125,1227,-102,2,1,0.142857,0.071429,-15,14,14,-2,0,0,1,4,false,true,true,0.975,0.025
288,250,38,18,15.625,38,1221,1438,-217,0,0,0,0,13,16,16,3.461538,0,1,20,7,false,true,true,0.683,0.317
251,236,15,27.888889,29.5,15,1256,1232,24,1,0,0.111111,0,33,9,8,0.909091,0,0,12,19,false,true,true,0.716,0.284
318,270,48,26.5,22.5,48,965,1013,-48,1,0,0.083333,0,5,12,12,6.6,0,1,8,11,false,true,true,0.995,0.005
0,34,-34,0,34,-34,907,752,155,0,0,0,0,95,1,1,0.347368,0,0,16,12,false,true,false,0.246,0.754
348,311,37,20.470588,19.4375,37,1513,1479,34,0,0,0,0,-14,17,16,-2.428571,0,0,1,3,false,true,true,0.991,0.009
349,280,69,29.083333,23.333333,69,1428,1606,-178,1,0,0.083333,0,6,12,12,5.333333,1,0,6,10,false,true,true,1,0
46,32,14,23,32,14,758,952,-194,0,0,0,0,85,2,1,0.470588,0,1,11,10,false,true,false,0.207,0.793
157,194,-37,17.444444,21.555556,-37,1027,856,171,1,1,0.111111,0.111111,27,9,9,1.222222,1,0,19,10,false,true,false,0.363,0.637
372,273,99,18.6,14.368421,99,527,503,24,0,0,0,0,-20,20,19,-2.05,0,0,1,2,false,true,true,1,0
187,152,35,18.7,15.2,35,1181,1069,112,0,0,0,0,34,10,10,1.088235,1,0,15,9,false,true,true,0.875,0.125
397,291,106,26.466667,20.785714,106,1051,1030,21,0,0,0,0,-9,15,14,-3.333333,0,0,4,4,false,true,true,1,0
315,224,91,35,24.888889,91,1507,1554,-47,1,2,0.111111,0.222222,20,9,9,1.45,0,0,14,8,false,true,true,0.999,0.001
164,172,-8,18.222222,21.5,-8,1277,1166,111,0,1,0,0.125,41,9,8,0.878049,0,0,16,11,false,true,false,0.389,0.611
62,66,-4,20.666667,33,-4,505,95,410,0,1,0,0.5,86,3,2,0.511628,0,0,12,12,false,true,false,0.443,0.557
294,268,26,17.294118,15.764706,26,1583,1422,161,1,0,0.058824,0,14,17,17,3.642857,0,0,7,17,false,true,true,0.835,0.165
334,259,75,25.692308,21.583333,75,1302,1234,68,1,1,0.076923,0.083333,9,13,12,3.444444,0,0,14,13,false,true,true,0.992,0.008
337,317,20,21.0625,19.8125,20,1344,1209,135,1,1,0.0625,0.0625,-18,16,16,-1.888889,0,0,3,1,false,true,true,0.832,0.168
288,193,95,32,24.125,95,1334,1477,-143,1,1,0.111111,0.125,31,9,8,0.967742,0,0,13,8,false,true,true,0.993,0.007
139,111,28,17.375,13.875,28,371,435,-64,0,0,0,0,40,8,8,1.1,0,0,10,11,false,true,true,0.846,0.154
225,167,58,17.307692,13.916667,58,272,288,-16,0,0,0,0,35,13,12,1.485714,0,0,9,17,false,true,true,0.923,0.077
51,57,-6,17,19,-6,1452,1469,-17,0,0,0,0,78,3,3,0.487179,0,0,7,10,false,true,false,0.278,0.722
228,212,16,25.333333,26.5,16,1305,1218,87,1,0,0.111111,0,31,9,8,1.225806,0,0,32,8,false,true,true,0.73,0.27
191,213,-22,17.363636,19.363636,-22,721,689,32,0,0,0,0,9,11,11,3.777778,0,1,21,6,false,true,false,0.271,0.729
180,123,57,20,15.375,57,566,542,24,0,0,0,0,41,9,8,1,0,1,19,10,false,true,true,0.976,0.024
298,298,0,12.956522,13.545455,0,1029,1075,-46,0,0,0,0,-23,23,22,-2.086957,0,0,1,1,false,true,true,0.677,0.323
52,46,6,17.333333,23,6,778,758,20,0,0,0,0,77,3,2,0.506494,0,0,10,9,false,true,false,0.395,0.605
27,26,1,13.5,13,1,1089,1063,26,0,0,0,0,89,2,2,0.426966,1,0,15,20,false,true,true,0.73,0.27
300,279,21,17.647059,17.4375,21,658,817,-159,0,0,0,0,0,17,16,0,1,0,10,7,false,true,true,0.832,0.168
186,73,113,26.571429,10.428571,113,942,1003,-61,0,0,0,0,48,7,7,0.9375,0,0,19,16,false,true,true,0.981,0.019
304,225,79,20.266667,16.071429,79,1270,1315,-45,0,0,0,0,1,15,14,36,0,0,5,38,false,true,true,0.997,0.003
228,99,129,25.333333,12.375,129,554,342,212,0,0,0,0,39,9,8,0.923077,0,0,10,18,false,true,true,1,0
48,32,16,12,10.666667,16,1281,1339,-58,0,0,0,0,78,4,3,0.525641,0,0,25,12,false,true,false,0.448,0.552
310,211,99,17.222222,11.722222,99,218,86,132,0,0,0,0,-24,18,18,-1.666667,0,0,6,6,false,true,true,1,0
78,66,12,13,13.2,12,719,614,105,0,0,0,0,62,6,5,0.693548,0,2,22,14,false,true,true,0.779,0.221
282,170,112,28.2,18.888889,112,769,527,242,1,0,0.1,0,23,10,9,1.565217,1,0,10,12,false,true,true,1,0
358,175,183,17.9,9.210526,183,1176,1076,100,0,0,0,0,15,20,19,3.933333,0,0,10,14,false,true,true,1,0
225,132,93,25,14.666667,93,1439,1413,26,0,0,0,0,45,9,9,0.8,1,0,14,10,false,true,true,0.996,0.004
320,233,87,20,14.5625,87,831,830,1,0,0,0,0,-5,16,16,-7.4,0,0,14,10,false,true,true,1,0
278,271,7,30.888889,30.111111,7,1333,1331,2,1,0,0.111111,0,20,9,9,1.5,0,0,14,8,false,true,true,0.72,0.28
314,239,75,17.444444,14.058824,75,620,513,107,0,0,0,0,-6,18,17,-7.5,0,0,15,6,false,true,true,0.996,0.004
378,286,92,16.434783,13,92,719,651,68,0,1,0,0.045455,-31,23,22,-1.451613,0,0,1,1,true,true,true,1,0
66,65,1,16.5,21.666667,1,1011,921,90,0,0,0,0,75,4,3,0.653333,0,0,12,15,false,true,false,0.245,0.755
251,251,0,16.733333,16.733333,0,613,549,64,0,0,0,0,2,15,15,22,1,0,13,7,false,true,true,0.901,0.099
375,367,8,28.846154,30.583333,8,1489,1558,-69,0,1,0,0.083333,-2,13,12,-14,0,0,6,14,false,true,true,0.986,0.014
121,114,7,12.1,12.666667,7,539,632,-93,0,0,0,0,45,10,9,1.022222,0,1,18,13,false,true,false,0.189,0.811
272,232,40,27.2,23.2,40,416,282,134,1,0,0.1,0,28,10,10,1.214286,0,0,11,11,false,true,true,0.827,0.173
278,278,0,14.631579,14.631579,0,540,518,22,0,0,0,0,-23,19,19,-1.73913,0,0,1,1,false,true,true,0.792,0.208
448,226,222,29.866667,16.142857,222,918,619,299,2,0,0.133333,0,-3,15,14,-11.666667,0,0,9,9,false,true,true,1,0
368,364,4,21.647059,21.411765,4,992,1100,-108,2,0,0.117647,0,-15,17,17,-2.266667,0,0,1,1,true,true,true,0.829,0.171
12,0,12,12,0,12,1011,921,90,0,0,0,0,97,1,0,0.505155,0,0,9,0,false,true,true,0.501,0.499
138,105,33,19.714286,17.5,33,363,668,-305,0,0,0,0,65,7,6,0.661538,0,0,7,11,false,true,true,0.544,0.456
262,279,-17,20.153846,21.461538,-17,771,754,17,0,0,0,0,8,13,13,4,0,0,12,7,false,true,true,0.577,0.423
350,179,171,16.666667,8.52381,171,859,719,140,0,1,0,0.047619,-29,21,21,-1.827586,0,1,17,9,false,true,true,1,0
103,109,-6,14.714286,15.571429,-6,908,859,49,0,0,0,0,53,7,7,0.735849,1,0,11,15,false,true,false,0.498,0.502
267,185,82,33.375,23.125,82,1148,1164,-16,1,1,0.125,0.125,28,8,8,0.892857,0,0,9,7,false,true,true,0.995,0.005
101,117,-16,16.833333,19.5,-16,1482,1394,88,0,0,0,0,62,6,6,0.580645,1,0,12,16,false,true,true,0.702,0.298
210,191,19,21,21.222222,19,1304,1040,264,1,0,0.1,0,34,10,9,0.970588,0,0,21,17,false,true,true,0.727,0.273
205,160,45,22.777778,20,45,1210,1253,-43,0,1,0,0.125,36,9,8,0.972222,0,0,9,14,false,true,true,0.807,0.193
162,141,21,14.727273,12.818182,21,218,86,132,0,0,0,0,21,11,11,1.904762,0,0,26,11,false,true,true,0.818,0.182
35,38,-3,11.666667,19,-3,491,398,93,0,0,0,0,84,3,2,0.428571,0,1,15,16,false,true,false,0.209,0.791
190,153,37,19,15.3,37,954,1078,-124,0,1,0,0.1,32,10,10,1.1875,1,0,12,15,false,true,true,0.962,0.038
177,79,98,35.4,19.75,98,1826,1803,23,1,0,0.2,0,62,5,4,0.483871,1,0,15,14,false,true,true,0.975,0.025
223,217,6,24.777778,24.111111,6,1004,840,164,1,0,0.111111,0,27,9,9,1.111111,1,0,8,13,false,true,false,0.408,0.592
57,46,11,19,15.333333,11,1266,1247,19,0,0,0,0,80,3,3,0.4,0,0,8,9,false,true,false,0.487,0.513
175,154,21,19.444444,19.25,21,349,315,34,0,0,0,0,29,9,8,1.172414,0,0,10,9,false,true,true,0.727,0.273
284,291,-7,21.846154,22.384615,-7,1431,802,629,0,0,0,0,0,13,13,0,0,0,11,8,false,true,true,0.996,0.004
308,260,48,30.8,26,48,1428,1452,-24,1,1,0.1,0.1,23,10,10,1.347826,0,1,11,8,false,true,true,0.843,0.157
136,121,15,22.666667,20.166667,15,1297,1606,-309,0,0,0,0,58,6,6,0.517241,2,0,5,25,false,true,true,0.684,0.316
319,252,67,24.538462,21,67,834,758,76,0,1,0,0.083333,8,13,12,4.5,0,0,9,16,false,true,true,0.999,0.001
371,269,102,24.733333,17.933333,102,1305,1390,-85,0,1,0,0.066667,-9,15,15,-4,0,2,10,10,false,true,true,0.998,0.002
280,261,19,16.470588,15.352941,19,719,614,105,0,1,0,0.058824,-12,17,17,-3.583333,0,0,10,9,false,true,true,0.921,0.079
238,168,70,15.866667,11.2,70,1428,1302,126,0,0,0,0,9,15,15,5.888889,0,1,13,15,false,true,true,0.94,0.06
134,147,-13,26.8,29.4,-13,791,885,-94,1,1,0.2,0.2,60,5,5,0.633333,0,0,24,9,false,true,true,0.726,0.274
61,61,0,20.333333,20.333333,0,613,549,64,0,0,0,0,74,3,3,0.594595,0,0,13,11,false,true,false,0.366,0.634
239,234,5,26.555556,26,5,1554,1716,-162,1,1,0.111111,0.111111,28,9,9,1.25,0,0,12,15,false,true,true,0.705,0.295
73,46,27,18.25,15.333333,27,1266,1247,19,0,0,0,0,76,4,3,0.421053,0,0,11,9,false,true,false,0.491,0.509
258,143,115,25.8,14.3,115,1691,1692,-1,0,0,0,0,30,10,10,1,0,0,16,15,false,true,true,0.998,0.002
337,311,26,21.0625,20.733333,26,1344,1209,135,1,1,0.0625,0.066667,-15,16,15,-2.266667,0,0,3,3,false,true,true,0.836,0.164
77,78,-1,19.25,26,-1,1731,1691,40,0,0,0,0,73,4,3,0.465753,0,0,28,9,false,true,false,0.442,0.558
215,205,10,15.357143,15.769231,10,1583,1422,161,0,0,0,0,31,14,13,1.645161,2,0,8,20,false,true,true,0.894,0.106
311,275,36,19.4375,18.333333,36,1176,1127,49,0,0,0,0,-4,16,15,-9.25,0,0,7,7,false,true,true,0.892,0.108
22,25,-3,11,12.5,-3,856,897,-41,0,0,0,0,84,2,2,0.416667,1,0,14,7,false,true,true,0.521,0.479
61,34,27,15.25,11.333333,27,808,812,-4,0,0,0,0,74,4,3,0.5,0,1,11,7,false,true,false,0.455,0.545
38,26,12,19,13,12,1181,1069,112,0,0,0,0,84,2,2,0.440476,1,0,11,16,false,true,true,0.808,0.192
64,29,35,21.333333,14.5,35,971,658,313,0,0,0,0,82,3,2,0.439024,0,0,11,12,false,true,true,0.783,0.217
315,192,123,22.5,13.714286,123,303,342,-39,0,0,0,0,12,14,14,3.166667,0,1,7,8,false,true,true,1,0
18,20,-2,9,20,-2,831,830,1,0,0,0,0,90,2,1,0.411111,0,0,10,17,false,true,false,0.142,0.858
120,53,67,20,10.6,67,1067,95,972,0,0,0,0,68,6,5,0.5,0,0,15,7,false,true,true,1,0
333,195,138,19.588235,11.470588,138,872,818,54,0,1,0,0.058824,3,17,17,13.666667,0,0,15,10,false,true,true,1,0
293,249,44,17.235294,15.5625,44,609,620,-11,0,0,0,0,-12,17,16,-3.083333,0,1,7,6,false,true,true,0.999,0.001
108,149,-41,13.5,21.285714,-41,262,306,-44,0,0,0,0,60,8,7,0.766667,0,0,20,10,false,true,false,0.113,0.887
208,247,-39,26,35.285714,-39,1636,1576,60,0,2,0,0.285714,34,8,7,1,0,0,10,18,false,true,false,0.013,0.987
174,176,-2,17.4,17.6,-2,695,523,172,0,0,0,0,24,10,10,1.541667,0,0,12,20,false,true,true,0.722,0.278
0,0,0,0,0,0,1270,1348,-78,0,0,0,0,100,1,0,0.38,0,0,13,0,false,true,false,0.248,0.752
131,137,-6,21.833333,22.833333,-6,1302,1234,68,0,0,0,0,55,6,6,0.563636,1,0,10,8,false,true,true,0.783,0.217
147,145,2,16.333333,16.111111,2,272,288,-16,0,0,0,0,50,9,9,1.04,0,0,18,13,false,true,true,0.718,0.282
297,247,50,22.846154,19,50,1065,1030,35,0,1,0,0.076923,6,13,13,5.666667,1,0,9,7,false,true,true,0.985,0.015
270,264,6,16.875,16.5,6,908,859,49,0,0,0,0,-1,16,16,-39,0,0,12,10,false,true,true,0.551,0.449
342,257,85,20.117647,15.117647,85,831,830,1,0,0,0,0,-9,17,17,-4.111111,0,0,9,6,false,true,true,1,0
378,344,34,21,20.235294,34,856,897,-41,0,1,0,0.058824,-24,18,17,-1.458333,0,0,3,1,true,true,true,0.998,0.002
91,62,29,11.375,8.857143,29,310,359,-49,0,0,0,0,48,8,7,1.020833,2,0,5,21,false,true,true,0.883,0.117
41,76,-35,20.5,76,-35,316,306,10,0,1,0,1,86,2,1,0.44186,0,0,10,11,false,true,false,0.13,0.87
254,86,168,21.166667,7.818182,168,896,818,78,0,0,0,0,36,12,11,1.222222,0,0,7,11,false,true,true,1,0
273,232,41,18.2,16.571429,41,885,719,166,0,0,0,0,4,15,14,9.5,0,0,9,12,false,true,true,0.889,0.111
352,275,77,20.705882,17.1875,77,1364,1093,271,0,1,0,0.0625,-6,17,16,-6.333333,0,0,7,9,false,true,true,1,0
12,0,12,12,0,12,1782,1512,270,0,0,0,0,96,1,0,0.4375,1,0,8,0,false,true,true,0.992,0.008
14,15,-1,14,15,-1,448,598,-150,0,0,0,0,93,1,1,0.387097,0,0,13,9,false,true,false,0.474,0.526
185,84,101,30.833333,14,101,1295,1477,-182,2,0,0.333333,0,59,6,6,0.779661,0,0,13,7,false,true,true,0.982,0.018
179,177,2,19.888889,19.666667,2,1547,1439,108,1,0,0.111111,0,40,9,9,0.925,0,0,17,7,false,true,true,0.586,0.414
140,114,26,20,19,26,847,952,-105,0,0,0,0,62,7,6,0.580645,0,0,10,18,false,true,false,0.351,0.649
63,43,20,15.75,14.333333,20,416,222,194,0,0,0,0,74,4,3,0.743243,1,1,10,10,false,true,true,0.563,0.437
129,226,-97,18.428571,37.666667,-97,1762,1538,224,0,2,0,0.333333,47,7,6,0.723404,1,0,9,14,false,true,true,0.894,0.106
308,269,39,14,12.227273,39,613,502,111,0,0,0,0,-28,22,22,-1.75,0,0,4,15,false,true,true,0.997,0.003
317,273,44,16.684211,14.368421,44,1221,1438,-217,0,0,0,0,-4,19,19,-11.25,0,1,15,7,false,true,true,0.766,0.234
280,191,89,18.666667,12.733333,89,1253,1166,87,1,0,0.066667,0,10,15,15,4.3,0,0,12,17,false,true,true,0.998,0.002
279,294,-15,25.363636,29.4,-15,1762,1538,224,1,2,0.090909,0.2,22,11,10,1.545455,0,0,21,20,false,true,true,0.966,0.034
119,63,56,29.75,15.75,56,769,527,242,1,0,0.25,0,63,4,4,0.571429,0,0,29,9,false,true,true,0.925,0.075
165,95,70,23.571429,13.571429,70,871,867,4,0,0,0,0,53,7,7,0.811321,0,0,7,11,false,true,true,0.933,0.067
357,225,132,23.8,15,132,1482,1554,-72,1,0,0.066667,0,-1,15,15,-36,0,0,16,7,false,true,true,1,0
357,287,70,18.789474,15.105263,70,1045,1009,36,1,0,0.052632,0,-17,19,19,-2.235294,0,0,2,3,true,true,true,1,0
145,173,-28,20.714286,24.714286,-28,1554,1622,-68,1,0,0.142857,0,45,7,7,0.688889,0,0,14,12,false,true,false,0.123,0.877
364,281,83,21.411765,16.529412,83,613,569,44,0,0,0,0,-14,17,17,-2.785714,0,0,2,2,false,true,true,1,0
212,221,-9,30.285714,31.571429,-9,1265,1237,28,1,0,0.142857,0,34,7,7,0.882353,0,0,12,19,false,true,false,0.378,0.622
8,13,-5,8,13,-5,1096,1009,87,0,0,0,0,96,1,1,0.458333,1,0,29,13,false,true,true,0.851,0.149
179,155,24,25.571429,22.142857,24,1493,1513,-20,1,0,0.142857,0,52,7,7,0.634615,0,1,17,16,false,true,false,0.372,0.628
16,11,5,8,11,5,1281,1339,-58,0,0,0,0,90,2,1,0.455556,0,0,18,11,false,true,false,0.292,0.708
175,125,50,25,17.857143,50,1334,1256,78,1,0,0.142857,0,50,7,7,0.62,0,0,13,8,false,true,true,0.898,0.102
18,31,-13,9,15.5,-13,1156,1114,42,0,0,0,0,82,2,2,0.390244,1,0,6,7,false,true,false,0.469,0.531
237,246,-9,19.75,20.5,-9,869,820,49,0,1,0,0.083333,19,12,12,1.947368,0,1,12,7,false,true,false,0.16,0.84
277,175,102,19.785714,13.461538,102,1295,1477,-182,2,0,0.142857,0,20,14,13,2.3,0,0,16,14,false,true,true,0.99,0.01
158,163,-5,22.571429,23.285714,-5,290,416,-126,0,0,0,0,51,7,7,0.666667,0,0,10,19,false,true,true,0.681,0.319
357,258,99,19.833333,14.333333,99,746,796,-50,0,1,0,0.055556,-10,18,18,-4.8,0,0,5,7,false,true,true,1,0
344,262,82,21.5,17.466667,82,1364,1093,271,0,1,0,0.066667,-1,16,15,-38,0,0,10,13,false,true,true,1,0
170,120,50,28.333333,20,50,630,786,-156,1,0,0.166667,0,53,6,6,0.660377,0,0,23,16,false,true,true,0.74,0.26
300,217,83,21.428571,15.5,83,620,658,-38,0,0,0,0,6,14,14,6,0,0,14,9,false,true,true,0.999,0.001
103,96,7,17.166667,19.2,7,808,639,169,0,0,0,0,56,6,5,0.732143,0,0,25,9,false,true,false,0.448,0.552
352,294,58,22,19.6,58,1089,1063,26,1,0,0.0625,0,-7,16,15,-5.428571,0,0,5,7,false,true,true,0.999,0.001
197,214,-17,19.7,21.4,-17,942,976,-34,0,0,0,0,29,10,10,1.37931,0,0,14,7,false,true,false,0.223,0.777
39,76,-37,19.5,76,-37,315,294,21,0,1,0,1,85,2,1,0.411765,0,0,10,23,false,true,false,0.039,0.961
38,24,14,12.666667,12,14,1110,1039,71,0,0,0,0,85,3,2,0.423529,1,0,22,10,false,true,true,0.654,0.346
296,286,10,21.142857,22,10,1513,1479,34,0,0,0,0,8,14,13,4.25,1,0,13,8,false,true,true,0.59,0.41
301,265,36,23.153846,20.384615,36,758,796,-38,0,0,0,0,12,13,13,3.166667,0,0,9,8,false,true,true,0.804,0.196
28,4,24,14,4,24,1033,1037,-4,0,0,0,0,87,2,1,0.517241,0,0,10,7,false,true,true,0.5,0.5
129,102,27,18.428571,14.571429,27,777,830,-53,0,0,0,0,54,7,7,0.759259,0,0,14,10,false,true,true,0.869,0.131
46,14,32,23,14,32,1513,1482,31,0,0,0,0,85,2,1,0.388235,1,0,9,28,false,true,true,0.855,0.145
224,174,50,28,21.75,50,1023,1070,-47,1,0,0.125,0,39,8,8,0.820513,1,0,13,20,false,true,true,0.986,0.014
341,213,128,21.3125,14.2,128,777,830,-53,1,0,0.0625,0,1,16,15,41,0,0,16,10,false,true,true,0.999,0.001
263,180,83,17.533333,12,83,1586,1782,-196,0,0,0,0,7,15,15,5.714286,1,0,9,10,false,true,true,0.984,0.016
321,144,177,35.666667,16,177,1054,917,137,2,0,0.222222,0,23,9,9,1.521739,0,0,15,12,false,true,true,1,0
12,0,12,12,0,12,948,933,15,0,0,0,0,95,1,0,0.4,1,0,16,0,false,true,true,0.541,0.459
84,73,11,16.8,18.25,11,725,771,-46,0,1,0,0.25,64,5,4,0.71875,0,1,19,17,false,true,false,0.449,0.551
32,12,20,16,12,20,808,812,-4,0,0,0,0,89,2,1,0.41573,0,1,10,6,false,true,false,0.415,0.585
385,327,58,25.666667,21.8,58,1554,1573,-19,1,0,0.066667,0,0,15,15,0,1,1,8,8,false,true,true,0.994,0.006
373,276,97,24.866667,19.714286,97,1394,1118,276,0,1,0,0.071429,0,15,14,0,0,0,17,5,false,true,true,1,0
262,94,168,18.714286,7.230769,168,859,719,140,0,1,0,0.076923,12,14,13,4.416667,0,1,12,13,false,true,true,1,0
342,278,64,18,14.631579,64,1253,1166,87,1,0,0.052632,0,-13,19,19,-3.307692,0,0,5,7,false,true,true,1,0
142,149,-7,23.666667,24.833333,-7,518,448,70,0,0,0,0,58,6,6,0.586207,0,0,13,8,false,true,true,0.715,0.285
157,110,47,31.4,27.5,47,1762,1582,180,1,1,0.2,0.25,64,5,4,0.5,0,0,21,12,false,true,true,0.702,0.298
180,124,56,36,31,56,416,282,134,1,0,0.2,0,66,5,4,0.515152,0,0,13,12,false,true,true,0.732,0.268
164,181,-17,16.4,18.1,-17,500,567,-67,0,0,0,0,39,10,10,1.128205,0,0,12,22,false,true,false,0.431,0.569
336,211,125,16,10.55,125,1069,1040,29,0,0,0,0,-31,21,20,-1.419355,0,0,1,1,false,true,true,1,0
199,106,93,28.428571,15.142857,93,1803,1552,251,1,0,0.142857,0,50,7,7,0.56,1,1,12,6,false,true,true,0.518,0.482
362,301,61,24.133333,21.5,61,1210,1253,-43,0,1,0,0.071429,-16,15,14,-2.125,0,0,3,13,false,true,true,0.999,0.001
420,291,129,26.25,19.4,129,1101,1078,23,1,0,0.0625,0,-12,16,15,-2.75,0,1,1,1,false,true,true,1,0
8,0,8,8,0,8,1394,1230,164,0,0,0,0,96,1,0,0.395833,0,0,13,0,false,true,true,0.502,0.498
20,0,20,20,0,20,1428,1302,126,0,0,0,0,95,1,0,0.557895,0,0,15,0,false,true,true,0.523,0.477
256,229,27,15.058824,13.470588,27,871,999,-128,0,0,0,0,1,17,17,48,0,0,10,11,false,true,true,0.903,0.097
333,315,18,23.785714,24.230769,18,1305,1242,63,2,1,0.142857,0.076923,2,14,13,17,0,0,14,8,false,true,true,0.659,0.341
40,13,27,20,13,27,1439,1397,42,0,0,0,0,91,2,1,0.373626,0,0,17,12,false,true,true,0.515,0.485
10,0,10,10,0,10,918,619,299,0,0,0,0,97,1,0,0.360825,0,0,7,0,false,true,true,0.531,0.469
271,239,32,20.846154,19.916667,32,1530,1550,-20,0,1,0,0.083333,9,13,12,3.777778,1,0,8,12,false,true,true,0.87,0.13
442,416,26,29.466667,29.714286,26,1897,1793,104,2,3,0.133333,0.214286,-1,15,14,-32,0,0,2,3,false,true,true,0.995,0.005
322,263,59,11.925926,9.740741,59,416,222,194,0,0,0,0,-44,27,27,-1.25,0,0,7,2,false,true,true,0.999,0.001
153,82,71,17,9.111111,71,859,719,140,0,1,0,0.111111,35,9,9,1.514286,0,2,19,13,false,true,true,0.906,0.094
101,68,33,20.2,13.6,33,791,774,17,1,0,0.2,0,73,5,5,0.561644,0,0,12,16,false,true,true,0.822,0.178
150,93,57,21.428571,13.285714,57,613,502,111,0,0,0,0,51,7,7,0.960784,0,0,7,19,false,true,true,0.885,0.115
55,32,23,13.75,10.666667,23,580,620,-40,0,0,0,0,76,4,3,0.565789,1,0,20,19,false,true,true,0.536,0.464
40,33,7,13.333333,16.5,7,1037,950,87,0,0,0,0,83,3,2,0.373494,1,0,8,10,false,true,true,0.508,0.492
298,280,18,22.923077,21.538462,18,1388,1506,-118,2,1,0.153846,0.076923,14,13,13,2.428571,0,0,11,17,false,true,true,0.906,0.094
287,247,40,16.882353,15.4375,40,904,857,47,0,0,0,0,-4,17,16,-10.25,0,0,20,9,false,true,true,0.919,0.081
210,158,52,19.090909,14.363636,52,1281,1339,-58,0,0,0,0,38,11,11,1.078947,0,0,13,7,false,true,true,0.923,0.077
253,213,40,18.071429,16.384615,40,609,620,-11,0,0,0,0,8,14,13,4.625,0,0,8,12,false,true,true,0.785,0.215
236,168,68,21.454545,16.8,68,808,639,169,0,0,0,0,26,11,10,1.576923,0,0,19,14,false,true,true,0.937,0.063
149,160,-11,16.555556,17.777778,-11,725,771,-46,0,1,0,0.111111,41,9,9,1.121951,1,0,9,19,false,true,false,0.377,0.623
262,204,58,21.833333,18.545455,58,691,675,16,0,0,0,0,21,12,11,1.761905,0,1,25,9,false,true,true,0.971,0.029
176,179,-3,19.555556,19.888889,-3,518,448,70,0,0,0,0,38,9,9,0.894737,0,0,12,9,false,true,true,0.727,0.273
432,332,100,36,27.666667,100,1824,1793,31,1,0,0.083333,0,0,12,12,0,0,0,10,11,false,true,true,1,0
44,14,30,22,14,30,871,999,-128,0,0,0,0,87,2,1,0.551724,0,0,10,23,false,true,false,0.263,0.737
165,106,59,33,21.2,59,1935,2020,-85,0,0,0,0,61,5,5,0.508197,1,0,7,11,false,true,true,0.867,0.133
273,247,26,21,19,26,838,786,52,0,1,0,0.076923,12,13,13,2.666667,0,0,10,10,false,true,true,0.934,0.066
140,112,28,28,22.4,28,1170,1156,14,1,0,0.2,0,66,5,5,0.575758,0,0,10,16,false,true,true,0.639,0.361
107,167,-60,21.4,33.4,-60,1431,825,606,0,1,0,0.2,55,5,5,0.618182,1,0,12,15,false,true,true,0.967,0.033
339,294,45,21.1875,19.6,45,795,830,-35,1,1,0.0625,0.066667,-5,16,15,-8.4,0,0,11,13,false,true,true,0.998,0.002
296,253,43,17.411765,15.8125,43,739,480,259,1,0,0.058824,0,-7,17,16,-5.142857,0,2,11,9,false,true,false,0.057,0.943
90,14,76,22.5,4.666667,76,1033,1037,-4,0,0,0,0,76,4,3,0.592105,0,0,13,7,false,true,true,0.91,0.09
261,215,46,26.1,21.5,46,834,758,76,0,1,0,0.1,23,10,10,1.565217,0,0,7,12,false,true,true,0.932,0.068
47,99,-52,11.75,24.75,-52,1897,1793,104,0,1,0,0.25,79,4,4,0.405063,0,0,8,19,false,true,false,0.317,0.683
289,241,48,19.266667,16.066667,48,1040,925,115,0,0,0,0,-5,15,15,-8.6,1,0,7,14,false,true,true,0.999,0.001
85,59,26,21.25,19.666667,26,784,758,26,0,0,0,0,75,4,3,0.466667,0,0,11,10,false,true,true,0.578,0.422
246,251,-5,17.571429,19.307692,-5,1077,1094,-17,0,0,0,0,15,14,13,2.8,0,1,13,6,false,true,false,0.135,0.865
205,76,129,41,19,129,1349,1302,47,0,0,0,0,62,5,4,0.467742,0,0,11,7,false,true,true,0.999,0.001
309,309,0,14.714286,14.714286,0,576,494,82,0,0,0,0,-25,21,21,-1.76,0,0,2,3,false,true,false,0.402,0.598
143,148,-5,28.6,29.6,-5,974,995,-21,0,1,0,0.2,59,5,5,0.559322,0,0,18,10,false,true,true,0.73,0.27
129,159,-30,18.428571,26.5,-30,1554,1573,-19,0,0,0,0,54,7,6,0.62963,0,0,17,11,false,true,false,0.106,0.894
107,101,6,17.833333,20.2,6,1142,1176,-34,0,0,0,0,59,6,5,0.610169,1,0,9,7,false,true,false,0.423,0.577
86,102,-16,14.333333,17,-16,721,689,32,0,0,0,0,49,6,6,0.693878,0,0,23,15,false,true,false,0.295,0.705
214,165,49,21.4,16.5,49,1516,1397,119,0,1,0,0.1,22,10,10,1.5,0,0,18,14,false,true,true,0.951,0.049
315,215,100,21,15.357143,100,539,500,39,0,0,0,0,-3,15,14,-13.333333,0,0,8,10,false,true,true,1,0
94,78,16,18.8,15.6,16,1266,1247,19,0,0,0,0,64,5,5,0.5,0,0,7,7,false,true,false,0.499,0.501
271,252,19,19.357143,19.384615,19,1782,1512,270,1,1,0.071429,0.076923,10,14,13,4.2,0,0,22,12,false,true,true,0.994,0.006
324,302,22,19.058824,18.875,22,901,889,12,0,1,0,0.0625,-5,17,16,-8.6,0,0,11,11,false,true,true,0.854,0.146
276,268,8,23,22.333333,8,795,830,-35,1,1,0.083333,0.083333,12,12,12,3.5,0,0,17,10,false,true,true,0.831,0.169
332,291,41,22.133333,20.785714,41,1302,1082,220,0,0,0,0,-16,15,14,-1.875,0,0,2,6,false,true,true,0.967,0.033
212,137,75,21.2,15.222222,75,739,480,259,1,0,0.1,0,37,10,9,0.972973,0,1,12,6,false,true,true,0.993,0.007
48,47,1,24,23.5,1,1305,1218,87,0,0,0,0,83,2,2,0.457831,0,0,11,10,false,true,true,0.513,0.487
338,309,29,16.095238,14.714286,29,1221,1438,-217,0,0,0,0,-16,21,21,-2.8125,0,0,4,1,false,true,true,0.992,0.008
371,296,75,28.538462,22.769231,75,1093,1100,-7,3,3,0.230769,0.230769,3,13,13,10.666667,0,1,14,7,false,true,true,0.74,0.26
123,109,14,20.5,21.8,14,1516,1397,119,0,1,0,0.2,58,6,5,0.568966,0,0,16,14,false,true,false,0.439,0.561
211,153,58,17.583333,13.909091,58,363,668,-305,0,0,0,0,30,12,11,1.433333,0,0,7,14,false,true,true,0.716,0.284
103,58,45,25.75,19.333333,45,306,169,137,0,0,0,0,73,4,3,0.465753,0,0,11,12,false,true,true,0.826,0.174
325,315,10,17.105263,17.5,10,1388,1477,-89,1,0,0.052632,0,-12,19,18,-4,1,0,4,13,false,true,true,0.923,0.077
187,181,6,20.777778,20.111111,6,1040,925,115,0,0,0,0,31,9,9,1.387097,0,0,15,10,false,true,true,0.668,0.332
8,0,8,8,0,8,699,448,251,0,0,0,0,98,1,0,0.408163,0,0,20,0,false,true,true,0.528,0.472
399,319,80,15.96,13.291667,80,1583,1422,161,1,0,0.04,0,-18,25,24,-2.833333,0,0,2,7,false,true,true,0.993,0.007
291,256,35,24.25,23.272727,35,1355,1210,145,1,0,0.083333,0,20,12,11,1.5,1,0,9,15,false,true,true,0.972,0.028
330,207,123,23.571429,15.923077,123,526,370,156,0,0,0,0,1,14,13,35,0,0,16,16,false,true,true,1,0
203,178,25,29,29.666667,25,1096,1009,87,1,0,0.142857,0,62,7,6,0.709677,0,0,11,13,false,true,true,0.73,0.27
224,255,-31,24.888889,28.333333,-31,1636,1576,60,0,2,0,0.222222,28,9,9,1.214286,0,0,10,9,false,true,false,0.183,0.817
429,385,44,25.235294,22.647059,44,1030,1144,-114,0,2,0,0.117647,-18,17,17,-1.944444,1,0,1,1,false,true,true,1,0
331,309,22,17.421053,17.166667,22,758,952,-194,0,0,0,0,-24,19,18,-1.666667,0,0,1,1,false,true,true,0.987,0.013
324,292,32,18,16.222222,32,1176,1127,49,0,0,0,0,-20,18,18,-1.85,0,0,1,1,false,true,true,0.998,0.002
228,219,9,20.727273,19.909091,9,901,889,12,0,1,0,0.090909,29,11,11,1.482759,0,0,16,11,false,true,true,0.768,0.232
136,96,40,22.666667,16,40,830,907,-77,1,0,0.166667,0,57,6,6,0.684211,0,0,16,14,false,true,true,0.835,0.165
192,140,52,19.2,15.555556,52,791,774,17,1,0,0.1,0,47,10,9,0.87234,0,0,9,20,false,true,true,0.837,0.163
360,227,133,32.727273,22.7,133,1396,1454,-58,2,0,0.181818,0,20,11,10,1.65,0,0,7,11,false,true,true,1,0
60,76,-16,20,38,-16,315,294,21,0,1,0,0.5,79,3,2,0.443038,1,0,8,26,false,true,false,0.303,0.697
150,93,57,18.75,13.285714,57,613,502,111,0,0,0,0,51,8,7,0.960784,0,0,12,19,false,true,true,0.812,0.188
346,314,32,18.210526,17.444444,32,1181,1149,32,0,1,0,0.055556,-9,19,18,-5,0,0,12,8,false,true,true,0.821,0.179
140,98,42,17.5,14,42,913,871,42,0,0,0,0,50,8,7,0.86,0,0,9,17,false,true,true,0.795,0.205
250,159,91,22.727273,15.9,91,526,370,156,0,0,0,0,23,11,10,1.521739,1,0,8,9,false,true,true,0.997,0.003
42,9,33,21,9,33,1075,1009,66,0,0,0,0,90,2,1,0.355556,1,0,13,14,false,true,true,0.819,0.181
162,151,11,16.2,15.1,11,859,822,37,0,0,0,0,31,10,10,1.225806,0,0,19,14,false,true,true,0.726,0.274
319,231,88,21.266667,16.5,88,691,473,218,0,0,0,0,-3,15,14,-12,1,1,7,13,false,true,true,0.999,0.001
67,142,-75,16.75,35.5,-75,1762,1538,224,0,1,0,0.25,68,4,4,0.5,0,0,10,8,false,true,true,0.624,0.376
203,151,52,20.3,16.777778,52,831,830,1,0,0,0,0,36,10,9,1.027778,1,0,20,9,false,true,true,0.927,0.073
322,272,50,16.947368,15.111111,50,1077,1094,-17,0,0,0,0,-10,19,18,-4.2,1,1,6,7,false,true,true,0.961,0.039
334,277,57,30.363636,27.7,57,1333,1331,2,1,0,0.090909,0,7,11,10,4.285714,0,0,11,10,false,true,true,0.991,0.009
184,220,-36,23,27.5,-36,1434,1493,-59,1,0,0.125,0,35,8,8,1.057143,1,1,9,6,false,true,false,0.25,0.75
311,265,46,22.214286,20.384615,46,758,796,-38,0,0,0,0,7,14,13,5.428571,0,0,7,8,false,true,true,0.918,0.082
381,262,119,25.4,18.714286,119,1069,917,152,1,1,0.066667,0.071429,-3,15,14,-11.333333,0,0,6,9,false,true,true,1,0
39,17,22,19.5,17,22,1048,1000,48,0,0,0,0,90,2,1,0.444444,0,0,17,13,false,true,true,0.513,0.487
244,187,57,22.181818,18.7,57,784,758,26,0,0,0,0,22,11,10,1.590909,0,0,10,9,false,true,true,0.878,0.122
81,71,10,16.2,14.2,10,847,952,-105,0,0,0,0,72,5,5,0.5,0,0,16,25,false,true,false,0.285,0.715
274,161,113,21.076923,12.384615,113,786,757,29,1,0,0.076923,0,16,13,13,2.4375,0,0,11,16,false,true,true,1,0
393,310,83,26.2,20.666667,83,1428,1606,-178,1,0,0.066667,0,-12,15,15,-2.666667,0,0,2,1,false,true,true,1,0
222,157,65,22.2,17.444444,65,518,533,-15,1,0,0.1,0,30,10,9,1.166667,1,0,14,7,false,true,true,0.981,0.019
354,290,64,19.666667,16.111111,64,791,774,17,1,0,0.055556,0,-10,18,18,-4.1,0,0,4,3,false,true,true,1,0
225,159,66,20.454545,14.454545,66,1091,1078,13,0,0,0,0,38,11,11,1.131579,0,0,12,8,false,true,true,0.975,0.025
152,179,-27,16.888889,22.375,-27,999,1011,-12,0,0,0,0,41,9,8,1.121951,0,0,15,11,false,true,false,0.107,0.893
267,250,17,24.272727,22.727273,17,1244,1361,-117,2,1,0.181818,0.090909,29,11,11,1.310345,0,0,16,12,false,true,true,0.907,0.093
307,257,50,17.055556,15.117647,50,609,620,-11,0,0,0,0,-18,18,17,-2.055556,0,1,2,2,false,true,true,1,0
265,205,60,17.666667,14.642857,60,523,480,43,1,0,0.066667,0,-7,15,14,-4.714286,0,0,8,18,false,true,true,0.999,0.001
321,295,26,21.4,19.666667,26,315,294,21,0,1,0,0.066667,-17,15,15,-2.058824,0,0,10,3,false,true,true,0.988,0.012
172,119,53,24.571429,19.833333,53,1548,1493,55,1,0,0.142857,0,50,7,6,0.82,0,0,14,19,false,true,true,0.697,0.303
22,18,4,22,18,4,1735,1770,-35,0,0,0,0,89,1,1,0.314607,0,0,11,11,false,true,false,0.407,0.593
18,19,-1,18,19,-1,820,822,-2,0,0,0,0,91,1,1,0.428571,0,0,24,17,false,true,false,0.296,0.704
69,52,17,17.25,17.333333,17,361,493,-132,0,0,0,0,72,4,3,0.569444,0,1,14,7,false,true,false,0.232,0.768
274,210,64,22.833333,19.090909,64,1075,1152,-77,0,1,0,0.090909,19,12,11,2.105263,0,0,11,11,false,true,true,0.966,0.034
495,271,224,27.5,15.941176,224,1054,917,137,2,0,0.111111,0,-34,18,17,-1.029412,0,0,15,6,true,true,true,1,0
302,185,117,37.75,23.125,117,1489,1405,84,2,0,0.25,0,40,8,8,0.7,0,0,12,7,false,true,true,0.999,0.001
112,38,74,37.333333,19,74,1302,1349,-47,0,0,0,0,77,3,2,0.363636,0,0,15,8,false,true,true,0.878,0.122
40,13,27,40,13,27,742,696,46,0,0,0,0,90,1,1,0.355556,0,1,20,9,false,true,true,0.942,0.058
47,31,16,15.666667,15.5,16,725,771,-46,0,0,0,0,81,3,2,0.567901,0,1,20,13,false,true,false,0.468,0.532
206,131,75,29.428571,18.714286,75,880,952,-72,0,0,0,0,51,7,7,0.686275,0,0,14,18,false,true,true,0.871,0.129
325,296,29,15.47619,14.095238,29,480,518,-38,0,0,0,0,-24,21,21,-1.916667,0,0,2,4,false,true,true,0.998,0.002
8,0,8,8,0,8,1281,1339,-58,0,0,0,0,96,1,0,0.427083,0,0,16,0,false,true,false,0.335,0.665
376,303,73,22.117647,18.9375,73,416,282,134,1,0,0.058824,0,-18,17,16,-1.888889,0,0,3,4,false,true,true,1,0
69,62,7,13.8,12.4,7,1128,889,239,0,1,0,0.2,66,5,5,0.712121,1,0,12,7,false,true,true,0.806,0.194
98,112,-14,16.333333,18.666667,-14,831,830,1,0,0,0,0,62,6,6,0.596774,1,0,21,9,false,true,true,0.522,0.478
462,246,216,28.875,16.4,216,918,619,299,2,0,0.125,0,-11,16,15,-3.181818,0,0,6,3,false,true,true,1,0
98,77,21,32.666667,25.666667,21,866,949,-83,0,0,0,0,77,3,3,0.519481,0,1,9,6,false,true,true,0.6,0.4
24,46,-22,12,23,-22,1159,1051,108,0,0,0,0,85,2,2,0.470588,0,0,17,17,false,true,false,0.257,0.743
189,126,63,21,14,63,939,913,26,0,0,0,0,43,9,9,0.930233,0,1,8,10,false,true,true,0.992,0.008
105,101,4,21,20.2,4,1167,1216,-49,0,0,0,0,68,5,5,0.602941,1,0,10,22,false,true,true,0.739,0.261
296,238,58,21.142857,18.307692,58,971,658,313,0,0,0,0,4,14,13,9,0,0,11,9,false,true,true,0.914,0.086
44,0,44,44,0,44,1270,1315,-45,0,0,0,0,95,1,0,0.378947,0,0,14,0,false,true,true,0.783,0.217
41,28,13,20.5,14,13,880,952,-72,0,0,0,0,84,2,2,0.488095,0,0,8,7,false,true,true,0.516,0.484
328,320,8,18.222222,18.823529,8,561,526,35,0,0,0,0,-27,18,17,-1.296296,0,0,3,9,true,true,true,0.961,0.039
168,149,19,18.666667,16.555556,19,613,461,152,0,0,0,0,33,9,9,1.121212,0,0,12,9,false,true,true,0.803,0.197
166,112,54,27.666667,22.4,54,1170,1156,14,1,0,0.166667,0,62,6,5,0.612903,0,0,18,16,false,true,true,0.754,0.246
18,22,-4,18,22,-4,1237,1277,-40,0,0,0,0,89,1,1,0.325843,0,0,9,7,false,true,false,0.457,0.543
110,116,-6,22,23.2,-6,902,866,36,0,0,0,0,59,5,5,0.542373,0,0,13,7,false,true,false,0.344,0.656
53,22,31,17.666667,11,31,527,514,13,0,0,0,0,85,3,2,0.458824,0,0,10,7,false,true,true,0.695,0.305
41,33,8,13.666667,11,8,1176,1076,100,0,0,0,0,85,3,3,0.694118,0,0,8,7,false,true,false,0.484,0.516
229,172,57,17.615385,14.333333,57,1164,1201,-37,0,0,0,0,20,13,12,2.1,0,1,18,13,false,true,true,0.74,0.26
172,106,66,24.571429,17.666667,66,901,1159,-258,2,0,0.285714,0,52,7,6,0.673077,0,0,12,19,false,true,true,0.83,0.17
314,267,47,24.153846,20.538462,47,1089,1063,26,1,0,0.076923,0,9,13,13,4.222222,0,0,8,12,false,true,true,0.985,0.015
281,201,80,25.545455,20.1,80,1394,1118,276,0,1,0,0.1,23,11,10,1.608696,0,0,11,13,false,true,true,0.898,0.102
85,106,-21,17,26.5,-21,1075,989,86,0,0,0,0,71,5,4,0.549296,0,0,27,11,false,true,false,0.255,0.745
363,208,155,33,20.8,155,971,621,350,2,0,0.181818,0,13,11,10,2.461538,1,0,16,8,false,true,true,1,0
135,182,-47,19.285714,26,-47,1125,1227,-102,0,0,0,0,42,7,7,0.714286,1,0,16,12,false,true,false,0.127,0.873
236,231,5,18.153846,17.769231,5,448,598,-150,0,0,0,0,7,13,13,5.142857,0,0,17,7,false,true,true,0.71,0.29
260,171,89,21.666667,14.25,89,1606,1544,62,0,0,0,0,34,12,12,1.323529,0,1,9,6,false,true,true,0.993,0.007
64,59,5,16,14.75,5,801,925,-124,1,0,0.25,0,69,4,4,0.507246,1,0,10,14,false,true,true,0.523,0.477
287,293,-6,16.882353,17.235294,-6,1164,1201,-37,0,0,0,0,-7,17,17,-6,0,0,18,7,false,true,false,0.449,0.551
92,97,-5,23,24.25,-5,1539,1537,2,0,0,0,0,76,4,4,0.421053,1,0,6,9,false,true,true,0.746,0.254
366,265,101,19.263158,13.947368,101,746,796,-50,0,1,0,0.052632,-15,19,19,-3.2,0,0,4,6,false,true,true,1,0
306,283,23,19.125,17.6875,23,921,1072,-151,1,0,0.0625,0,2,16,16,19,0,0,9,8,false,true,true,0.776,0.224
175,91,84,21.875,13,84,939,913,26,0,0,0,0,59,8,7,0.677966,0,0,7,7,false,true,true,0.968,0.032
293,249,44,20.928571,17.785714,44,904,783,121,0,0,0,0,15,14,14,2.8,0,0,13,8,false,true,true,0.962,0.038
285,269,16,13.571429,13.45,16,1029,1075,-46,0,0,0,0,-12,21,20,-4,1,0,5,8,false,true,true,0.749,0.251
186,119,67,18.6,13.222222,67,1011,921,90,0,0,0,0,40,10,9,1.225,0,0,10,19,false,true,true,0.931,0.069
245,172,73,24.5,19.111111,73,1051,1030,21,0,0,0,0,28,10,9,1.071429,0,0,10,7,false,true,true,0.917,0.083
308,285,23,14,12.954545,23,262,306,-44,1,0,0.045455,0,-38,22,22,-1.210526,0,0,1,4,false,true,true,0.977,0.023
343,176,167,17.15,9.263158,167,421,306,115,0,1,0,0.052632,-15,20,19,-2.933333,0,0,8,9,false,true,true,1,0
398,266,132,24.875,16.625,132,1221,1266,-45,1,0,0.0625,0,-17,16,16,-2.058824,0,0,14,5,false,true,true,1,0
174,194,-20,19.333333,21.555556,-20,1077,1094,-17,0,0,0,0,40,9,9,1.05,0,0,11,7,false,true,false,0.12,0.88
192,174,18,27.428571,29,18,791,885,-94,1,1,0.142857,0.166667,50,7,6,0.76,0,0,22,11,false,true,true,0.734,0.266
319,312,7,22.785714,24,7,1266,1144,122,0,0,0,0,2,14,13,17,1,0,7,18,false,true,true,0.509,0.491
156,163,-7,17.333333,18.111111,-7,1221,1258,-37,1,0,0.111111,0,42,9,9,0.928571,0,0,22,9,false,true,false,0.441,0.559
103,52,51,25.75,13,51,1022,1095,-73,0,0,0,0,75,4,4,0.44,1,0,21,8,false,true,true,0.935,0.065
318,263,55,17.666667,15.470588,55,1270,1315,-45,0,0,0,0,-16,18,17,-2.25,0,0,1,18,false,true,true,0.995,0.005
292,241,51,19.466667,17.214286,51,1045,1009,36,1,0,0.066667,0,4,15,14,9.5,1,0,15,16,false,true,true,0.982,0.018
296,212,84,24.666667,17.666667,84,1014,1303,-289,1,0,0.083333,0,14,12,12,2.714286,0,0,10,13,false,true,true,1,0
74,88,-14,18.5,22,-14,1482,1394,88,0,0,0,0,76,4,4,0.473684,1,0,6,20,false,true,true,0.696,0.304
256,226,30,23.272727,20.545455,30,1156,1184,-28,1,0,0.090909,0,19,11,11,1.473684,1,0,8,10,false,true,true,0.881,0.119
209,225,-16,19,22.5,-16,947,810,137,0,1,0,0.1,28,11,10,1.5,0,0,18,13,false,true,true,0.621,0.379
164,80,84,27.333333,13.333333,84,1586,1782,-196,0,0,0,0,55,6,6,0.727273,1,0,9,7,false,true,true,0.971,0.029
326,238,88,16.3,12.526316,88,913,871,42,0,0,0,0,-19,20,19,-2.263158,0,0,3,2,false,true,true,1,0
6,14,-8,6,14,-8,1297,1606,-309,0,0,0,0,92,1,1,0.326087,1,0,10,18,false,true,false,0.247,0.753
104,146,-42,13,18.25,-42,576,494,82,0,0,0,0,50,8,8,0.88,0,0,7,12,false,true,false,0.109,0.891
225,161,64,28.125,20.125,64,1216,1217,-1,1,0,0.125,0,39,8,8,0.871795,1,0,9,22,false,true,true,0.996,0.004
371,349,22,24.733333,23.266667,22,1144,1014,130,0,0,0,0,-5,15,15,-7.2,0,0,13,6,false,true,true,0.877,0.123
256,153,103,21.333333,12.75,103,1586,1782,-196,0,0,0,0,19,12,12,2.105263,1,0,9,14,false,true,true,0.999,0.001
169,107,62,21.125,13.375,62,1033,1037,-4,0,1,0,0.125,47,8,8,0.957447,0,0,20,12,false,true,true,0.98,0.02
391,262,129,19.55,13.1,129,1413,1422,-9,0,0,0,0,-16,20,20,-3.5625,0,0,7,7,false,true,true,1,0
316,211,105,16.631579,11.722222,105,1069,1040,29,0,0,0,0,-20,19,18,-2.2,0,0,3,1,false,true,true,1,0
24,0,24,24,0,24,808,639,169,0,0,0,0,95,1,0,0.431579,0,0,9,0,false,true,true,0.561,0.439
269,159,110,24.454545,14.454545,110,539,500,39,0,0,0,0,17,11,11,2.352941,0,0,10,10,false,true,true,1,0
252,156,96,22.909091,15.6,96,1065,1030,35,0,0,0,0,26,11,10,1.307692,1,0,9,7,false,true,true,0.988,0.012
334,337,-3,20.875,21.0625,-3,1100,1008,92,1,0,0.0625,0,-13,16,16,-2.769231,0,0,3,2,false,true,false,0.426,0.574
383,344,39,22.529412,20.235294,39,880,952,-72,0,0,0,0,-13,17,17,-2.692308,0,0,1,2,false,true,true,0.998,0.002
400,310,90,22.222222,17.222222,90,1305,1390,-85,0,1,0,0.055556,-27,18,18,-1.333333,0,2,3,4,true,true,true,0.997,0.003
169,133,36,21.125,16.625,36,784,758,26,0,0,0,0,41,8,8,0.853659,0,1,15,9,false,true,true,0.89,0.11
168,180,-12,15.272727,18,-12,719,614,105,0,1,0,0.1,29,11,10,1.482759,0,0,20,11,false,true,true,0.713,0.287
207,211,-4,17.25,17.583333,-4,95,378,-283,0,0,0,0,13,12,12,2.692308,1,0,7,17,false,true,false,0.152,0.848
264,229,35,14.666667,13.470588,35,871,999,-128,0,0,0,0,-2,18,17,-24,0,0,10,11,false,true,true,0.834,0.166
212,241,-29,23.555556,26.777778,-29,1431,802,629,0,0,0,0,30,9,9,1.066667,0,0,9,7,false,true,true,0.932,0.068
313,269,44,13.608696,11.695652,44,613,502,111,0,0,0,0,-30,23,23,-1.633333,0,0,3,15,false,true,true,0.998,0.002
264,193,71,20.307692,16.083333,71,505,95,410,0,1,0,0.083333,28,13,12,1.571429,0,0,7,11,false,true,true,0.983,0.017
61,34,27,15.25,11.333333,27,1069,1040,29,0,0,0,0,75,4,3,0.586667,0,1,20,11,false,true,false,0.497,0.503
371,297,74,19.526316,15.631579,74,527,581,-54,0,0,0,0,-29,19,19,-1.448276,0,0,2,5,false,true,true,1,0
163,168,-5,27.166667,28,-5,1030,1144,-114,0,1,0,0.166667,55,6,6,0.636364,0,1,24,10,false,true,false,0.395,0.605
358,350,8,19.888889,19.444444,8,1265,1045,220,0,1,0,0.055556,-21,18,18,-2,0,0,3,5,false,true,true,0.964,0.036
352,304,48,18.526316,16,48,820,822,-2,0,0,0,0,-21,19,19,-1.857143,0,0,1,1,false,true,true,1,0
354,340,14,25.285714,26.153846,14,1265,1237,28,1,0,0.071429,0,-6,14,13,-5,0,0,4,9,false,true,true,0.988,0.012
79,74,5,13.166667,14.8,5,448,598,-150,0,0,0,0,62,6,5,0.580645,1,0,13,11,false,true,false,0.43,0.57
68,42,26,22.666667,14,26,1216,1217,-1,0,0,0,0,78,3,3,0.435897,0,0,14,25,false,true,false,0.352,0.648
60,41,19,15,10.25,19,1091,1078,13,0,0,0,0,75,4,4,0.573333,0,0,17,22,false,true,false,0.369,0.631
247,222,25,24.7,22.2,25,1089,1063,26,1,0,0.1,0,33,10,10,1.151515,0,0,8,11,false,true,true,0.738,0.262
392,284,108,20.631579,15.777778,108,1030,998,32,1,0,0.052632,0,-24,19,18,-1.583333,0,0,1,1,false,true,true,1,0
36,52,-16,12,17.333333,-16,1093,1090,3,0,0,0,0,83,3,3,0.409639,1,0,14,12,false,true,false,0.45,0.55
236,221,15,15.733333,15.785714,15,272,238,34,0,0,0,0,1,15,14,40,0,0,24,7,false,true,true,0.798,0.202
98,139,-41,12.25,17.375,-41,450,412,38,0,0,0,0,43,8,8,0.883721,1,0,19,10,false,true,false,0.347,0.653
52,22,30,26,22,30,1075,989,86,0,0,0,0,89,2,1,0.438202,0,0,11,7,false,true,true,0.533,0.467
69,43,26,23,14.333333,26,415,518,-103,0,0,0,0,77,3,3,0.493506,0,0,14,19,false,true,true,0.734,0.266
173,176,-3,21.625,22,-3,1530,1550,-20,0,1,0,0.125,36,8,8,0.944444,0,0,18,13,false,true,false,0.444,0.556
266,234,32,17.733333,15.6,32,363,668,-305,0,0,0,0,8,15,15,5.375,0,1,20,15,false,true,false,0.464,0.536
336,299,37,19.764706,18.6875,37,1094,1030,64,0,0,0,0,-15,17,16,-2.4,0,0,2,4,false,true,true,0.995,0.005
343,235,108,34.3,26.111111,108,1633,1580,53,3,0,0.3,0,23,10,9,1.217391,0,0,9,14,false,true,true,1,0
265,126,139,24.090909,11.454545,139,1295,1477,-182,2,0,0.181818,0,32,11,11,1.4375,0,0,22,13,false,true,true,0.992,0.008
47,10,37,23.5,10,37,1413,1422,-9,0,0,0,0,89,2,1,0.640449,1,0,11,18,false,true,true,0.858,0.142
125,103,22,31.25,34.333333,22,974,995,-21,0,1,0,0.333333,68,4,3,0.485294,0,0,10,9,false,true,true,0.87,0.13
107,95,12,21.4,23.75,12,871,999,-128,0,0,0,0,68,5,4,0.705882,1,0,9,7,false,true,false,0.466,0.534
74,0,74,74,0,74,1493,1513,-20,1,0,1,0,93,1,0,0.354839,0,0,24,0,false,true,true,0.552,0.448
296,295,1,13.454545,13.409091,1,871,999,-128,0,0,0,0,-30,22,22,-1.6,0,0,6,3,false,true,true,0.854,0.146
147,208,-61,16.333333,23.111111,-61,1154,1062,92,0,0,0,0,41,9,9,0.853659,1,0,7,15,false,true,false,0.107,0.893
56,81,-25,9.333333,13.5,-25,826,771,55,0,0,0,0,69,6,6,0.652174,0,0,11,17,false,true,false,0.109,0.891
368,358,10,20.444444,19.888889,10,1501,1473,28,1,0,0.055556,0,-22,18,18,-1.636364,0,0,1,1,true,true,true,0.977,0.023
320,271,49,24.615385,20.846154,49,1434,1493,-59,1,0,0.076923,0,3,13,13,12.333333,0,1,15,5,false,true,true,0.888,0.112
116,96,20,19.333333,16,20,1691,1692,-1,0,0,0,0,53,6,6,0.566038,0,0,12,10,false,true,false,0.493,0.507
278,271,7,21.384615,20.846154,7,1439,1294,145,1,0,0.076923,0,11,13,13,3.272727,0,0,8,20,false,true,true,0.715,0.285
245,256,-11,15.3125,16,-11,628,658,-30,0,0,0,0,6,16,16,7.666667,0,0,14,8,false,true,false,0.371,0.629
182,123,59,22.75,15.375,59,1551,1550,1,0,0,0,0,46,8,8,0.913043,0,1,8,15,false,true,true,0.752,0.248
221,205,16,18.416667,18.636364,16,838,786,52,0,1,0,0.090909,26,12,11,1.230769,1,0,18,13,false,true,true,0.961,0.039
141,116,25,17.625,16.571429,25,491,398,93,0,0,0,0,53,8,7,0.679245,0,1,18,6,false,true,true,0.808,0.192
338,233,105,24.142857,17.923077,105,801,925,-124,1,0,0.071429,0,4,14,13,8.75,1,0,12,10,false,true,true,1,0
97,79,18,24.25,19.75,18,746,796,-50,0,1,0,0.25,64,4,4,0.75,1,0,7,11,false,true,true,0.718,0.282
215,169,46,21.5,16.9,46,1270,1315,-45,0,0,0,0,31,10,10,1.16129,1,0,9,26,false,true,true,0.887,0.113
93,92,1,23.25,23,1,892,819,73,0,1,0,0.25,70,4,4,0.485714,1,0,22,9,false,true,true,0.859,0.141
205,115,90,25.625,14.375,90,778,758,20,0,0,0,0,42,8,8,0.928571,0,0,18,8,false,true,true,0.98,0.02
363,293,70,25.928571,22.538462,70,1554,1573,-19,1,0,0.071429,0,9,14,13,3.777778,1,1,15,9,false,true,true,0.938,0.062
71,62,9,14.2,12.4,9,786,847,-61,0,0,0,0,68,5,5,0.5,0,1,14,8,false,true,false,0.347,0.653
183,100,83,22.875,14.285714,83,1439,1413,26,0,0,0,0,55,8,7,0.654545,0,0,20,11,false,true,true,0.932,0.068
91,83,8,18.2,20.75,8,999,1011,-12,0,0,0,0,67,5,4,0.686567,0,0,12,25,false,true,false,0.168,0.832
87,59,28,21.75,19.666667,28,1167,1216,-49,0,0,0,0,76,4,3,0.539474,1,0,13,26,false,true,true,0.826,0.174
193,211,-18,14.846154,17.583333,-18,699,448,251,0,0,0,0,23,13,12,1.73913,0,0,13,7,false,true,false,0.478,0.522
385,303,82,25.666667,21.642857,82,1554,1573,-19,1,0,0.066667,0,2,15,14,17,1,1,8,10,false,true,true,0.995,0.005
321,278,43,20.0625,18.533333,43,721,689,32,0,0,0,0,-23,16,15,-1.478261,0,0,1,2,false,true,true,0.998,0.002
285,234,51,28.5,23.4,51,992,1100,-108,2,0,0.2,0,23,10,10,1.478261,0,0,7,13,false,true,true,0.973,0.027
133,106,27,22.166667,21.2,27,1075,1152,-77,0,0,0,0,63,6,5,0.634921,0,1,16,7,false,true,false,0.371,0.629
180,170,10,18,18.888889,10,671,725,-54,0,0,0,0,32,10,9,1.15625,0,0,14,9,false,true,true,0.543,0.457
103,104,-1,25.75,34.666667,-1,1394,1424,-30,0,1,0,0.333333,70,4,3,0.457143,0,0,20,7,false,true,true,0.526,0.474
116,73,43,29,18.25,43,1127,1075,52,1,0,0.25,0,72,4,4,0.430556,0,0,21,10,false,true,true,0.873,0.127
92,99,-7,18.4,19.8,-7,901,889,12,0,1,0,0.2,71,5,5,0.605634,1,0,8,13,false,true,true,0.574,0.426
63,68,-5,21,22.666667,-5,1093,1197,-104,0,0,0,0,81,3,3,0.382716,0,0,8,8,false,true,false,0.29,0.71
92,118,-26,23,29.5,-26,1203,1221,-18,0,0,0,0,74,4,4,0.472973,1,0,9,12,false,true,true,0.707,0.293
270,147,123,27,16.333333,123,742,696,46,0,0,0,0,30,10,9,1.066667,0,0,10,17,false,true,true,1,0
347,328,19,26.692308,25.230769,19,1803,1552,251,1,2,0.076923,0.153846,-1,13,13,-28,0,0,11,15,false,true,true,0.999,0.001
247,233,14,13.722222,13.705882,14,826,771,55,0,0,0,0,1,18,17,45,0,0,16,10,false,true,true,0.837,0.163
75,49,26,15,9.8,26,561,526,35,0,0,0,0,59,5,5,0.59322,1,0,18,18,false,true,true,0.7,0.3
354,321,33,29.5,26.75,33,1148,1164,-16,1,2,0.083333,0.166667,-4,12,12,-6.25,0,0,3,2,false,true,true,0.998,0.002
32,52,-20,16,26,-20,1077,1094,-17,0,0,0,0,83,2,2,0.506024,0,0,22,16,false,true,false,0.269,0.731
125,116,9,17.857143,16.571429,9,947,909,38,0,0,0,0,56,7,7,0.821429,1,0,9,36,false,true,false,0.286,0.714
270,255,15,16.875,15.9375,15,719,614,105,0,1,0,0.0625,-4,16,16,-10.75,0,0,10,7,false,true,true,0.927,0.073
209,168,41,26.125,24,41,1489,1555,-66,1,0,0.125,0,41,8,7,0.707317,1,0,15,14,false,true,true,0.87,0.13
206,178,28,20.6,19.777778,28,1266,1247,19,0,0,0,0,34,10,9,0.941176,0,0,12,11,false,true,true,0.539,0.461
208,213,-5,12.235294,12.529412,-5,1030,1045,-15,0,0,0,0,5,17,17,9.2,1,0,9,8,false,true,true,0.674,0.326
397,319,78,17.26087,14.5,78,1583,1422,161,1,0,0.043478,0,-16,23,22,-3.1875,0,0,3,7,false,true,true,0.995,0.005
333,308,25,20.8125,20.533333,25,1265,1045,220,0,1,0,0.066667,-8,16,15,-5.25,0,0,11,8,false,true,true,0.635,0.365
111,130,-19,15.857143,18.571429,-19,272,238,34,0,0,0,0,48,7,7,0.833333,0,0,10,9,false,true,false,0.461,0.539
174,134,40,21.75,19.142857,40,1547,1439,108,1,0,0.125,0,50,8,7,0.74,0,0,18,19,false,true,true,0.71,0.29
335,290,45,18.611111,17.058824,45,921,1072,-151,1,0,0.055556,0,-9,18,17,-4.222222,0,0,2,6,false,true,true,0.997,0.003
20,16,4,20,16,4,1125,1227,-102,0,0,0,0,89,1,1,0.337079,0,0,21,19,false,true,false,0.316,0.684
346,300,46,19.222222,17.647059,46,820,822,-2,0,0,0,0,-13,18,17,-3,0,0,4,2,false,true,true,0.999,0.001
311,159,152,20.733333,11.357143,152,1067,95,972,1,0,0.066667,0,2,15,14,17,1,1,6,21,false,true,true,1,0
14,15,-1,14,15,-1,1167,1216,-49,0,0,0,0,92,1,1,0.445652,0,0,9,20,false,true,false,0.177,0.823
379,312,67,34.454545,28.363636,67,1890,2020,-130,1,2,0.090909,0.181818,3,11,11,9.666667,0,1,10,15,false,true,true,0.926,0.074
137,71,66,22.833333,11.833333,66,1093,1100,-7,1,0,0.166667,0,69,6,6,0.463768,0,1,10,6,false,true,true,0.825,0.175
48,140,-92,12,35,-92,947,810,137,0,1,0,0.25,67,4,4,0.626866,0,1,10,12,false,true,false,0.007,0.993
270,194,76,20.769231,16.166667,76,1270,1315,-45,0,0,0,0,14,13,12,2.571429,0,0,9,28,false,true,true,0.996,0.004
229,251,-22,17.615385,19.307692,-22,491,398,93,0,0,0,0,14,13,13,2.571429,0,0,7,15,false,true,false,0.33,0.67
262,234,28,18.714286,16.714286,28,739,480,259,1,0,0.071429,0,10,14,14,3.6,0,1,16,6,false,true,true,0.942,0.058
356,261,95,35.6,26.1,95,1645,1777,-132,2,0,0.2,0,6,10,10,4.166667,0,0,8,7,false,true,true,1,0
434,351,83,24.111111,19.5,83,791,885,-94,1,1,0.055556,0.055556,-26,18,18,-1.461538,0,0,1,1,false,true,true,1,0
254,156,98,14.111111,8.666667,98,310,359,-49,0,0,0,0,-19,18,18,-2.578947,0,0,13,22,false,true,true,1,0
173,144,29,15.727273,13.090909,29,777,830,-53,0,0,0,0,34,11,11,1.205882,0,0,14,12,false,true,true,0.863,0.137
147,193,-46,16.333333,24.125,-46,1154,1062,92,0,0,0,0,44,9,8,0.795455,1,0,7,18,false,true,false,0.108,0.892
416,294,122,27.733333,19.6,122,1023,1070,-47,2,0,0.133333,0,-12,15,15,-2.666667,0,0,1,11,false,true,true,1,0
177,206,-29,25.285714,29.428571,-29,1030,1144,-114,0,1,0,0.142857,49,7,7,0.714286,0,1,24,7,false,true,false,0.182,0.818
71,68,3,17.75,17,3,859,786,73,0,0,0,0,73,4,4,0.520548,0,0,7,14,false,true,false,0.349,0.651
220,106,114,31.428571,17.666667,114,1935,2020,-85,0,0,0,0,54,7,6,0.574074,1,0,8,10,false,true,true,0.986,0.014
179,149,30,22.375,18.625,30,916,837,79,0,0,0,0,48,8,8,0.833333,0,0,10,12,false,true,true,0.82,0.18
14,8,6,14,8,6,834,758,76,0,0,0,0,91,1,1,0.395604,0,1,8,7,false,true,false,0.499,0.501
355,342,13,23.666667,22.8,13,1554,1716,-162,1,1,0.066667,0.066667,-11,15,15,-3.181818,0,0,6,3,false,true,true,0.95,0.05
18,0,18,18,0,18,1305,1390,-85,0,0,0,0,95,1,0,0.378947,0,0,29,0,false,true,true,0.522,0.478
209,179,30,20.9,19.888889,30,971,906,65,0,0,0,0,26,10,9,1.230769,0,0,7,14,false,true,true,0.677,0.323
369,252,117,28.384615,21,117,1004,840,164,1,0,0.076923,0,-3,13,12,-10,0,0,14,10,false,true,true,1,0
164,144,20,16.4,16,20,871,999,-128,0,0,0,0,38,10,9,1.263158,0,1,8,25,false,true,false,0.106,0.894
170,145,25,18.888889,18.125,25,527,503,24,0,0,0,0,52,9,8,0.788462,0,0,14,13,false,true,true,0.717,0.283
352,293,59,23.466667,19.533333,59,1434,1493,-59,1,0,0.066667,0,-8,15,15,-4.625,0,0,6,3,false,true,true,1,0
67,69,-2,22.333333,23,-2,613,569,44,0,0,0,0,75,3,3,0.52,2,0,11,15,false,true,true,0.867,0.133
294,269,25,18.375,17.933333,25,1159,1051,108,0,0,0,0,1,16,15,40,1,0,6,10,false,true,true,0.775,0.225
169,72,97,24.142857,12,97,1004,653,351,0,0,0,0,50,7,6,0.7,0,0,9,14,false,true,true,0.998,0.002
250,210,40,25,21,40,995,912,83,2,0,0.2,0,38,10,10,1.157895,0,0,11,7,false,true,true,0.937,0.063
199,78,121,33.166667,15.6,121,996,1063,-67,1,1,0.166667,0.2,53,6,5,0.603774,0,1,18,12,false,true,true,0.943,0.057
162,92,70,40.5,23,70,971,1180,-209,1,0,0.25,0,69,4,4,0.463768,0,0,7,7,false,true,true,0.883,0.117
104,136,-32,13,19.428571,-32,576,494,82,0,0,0,0,54,8,7,0.814815,0,0,7,16,false,true,false,0.107,0.893
46,34,12,15.333333,11.333333,12,859,719,140,0,1,0,0.333333,75,3,3,0.706667,0,2,13,5,false,true,true,0.627,0.373
366,358,8,21.529412,21.058824,8,1501,1473,28,1,0,0.058824,0,-20,17,17,-1.8,0,0,1,1,false,true,true,0.975,0.025
346,241,105,26.615385,20.083333,105,977,976,1,1,0,0.076923,0,14,13,12,2.428571,1,0,7,7,false,true,true,1,0
22,41,-19,11,20.5,-19,947,810,137,0,0,0,0,86,2,2,0.488372,0,0,8,10,false,true,false,0.342,0.658
216,207,9,13.5,12.9375,9,611,584,27,0,0,0,0,9,16,16,4.888889,0,0,9,14,false,true,true,0.605,0.395
23,37,-14,7.666667,12.333333,-14,1397,1422,-25,0,0,0,0,85,3,3,0.423529,0,1,7,12,false,true,false,0.309,0.691
175,161,14,21.875,20.125,14,901,1159,-258,2,0,0.25,0,42,8,8,0.833333,0,0,13,10,false,true,true,0.618,0.382
381,301,80,23.8125,18.8125,80,977,976,1,2,0,0.125,0,-11,16,16,-3.090909,0,0,4,4,false,true,true,1,0
302,273,29,15.894737,15.166667,29,500,567,-67,0,0,0,0,-8,19,18,-5.5,0,0,6,17,false,true,true,0.985,0.015
40,43,-3,20,21.5,-3,1659,1782,-123,0,0,0,0,86,2,2,0.337209,0,0,10,13,false,true,false,0.249,0.751
153,112,41,17,14,41,1606,1544,62,0,0,0,0,54,9,8,0.833333,1,0,9,7,false,true,true,0.775,0.225
11,17,-6,5.5,8.5,-6,1397,1422,-25,0,0,0,0,91,2,2,0.395604,0,1,9,13,false,true,true,0.746,0.254
191,174,17,21.222222,19.333333,17,1302,1082,220,0,0,0,0,25,9,9,1.2,1,0,20,7,false,true,true,0.742,0.258
336,323,13,22.4,21.533333,13,1096,1009,87,2,0,0.133333,0,10,15,15,4.4,0,0,7,16,false,true,false,0.297,0.703
186,173,13,18.6,17.3,13,711,876,-165,0,0,0,0,32,10,10,1.34375,0,0,11,10,false,true,true,0.592,0.408
225,116,109,28.125,16.571429,109,1216,1217,-1,1,0,0.125,0,43,8,7,0.790698,1,0,9,31,false,true,true,1,0
300,141,159,21.428571,10.846154,159,1067,95,972,1,0,0.071429,0,10,14,13,3.4,1,1,6,7,false,true,true,1,0
342,314,28,24.428571,24.153846,28,1023,1110,-87,1,1,0.071429,0.076923,-11,14,13,-2.727273,0,0,3,4,false,true,true,0.997,0.003
271,271,0,22.583333,24.636364,0,1431,802,629,0,0,0,0,11,12,11,2.909091,0,1,11,6,false,true,true,0.992,0.008
265,181,84,17.666667,12.066667,84,872,818,54,0,1,0,0.066667,16,15,15,2.5625,1,0,17,16,false,true,true,0.982,0.018
280,278,2,14,14.631579,2,540,518,22,0,0,0,0,-25,20,19,-1.6,0,0,1,1,false,true,true,0.578,0.422
28,62,-34,14,31,-34,1710,1636,74,0,0,0,0,87,2,2,0.413793,0,0,19,14,false,true,false,0.126,0.874
401,268,133,21.105263,14.888889,133,939,907,32,1,0,0.052632,0,-16,19,18,-2.5,0,0,1,1,false,true,true,1,0
113,126,-13,12.555556,15.75,-13,480,518,-38,0,0,0,0,55,9,8,0.836364,0,1,16,8,false,true,false,0.158,0.842
197,193,4,15.153846,14.846154,4,540,518,22,0,0,0,0,15,13,13,2.666667,0,0,9,20,false,true,true,0.564,0.436
373,304,69,21.941176,19,69,1034,1040,-6,1,0,0.058824,0,-14,17,16,-2.5,0,0,3,3,false,true,true,1,0
274,176,98,19.571429,12.571429,98,421,306,115,0,1,0,0.071429,0,14,14,0,0,0,21,9,false,true,true,0.991,0.009
273,169,104,30.333333,18.777778,104,1408,1454,-46,1,0,0.111111,0,35,9,9,0.914286,0,0,9,19,false,true,true,1,0
163,124,39,20.375,15.5,39,847,952,-105,0,0,0,0,56,8,8,0.642857,0,1,7,17,false,true,false,0.473,0.527
366,340,26,26.142857,24.285714,26,1093,1197,-104,3,0,0.214286,0,-5,14,14,-6.2,0,0,8,6,false,true,false,0.091,0.909
153,144,9,19.125,18,9,904,783,121,0,0,0,0,51,8,8,0.823529,0,0,18,17,false,true,true,0.728,0.272
311,284,27,25.916667,25.818182,27,1439,1397,42,1,2,0.083333,0.181818,7,12,11,4.857143,0,0,20,22,false,true,true,0.768,0.232
238,170,68,17,13.076923,68,691,675,16,0,0,0,0,9,14,13,4.222222,0,0,14,19,false,true,true,0.963,0.037
117,104,13,13,13,13,218,86,132,0,0,0,0,40,9,8,1,1,0,25,12,false,true,true,0.781,0.219
193,147,46,24.125,21,46,1782,1512,270,1,1,0.125,0.142857,51,8,7,0.823529,0,0,10,11,false,true,true,0.994,0.006
61,26,35,20.333333,13,35,1181,1069,112,0,0,0,0,81,3,2,0.45679,1,0,12,16,false,true,true,0.832,0.168
115,101,14,38.333333,33.666667,14,1770,1689,81,0,0,0,0,71,3,3,0.366197,0,1,16,12,false,true,false,0.111,0.889
219,176,43,21.9,19.555556,43,901,1159,-258,2,0,0.2,0,31,10,9,1.129032,0,0,10,9,false,true,true,0.762,0.238
168,157,11,16.8,17.444444,11,859,786,73,0,0,0,0,35,10,9,1.085714,1,0,22,7,false,true,true,0.582,0.418
429,340,89,25.235294,20,89,791,885,-94,1,1,0.058824,0.058824,-20,17,17,-1.9,0,0,2,3,false,true,true,0.999,0.001
278,239,39,18.533333,15.933333,39,1221,1438,-217,0,0,0,0,17,15,15,2.647059,0,1,20,7,false,true,true,0.676,0.324
30,30,0,15,15,0,913,871,42,0,0,0,0,83,2,2,0.518072,0,0,11,19,false,true,false,0.287,0.713
75,45,30,25,22.5,30,594,605,-11,0,0,0,0,82,3,2,0.45122,0,0,7,19,false,true,true,0.575,0.425
108,122,-14,15.428571,17.428571,-14,671,725,-54,0,0,0,0,47,7,7,0.787234,1,0,11,14,false,true,false,0.462,0.538
177,219,-42,19.666667,24.333333,-42,1554,1573,-19,0,0,0,0,43,9,9,0.790698,0,0,9,10,false,true,false,0.106,0.894
174,174,0,17.4,17.4,0,719,785,-66,0,1,0,0.1,32,10,10,1.125,0,0,23,16,false,true,true,0.738,0.262
367,276,91,26.214286,19.714286,91,1394,1118,276,0,1,0,0.071429,3,14,14,12.333333,0,0,18,5,false,true,true,1,0
105,83,22,21,20.75,22,942,976,-34,0,0,0,0,66,5,4,0.606061,1,1,11,16,false,true,false,0.463,0.537
157,150,7,19.625,21.428571,7,1161,1166,-5,1,0,0.125,0,44,8,7,0.795455,0,1,10,13,false,true,false,0.139,0.861
268,281,-13,20.615385,23.416667,-13,758,952,-194,0,0,0,0,5,13,12,8,0,0,16,7,false,true,false,0.191,0.809
114,112,2,22.8,22.4,2,926,854,72,0,0,0,0,71,5,5,0.478873,0,0,20,10,false,true,true,0.676,0.324
346,319,27,15.727273,14.5,27,1583,1422,161,1,0,0.045455,0,-13,22,22,-3.923077,0,0,5,7,false,true,true,0.797,0.203
204,81,123,22.666667,10.125,123,993,897,96,1,0,0.111111,0,37,9,8,1.27027,0,0,11,16,false,true,true,0.99,0.01
277,243,34,25.181818,22.090909,34,758,796,-38,0,0,0,0,18,11,11,2.111111,0,0,7,10,false,true,true,0.801,0.199
352,298,54,20.705882,17.529412,54,1434,1493,-59,1,0,0.058824,0,-12,17,17,-3.083333,0,0,6,1,false,true,true,1,0
116,61,55,23.2,15.25,55,838,786,52,0,0,0,0,69,5,4,0.463768,0,0,10,9,false,true,true,0.879,0.121
348,184,164,29,15.333333,164,918,619,299,2,0,0.166667,0,14,12,12,2.5,2,0,15,15,false,true,true,1,0
88,78,10,12.571429,11.142857,10,904,857,47,0,0,0,0,54,7,7,0.759259,0,1,22,16,false,true,false,0.471,0.529
403,290,113,25.1875,18.125,113,996,1063,-67,1,1,0.0625,0.0625,-14,16,16,-2.285714,1,0,2,6,true,true,true,1,0
62,58,4,20.666667,19.333333,4,892,788,104,0,0,0,0,80,3,3,0.5375,1,0,14,22,false,true,true,0.806,0.194
146,198,-52,20.857143,28.285714,-52,1305,1218,87,0,0,0,0,44,7,7,0.863636,1,0,10,9,false,true,false,0.326,0.674
158,133,25,17.555556,16.625,25,871,999,-128,0,0,0,0,43,9,8,1.116279,0,0,7,28,false,true,false,0.241,0.759
303,300,3,18.9375,18.75,3,1266,1247,19,0,0,0,0,-8,16,16,-4,2,0,3,7,true,true,true,0.991,0.009
157,173,-16,19.625,24.714286,-16,1554,1622,-68,1,0,0.125,0,42,8,7,0.738095,0,0,14,12,false,true,false,0.111,0.889
252,255,-3,14.823529,15.9375,-3,540,518,22,0,0,0,0,-7,17,16,-5.714286,0,0,7,13,false,true,false,0.361,0.639
301,145,156,18.8125,9.666667,156,1176,1076,100,0,0,0,0,30,16,15,1.966667,0,0,12,8,false,true,true,1,0
261,209,52,17.4,13.933333,52,620,513,107,0,0,0,0,8,15,15,5.625,1,0,24,7,false,true,true,0.981,0.019
274,159,115,22.833333,14.454545,115,539,500,39,0,0,0,0,15,12,11,2.666667,0,0,10,10,false,true,true,1,0
293,242,51,18.3125,16.133333,51,885,719,166,0,0,0,0,-2,16,15,-19,0,0,16,14,false,true,true,0.971,0.029
323,302,21,20.1875,20.133333,21,771,754,17,0,0,0,0,-12,16,15,-2.666667,0,0,6,5,false,true,true,0.923,0.077
227,212,15,32.428571,30.285714,15,1454,1531,-77,1,1,0.142857,0.142857,39,7,7,0.769231,0,0,12,8,false,true,true,0.733,0.267
331,208,123,15.761905,10.4,123,1128,889,239,0,1,0,0.05,-18,21,20,-2.611111,0,1,4,14,false,true,true,1,0
230,129,101,25.555556,16.125,101,1550,1546,4,0,0,0,0,46,9,8,0.652174,1,0,10,7,false,true,true,0.987,0.013
270,251,19,16.875,16.733333,19,719,614,105,0,1,0,0.066667,-1,16,15,-43,0,0,10,8,false,true,true,0.831,0.169
249,158,91,27.666667,19.75,91,1388,1506,-118,2,1,0.222222,0.125,39,9,8,0.871795,0,0,7,24,false,true,true,1,0
127,117,10,15.875,16.714286,10,864,808,56,1,0,0.125,0,42,8,7,0.809524,1,0,9,7,false,true,true,0.598,0.402
409,279,130,29.214286,21.461538,130,1023,1070,-47,2,0,0.142857,0,-3,14,13,-10.666667,0,0,3,15,false,true,true,0.999,0.001
305,262,43,23.461538,21.833333,43,416,282,134,1,0,0.076923,0,7,13,12,4.857143,1,0,13,8,false,true,true,0.976,0.024
230,163,67,25.555556,20.375,67,866,949,-83,0,0,0,0,40,9,8,1,0,0,9,16,false,true,true,0.788,0.212
309,205,104,22.071429,15.769231,104,518,533,-15,1,0,0.071429,0,0,14,13,0,0,0,7,12,false,true,true,1,0
12,20,-8,12,20,-8,491,398,93,0,0,0,0,95,1,1,0.378947,0,1,16,17,false,true,false,0.277,0.723
260,201,59,18.571429,15.461538,59,804,683,121,0,0,0,0,17,14,13,2.647059,0,1,12,12,false,true,true,0.993,0.007
249,151,98,27.666667,18.875,98,1501,1622,-121,1,0,0.111111,0,39,9,8,0.794872,0,0,7,11,false,true,true,0.992,0.008
219,157,62,15.642857,12.076923,62,777,830,-53,0,0,0,0,20,14,13,2.05,0,0,23,10,false,true,true,0.978,0.022
148,137,11,21.142857,22.833333,11,315,294,21,0,1,0,0.166667,45,7,6,0.777778,0,0,12,28,false,true,true,0.733,0.267
59,44,15,19.666667,22,15,1265,1237,28,0,0,0,0,79,3,2,0.379747,0,0,14,14,false,true,false,0.409,0.591
177,160,17,17.7,16,17,801,807,-6,0,0,0,0,27,10,10,1.296296,0,0,10,21,false,true,true,0.706,0.294
52,26,26,26,13,26,1824,1793,31,0,0,0,0,88,2,2,0.318182,0,0,11,13,false,true,true,0.505,0.495
206,127,79,22.888889,15.875,79,825,907,-82,1,0,0.111111,0,40,9,8,1,0,0,17,8,false,true,true,0.974,0.026
359,262,97,32.636364,26.2,97,1197,1127,70,0,0,0,0,15,11,10,2,1,0,14,9,false,true,true,1,0
192,109,83,21.333333,13.625,83,739,480,259,1,0,0.111111,0,42,9,8,0.857143,0,0,14,7,false,true,true,0.982,0.018
35,69,-34,8.75,17.25,-34,1214,1176,38,0,0,0,0,72,4,4,0.5,1,0,18,8,false,true,false,0.381,0.619
337,291,46,16.85,15.315789,46,866,949,-83,0,0,0,0,-20,20,19,-2,1,0,1,4,false,true,true,0.998,0.002
120,106,14,24,21.2,14,1075,1152,-77,0,0,0,0,65,5,5,0.615385,0,1,19,7,false,true,false,0.496,0.504
217,192,25,18.083333,17.454545,25,1090,1244,-154,0,0,0,0,22,12,11,1.681818,1,1,8,13,false,true,false,0.247,0.753
203,148,55,20.3,14.8,55,939,913,26,0,1,0,0.1,32,10,10,1.25,0,0,10,14,false,true,true,0.979,0.021
62,37,25,20.666667,12.333333,25,1551,1550,1,0,0,0,0,83,3,3,0.506024,0,1,20,22,false,true,false,0.445,0.555
46,25,21,23,12.5,21,786,976,-190,0,0,0,0,89,2,2,0.359551,0,0,7,12,false,true,false,0.469,0.531
201,171,30,25.125,21.375,30,892,819,73,0,1,0,0.125,43,8,8,0.790698,0,0,7,8,false,true,true,0.872,0.128
279,177,102,16.411765,11.0625,102,1128,889,239,0,1,0,0.0625,3,17,16,15.666667,0,0,16,18,false,true,true,0.814,0.186
125,112,13,31.25,28,13,1142,1095,47,1,0,0.25,0,65,4,4,0.538462,0,0,15,19,false,true,false,0.338,0.662
270,172,98,24.545455,17.2,98,847,952,-105,0,0,0,0,37,11,10,0.972973,0,0,7,11,false,true,true,0.998,0.002
87,84,3,14.5,14,3,416,222,194,0,0,0,0,57,6,6,0.964912,1,0,6,7,false,true,true,0.604,0.396
222,207,15,15.857143,15.923077,15,450,412,38,0,0,0,0,6,14,13,6.333333,0,0,10,8,false,true,true,0.701,0.299
33,68,-35,11,22.666667,-35,691,675,16,0,0,0,0,77,3,3,0.493506,1,0,13,9,false,true,false,0.479,0.521
273,271,2,22.75,24.636364,2,1539,1537,2,0,1,0,0.090909,19,12,11,1.684211,0,0,7,18,false,true,false,0.353,0.647
347,325,22,15.086957,14.772727,22,628,658,-30,0,0,0,0,-29,23,22,-1.586207,0,0,1,3,false,true,true,0.97,0.03
289,226,63,24.083333,18.833333,63,1216,1228,-12,1,0,0.083333,0,23,12,12,1.434783,0,0,11,13,false,true,true,0.973,0.027
267,193,74,20.538462,14.846154,74,1011,921,90,1,0,0.076923,0,19,13,13,2.578947,1,0,16,10,false,true,true,0.981,0.019
319,325,-6,22.785714,23.214286,-6,1266,1144,122,0,0,0,0,-1,14,14,-34,1,0,7,16,false,true,true,0.958,0.042
107,63,44,26.75,21,44,971,906,65,0,0,0,0,72,4,3,0.444444,0,1,12,9,false,true,true,0.878,0.122
447,290,157,26.294118,18.125,157,1513,1482,31,1,0,0.058824,0,-16,17,16,-2.0625,0,0,1,9,true,true,true,1,0
315,259,56,18.529412,16.1875,56,1040,925,115,0,0,0,0,-16,17,16,-2.6875,0,0,15,12,false,true,true,0.997,0.003
140,88,52,23.333333,14.666667,52,1875,1793,82,1,0,0.166667,0,60,6,6,0.5,1,1,11,18,false,true,true,0.999,0.001
259,287,-28,16.1875,19.133333,-28,999,1011,-12,0,0,0,0,1,16,15,46,1,0,11,16,false,true,false,0.074,0.926
310,337,-27,22.142857,24.071429,-27,1320,1339,-19,2,1,0.142857,0.071429,5,14,14,7.8,0,0,15,11,false,true,false,0.107,0.893
42,26,16,21,13,16,1181,1149,32,0,0,0,0,89,2,2,0.505618,0,0,9,17,false,true,true,0.5,0.5
321,193,128,22.928571,14.846154,128,1011,921,90,1,0,0.071429,0,15,14,13,3.266667,1,0,9,10,false,true,true,1,0
145,124,21,20.714286,17.714286,21,505,95,410,0,1,0,0.142857,62,7,7,0.709677,0,0,14,8,false,true,true,0.98,0.02
314,280,34,22.428571,20,34,1089,1063,26,1,0,0.071429,0,6,14,14,6.333333,0,0,12,10,false,true,true,0.89,0.11
125,135,-10,31.25,33.75,-10,1434,1493,-59,1,0,0.25,0,59,4,4,0.627119,0,0,25,11,false,true,false,0.286,0.714
272,153,119,19.428571,10.928571,119,595,543,52,0,0,0,0,17,14,14,2.764706,0,0,12,12,false,true,true,1,0
41,88,-47,20.5,44,-47,316,306,10,0,1,0,0.5,82,2,2,0.463415,0,0,10,9,false,true,false,0.312,0.688
421,294,127,26.3125,19.6,127,1023,1070,-47,2,0,0.125,0,-15,16,15,-2.133333,0,0,1,11,false,true,true,1,0
56,26,30,28,26,30,1109,1065,44,0,0,0,0,91,2,1,0.362637,0,0,15,16,false,true,false,0.451,0.549
91,33,58,30.333333,16.5,58,974,995,-21,0,0,0,0,78,3,2,0.423077,0,0,11,8,false,true,true,0.855,0.145
306,309,-3,20.4,22.071429,-3,1210,1252,-42,1,0,0.066667,0,-4,15,14,-8,1,0,2,9,false,true,false,0.251,0.749
324,295,29,19.058824,17.352941,29,1210,1253,-43,0,1,0,0.058824,-17,17,17,-2.058824,0,0,3,3,false,true,true,0.997,0.003
361,369,-8,21.235294,21.705882,-8,1762,1538,224,1,2,0.058824,0.117647,-16,17,17,-2.125,0,0,1,2,true,true,true,0.699,0.301
300,222,78,21.428571,17.076923,78,866,949,-83,0,0,0,0,8,14,13,5,1,0,11,17,false,true,true,1,0
333,309,24,19.588235,18.176471,24,518,448,70,0,0,0,0,-15,17,17,-2.266667,0,0,1,1,true,true,true,1,0
336,337,-1,22.4,24.071429,-1,1320,1339,-19,2,1,0.133333,0.071429,2,15,14,19.5,0,0,11,11,false,true,false,0.186,0.814
279,281,-2,17.4375,18.733333,-2,1078,1130,-52,0,1,0,0.066667,-3,16,15,-13,0,0,11,11,false,true,false,0.459,0.541
378,350,28,22.235294,21.875,28,1014,948,66,1,0,0.058824,0,-13,17,16,-2.538462,0,0,6,1,true,true,true,0.961,0.039
187,118,69,23.375,16.857143,69,1513,1479,34,0,0,0,0,48,8,7,0.708333,1,0,7,15,false,true,true,0.964,0.036
10,8,2,10,8,2,1110,1039,71,0,0,0,0,95,1,1,0.378947,0,0,23,8,false,true,true,0.523,0.477
66,73,-7,16.5,24.333333,-7,1583,1422,161,0,0,0,0,77,4,3,0.662338,0,0,17,9,false,true,false,0.432,0.568
38,50,-12,19,25,-12,1344,1325,19,0,0,0,0,82,2,2,0.378049,0,0,11,15,false,true,false,0.23,0.77
243,117,126,40.5,23.4,126,1507,1554,-47,1,1,0.166667,0.2,49,6,5,0.591837,0,0,15,21,false,true,true,0.999,0.001
196,179,17,19.6,19.888889,17,1364,1093,271,0,1,0,0.111111,35,10,9,1.085714,0,0,9,14,false,true,true,0.772,0.228
28,0,28,28,0,28,777,830,-53,0,0,0,0,95,1,0,0.431579,0,0,15,0,false,true,true,0.592,0.408
168,144,24,18.666667,18,24,904,783,121,0,0,0,0,47,9,8,0.893617,0,0,15,17,false,true,true,0.72,0.28
236,161,75,26.222222,20.125,75,1216,1217,-1,1,0,0.111111,0,36,9,8,0.944444,1,0,7,22,false,true,true,0.998,0.002
238,143,95,26.444444,17.875,95,1826,1803,23,1,0,0.111111,0,37,9,8,0.810811,1,0,9,10,false,true,true,0.981,0.019
8,0,8,8,0,8,1030,998,32,0,0,0,0,96,1,0,0.395833,1,0,14,0,false,true,true,0.53,0.47
210,109,101,30,18.166667,101,1156,1114,42,1,0,0.142857,0,43,7,6,0.744186,0,0,15,13,false,true,true,0.974,0.026
174,113,61,21.75,14.125,61,576,532,44,0,0,0,0,46,8,8,1,1,0,11,16,false,true,true,0.98,0.02
148,158,-10,21.142857,26.333333,-10,1177,1214,-37,0,0,0,0,54,7,6,0.648148,0,0,16,13,false,true,false,0.122,0.878
36,15,21,18,15,21,1670,1770,-100,1,0,0.5,0,85,2,1,0.376471,0,0,19,10,false,true,true,0.99,0.01
213,141,72,26.625,17.625,72,971,1180,-209,1,0,0.125,0,44,8,8,0.727273,0,0,10,12,false,true,true,0.939,0.061
285,251,34,16.764706,15.6875,34,916,876,40,0,0,0,0,-22,17,16,-1.545455,1,0,0,3,false,true,true,0.996,0.004
326,245,81,14.818182,11.666667,81,913,871,42,0,0,0,0,-22,22,21,-1.954545,0,0,3,2,true,true,true,1,0
228,232,-4,17.538462,17.846154,-4,1090,1244,-154,0,0,0,0,13,13,13,2.846154,1,1,6,6,false,true,false,0.245,0.755
404,226,178,21.263158,11.894737,178,1033,1037,-4,0,1,0,0.052632,-20,19,19,-2.25,0,1,2,2,false,true,true,1,0
100,46,54,14.285714,7.666667,54,1016,1037,-21,0,0,0,0,63,7,6,0.761905,0,1,7,14,false,true,false,0.32,0.68
259,256,3,17.266667,17.066667,3,1077,1094,-17,0,0,0,0,9,15,15,4.666667,0,1,13,6,false,true,false,0.324,0.676
358,309,49,21.058824,18.176471,49,1227,1060,167,0,2,0,0.117647,-16,17,17,-2.5,0,0,13,6,false,true,true,0.896,0.104
174,218,-44,43.5,54.5,-44,1370,1431,-61,1,1,0.25,0.25,55,4,4,0.418182,0,0,10,15,false,true,false,0.271,0.729
12,0,12,12,0,12,561,526,35,0,0,0,0,96,1,0,0.364583,2,0,16,0,false,true,true,0.975,0.025
132,105,27,22,17.5,27,526,370,156,0,0,0,0,58,6,6,0.603448,0,0,16,16,false,true,true,0.737,0.263
255,177,78,25.5,19.666667,78,1731,1691,40,1,0,0.1,0,25,10,9,1.36,0,0,9,8,false,true,true,0.945,0.055
127,89,38,15.875,12.714286,38,272,288,-16,0,0,0,0,59,8,7,0.881356,1,0,17,20,false,true,true,0.932,0.068
119,118,1,13.222222,13.111111,1,719,614,105,0,0,0,0,44,9,9,0.977273,0,1,15,8,false,true,false,0.404,0.596
214,180,34,21.4,18,34,1227,1060,167,0,1,0,0.1,34,10,10,1.176471,0,0,8,16,false,true,true,0.635,0.365
238,106,132,29.75,15.142857,132,1803,1552,251,1,0,0.125,0,46,8,7,0.608696,1,1,8,6,false,true,true,0.938,0.062
171,218,-47,19,24.222222,-47,971,761,210,0,0,0,0,32,9,9,0.9375,0,0,20,13,false,true,false,0.278,0.722
284,223,61,23.666667,20.272727,61,1489,1445,44,0,0,0,0,20,12,11,1.6,1,0,6,7,false,true,true,0.975,0.025
313,199,114,26.083333,16.583333,114,1216,1230,-14,1,0,0.083333,0,19,12,12,1.684211,1,0,6,26,false,true,true,1,0
228,133,95,28.5,19,95,1109,1065,44,0,0,0,0,40,8,7,0.825,0,1,7,10,false,true,true,0.998,0.002
72,66,6,14.4,13.2,6,719,614,105,0,0,0,0,66,5,5,0.651515,0,2,10,14,false,true,false,0.045,0.955
77,44,33,19.25,14.666667,33,1439,1413,26,0,0,0,0,79,4,3,0.455696,0,0,22,8,false,true,true,0.525,0.475
253,186,67,16.866667,12.4,67,913,871,42,0,0,0,0,10,15,15,4.3,0,0,14,22,false,true,true,0.98,0.02
328,273,55,20.5,17.0625,55,791,774,17,1,0,0.0625,0,2,16,16,20.5,0,0,11,7,false,true,true,0.982,0.018
446,308,138,24.777778,17.111111,138,1167,1216,-49,1,0,0.055556,0,-9,18,18,-4.555556,0,0,2,3,false,true,true,1,0
236,124,112,19.666667,11.272727,112,421,306,115,0,1,0,0.090909,18,12,11,2.444444,0,0,33,9,false,true,true,0.982,0.018
81,36,45,20.25,9,45,896,818,78,0,0,0,0,80,4,4,0.55,0,0,17,10,false,true,true,0.887,0.113
265,290,-25,26.5,29,-25,1297,1606,-309,1,1,0.1,0.1,22,10,10,1.363636,0,0,10,9,false,true,false,0.317,0.683
350,270,80,23.333333,18,80,613,569,44,0,0,0,0,-4,15,15,-9.75,0,0,4,8,false,true,true,1,0
336,302,34,17.684211,15.894737,34,363,668,-305,0,0,0,0,-15,19,19,-2.866667,0,1,7,2,false,true,true,0.987,0.013
12,22,-10,12,22,-10,611,584,27,0,0,0,0,93,1,1,0.473118,0,0,23,19,false,true,false,0.289,0.711
116,74,42,23.2,14.8,42,838,786,52,0,0,0,0,64,5,5,0.5,0,0,10,7,false,true,true,0.881,0.119
81,71,10,27,23.666667,10,695,671,24,0,0,0,0,73,3,3,0.452055,0,0,18,16,false,true,true,0.662,0.338
227,207,20,28.375,25.875,20,1710,1636,74,1,1,0.125,0.125,41,8,8,0.878049,1,0,11,17,false,true,true,0.959,0.041
268,244,24,20.615385,20.333333,24,1027,856,171,1,1,0.076923,0.083333,2,13,12,16.5,0,0,22,10,false,true,true,0.933,0.067
233,167,66,25.888889,20.875,66,1034,1040,-6,1,0,0.111111,0,35,9,8,1,1,0,6,20,false,true,true,0.986,0.014
338,263,75,30.727273,26.3,75,1454,1531,-77,1,1,0.090909,0.1,15,11,10,2,0,0,8,9,false,true,true,0.999,0.001
22,0,22,22,0,22,1181,1149,32,0,0,0,0,95,1,0,0.473684,0,0,7,0,false,true,true,0.506,0.494
171,108,63,24.428571,18,63,939,907,32,0,0,0,0,58,7,6,0.689655,1,0,15,7,false,true,true,0.958,0.042
59,25,34,19.666667,12.5,34,804,683,121,0,0,0,0,79,3,2,0.56962,0,0,20,8,false,true,true,0.756,0.244
169,130,39,16.9,14.444444,39,913,871,42,0,0,0,0,41,10,9,1.04878,0,1,11,17,false,true,false,0.416,0.584
257,223,34,32.125,31.857143,34,1333,1331,2,1,0,0.125,0,33,8,7,0.909091,0,0,10,13,false,true,true,0.721,0.279
278,281,-3,19.857143,20.071429,-3,1334,1270,64,1,0,0.071429,0,13,14,14,2.846154,1,0,14,10,false,true,true,0.803,0.197
248,236,12,16.533333,16.857143,12,725,771,-46,0,1,0,0.071429,9,15,14,5.111111,1,0,13,13,false,true,true,0.908,0.092
140,81,59,28,20.25,59,880,952,-72,0,0,0,0,65,5,4,0.538462,1,0,18,13,false,true,true,0.868,0.132
377,263,114,22.176471,15.470588,114,1394,1230,164,0,1,0,0.058824,-15,17,17,-2.533333,0,1,12,12,false,true,true,1,0
6,8,-2,6,8,-2,1075,1152,-77,0,0,0,0,93,1,1,0.430108,1,1,7,19,false,true,false,0.253,0.747
42,26,16,14,13,16,1253,1166,87,0,0,0,0,83,3,2,0.518072,0,0,10,18,false,true,false,0.356,0.644
40,27,13,20,13.5,13,859,786,73,0,0,0,0,86,2,2,0.44186,0,1,16,6,false,true,true,0.533,0.467
213,168,45,26.625,24,45,1670,1770,-100,1,1,0.125,0.142857,46,8,7,0.695652,0,0,12,17,false,true,true,0.751,0.249
179,143,36,16.272727,13,36,498,43,455,0,0,0,0,24,11,11,1.541667,0,0,13,17,false,true,true,0.746,0.254
77,68,9,19.25,22.666667,9,1170,1156,14,0,0,0,0,79,4,3,0.481013,1,0,6,15,false,true,true,0.614,0.386
24,19,5,24,19,5,1388,1477,-89,0,0,0,0,91,1,1,0.527473,0,0,7,12,false,true,false,0.367,0.633
334,299,35,37.111111,33.222222,35,1770,1689,81,0,1,0,0.111111,18,9,9,1.444444,0,0,10,19,false,true,true,0.976,0.024
164,152,12,18.222222,16.888889,12,704,691,13,0,0,0,0,42,9,9,0.904762,1,0,9,10,false,true,true,0.63,0.37
353,270,83,19.611111,15,83,620,658,-38,0,0,0,0,-21,18,18,-1.714286,0,0,7,2,true,true,true,1,0
394,348,46,23.176471,20.470588,46,1203,1221,-18,2,0,0.117647,0,-13,17,17,-2.692308,0,0,4,2,false,true,true,0.999,0.001
386,365,21,24.125,24.333333,21,1670,1770,-100,1,1,0.0625,0.066667,-25,16,15,-1.28,0,0,4,2,false,true,true,0.995,0.005
253,232,21,16.866667,16.571429,21,859,822,37,0,0,0,0,3,15,14,12.666667,1,0,8,9,false,true,true,0.806,0.194
272,209,63,27.2,23.222222,63,416,282,134,1,0,0.1,0,32,10,9,1.0625,0,0,11,10,false,true,true,0.899,0.101
10,0,10,10,0,10,1051,1030,21,0,0,0,0,95,1,0,0.315789,0,0,14,0,false,true,false,0.493,0.507
117,61,56,29.25,20.333333,56,1270,1315,-45,0,0,0,0,71,4,3,0.507042,0,1,12,7,false,true,true,0.731,0.269
357,234,123,19.833333,13.764706,123,1281,1339,-58,0,0,0,0,-2,18,17,-20.5,0,0,9,5,false,true,true,1,0
287,241,46,23.916667,20.083333,46,1302,1082,220,0,0,0,0,4,12,12,7.5,1,0,10,12,false,true,true,0.949,0.051
375,301,74,23.4375,18.8125,74,995,912,83,2,0,0.125,0,1,16,16,44,0,0,10,16,false,true,true,0.996,0.004
353,283,70,25.214286,20.214286,70,1109,1065,44,0,0,0,0,-13,14,14,-2.538462,0,0,6,4,false,true,true,1,0
287,262,25,15.105263,13.789474,25,1030,1045,-15,1,0,0.052632,0,-9,19,19,-5.111111,0,0,19,8,false,true,true,0.945,0.055
124,86,38,15.5,12.285714,38,346,231,115,0,0,0,0,44,8,7,0.931818,0,0,7,12,false,true,true,0.861,0.139
79,82,-3,39.5,41,-3,1344,1209,135,0,1,0,0.5,79,2,2,0.43038,0,0,10,10,false,true,false,0.179,0.821
317,166,151,26.416667,15.090909,151,1482,1554,-72,1,0,0.083333,0,19,12,11,1.894737,0,0,7,11,false,true,true,1,0
24,0,24,24,0,24,786,757,29,0,0,0,0,95,1,0,0.410526,0,0,16,0,false,true,true,0.56,0.44
257,197,60,23.363636,17.909091,60,960,1070,-110,1,0,0.090909,0,25,11,11,1.4,0,1,17,6,false,true,true,0.885,0.115
232,193,39,25.777778,24.125,39,1297,1606,-309,1,0,0.111111,0,36,9,8,0.833333,0,0,10,9,false,true,false,0.456,0.544
341,276,65,20.058824,16.235294,65,939,913,26,0,1,0,0.058824,-11,17,17,-3.636364,1,0,4,6,false,true,true,1,0
209,152,57,20.9,16.888889,57,784,758,26,0,0,0,0,31,10,9,1.129032,0,0,11,10,false,true,true,0.892,0.108
157,79,78,39.25,19.75,78,1489,1405,84,1,0,0.25,0,72,4,4,0.388889,1,0,14,10,false,true,true,0.98,0.02
296,275,21,17.411765,16.176471,21,739,480,259,1,0,0.058824,0,-11,17,17,-3.272727,0,2,11,2,false,true,false,0.027,0.973
311,237,74,17.277778,13.166667,74,272,288,-16,0,0,0,0,3,18,18,17.333333,0,0,13,9,false,true,true,0.986,0.014
117,54,63,29.25,13.5,63,1093,1100,-7,1,0,0.25,0,81,4,4,0.395062,0,1,12,9,false,true,true,0.646,0.354
354,222,132,25.285714,15.857143,132,939,907,32,1,0,0.071429,0,11,14,14,3.636364,0,0,9,7,false,true,true,1,0
172,174,-2,19.111111,19.333333,-2,1073,1177,-104,0,0,0,0,37,9,9,0.864865,0,0,9,24,false,true,false,0.132,0.868
313,217,96,14.227273,10.333333,96,416,222,194,0,0,0,0,-22,22,21,-2.5,0,0,12,13,false,true,true,1,0
348,291,57,21.75,18.1875,57,976,965,11,1,0,0.0625,0,-15,16,16,-2.133333,1,0,2,4,true,true,true,0.999,0.001
123,208,-85,20.5,41.6,-85,1762,1538,224,0,2,0,0.4,54,6,5,0.62963,1,0,9,8,false,true,true,0.909,0.091
88,19,69,44,19,69,1983,2020,-37,1,0,0.5,0,83,2,1,0.313253,0,0,12,13,false,true,true,0.613,0.387
126,110,16,14,13.75,16,1214,1176,38,0,0,0,0,49,9,8,0.734694,0,1,11,22,false,true,false,0.134,0.866
148,99,49,18.5,14.142857,49,1181,1069,112,0,0,0,0,48,8,7,0.770833,1,0,22,11,false,true,true,0.878,0.122
98,51,47,32.666667,25.5,47,866,949,-83,0,0,0,0,80,3,2,0.5,0,0,9,9,false,true,true,0.829,0.171
170,170,0,17,17,0,704,691,13,0,0,0,0,34,10,10,1.117647,1,0,9,10,false,true,true,0.55,0.45
317,216,101,21.133333,15.428571,101,518,533,-15,1,0,0.066667,0,-6,15,14,-5.833333,0,0,9,12,false,true,true,1,0
116,127,-11,16.571429,21.166667,-11,1261,1349,-88,0,0,0,0,53,7,6,0.245283,1,1,15,18,true,true,false,0.407,0.593
341,310,31,17.947368,17.222222,31,859,786,73,0,0,0,0,-27,19,18,-1.407407,0,0,3,1,false,true,true,0.998,0.002
333,291,42,17.526316,15.315789,42,866,949,-83,0,0,0,0,-18,19,19,-2.222222,1,0,1,4,false,true,true,0.999,0.001
126,89,37,12.6,9.888889,37,892,768,124,0,0,0,0,50,10,9,0.86,0,0,7,20,false,true,true,0.705,0.295
365,251,114,26.071429,19.307692,114,977,976,1,1,0,0.071429,0,8,14,13,4.25,1,0,10,10,false,true,true,1,0
19,39,-20,9.5,19.5,-20,691,675,16,0,0,0,0,85,2,2,0.447059,0,0,16,11,false,true,false,0.277,0.723
12,21,-9,12,21,-9,1029,1227,-198,0,0,0,0,92,1,1,0.347826,0,0,15,12,false,true,false,0.215,0.785
180,162,18,18,18,18,808,812,-4,0,0,0,0,34,10,9,1.088235,1,0,7,9,false,true,true,0.53,0.47
26,0,26,26,0,26,1935,2020,-85,0,0,0,0,94,1,1,0.329787,1,0,8,30,false,true,true,0.774,0.226
39,37,2,19.5,18.5,2,976,965,11,0,0,0,0,82,2,2,0.390244,0,0,11,25,false,true,false,0.276,0.724
166,129,37,18.444444,16.125,37,695,523,172,0,0,0,0,32,9,8,1.15625,0,0,13,19,false,true,true,0.735,0.265
18,0,18,18,0,18,613,549,64,0,0,0,0,96,1,0,0.458333,0,0,10,0,false,true,true,0.531,0.469
365,257,108,24.333333,18.357143,108,801,925,-124,1,0,0.066667,0,-4,15,14,-8.75,0,0,6,9,false,true,true,1,0
20,0,20,20,0,20,725,771,-46,0,0,0,0,95,1,0,0.484211,0,0,9,0,false,true,true,0.517,0.483
279,260,19,16.411765,15.294118,19,801,807,-6,0,0,0,0,-17,17,17,-2.058824,0,0,2,2,false,true,true,0.953,0.047
229,193,36,17.615385,16.083333,36,334,446,-112,0,0,0,0,10,13,12,4,0,1,9,7,false,true,true,0.866,0.134
214,243,-29,16.461538,20.25,-29,316,306,10,0,2,0,0.166667,14,13,12,2.714286,0,0,14,23,false,true,false,0.059,0.941
65,97,-32,21.666667,32.333333,-32,1554,1573,-19,0,0,0,0,80,3,3,0.425,0,0,15,9,false,true,false,0.118,0.882
334,238,96,18.555556,14,96,371,336,35,2,0,0.111111,0,-26,18,17,-1.461538,0,0,1,13,false,true,true,0.999,0.001
362,275,87,18.1,13.75,87,1606,1544,62,0,0,0,0,-13,20,20,-3.461538,0,0,3,2,false,true,true,1,0
297,256,41,24.75,21.333333,41,1109,1065,44,0,0,0,0,1,12,12,33,0,0,18,11,false,true,true,0.783,0.217
112,84,28,18.666667,14,28,527,503,24,0,0,0,0,67,6,6,0.61194,0,0,24,15,false,true,true,0.778,0.222
258,201,57,23.454545,18.272727,57,1110,1039,71,0,0,0,0,20,11,11,1.8,0,0,16,10,false,true,true,0.93,0.07
199,182,17,16.583333,15.166667,17,908,859,49,0,0,0,0,23,12,12,1.695652,0,1,13,12,false,true,false,0.48,0.52
313,279,34,19.5625,18.6,34,1161,1166,-5,1,0,0.0625,0,-12,16,15,-2.916667,0,1,5,13,false,true,true,0.98,0.02
192,137,55,21.333333,15.222222,55,739,480,259,1,0,0.111111,0,40,9,9,0.9,0,1,14,6,false,true,true,0.992,0.008
290,233,57,24.166667,19.416667,57,902,866,36,0,0,0,0,1,12,12,32,1,0,11,11,false,true,true,0.984,0.016
199,176,23,24.875,25.142857,23,1355,1210,145,0,0,0,0,47,8,7,0.638298,1,0,8,10,false,true,true,0.858,0.142
264,249,15,20.307692,19.153846,15,1094,1030,64,0,0,0,0,8,13,13,4.5,0,0,14,18,false,true,true,0.725,0.275
95,86,9,19,17.2,9,628,658,-30,0,0,0,0,63,5,5,0.730159,0,0,25,13,false,true,true,0.707,0.293
400,313,87,26.666667,22.357143,87,1075,1027,48,2,1,0.133333,0.071429,-10,15,14,-3.7,0,0,6,5,false,true,true,0.999,0.001
51,52,-1,17,17.333333,-1,892,768,124,0,0,0,0,81,3,3,0.530864,0,0,11,17,false,true,false,0.298,0.702
358,359,-1,21.058824,22.4375,-1,1439,1413,26,0,1,0,0.0625,-9,17,16,-4,0,0,3,4,false,true,false,0.062,0.938
314,254,60,13.083333,11.043478,60,310,359,-49,0,0,0,0,-49,24,23,-1,0,0,3,2,false,true,true,0.999,0.001
308,237,71,22,18.230769,71,306,169,137,0,0,0,0,-8,14,13,-4.25,0,0,12,12,false,true,true,1,0
190,130,60,21.111111,16.25,60,1094,1030,64,0,0,0,0,42,9,8,0.857143,1,0,10,18,false,true,true,0.888,0.112
42,31,11,14,15.5,11,518,533,-15,0,0,0,0,83,3,2,0.421687,0,0,8,23,false,true,false,0.222,0.778
337,296,41,16.85,14.8,41,1040,925,115,0,0,0,0,-32,20,20,-1.34375,0,0,10,1,false,true,true,0.999,0.001
158,217,-59,22.571429,36.166667,-59,1419,1488,-69,0,1,0,0.166667,38,7,6,0.736842,1,0,17,11,false,true,false,0.406,0.594
156,186,-30,17.333333,23.25,-30,1177,1214,-37,0,0,0,0,42,9,8,0.833333,0,0,19,12,false,true,false,0.106,0.894
199,109,90,33.166667,21.8,90,1109,1065,44,0,0,0,0,59,6,5,0.559322,0,0,10,9,false,true,true,0.915,0.085
99,90,9,16.5,18,9,262,306,-44,0,0,0,0,71,6,5,0.647887,0,0,22,11,false,true,true,0.721,0.279
16,17,-1,16,17,-1,1048,1000,48,0,0,0,0,93,1,1,0.430108,0,0,17,13,false,true,false,0.48,0.52
245,121,124,24.5,13.444444,124,1216,1230,-14,1,0,0.1,0,39,10,9,0.820513,0,0,11,17,false,true,true,0.999,0.001
56,70,-14,9.333333,14,-14,826,771,55,0,0,0,0,72,6,5,0.625,0,0,11,21,false,true,false,0.107,0.893
236,190,46,23.6,21.111111,46,1406,1454,-48,0,1,0,0.111111,25,10,9,1.36,1,1,13,15,false,true,false,0.463,0.537
306,309,-3,25.5,28.090909,-3,1125,1227,-102,2,1,0.166667,0.090909,4,12,11,7.5,1,0,6,9,false,true,false,0.428,0.572
248,253,-5,16.533333,16.866667,-5,725,771,-46,0,1,0,0.066667,6,15,15,7.666667,1,0,13,11,false,true,true,0.923,0.077
116,115,1,16.571429,16.428571,1,721,689,32,0,0,0,0,43,7,7,0.790698,0,0,16,12,false,true,false,0.406,0.594
63,43,20,21,21.5,20,1148,1164,-16,0,0,0,0,80,3,2,0.3125,0,0,15,11,false,true,true,0.501,0.499
149,123,26,16.555556,15.375,26,947,909,38,0,0,0,0,42,9,8,1.095238,1,0,9,35,false,true,false,0.25,0.75
159,209,-50,19.875,29.857143,-50,1501,1473,28,0,0,0,0,42,8,7,0.857143,0,0,16,26,false,true,false,0.106,0.894
201,77,124,28.714286,11,124,925,801,124,1,0,0.142857,0,56,7,7,0.714286,1,0,13,15,false,true,true,0.996,0.004
39,31,8,19.5,15.5,8,725,771,-46,0,0,0,0,85,2,2,0.541176,0,1,11,13,false,true,false,0.457,0.543
316,211,105,16.631579,11.105263,105,1069,1040,29,0,0,0,0,-20,19,19,-2.2,0,0,3,1,false,true,true,1,0
365,306,59,22.8125,20.4,59,1210,1253,-43,0,1,0,0.066667,-21,16,15,-1.619048,0,0,1,12,false,true,true,0.999,0.001
13,35,-22,6.5,17.5,-22,523,480,43,0,0,0,0,90,2,2,0.366667,0,0,18,7,false,true,false,0.348,0.652
350,279,71,21.875,17.4375,71,1305,1218,87,1,0,0.0625,0,-16,16,16,-2.375,0,0,9,5,false,true,true,1,0
74,16,58,74,16,58,1216,1230,-14,1,0,1,0,89,1,1,0.359551,0,0,22,10,false,true,true,0.534,0.466
349,262,87,29.083333,23.818182,87,1428,1606,-178,1,0,0.083333,0,12,12,11,2.666667,1,0,6,10,false,true,true,1,0
152,120,32,21.714286,17.142857,32,1073,1177,-104,0,0,0,0,52,7,7,0.615385,0,0,9,19,false,true,true,0.646,0.354
296,254,42,24.666667,23.090909,42,416,282,134,1,0,0.083333,0,14,12,11,2.428571,1,0,14,10,false,true,true,0.96,0.04
103,177,-74,14.714286,25.285714,-74,613,611,2,0,0,0,0,47,7,7,0.808511,0,0,7,15,false,true,false,0.076,0.924
348,226,122,21.75,15.066667,122,1011,921,90,1,0,0.0625,0,5,16,15,9.8,0,0,12,11,false,true,true,1,0
362,291,71,22.625,19.4,71,1075,1152,-77,0,1,0,0.066667,-4,16,15,-10,0,0,14,11,false,true,true,0.999,0.001
120,64,56,17.142857,10.666667,56,859,719,140,0,1,0,0.166667,49,7,6,1.081633,0,2,19,8,false,true,true,0.623,0.377
202,84,118,28.857143,14,118,1295,1477,-182,2,0,0.285714,0,56,7,6,0.821429,0,0,22,7,false,true,true,0.981,0.019
174,147,27,21.75,21,27,1334,1270,64,1,0,0.125,0,48,8,7,0.770833,0,0,26,9,false,true,true,0.765,0.235
218,100,118,27.25,12.5,118,801,925,-124,1,0,0.125,0,41,8,8,0.853659,1,0,20,16,false,true,true,0.986,0.014
381,297,84,20.052632,15.631579,84,941,926,15,1,0,0.052632,0,-20,19,19,-1.9,0,0,4,1,true,true,true,1,0
126,75,51,25.2,15,51,1014,948,66,0,0,0,0,68,5,5,0.485294,0,0,15,15,false,true,true,0.883,0.117
243,98,145,27,10.888889,145,925,801,124,1,0,0.111111,0,44,9,9,0.909091,1,1,6,25,false,true,true,1,0
52,46,6,26,23,6,1349,1302,47,0,0,0,0,84,2,2,0.345238,2,0,6,8,false,true,true,0.863,0.137
51,46,5,17,15.333333,5,947,909,38,0,0,0,0,81,3,3,0.567901,1,0,10,25,false,true,true,0.588,0.412
368,197,171,40.888889,21.888889,171,1571,1554,17,2,1,0.222222,0.111111,23,9,9,1.434783,0,0,17,14,false,true,true,1,0
330,289,41,18.333333,16.055556,41,866,949,-83,0,0,0,0,-14,18,18,-2.857143,1,0,3,5,false,true,true,0.999,0.001
302,197,105,23.230769,16.416667,105,580,620,-40,1,0,0.076923,0,19,13,12,2.263158,0,0,11,16,false,true,true,0.999,0.001
215,186,29,21.5,18.6,29,1040,925,115,0,0,0,0,24,10,10,1.791667,0,0,13,10,false,true,true,0.815,0.185
422,393,29,32.461538,30.230769,29,1633,1580,53,3,1,0.230769,0.076923,-11,13,13,-2.545455,0,0,2,3,false,true,true,0.984,0.016
375,323,52,26.785714,23.071429,52,1394,1424,-30,1,1,0.071429,0.071429,3,14,14,10.666667,1,0,9,8,false,true,true,1,0
0,0,0,0,0,0,1897,1793,104,0,0,0,0,100,1,1,0.32,0,0,8,17,false,true,true,1,0
270,225,45,20.769231,17.307692,45,561,526,35,0,0,0,0,0,13,13,0,0,0,13,15,false,true,true,0.965,0.035
126,75,51,21,15,51,609,620,-11,0,0,0,0,63,6,5,0.587302,0,0,9,11,false,true,true,0.881,0.119
245,212,33,16.333333,15.142857,33,613,461,152,0,1,0,0.071429,-8,15,14,-4.625,0,0,31,15,false,true,true,0.947,0.053
338,252,86,28.166667,22.909091,86,1203,1221,-18,2,0,0.166667,0,24,12,11,1.458333,0,0,10,7,false,true,true,0.998,0.002
22,56,-34,11,28,-34,1211,1173,38,0,0,0,0,86,2,2,0.406977,0,0,19,11,false,true,false,0.17,0.83
142,160,-18,28.4,40,-18,1265,1237,28,0,0,0,0,58,5,4,0.517241,1,0,7,8,false,true,true,0.751,0.249
182,136,46,30.333333,27.2,46,1096,1009,87,1,0,0.166667,0,69,6,5,0.637681,0,0,8,13,false,true,true,0.744,0.256
172,158,14,21.5,19.75,14,948,933,15,1,0,0.125,0,49,8,8,0.77551,0,0,15,17,false,true,true,0.731,0.269
305,229,76,16.052632,12.052632,76,415,518,-103,0,0,0,0,-20,19,19,-1.9,0,0,1,11,true,true,true,1,0
0,0,0,0,0,0,1153,1065,88,0,0,0,0,100,1,0,0.28,0,0,0,0,false,true,false,0.249,0.751
90,67,23,18,16.75,23,695,523,172,0,0,0,0,64,5,4,0.578125,0,1,11,6,false,true,true,0.874,0.126
191,95,96,27.285714,15.833333,96,986,856,130,1,0,0.142857,0,48,7,6,0.645833,1,0,6,19,false,true,true,0.989,0.011
156,117,39,19.5,16.714286,39,1090,1244,-154,0,0,0,0,46,8,7,0.804348,0,0,10,18,false,true,false,0.259,0.741
228,206,22,19,17.166667,22,921,1072,-151,1,0,0.083333,0,26,12,12,1.461538,0,1,17,7,false,true,true,0.75,0.25
344,212,132,20.235294,12.470588,132,1413,1422,-9,0,0,0,0,2,17,17,28.5,0,0,11,17,false,true,true,1,0
310,300,10,19.375,18.75,10,1295,1281,14,0,0,0,0,5,16,16,7.6,0,0,17,7,false,true,true,0.514,0.486
263,200,63,16.4375,12.5,63,566,542,24,0,0,0,0,4,16,16,10.25,0,1,20,6,false,true,true,0.991,0.009
143,134,9,14.3,13.4,9,880,952,-72,0,0,0,0,31,10,10,1.322581,0,0,12,11,false,true,false,0.434,0.566
377,338,39,25.133333,22.533333,39,1762,1616,146,2,0,0.133333,0,-13,15,15,-2.307692,1,0,2,4,true,true,true,0.999,0.001
179,66,113,29.833333,13.2,113,925,801,124,1,0,0.166667,0,68,6,5,0.588235,1,0,9,9,false,true,true,0.995,0.005
67,49,18,16.75,16.333333,18,885,719,166,0,0,0,0,78,4,3,0.487179,0,1,23,9,false,true,true,0.53,0.47
36,46,-10,18,23,-10,942,976,-34,0,0,0,0,83,2,2,0.481928,0,0,12,22,false,true,false,0.23,0.77
24,11,13,24,11,13,272,238,34,0,0,0,0,92,1,1,0.434783,1,0,8,15,false,true,true,0.529,0.471
191,164,27,19.1,18.222222,27,1394,1230,164,0,1,0,0.111111,33,10,9,1.151515,0,1,12,15,false,true,false,0.061,0.939
291,292,-1,19.4,19.466667,-1,518,448,70,0,0,0,0,-4,15,15,-8.5,0,0,10,10,false,true,true,0.636,0.364
398,299,99,26.533333,19.933333,99,1334,1256,78,2,0,0.133333,0,-9,15,15,-3.444444,0,0,2,2,false,true,true,1,0
49,57,-8,16.333333,19,-8,1023,1070,-47,0,0,0,0,78,3,3,0.410256,1,0,21,13,false,true,true,0.618,0.382
68,67,1,17,16.75,1,859,822,37,0,0,0,0,66,4,4,0.575758,0,0,30,12,false,true,false,0.392,0.608
298,276,22,24.833333,23,22,1331,1399,-68,0,0,0,0,7,12,12,5,0,0,9,7,false,true,true,0.727,0.273
66,78,-12,13.2,15.6,-12,539,632,-93,0,0,0,0,71,5,5,0.647887,0,1,8,7,false,true,false,0.225,0.775
337,337,0,16.85,16.85,0,1164,1201,-37,0,0,0,0,-30,20,20,-1.4,0,0,2,1,false,true,true,0.938,0.062
61,61,0,20.333333,20.333333,0,758,952,-194,0,0,0,0,73,3,3,0.547945,0,1,12,14,false,true,false,0.224,0.776
36,35,1,18,17.5,1,769,527,242,0,0,0,0,83,2,2,0.433735,0,0,12,7,false,true,true,0.537,0.463
217,209,8,14.466667,14.928571,8,480,518,-38,0,0,0,0,16,15,14,2.875,1,1,10,7,false,true,false,0.246,0.754
266,244,22,17.733333,17.428571,22,892,788,104,2,0,0.133333,0,8,15,14,5.375,1,0,8,19,false,true,true,0.939,0.061
386,229,157,29.692308,17.615385,157,1101,1078,23,1,0,0.076923,0,7,13,13,4.714286,0,1,10,17,false,true,true,1,0
102,78,24,25.5,19.5,24,691,675,16,0,0,0,0,74,4,4,0.5,0,1,10,9,false,true,true,0.713,0.287
147,87,60,36.75,21.75,60,1935,2020,-85,0,0,0,0,68,4,4,0.455882,1,0,9,12,false,true,true,0.863,0.137
282,210,72,18.8,14,72,1048,1000,48,0,0,0,0,11,15,15,3.636364,0,1,10,16,false,true,true,0.999,0.001
272,188,84,18.133333,12.533333,84,691,675,16,0,0,0,0,2,15,15,19,0,0,11,16,false,true,true,0.999,0.001
278,277,1,14.631579,14.578947,1,480,518,-38,0,0,0,0,-11,19,19,-4.181818,1,0,8,7,false,true,true,0.911,0.089
27,34,-7,13.5,17,-7,1043,1055,-12,0,0,0,0,86,2,2,0.430233,0,0,8,12,false,true,false,0.329,0.671
250,192,58,25,21.333333,58,995,912,83,2,0,0.2,0,41,10,9,1.073171,0,0,11,7,false,true,true,0.96,0.04
330,280,50,22,18.666667,50,1406,1454,-48,0,2,0,0.133333,-6,15,15,-5.666667,0,0,4,11,false,true,true,0.991,0.009
28,18,10,28,18,10,769,527,242,0,0,0,0,90,1,1,0.4,0,0,7,10,false,true,true,0.681,0.319
183,89,94,36.6,17.8,94,1075,1027,48,2,0,0.4,0,59,5,5,0.627119,0,0,12,16,false,true,true,0.995,0.005
322,328,-6,32.2,36.444444,-6,2219,2029,190,0,0,0,0,13,10,9,2,0,0,12,11,false,true,true,0.96,0.04
44,42,2,14.666667,14,2,801,925,-124,1,0,0.333333,0,76,3,3,0.460526,1,0,6,12,false,true,false,0.475,0.525
26,0,26,26,0,26,996,1063,-67,0,0,0,0,95,1,0,0.336842,0,0,9,0,false,true,true,0.513,0.487
26,14,12,13,14,12,1210,1253,-43,0,0,0,0,89,2,1,0.382022,1,0,9,9,false,true,false,0.431,0.569
52,73,-21,17.333333,36.5,-21,1762,1582,180,0,1,0,0.5,82,3,2,0.390244,0,0,14,14,false,true,true,0.847,0.153
95,94,1,23.75,23.5,1,505,95,410,0,1,0,0.25,77,4,4,0.571429,0,0,10,9,false,true,true,0.655,0.345
308,268,40,22,19.142857,40,1047,1094,-47,1,1,0.071429,0.071429,7,14,14,5.142857,0,0,23,7,false,true,true,0.951,0.049
197,169,28,17.909091,16.9,28,725,771,-46,0,1,0,0.1,33,11,10,1.393939,1,0,6,18,false,true,true,0.929,0.071
77,49,28,19.25,16.333333,28,349,315,34,0,0,0,0,72,4,3,0.472222,0,0,10,13,false,true,true,0.726,0.274
414,282,132,19.714286,13.428571,132,942,1003,-61,0,0,0,0,-35,21,21,-1.285714,1,0,0,1,false,true,true,1,0
36,20,16,18,20,16,916,876,40,0,0,0,0,87,2,1,0.390805,0,0,8,14,false,true,false,0.419,0.581
263,239,24,21.916667,19.916667,24,1161,1166,-5,1,0,0.083333,0,10,12,12,3.5,0,1,9,15,false,true,true,0.624,0.376
356,285,71,25.428571,21.923077,71,1210,1253,-43,0,1,0,0.076923,-8,14,13,-4.25,0,0,8,14,false,true,true,0.999,0.001
298,250,48,17.529412,14.705882,48,1221,1438,-217,0,0,0,0,10,17,17,4.5,0,1,18,7,false,true,true,0.69,0.31
138,106,32,17.25,15.142857,32,859,822,37,0,0,0,0,46,8,7,0.826087,0,0,21,12,false,true,true,0.815,0.185
377,339,38,26.928571,26.076923,38,1659,1782,-123,1,0,0.071429,0,-10,14,13,-2.9,0,0,1,4,false,true,true,0.992,0.008
102,86,16,14.571429,12.285714,16,498,43,455,0,0,0,0,52,7,7,0.711538,1,0,11,17,false,true,true,0.583,0.417
391,282,109,18.619048,13.428571,109,746,796,-50,0,1,0,0.047619,-28,21,21,-1.714286,0,0,1,2,false,true,true,1,0
375,295,80,23.4375,19.666667,80,1109,1065,44,0,0,0,0,-26,16,15,-1.269231,0,0,1,1,false,true,true,1,0
207,186,21,20.7,20.666667,21,809,868,-59,1,0,0.1,0,30,10,9,1.066667,0,0,17,16,false,true,true,0.731,0.269
152,112,40,25.333333,18.666667,40,691,675,16,0,0,0,0,58,6,6,0.637931,0,1,13,7,false,true,true,0.976,0.024
180,131,49,20,14.555556,49,1037,950,87,1,0,0.111111,0,41,9,9,0.756098,0,0,10,12,false,true,true,0.958,0.042
329,268,61,19.352941,16.75,61,1221,1258,-37,1,0,0.058824,0,-2,17,16,-19.5,1,0,7,11,false,true,true,1,0
272,240,32,24.727273,21.818182,32,1388,1506,-118,2,1,0.181818,0.090909,28,11,11,1.214286,0,0,11,21,false,true,true,0.936,0.064
318,244,74,26.5,22.181818,74,1302,1234,68,1,1,0.083333,0.090909,16,12,11,1.9375,0,0,8,12,false,true,true,0.997,0.003
142,109,33,17.75,13.625,33,299,315,-16,0,0,0,0,48,8,8,0.875,1,0,8,17,false,true,true,0.919,0.081
306,290,16,20.4,19.333333,16,1295,1281,14,0,0,0,0,10,15,15,3.8,0,0,16,8,false,true,true,0.554,0.446
295,209,86,22.692308,17.416667,86,1216,1217,-1,1,0,0.076923,0,14,13,12,2.428571,0,0,11,11,false,true,true,0.998,0.002
106,98,8,15.142857,16.333333,8,971,761,210,0,0,0,0,52,7,6,0.576923,1,1,9,26,false,true,false,0.19,0.81
113,119,-6,22.6,23.8,-6,820,822,-2,0,0,0,0,62,5,5,0.629032,1,0,19,9,false,true,true,0.627,0.373
340,231,109,13.076923,8.884615,109,1428,1302,126,0,0,0,0,-34,26,26,-1.558824,0,1,12,11,false,true,true,0.999,0.001
174,165,9,12.428571,11.785714,9,892,768,124,0,0,0,0,25,14,14,1.72,0,0,15,21,false,true,true,0.526,0.474
73,68,5,18.25,17,5,908,859,49,0,0,0,0,70,4,4,0.557143,0,0,7,19,false,true,false,0.282,0.718
30,20,10,30,20,10,1586,1782,-196,0,0,0,0,91,1,1,0.43956,0,0,18,7,false,true,false,0.467,0.533
331,317,14,18.388889,18.647059,14,901,889,12,0,1,0,0.058824,-11,18,17,-3.909091,0,0,10,16,false,true,true,0.656,0.344
245,110,135,27.222222,13.75,135,1211,1173,38,0,0,0,0,45,9,8,0.777778,0,1,14,6,false,true,true,0.996,0.004
107,72,35,17.833333,12,35,1253,1166,87,0,0,0,0,63,6,6,0.68254,1,0,6,16,false,true,true,0.749,0.251
318,306,12,17.666667,18,12,1161,1166,-5,1,0,0.055556,0,-20,18,17,-1.75,0,1,1,9,true,true,true,0.973,0.027
326,269,57,25.076923,22.416667,57,1670,1770,-100,1,1,0.076923,0.083333,4,13,12,8,0,1,9,7,false,true,true,0.954,0.046
111,62,49,37,31,49,1428,1606,-178,1,0,0.333333,0,77,3,2,0.415584,1,0,8,14,false,true,true,0.858,0.142
80,62,18,26.666667,31,18,518,448,70,0,0,0,0,83,3,2,0.409639,0,0,10,12,false,true,true,0.613,0.387
162,223,-61,20.25,27.875,-61,758,952,-194,0,0,0,0,35,8,8,1.142857,1,0,13,10,false,true,false,0.106,0.894
122,89,33,13.555556,11.125,33,904,857,47,0,0,0,0,46,9,8,0.891304,0,1,16,17,false,true,false,0.357,0.643
333,128,205,41.625,18.285714,205,1550,1624,-74,1,0,0.125,0,47,8,7,0.638298,0,1,9,18,false,true,true,1,0
276,228,48,25.090909,22.8,48,795,830,-35,1,1,0.090909,0.1,20,11,10,2.1,0,0,17,13,false,true,true,0.936,0.064
325,292,33,25,24.333333,33,1154,1062,92,2,0,0.153846,0,13,13,12,2.692308,0,0,15,9,false,true,true,0.778,0.222
374,328,46,31.166667,27.333333,46,1237,1277,-40,0,0,0,0,-4,12,12,-7.25,0,0,23,3,false,true,true,0.953,0.047
140,148,-8,23.333333,24.666667,-8,1731,1691,40,0,0,0,0,55,6,6,0.618182,1,0,9,9,false,true,true,0.81,0.19
251,133,118,31.375,19,118,1075,1027,48,2,0,0.25,0,42,8,7,0.880952,0,0,7,10,false,true,true,0.999,0.001
136,55,81,22.666667,11,81,896,818,78,0,0,0,0,71,6,5,0.619718,0,0,17,16,false,true,true,0.942,0.058
226,180,46,22.6,18,46,719,651,68,0,1,0,0.1,44,10,10,1.022727,0,0,12,9,false,true,true,0.974,0.026
326,237,89,21.733333,16.928571,89,1394,1230,164,0,1,0,0.071429,1,15,14,38,0,0,20,22,false,true,true,0.849,0.151
52,69,-17,17.333333,23,-17,1548,1493,55,0,0,0,0,76,3,3,0.539474,1,0,6,8,false,true,true,0.691,0.309
348,282,66,23.2,18.8,66,1047,1094,-47,1,1,0.066667,0.066667,1,15,15,36,1,0,13,6,false,true,true,0.982,0.018
216,186,30,21.6,18.6,30,1493,1513,-20,1,0,0.1,0,32,10,10,1.03125,0,2,19,14,false,true,true,0.854,0.146
390,316,74,27.857143,24.307692,74,1156,1184,-28,2,1,0.142857,0.076923,-5,14,13,-5.6,0,0,3,9,false,true,true,0.999,0.001
188,181,7,23.5,22.625,7,907,752,155,0,0,0,0,44,8,8,0.75,0,0,15,8,false,true,true,0.735,0.265
261,205,56,17.4,14.642857,56,416,306,110,0,0,0,0,11,15,14,3.818182,0,0,8,10,false,true,true,0.976,0.024
357,283,74,25.5,21.769231,74,1245,1232,13,1,0,0.071429,0,-19,14,13,-1.526316,0,0,2,2,false,true,true,1,0
336,301,35,21,18.8125,35,892,788,104,3,0,0.1875,0,-5,16,16,-8.6,0,0,21,10,false,true,false,0.492,0.508
325,162,163,23.214286,12.461538,163,1033,1037,-4,0,1,0,0.076923,14,14,13,3.214286,0,0,23,9,false,true,true,1,0
298,172,126,29.8,19.111111,126,996,1063,-67,1,1,0.1,0.111111,23,10,9,1.391304,1,0,8,17,false,true,true,1,0
117,86,31,19.5,17.2,31,628,658,-30,0,0,0,0,61,6,5,0.754098,0,0,21,13,false,true,true,0.752,0.248
37,27,10,18.5,13.5,10,1439,1413,26,0,0,0,0,87,2,2,0.413793,0,0,13,10,false,true,true,0.501,0.499
195,209,-14,16.25,19,-14,1043,1055,-12,0,0,0,0,25,12,11,1.48,1,0,21,7,false,true,false,0.285,0.715
159,283,-124,19.875,35.375,-124,834,844,-10,0,2,0,0.25,34,8,8,1.058824,0,0,14,17,false,true,false,0.001,0.999
381,262,119,31.75,23.818182,119,1507,1554,-47,1,2,0.083333,0.181818,5,12,11,5.8,0,0,15,10,false,true,true,1,0
364,226,138,26,17.384615,138,1221,1266,-45,1,0,0.071429,0,0,14,13,0,0,0,24,7,false,true,true,1,0
94,127,-33,15.666667,25.4,-33,719,785,-66,0,1,0,0.2,58,6,5,0.62069,0,0,11,10,false,true,false,0.122,0.878
48,18,30,24,18,30,1305,1218,87,0,0,0,0,88,2,1,0.431818,0,0,11,10,false,true,true,0.523,0.477
302,277,25,30.2,27.7,25,1333,1331,2,1,0,0.1,0,10,10,10,3,0,0,15,10,false,true,true,0.746,0.254
34,53,-19,17,26.5,-19,1355,1210,145,0,0,0,0,84,2,2,0.357143,0,0,19,12,false,true,false,0.306,0.694
265,187,78,18.928571,14.384615,78,880,952,-72,0,0,0,0,8,14,13,5.125,0,0,16,19,false,true,true,0.991,0.009
114,76,38,22.8,15.2,38,576,532,44,0,0,0,0,65,5,5,0.707692,1,0,9,7,false,true,true,0.765,0.235
119,59,60,23.8,14.75,60,859,811,48,0,0,0,0,67,5,4,0.537313,0,0,12,8,false,true,true,0.882,0.118
175,143,32,17.5,15.888889,32,371,435,-64,0,0,0,0,29,10,9,1.517241,0,0,9,11,false,true,true,0.746,0.254
250,182,68,22.727273,18.2,68,1036,1181,-145,0,0,0,0,33,11,10,1.030303,0,0,16,8,false,true,true,0.905,0.095
350,336,14,16.666667,16.8,14,1782,1512,270,1,1,0.047619,0.05,-26,21,20,-1.615385,0,0,1,1,false,true,true,0.991,0.009
215,160,55,21.5,17.777778,55,1270,1315,-45,0,0,0,0,34,10,9,1.058824,1,0,9,20,false,true,true,0.826,0.174
329,317,12,20.5625,19.8125,12,869,820,49,0,1,0,0.0625,-13,16,16,-2.846154,0,0,8,5,false,true,true,0.937,0.063
302,227,75,16.777778,12.611111,75,691,675,16,0,0,0,0,-17,18,18,-2.235294,0,0,1,11,false,true,true,1,0
64,55,9,21.333333,27.5,9,758,796,-38,0,0,0,0,80,3,2,0.475,1,0,10,11,false,true,true,0.533,0.467
141,119,22,17.625,14.875,22,698,742,-44,0,0,0,0,56,8,8,0.732143,0,0,8,13,false,true,true,0.771,0.229
202,144,58,20.2,14.4,58,1091,1078,13,0,0,0,0,43,10,10,1,0,0,16,11,false,true,true,0.949,0.051
30,10,20,10,5,20,450,412,38,0,0,0,0,85,3,2,0.447059,0,1,7,9,false,true,false,0.386,0.614
64,104,-40,9.142857,17.333333,-40,480,518,-38,0,0,0,0,67,7,6,0.686567,0,1,10,8,false,true,false,0.09,0.91
328,246,82,27.333333,20.5,82,1550,1466,84,1,0,0.083333,0,16,12,12,2.3125,0,0,10,12,false,true,true,0.999,0.001
363,359,4,22.6875,23.933333,4,1636,1576,60,0,2,0,0.133333,-12,16,15,-2.833333,0,0,1,15,false,true,true,0.804,0.196
297,264,33,22.846154,20.307692,33,1493,1513,-20,1,0,0.076923,0,12,13,13,2.75,0,2,8,8,false,true,true,0.689,0.311
10,0,10,10,0,10,1159,1051,108,0,0,0,0,96,1,0,0.416667,0,0,18,0,false,true,true,0.52,0.48
156,132,24,39,33,24,1302,1349,-47,0,0,0,0,64,4,4,0.4375,0,0,10,7,false,true,true,0.712,0.288
270,243,27,16.875,16.2,27,908,859,49,0,0,0,0,2,16,15,19.5,0,0,12,12,false,true,true,0.621,0.379
120,104,16,24,26,16,1394,1424,-30,0,1,0,0.25,67,5,4,0.477612,0,0,21,14,false,true,true,0.679,0.321
290,180,110,18.125,11.25,110,871,867,4,0,0,0,0,4,16,16,10.75,0,1,17,16,false,true,true,1,0
80,70,10,26.666667,23.333333,10,820,783,37,0,0,0,0,79,3,3,0.417722,0,0,20,9,false,true,true,0.774,0.226
69,49,20,23,16.333333,20,871,867,4,0,0,0,0,76,3,3,0.565789,1,0,18,10,false,true,true,0.642,0.358
362,307,55,22.625,19.1875,55,1142,1095,47,1,0,0.0625,0,-16,16,16,-2.1875,0,0,8,5,false,true,true,0.999,0.001
365,329,36,21.470588,20.5625,36,965,1013,-48,1,0,0.058824,0,-18,17,16,-1.833333,0,1,3,3,true,true,true,0.998,0.002
221,179,42,24.555556,19.888889,42,1170,1156,14,1,0,0.111111,0,34,9,9,1.117647,1,0,7,16,false,true,true,0.899,0.101
241,168,73,21.909091,15.272727,73,746,796,-50,0,1,0,0.090909,23,11,11,2.086957,0,1,23,9,false,true,true,0.934,0.066
59,32,27,19.666667,16,27,1334,1477,-143,0,0,0,0,80,3,2,0.375,0,1,19,15,false,true,false,0.292,0.708
116,67,49,19.333333,13.4,49,1277,1166,111,0,0,0,0,64,6,5,0.5625,0,2,10,8,false,true,true,0.693,0.307
436,235,201,29.066667,15.666667,201,820,783,37,1,1,0.066667,0.066667,-11,15,15,-3,0,0,8,1,false,true,true,1,0
313,223,90,31.3,22.3,90,1489,1555,-66,1,0,0.1,0,21,10,10,1.380952,0,0,10,7,false,true,true,0.999,0.001
400,218,182,30.769231,16.769231,182,1513,1482,31,1,0,0.076923,0,0,13,13,0,0,1,9,23,false,true,true,1,0
322,267,55,17.888889,15.705882,55,671,725,-54,0,0,0,0,-18,18,17,-2.055556,0,0,4,1,false,true,true,0.999,0.001
262,238,24,13.789474,12.526316,24,947,909,38,0,0,0,0,-21,19,19,-2.190476,0,1,10,27,false,true,true,0.969,0.031
251,189,62,22.818182,17.181818,62,939,907,32,0,0,0,0,34,11,11,1.176471,2,0,5,10,false,true,true,0.979,0.021
203,159,44,20.3,15.9,44,831,830,1,0,0,0,0,33,10,10,1.121212,1,0,20,8,false,true,true,0.962,0.038
104,64,40,17.333333,10.666667,40,1394,1230,164,0,0,0,0,58,6,6,0.655172,0,0,7,7,false,true,true,0.581,0.419
269,289,-20,26.9,28.9,-20,1256,1232,24,1,0,0.1,0,21,10,10,1.428571,0,0,15,17,false,true,true,0.637,0.363
265,174,91,18.928571,12.428571,91,871,867,4,0,0,0,0,14,14,14,3.071429,0,1,20,16,false,true,true,0.994,0.006
181,158,23,30.166667,26.333333,23,2219,2106,113,1,0,0.166667,0,47,6,6,0.574468,0,0,15,13,false,true,false,0.441,0.559
142,100,42,28.4,20,42,306,169,137,0,0,0,0,62,5,5,0.548387,0,1,11,15,false,true,true,0.989,0.011
14,0,14,14,0,14,1334,1477,-143,0,0,0,0,94,1,0,0.319149,0,0,22,0,false,true,false,0.436,0.564
76,91,-15,15.2,18.2,-15,272,238,34,0,0,0,0,60,5,5,0.666667,0,0,22,12,false,true,true,0.567,0.433
339,220,119,18.833333,12.222222,119,871,867,4,0,0,0,0,-12,18,18,-3.583333,0,0,10,9,false,true,true,1,0
316,317,-1,14.363636,14.409091,-1,999,1011,-12,0,0,0,0,-31,22,22,-1.483871,1,0,1,5,false,true,true,0.958,0.042
428,316,112,30.571429,24.307692,112,1197,1127,70,0,0,0,0,-8,14,13,-3.75,0,0,3,9,false,true,true,1,0
210,182,28,23.333333,20.222222,28,948,933,15,1,0,0.111111,0,44,9,9,0.863636,0,0,10,11,false,true,true,0.754,0.246
77,86,-9,19.25,21.5,-9,1170,1156,14,0,0,0,0,76,4,4,0.5,1,0,6,18,false,true,true,0.621,0.379
326,243,83,21.733333,16.2,83,1394,1230,164,0,1,0,0.066667,-3,15,15,-12.666667,0,0,20,22,false,true,true,0.986,0.014
154,198,-44,15.4,19.8,-44,262,306,-44,0,0,0,0,39,10,10,1.179487,0,0,12,11,false,true,false,0.141,0.859
248,159,89,24.8,15.9,89,904,668,236,0,0,0,0,18,10,10,1.888889,0,2,14,7,false,true,true,0.926,0.074
272,243,29,16,15.1875,29,808,812,-4,0,0,0,0,-8,17,16,-4.625,1,0,8,8,false,true,true,0.849,0.151
191,228,-37,15.916667,19,-37,1077,1094,-17,0,0,0,0,26,12,12,1.615385,0,1,10,10,false,true,false,0.104,0.896
133,89,44,33.25,29.666667,44,1493,1513,-20,1,0,0.25,0,72,4,3,0.458333,0,1,16,6,false,true,true,0.523,0.477
295,289,6,26.818182,28.9,6,1256,1232,24,1,0,0.090909,0,17,11,10,1.764706,0,0,10,17,false,true,true,0.712,0.288
104,71,33,20.8,17.75,33,1094,1030,64,0,0,0,0,68,5,4,0.529412,0,0,7,8,false,true,true,0.537,0.463
190,89,101,27.142857,12.714286,101,1586,1782,-196,0,0,0,0,50,7,7,0.8,1,0,9,7,false,true,true,0.976,0.024
115,127,-12,19.166667,21.166667,-12,1127,1134,-7,0,0,0,0,55,6,6,0.545455,1,0,13,13,false,true,true,0.52,0.48
207,170,37,23,21.25,37,1548,1493,55,1,0,0.111111,0,38,9,8,1.078947,0,0,12,8,false,true,true,0.783,0.217
381,239,142,17.318182,10.863636,142,896,818,78,0,1,0,0.045455,-25,22,22,-1.76,1,0,5,5,true,true,true,1,0
214,199,15,16.461538,16.583333,15,725,771,-46,0,1,0,0.083333,22,13,12,2.090909,1,0,6,15,false,true,true,0.794,0.206
180,161,19,18,16.1,19,613,502,111,0,0,0,0,34,10,10,1.441176,0,0,7,24,false,true,true,0.73,0.27
121,130,-9,17.285714,18.571429,-9,808,639,169,0,0,0,0,44,7,7,0.931818,0,0,32,7,false,true,true,0.668,0.332
189,113,76,23.625,16.142857,76,1388,1477,-89,1,0,0.125,0,47,8,7,1.021277,0,0,8,10,false,true,true,0.92,0.08
301,303,-2,21.5,21.642857,-2,1265,1045,220,0,1,0,0.071429,1,14,14,42,0,0,14,8,false,true,true,0.563,0.437
438,288,150,15.642857,10.666667,150,1176,1076,100,0,0,0,0,-32,28,27,-1.84375,0,0,1,3,false,true,true,1,0
396,215,181,30.461538,16.538462,181,820,783,37,1,0,0.076923,0,6,13,13,5.5,0,0,7,10,false,true,true,1,0
65,106,-41,16.25,26.5,-41,1075,989,86,0,0,0,0,73,4,4,0.534247,0,0,28,11,false,true,false,0.268,0.732
51,79,-28,12.75,19.75,-28,758,750,8,0,0,0,0,67,4,4,0.552239,1,0,10,12,false,true,false,0.468,0.532
55,45,10,18.333333,22.5,10,1189,1266,-77,0,0,0,0,83,3,2,0.409639,1,0,19,12,false,true,true,0.808,0.192
346,308,38,21.625,20.533333,38,1304,1040,264,1,0,0.0625,0,-5,16,15,-6.6,0,1,2,2,false,true,true,0.988,0.012
308,241,67,19.25,16.066667,67,1040,925,115,0,0,0,0,-10,16,15,-4.3,0,0,16,14,false,true,true,0.998,0.002
348,268,80,23.2,19.142857,80,1047,1094,-47,1,1,0.066667,0.071429,4,15,14,9,1,0,13,7,false,true,true,0.997,0.003
312,205,107,28.363636,18.636364,107,769,527,242,1,0,0.090909,0,13,11,11,2.769231,0,0,10,9,false,true,true,1,0
136,174,-38,11.333333,14.5,-38,480,518,-38,0,0,0,0,32,12,12,1.4375,0,1,27,13,false,true,false,0.089,0.911
130,168,-38,18.571429,28,-38,594,605,-11,0,0,0,0,59,7,6,0.627119,1,0,8,10,false,true,false,0.11,0.89
308,146,162,18.117647,9.125,162,993,897,96,1,0,0.058824,0,-6,17,16,-7.833333,0,1,26,20,false,true,true,1,0
291,221,70,29.1,22.1,70,977,976,1,1,0,0.1,0,31,10,10,1.096774,0,0,12,8,false,true,true,0.972,0.028
148,126,22,18.5,18,22,808,812,-4,0,0,0,0,42,8,7,0.880952,1,0,16,17,false,true,true,0.52,0.48
178,69,109,29.666667,13.8,109,976,965,11,0,0,0,0,58,6,5,0.551724,0,0,7,26,false,true,true,0.997,0.003
358,227,131,29.833333,18.916667,131,1439,1353,86,1,0,0.083333,0,12,12,12,2.5,0,0,11,22,false,true,true,1,0
263,221,42,23.909091,20.090909,42,976,965,11,1,0,0.090909,0,14,11,11,2.285714,1,0,11,14,false,true,true,0.979,0.021
68,0,68,68,0,68,1245,1241,4,1,0,1,0,93,1,0,0.311828,0,0,14,0,false,true,true,0.533,0.467
222,228,-6,17.076923,19,-6,1077,1094,-17,0,0,0,0,23,13,12,1.826087,0,1,7,10,false,true,false,0.115,0.885
279,308,-29,25.363636,28,-29,1762,1538,224,1,2,0.090909,0.181818,18,11,11,1.888889,0,0,21,11,false,true,true,0.966,0.034
217,206,11,19.727273,20.6,11,1027,856,171,1,1,0.090909,0.1,15,11,10,2.2,1,0,21,10,false,true,true,0.936,0.064
122,167,-45,17.428571,27.833333,-45,947,810,137,0,1,0,0.166667,52,7,6,0.807692,0,0,29,14,false,true,false,0.366,0.634
212,206,6,26.5,29.428571,6,1030,1144,-114,0,1,0,0.142857,47,8,7,0.744681,0,1,15,7,false,true,false,0.2,0.8
97,92,5,19.4,23,5,892,819,73,0,1,0,0.25,66,5,4,0.515152,1,0,23,9,false,true,true,0.667,0.333
416,374,42,21.894737,19.684211,42,1220,1261,-41,2,0,0.105263,0,-15,19,19,-3,0,0,11,3,false,true,true,0.977,0.023
97,46,51,19.4,9.2,51,777,830,-53,0,0,0,0,70,5,5,0.585714,0,0,10,11,false,true,true,0.888,0.112
330,188,142,25.384615,15.666667,142,1482,1394,88,2,0,0.153846,0,13,13,12,2.769231,0,0,10,18,false,true,true,1,0
368,321,47,20.444444,18.882353,47,960,1070,-110,1,0,0.055556,0,-17,18,17,-2.058824,0,0,1,1,true,true,true,0.998,0.002
58,61,-3,19.333333,20.333333,-3,864,808,56,0,0,0,0,75,3,3,0.453333,0,0,7,11,false,true,false,0.387,0.613
267,186,81,29.666667,23.25,81,1355,1210,145,1,0,0.111111,0,36,9,8,0.833333,0,0,9,9,false,true,true,0.953,0.047
49,104,-55,8.166667,17.333333,-55,480,518,-38,0,0,0,0,70,6,6,0.657143,0,1,9,8,false,true,false,0.072,0.928
30,0,30,30,0,30,1691,1692,-1,0,0,0,0,95,1,0,0.315789,0,0,9,0,false,true,false,0.491,0.509
396,310,86,24.75,19.375,86,1428,1606,-178,1,0,0.0625,0,-15,16,16,-2.133333,0,0,2,1,true,true,true,1,0
304,277,27,20.266667,18.466667,27,838,786,52,0,1,0,0.066667,-4,15,15,-8,0,0,4,3,false,true,true,0.972,0.028
10,0,10,10,0,10,566,542,24,0,0,0,0,98,1,0,0.418367,0,0,11,0,false,true,true,0.512,0.488
345,318,27,15.681818,15.142857,27,628,658,-30,0,0,0,0,-24,22,21,-1.916667,0,0,1,5,false,true,true,0.983,0.017
130,57,73,26,14.25,73,1210,1253,-43,0,0,0,0,64,5,4,0.53125,0,1,19,8,false,true,true,0.736,0.264
245,183,62,27.222222,20.333333,62,880,952,-72,0,0,0,0,40,9,9,0.875,0,0,22,12,false,true,true,0.852,0.148
10,28,-18,3.333333,14,-18,791,774,17,0,0,0,0,91,3,2,0.450549,0,0,11,14,false,true,false,0.11,0.89
286,290,-4,15.052632,16.111111,-4,613,549,64,0,0,0,0,-20,19,18,-2.2,0,0,3,3,false,true,false,0.233,0.767
273,218,55,17.0625,14.533333,55,786,788,-2,0,0,0,0,-12,16,15,-2.833333,1,0,2,16,false,true,true,0.999,0.001
47,49,-2,15.666667,16.333333,-2,1090,1244,-154,0,0,0,0,77,3,3,0.480519,0,0,19,20,false,true,false,0.183,0.817
232,167,65,38.666667,33.4,65,1885,1793,92,0,0,0,0,50,6,5,0.54,0,0,22,7,false,true,true,0.975,0.025
211,210,1,16.230769,16.153846,1,908,859,49,0,0,0,0,16,13,13,2.4375,0,1,17,11,false,true,false,0.22,0.78
254,133,121,23.090909,13.3,121,1159,1031,128,1,0,0.090909,0,23,11,10,1.695652,0,0,7,17,false,true,true,1,0
273,212,61,22.75,19.272727,61,1221,1266,-45,0,0,0,0,18,12,11,1.944444,2,0,6,7,false,true,true,0.987,0.013
179,153,26,16.272727,13.909091,26,363,668,-305,0,0,0,0,34,11,11,1.264706,0,0,10,14,false,true,false,0.498,0.502
131,72,59,32.75,24,59,1762,1616,146,1,0,0.25,0,70,4,3,0.428571,0,0,10,14,false,true,true,0.54,0.46
23,40,-17,11.5,40,-17,1305,1242,63,0,0,0,0,91,2,1,0.373626,0,0,10,14,false,true,false,0.113,0.887
409,291,118,29.214286,20.785714,118,1023,1070,-47,2,0,0.142857,0,-6,14,14,-5.333333,0,0,3,12,false,true,true,1,0
290,183,107,20.714286,13.071429,107,925,801,124,1,0,0.071429,0,14,14,14,2.857143,1,0,9,10,false,true,true,0.999,0.001
233,182,51,21.181818,16.545455,51,844,821,23,0,0,0,0,42,11,11,1,0,0,23,9,false,true,true,0.956,0.044
60,47,13,12,11.75,13,658,817,-159,0,0,0,0,76,5,4,0.5,0,1,23,10,false,true,false,0.26,0.74
54,56,-2,13.5,18.666667,-2,518,533,-15,1,0,0.25,0,74,4,3,0.472973,0,0,19,18,false,true,false,0.28,0.72
41,25,16,20.5,25,16,613,569,44,0,0,0,0,84,2,1,0.464286,2,0,11,20,false,true,true,0.863,0.137
262,210,52,23.818182,19.090909,52,1731,1691,40,1,0,0.090909,0,17,11,11,2,0,0,10,9,false,true,true,0.924,0.076
419,218,201,29.928571,16.769231,201,1513,1482,31,1,0,0.071429,0,-2,14,13,-16.5,0,1,5,23,false,true,true,1,0
223,145,78,17.153846,12.083333,78,1069,1040,29,0,0,0,0,15,13,12,2.933333,0,2,7,7,false,true,true,0.816,0.184
20,18,2,20,18,2,1645,1777,-132,0,0,0,0,90,1,1,0.277778,0,0,15,12,false,true,false,0.327,0.673
90,38,52,22.5,9.5,52,1413,1422,-9,0,0,0,0,70,4,4,0.814286,1,0,16,18,false,true,true,0.933,0.067
281,229,52,20.071429,16.357143,52,1221,1258,-37,1,0,0.071429,0,15,14,14,2.6,0,0,10,15,false,true,true,0.966,0.034
241,213,28,18.538462,16.384615,28,609,620,-11,0,0,0,0,11,13,13,3.363636,0,0,8,12,false,true,true,0.774,0.226
348,240,108,23.2,16,108,596,595,1,1,0,0.066667,0,0,15,15,0,0,0,7,25,false,true,true,0.999,0.001
190,142,48,14.615385,11.833333,48,1128,889,239,0,1,0,0.083333,29,13,12,1.62069,0,0,28,20,false,true,true,0.802,0.198
55,26,29,27.5,26,29,518,448,70,0,0,0,0,90,2,1,0.377778,1,1,6,16,false,true,false,0.006,0.994
298,234,64,18.625,15.6,64,450,412,38,0,0,0,0,-9,16,15,-4.222222,0,0,6,13,false,true,true,0.999,0.001
67,118,-51,16.75,39.333333,-51,1762,1538,224,0,1,0,0.333333,73,4,3,0.465753,0,0,10,10,false,true,true,0.658,0.342
213,208,5,17.75,17.333333,5,1388,1477,-89,1,0,0.083333,0,25,12,12,1.92,0,0,12,18,false,true,false,0.414,0.586
341,317,24,22.733333,21.133333,24,1177,1214,-37,0,0,0,0,-8,15,15,-4.375,0,0,6,3,false,true,true,0.978,0.022
97,90,7,24.25,22.5,7,804,988,-184,1,0,0.25,0,69,4,4,0.478261,0,0,11,26,false,true,false,0.247,0.753
416,266,150,24.470588,16.625,150,1221,1266,-45,1,0,0.058824,0,-21,17,16,-1.666667,0,0,13,5,false,true,true,1,0
344,263,81,20.235294,16.4375,81,691,473,218,0,0,0,0,-13,17,16,-2.769231,1,0,0,2,false,true,true,1,0
40,32,8,20,16,8,1334,1477,-143,0,0,0,0,84,2,2,0.357143,0,1,22,15,false,true,false,0.343,0.657
169,283,-114,18.777778,35.375,-114,834,844,-10,0,2,0,0.25,31,9,8,1.16129,0,0,11,17,false,true,false,0.001,0.999
157,125,32,17.444444,13.888889,32,363,668,-305,0,0,0,0,50,9,9,0.86,0,0,8,13,false,true,true,0.633,0.367
354,261,93,23.6,18.642857,93,1034,1040,-6,1,0,0.066667,0,0,15,14,0,1,0,11,10,false,true,true,1,0
310,202,108,28.181818,18.363636,108,1408,1454,-46,1,0,0.090909,0,24,11,11,1.333333,0,0,13,9,false,true,true,1,0
322,261,61,24.769231,21.75,61,856,897,-41,0,1,0,0.083333,2,13,12,17.5,0,0,17,8,false,true,true,0.952,0.048
12,0,12,12,0,12,1076,1176,-100,0,0,0,0,95,1,0,0.336842,0,0,8,0,false,true,false,0.295,0.705
281,193,88,25.545455,17.545455,88,1651,1691,-40,1,0,0.090909,0,27,11,11,1.259259,0,0,16,10,false,true,true,0.982,0.018
73,105,-32,24.333333,35,-32,1030,1144,-114,0,1,0,0.333333,74,3,3,0.472973,0,0,12,15,false,true,false,0.253,0.747
26,0,26,26,0,26,1583,1422,161,0,0,0,0,95,1,0,0.536842,0,0,17,0,false,true,true,0.536,0.464
84,97,-13,16.8,19.4,-13,620,513,107,0,0,0,0,68,5,5,0.661765,0,1,9,6,false,true,false,0.409,0.591
169,94,75,24.142857,13.428571,75,719,651,68,0,0,0,0,63,7,7,0.714286,0,0,19,8,false,true,true,0.974,0.026
122,157,-35,11.090909,14.272727,-35,826,771,55,0,0,0,0,42,11,11,1.071429,0,1,12,9,false,true,false,0.174,0.826
349,245,104,34.9,27.222222,104,1824,1793,31,1,0,0.1,0,27,10,9,1.037037,1,0,8,11,false,true,true,1,0
340,222,118,21.25,13.875,118,303,342,-39,0,0,0,0,0,16,16,0,0,0,10,7,false,true,true,1,0
287,141,146,22.076923,10.846154,146,1067,95,972,1,0,0.076923,0,13,13,13,2.615385,1,1,13,7,false,true,true,1,0
112,101,11,37.333333,33.666667,11,1030,998,32,0,0,0,0,75,3,3,0.506667,0,0,8,10,false,true,true,0.543,0.457
332,310,22,19.529412,19.375,22,594,605,-11,0,0,0,0,-15,17,16,-2.466667,0,0,2,2,false,true,true,0.974,0.026
208,160,48,20.8,17.777778,48,820,822,-2,0,0,0,0,36,10,9,1.083333,0,0,14,10,false,true,true,0.858,0.142
207,173,34,29.571429,24.714286,34,1397,1195,202,1,0,0.142857,0,45,7,7,0.777778,0,0,21,13,false,true,true,0.739,0.261
81,115,-34,16.2,23,-34,892,788,104,0,0,0,0,69,5,5,0.623188,1,0,13,13,false,true,false,0.382,0.618
14,13,1,14,13,1,971,658,313,0,0,0,0,94,1,1,0.382979,0,0,11,11,false,true,true,0.531,0.469
64,72,-8,21.333333,24,-8,758,796,-38,0,0,0,0,77,3,3,0.493506,1,0,10,14,false,true,true,0.529,0.471
472,267,205,52.444444,29.666667,205,991,996,-5,3,0,0.333333,0,23,9,9,1.304348,0,0,7,7,false,true,true,0.999,0.001
347,250,97,26.692308,20.833333,97,880,952,-72,0,0,0,0,12,13,12,2.916667,0,0,7,10,false,true,true,1,0
363,229,134,30.25,20.818182,134,1826,1803,23,1,0,0.083333,0,10,12,11,3,1,0,13,9,false,true,true,1,0
59,82,-23,9.833333,16.4,-23,416,374,42,0,0,0,0,73,6,5,0.630137,1,0,9,10,false,true,false,0.259,0.741
144,135,9,16,15,9,691,675,16,0,0,0,0,37,9,9,1.027027,0,0,14,24,false,true,true,0.705,0.295
309,262,47,14.045455,11.909091,47,584,565,19,0,0,0,0,-35,22,22,-1.314286,0,0,1,2,false,true,true,0.999,0.001
295,225,70,18.4375,14.0625,70,620,513,107,0,0,0,0,2,16,16,22.5,0,0,21,7,false,true,true,0.982,0.018
256,201,55,23.272727,20.1,55,1156,1184,-28,1,0,0.090909,0,22,11,10,1.272727,1,0,8,17,false,true,true,0.955,0.045
265,245,20,17.666667,16.333333,20,523,480,43,1,0,0.066667,0,-13,15,15,-2.538462,0,0,8,2,false,true,true,0.948,0.052
50,6,44,25,6,44,904,783,121,0,0,0,0,90,2,1,0.466667,0,0,13,12,false,true,true,0.843,0.157
344,271,73,21.5,18.066667,73,1452,1469,-17,1,1,0.0625,0.066667,-8,16,15,-4.75,0,0,5,19,false,true,true,0.999,0.001
272,264,8,24.727273,24,8,1394,1424,-30,0,1,0,0.090909,24,11,11,1.333333,1,0,6,11,false,true,true,0.931,0.069
121,66,55,40.333333,33,55,1493,1513,-20,1,0,0.333333,0,77,3,2,0.428571,0,1,13,6,false,true,true,0.525,0.475
47,82,-35,9.4,16.4,-35,416,374,42,0,0,0,0,76,5,5,0.605263,1,0,12,10,false,true,false,0.336,0.664
154,133,21,19.25,16.625,21,871,999,-128,0,0,0,0,46,8,8,1.043478,0,0,7,28,false,true,false,0.464,0.536
305,272,33,16.052632,14.315789,33,804,683,121,0,0,0,0,-12,19,19,-3.75,0,1,15,6,false,true,true,0.945,0.055
317,282,35,15.095238,13.428571,35,804,683,121,0,0,0,0,-24,21,21,-1.875,0,1,13,2,false,true,true,0.851,0.149
154,129,25,17.111111,14.333333,25,758,750,8,0,0,0,0,34,9,9,1.088235,0,1,9,11,false,true,true,0.603,0.397
187,168,19,15.583333,15.272727,19,904,857,47,0,0,0,0,25,12,11,1.64,1,0,9,14,false,true,true,0.641,0.359
384,281,103,29.538462,23.416667,103,1735,1770,-35,2,1,0.153846,0.083333,-3,13,12,-9.333333,0,1,11,7,false,true,true,0.998,0.002
278,235,43,19.857143,16.785714,43,1221,1438,-217,0,0,0,0,19,14,14,2.368421,0,1,19,7,false,true,true,0.674,0.326
44,46,-2,14.666667,23,-2,1159,1051,108,0,0,0,0,82,3,2,0.487805,0,0,16,17,false,true,false,0.251,0.749
68,39,29,17,13,29,303,342,-39,0,0,0,0,80,4,3,0.475,0,0,18,13,false,true,true,0.802,0.198
39,76,-37,19.5,38,-37,315,294,21,0,1,0,0.5,85,2,2,0.411765,0,0,10,26,false,true,true,0.546,0.454
224,139,85,28,19.857143,85,1167,1216,-49,1,0,0.125,0,45,8,7,0.911111,1,0,10,17,false,true,true,0.994,0.006
38,49,-11,9.5,16.333333,-11,1221,1258,-37,0,0,0,0,82,4,3,0.47561,0,0,8,9,false,true,false,0.236,0.764
20,13,7,10,6.5,7,1016,1037,-21,0,0,0,0,91,2,2,0.527473,0,0,15,12,false,true,false,0.467,0.533
366,283,83,24.4,20.214286,83,1109,1065,44,0,0,0,0,-19,15,14,-1.736842,0,0,5,4,false,true,true,1,0
323,279,44,29.363636,27.9,44,1826,1656,170,2,0,0.181818,0,13,11,10,2.076923,1,0,13,13,false,true,true,0.98,0.02
320,290,30,24.615385,22.307692,30,965,1013,-48,1,0,0.076923,0,0,13,13,0,0,1,8,8,false,true,true,0.976,0.024
14,38,-24,7,19,-24,416,374,42,0,0,0,0,88,2,2,0.522727,0,0,11,18,false,true,false,0.222,0.778
186,118,68,37.2,29.5,68,1571,1554,17,2,1,0.4,0.25,58,5,4,0.568966,0,0,9,11,false,true,true,0.954,0.046
183,102,81,18.3,11.333333,81,595,543,52,0,0,0,0,43,10,9,1.093023,1,0,15,10,false,true,true,0.981,0.019
108,138,-30,18,23,-30,334,446,-112,0,0,0,0,58,6,6,0.689655,0,0,10,10,false,true,false,0.143,0.857
351,268,83,27,22.333333,83,1245,1232,13,1,0,0.076923,0,-10,13,12,-2.9,0,1,3,2,false,true,true,1,0
260,176,84,21.666667,16,84,1159,1031,128,1,0,0.083333,0,16,12,11,2.4375,0,0,7,16,false,true,true,0.999,0.001
80,79,1,26.666667,26.333333,1,518,448,70,0,0,0,0,79,3,3,0.43038,0,0,10,11,false,true,true,0.653,0.347
321,206,115,26.75,17.166667,115,939,907,32,1,0,0.083333,0,25,12,12,1.6,0,0,15,7,false,true,true,0.999,0.001
231,230,1,23.1,23,1,856,897,-41,0,1,0,0.1,17,10,10,2.058824,0,0,26,11,false,true,true,0.735,0.265
361,313,48,25.785714,24.076923,48,1075,1009,66,2,0,0.142857,0,-2,14,13,-16,0,0,6,11,false,true,true,0.998,0.002
287,258,29,16.882353,15.176471,29,904,857,47,0,0,0,0,-6,17,17,-6.833333,0,0,20,5,false,true,true,0.969,0.031
366,239,127,20.333333,14.058824,127,1011,921,90,1,0,0.055556,0,-4,18,17,-12.25,0,0,11,16,false,true,true,1,0
145,111,34,18.125,15.857143,34,363,668,-305,0,0,0,0,58,8,7,0.741379,0,0,9,12,false,true,true,0.533,0.467
293,151,142,48.833333,30.2,142,991,996,-5,2,0,0.333333,0,53,6,5,0.566038,1,0,11,9,false,true,true,1,0
358,276,82,19.888889,16.235294,82,939,913,26,0,1,0,0.058824,-14,18,17,-2.857143,1,0,1,6,false,true,true,1,0
205,192,13,18.636364,17.454545,13,1090,1244,-154,0,0,0,0,25,11,11,1.48,0,1,10,13,false,true,false,0.199,0.801
269,228,41,26.9,25.333333,41,1439,1397,42,1,2,0.1,0.222222,18,10,9,1.888889,0,0,14,10,false,true,true,0.791,0.209
73,77,-4,18.25,25.666667,-4,1177,1214,-37,0,0,0,0,74,4,3,0.472973,0,0,15,15,false,true,false,0.141,0.859
374,241,133,17.809524,12.05,133,595,543,52,0,0,0,0,-24,21,20,-1.958333,0,0,8,6,false,true,true,1,0
138,124,14,23,20.666667,14,1556,1591,-35,0,0,0,0,58,6,6,0.62069,1,1,18,17,false,true,false,0.454,0.546
245,228,17,15.3125,14.25,17,613,502,111,0,0,0,0,-3,16,16,-16.333333,1,0,7,19,false,true,true,0.983,0.017
99,44,55,33,14.666667,55,1572,1550,22,1,0,0.333333,0,77,3,3,0.506494,0,0,11,10,false,true,true,0.54,0.46
140,64,76,23.333333,12.8,76,1875,1793,82,1,0,0.166667,0,66,6,5,0.454545,1,0,11,8,false,true,true,0.976,0.024
127,140,-13,15.875,17.5,-13,611,584,27,0,0,0,0,54,8,8,0.814815,0,0,8,7,false,true,false,0.282,0.718
223,184,39,11.736842,10.222222,39,416,222,194,0,0,0,0,-6,19,18,-9.166667,0,0,14,26,false,true,true,0.92,0.08
204,164,40,20.4,16.4,40,691,473,218,0,0,0,0,30,10,10,1.2,0,0,15,19,false,true,true,0.791,0.209
218,154,64,36.333333,25.666667,64,1302,1349,-47,0,0,0,0,46,6,6,0.608696,0,1,13,9,false,true,true,0.989,0.011
246,95,151,30.75,13.571429,151,1093,1100,-7,2,1,0.25,0.142857,52,8,7,0.615385,0,1,8,13,false,true,true,1,0
236,105,131,23.6,11.666667,131,942,1003,-61,0,0,0,0,32,10,9,1.40625,0,1,24,17,false,true,true,0.996,0.004
218,171,47,24.222222,21.375,47,1344,1209,135,1,1,0.111111,0.125,32,9,8,1.0625,0,0,7,16,false,true,true,0.881,0.119
273,242,31,18.2,16.133333,31,885,719,166,0,0,0,0,1,15,15,38,0,0,9,14,false,true,true,0.938,0.062
14,0,14,14,0,14,1355,1210,145,0,0,0,0,97,1,0,0.309278,0,0,18,0,false,true,true,0.523,0.477
33,33,0,11,16.5,0,299,315,-16,0,0,0,0,84,3,2,0.5,0,0,7,17,false,true,false,0.188,0.812
88,65,23,14.666667,13,23,346,231,115,0,0,0,0,57,6,5,0.719298,0,0,10,12,false,true,true,0.736,0.264
187,142,45,18.7,15.777778,45,1181,1069,112,0,0,0,0,36,10,9,1.027778,1,0,15,8,false,true,true,0.863,0.137
33,27,6,16.5,13.5,6,620,658,-38,0,0,0,0,84,2,2,0.428571,1,0,9,10,false,true,true,0.525,0.475
159,126,33,31.8,25.2,33,1344,1325,19,1,0,0.2,0,58,5,5,0.534483,0,0,13,15,false,true,true,0.628,0.372
176,180,-4,14.666667,15,-4,658,817,-159,0,0,0,0,28,12,12,1.357143,0,0,19,19,false,true,false,0.445,0.555
198,194,4,16.5,16.166667,4,613,461,152,0,1,0,0.083333,10,12,12,3.7,0,0,11,14,false,true,true,0.842,0.158
170,105,65,34,21,65,1880,1777,103,1,0,0.2,0,59,5,5,0.474576,0,1,7,19,false,true,true,1,0
186,282,-96,16.909091,25.636364,-96,1265,1045,220,0,1,0,0.090909,17,11,11,2.470588,0,0,23,9,false,true,false,0.058,0.942
352,268,84,29.333333,22.333333,84,1397,1361,36,1,0,0.083333,0,3,12,12,9.666667,0,0,5,6,false,true,true,1,0
87,151,-64,21.75,37.75,-64,1075,1009,66,0,0,0,0,67,4,4,0.477612,0,0,8,17,false,true,false,0.108,0.892
245,172,73,35,24.571429,73,1510,1583,-73,1,0,0.142857,0,39,7,7,0.820513,0,0,10,11,false,true,true,0.935,0.065
163,135,28,27.166667,22.5,28,1344,1209,135,1,1,0.166667,0.166667,53,6,6,0.641509,0,0,8,19,false,true,true,0.754,0.246
293,309,-16,20.928571,22.071429,-16,1210,1252,-42,1,0,0.071429,0,0,14,14,0,1,0,8,9,false,true,false,0.217,0.783
103,82,21,34.333333,41,21,1344,1209,135,0,1,0,0.5,74,3,2,0.459459,0,0,16,10,false,true,false,0.261,0.739
119,113,6,17,16.142857,6,1011,921,90,0,0,0,0,55,7,7,0.890909,0,0,7,20,false,true,false,0.292,0.708
264,235,29,20.307692,19.583333,29,1094,1030,64,0,0,0,0,10,13,12,3.6,0,0,14,11,false,true,true,0.728,0.272
358,220,138,19.888889,12.941176,138,1586,1782,-196,0,0,0,0,-13,18,17,-3.076923,1,0,4,4,false,true,true,1,0
380,353,27,23.75,23.533333,27,1075,1009,66,2,0,0.125,0,-12,16,15,-2.666667,0,0,1,2,false,true,true,0.964,0.036
262,185,77,18.714286,14.230769,77,739,480,259,1,0,0.071429,0,14,14,13,2.571429,0,1,16,13,false,true,true,0.99,0.01
92,104,-12,15.333333,20.8,-12,691,675,16,0,0,0,0,59,6,5,0.644068,0,0,25,7,false,true,false,0.287,0.713
338,271,67,24.142857,20.846154,67,1434,1493,-59,1,0,0.071429,0,1,14,13,37,0,1,11,5,false,true,true,0.899,0.101
347,221,126,26.692308,18.416667,126,695,671,24,0,0,0,0,10,13,12,3.3,0,0,7,14,false,true,true,1,0
165,164,1,18.333333,18.222222,1,1394,1230,164,0,1,0,0.111111,36,9,9,1.055556,0,1,13,15,false,true,false,0.025,0.975
334,356,-22,30.363636,35.6,-22,2219,2029,190,0,0,0,0,4,11,10,6.5,0,0,10,17,false,true,true,0.881,0.119
94,114,-20,15.666667,19,-20,671,725,-54,0,0,0,0,56,6,6,0.660714,1,0,6,14,false,true,false,0.331,0.669
179,138,41,25.571429,23,41,1493,1513,-20,1,0,0.142857,0,55,7,6,0.6,0,1,17,9,false,true,true,0.514,0.486
165,132,33,23.571429,18.857143,33,804,988,-184,1,0,0.142857,0,49,7,7,0.673469,0,0,13,19,false,true,true,0.731,0.269
313,220,93,20.866667,15.714286,93,527,503,24,0,0,0,0,10,15,14,4.1,0,0,7,7,false,true,true,1,0
335,284,51,19.705882,17.75,51,904,783,121,0,0,0,0,-6,17,16,-7,1,0,11,8,false,true,true,0.998,0.002
188,152,36,23.5,21.714286,36,907,752,155,0,0,0,0,47,8,7,0.702128,0,0,15,11,false,true,true,0.753,0.247
47,32,15,15.666667,16,15,1090,1244,-154,0,0,0,0,80,3,2,0.4625,0,0,19,12,false,true,false,0.395,0.605
223,147,76,37.166667,24.5,76,1320,1339,-19,2,1,0.333333,0.166667,49,6,6,0.795918,0,1,11,19,false,true,true,1,0
194,168,26,27.714286,24,26,1670,1770,-100,1,1,0.142857,0.142857,49,7,7,0.653061,0,0,15,17,false,true,true,0.736,0.264
387,360,27,25.8,25.714286,27,1489,1555,-66,1,0,0.066667,0,-11,15,14,-2.636364,0,0,5,10,true,true,true,0.98,0.02
68,13,55,68,13,55,371,336,35,1,0,1,0,89,1,1,0.426966,0,0,14,10,false,true,true,0.506,0.494
87,76,11,17.4,19,11,262,306,-44,0,0,0,0,77,5,4,0.597403,0,0,23,14,false,true,true,0.724,0.276
173,74,99,28.833333,12.333333,99,1014,1303,-289,1,0,0.166667,0,56,6,6,0.678571,0,1,18,7,false,true,true,0.879,0.121
31,41,-10,15.5,41,-10,416,306,110,0,0,0,0,92,2,1,0.456522,0,0,25,12,false,true,false,0.294,0.706
358,272,86,16.272727,12.952381,86,711,876,-165,0,0,0,0,-18,22,21,-2.388889,0,0,3,1,true,true,true,1,0
144,128,16,18,16,16,580,620,-40,0,0,0,0,53,8,8,0.811321,1,0,7,10,false,true,true,0.628,0.372
72,81,-9,12,16.2,-9,1214,1176,38,0,0,0,0,64,6,5,0.5625,1,1,15,6,false,true,false,0.253,0.747
396,270,126,26.4,19.285714,126,1489,1445,44,1,0,0.066667,0,-1,15,14,-32,0,0,2,5,false,true,true,1,0
120,76,44,30,19,44,1556,1591,-35,0,0,0,0,73,4,4,0.493151,0,0,19,10,false,true,true,0.79,0.21
110,62,48,36.666667,31,48,1684,1320,364,1,0,0.333333,0,79,3,2,0.379747,0,0,8,14,false,true,true,0.911,0.089
356,246,110,35.6,27.333333,110,1645,1777,-132,2,0,0.2,0,9,10,9,2.777778,0,0,8,7,false,true,true,1,0
259,263,-4,19.923077,20.230769,-4,901,889,12,0,1,0,0.076923,18,13,13,2.388889,0,0,17,8,false,true,true,0.72,0.28
408,339,69,27.2,24.214286,69,1793,1897,-104,2,0,0.133333,0,-11,15,14,-2.727273,0,0,3,10,false,true,true,0.999,0.001
172,163,9,21.5,23.285714,9,290,416,-126,0,0,0,0,47,8,7,0.723404,0,0,18,19,false,true,true,0.715,0.285
136,93,43,19.428571,15.5,43,1090,1244,-154,0,0,0,0,53,7,6,0.698113,0,0,11,19,false,true,false,0.346,0.654
212,177,35,21.2,19.666667,35,1452,1469,-17,0,1,0,0.111111,34,10,9,1.117647,1,0,6,21,false,true,true,0.927,0.073
93,60,33,15.5,10,33,1281,1339,-58,0,0,0,0,67,6,6,0.61194,1,1,18,9,false,true,false,0.473,0.527
364,301,63,21.411765,18.8125,63,892,788,104,3,0,0.176471,0,-7,17,16,-6.142857,0,0,14,10,false,true,true,0.969,0.031
153,170,-17,17,18.888889,-17,671,725,-54,0,0,0,0,34,9,9,1.088235,0,0,11,9,false,true,false,0.191,0.809
340,247,93,26.153846,19,93,1034,1040,-6,1,0,0.076923,0,9,13,13,3.888889,1,0,7,13,false,true,true,1,0
328,310,18,20.5,19.375,18,594,605,-11,0,0,0,0,-12,16,16,-3.083333,0,0,4,2,false,true,true,0.977,0.023
257,213,44,17.133333,14.2,44,346,231,115,0,0,0,0,-16,15,15,-2.5625,0,1,22,7,false,true,true,0.994,0.006
315,256,59,21,18.285714,59,825,907,-82,1,0,0.066667,0,7,15,14,5.714286,0,0,18,18,false,true,true,0.963,0.037
152,165,-13,16.888889,18.333333,-13,500,567,-67,0,0,0,0,44,9,9,1,0,0,9,24,false,true,false,0.411,0.589
55,33,22,18.333333,16.5,22,885,719,166,0,0,0,0,84,3,2,0.452381,0,1,25,9,false,true,true,0.533,0.467
272,126,146,22.666667,11.454545,146,1295,1477,-182,2,0,0.166667,0,29,12,11,1.586207,0,0,19,13,false,true,true,0.999,0.001
296,262,34,24.666667,21.833333,34,416,282,134,1,0,0.083333,0,11,12,12,3.090909,1,0,14,8,false,true,true,0.976,0.024
167,172,-5,27.833333,28.666667,-5,1428,1452,-24,0,0,0,0,57,6,6,0.54386,0,1,15,12,false,true,false,0.141,0.859
11,44,-33,5.5,22,-33,1554,1622,-68,1,0,0.5,0,85,2,2,0.364706,0,0,15,15,false,true,true,1,0
126,52,74,42,26,74,1793,1897,-104,1,0,0.333333,0,81,3,2,0.37037,0,0,7,11,false,true,true,0.527,0.473
287,207,80,16.882353,12.9375,80,1164,1201,-37,0,0,0,0,1,17,16,42,0,2,18,8,false,true,true,0.962,0.038
163,109,54,23.285714,18.166667,54,1115,1078,37,0,0,0,0,54,7,6,0.62963,1,0,16,8,false,true,true,0.903,0.097
262,240,22,23.818182,21.818182,22,856,897,-41,0,1,0,0.090909,12,11,11,2.916667,0,0,17,10,false,true,true,0.781,0.219
227,129,98,25.222222,16.125,98,904,668,236,0,0,0,0,34,9,8,1,0,1,12,9,false,true,true,0.978,0.022
245,263,-18,27.222222,29.222222,-18,1875,1793,82,2,1,0.222222,0.111111,32,9,9,0.9375,0,0,7,10,false,true,true,0.618,0.382
320,161,159,16.842105,8.944444,159,993,897,96,1,0,0.052632,0,-14,19,18,-3.357143,0,1,23,25,false,true,true,1,0
333,211,122,16.65,11.105263,122,218,86,132,0,0,0,0,-30,20,19,-1.333333,0,0,2,6,false,true,true,1,0
171,127,44,21.375,18.142857,44,1305,1242,63,1,0,0.125,0,52,8,7,0.653846,0,1,11,19,false,true,true,0.846,0.154
278,269,9,14.631579,14.157895,9,361,493,-132,1,0,0.052632,0,-34,19,19,-1.205882,0,0,2,1,false,true,true,0.986,0.014
22,0,22,22,0,22,786,976,-190,0,0,0,0,96,1,0,0.333333,0,0,8,0,false,true,false,0.404,0.596
24,30,-6,12,15,-6,1055,1050,5,0,0,0,0,85,2,2,0.4,0,0,14,10,false,true,false,0.476,0.524
127,139,-12,15.875,17.375,-12,699,448,251,0,0,0,0,52,8,8,0.769231,0,0,12,12,false,true,true,0.69,0.31
313,234,79,26.083333,19.5,79,1014,948,66,1,0,0.083333,0,16,12,12,2.0625,0,0,10,11,false,true,true,0.999,0.001
140,173,-33,11.666667,14.416667,-33,826,771,55,0,0,0,0,36,12,12,1.25,0,1,18,9,false,true,false,0.146,0.854
343,206,137,20.176471,12.875,137,1586,1782,-196,0,0,0,0,-6,17,16,-6.666667,1,0,14,16,false,true,true,1,0
267,201,66,26.7,20.1,66,1394,1118,276,0,1,0,0.1,27,10,10,1.37037,0,0,11,13,false,true,true,0.921,0.079
230,146,84,25.555556,16.222222,84,1045,1009,36,1,0,0.111111,0,40,9,9,0.95,0,0,9,19,false,true,true,0.986,0.014
180,147,33,18,16.333333,33,613,502,111,0,0,0,0,37,10,9,1.324324,0,0,7,27,false,true,true,0.723,0.277
142,129,13,20.285714,21.5,13,1539,1537,2,0,0,0,0,60,7,6,0.533333,1,1,6,8,false,true,false,0.246,0.754
255,186,69,18.214286,13.285714,69,1037,950,87,1,0,0.071429,0,11,14,14,2.818182,0,0,8,18,false,true,true,0.996,0.004
166,104,62,33.2,20.8,62,1210,1252,-42,1,0,0.2,0,63,5,5,0.507937,0,0,11,21,false,true,true,0.765,0.235
323,266,57,20.1875,16.625,57,539,500,39,0,0,0,0,-11,16,16,-3.636364,0,0,8,11,false,true,true,0.999,0.001
267,259,8,29.666667,28.777778,8,2219,2106,113,1,0,0.111111,0,20,9,9,1.35,0,0,9,16,false,true,false,0.178,0.822
130,105,25,14.444444,11.666667,25,880,952,-72,0,0,0,0,40,9,9,1.025,0,0,16,8,false,true,true,0.821,0.179
173,199,-26,21.625,24.875,-26,771,754,17,0,0,0,0,42,8,8,0.761905,0,0,10,10,false,true,false,0.228,0.772
108,114,-6,15.428571,19,-6,671,725,-54,0,0,0,0,51,7,6,0.72549,1,0,11,14,false,true,false,0.366,0.634
343,244,99,24.5,18.769231,99,1073,1177,-104,1,0,0.071429,0,-1,14,13,-32,0,0,6,16,false,true,true,0.999,0.001
19,12,7,9.5,12,7,595,543,52,0,0,0,0,91,2,1,0.516484,0,0,17,8,false,true,true,0.511,0.489
243,98,145,24.3,10.888889,145,925,801,124,1,0,0.1,0,44,10,9,0.909091,1,1,6,25,false,true,true,1,0
29,22,7,9.666667,11,7,596,595,1,0,0,0,0,84,3,2,0.47619,1,0,19,14,false,true,true,0.523,0.477
240,177,63,20,14.75,63,739,480,259,1,0,0.083333,0,20,12,12,1.8,0,1,11,9,false,true,true,0.99,0.01
106,74,32,17.666667,14.8,32,620,658,-38,0,0,0,0,61,6,5,0.590164,0,0,18,7,false,true,true,0.841,0.159
208,207,1,18.909091,18.818182,1,1547,1439,108,1,0,0.090909,0,24,11,11,1.541667,0,0,23,8,false,true,true,0.718,0.282
47,38,9,23.5,19,9,1735,1770,-35,0,0,0,0,79,2,2,0.35443,0,0,8,7,false,true,false,0.454,0.546
406,368,38,22.555556,20.444444,38,1220,1261,-41,2,0,0.111111,0,-11,18,18,-4.090909,0,0,13,5,false,true,true,0.951,0.049
131,125,6,10.916667,11.363636,6,416,222,194,0,0,0,0,35,12,11,1.571429,1,0,12,23,false,true,true,0.638,0.362
436,285,151,29.066667,20.357143,151,1519,1782,-263,2,0,0.133333,0,-2,15,14,-16.5,0,0,3,8,false,true,true,1,0
330,158,172,25.384615,13.166667,172,1397,1422,-25,3,0,0.230769,0,26,13,12,1.384615,0,2,26,19,false,true,true,1,0
232,227,5,38.666667,37.833333,5,1885,1793,92,0,0,0,0,42,6,6,0.642857,0,0,22,8,false,true,true,0.693,0.307
82,50,32,16.4,12.5,32,1047,1094,-47,0,0,0,0,71,5,4,0.507042,0,1,7,18,false,true,false,0.256,0.744
86,23,63,43,11.5,63,993,897,96,1,0,0.5,0,82,2,2,0.573171,0,0,10,7,false,true,true,0.697,0.303
400,310,90,22.222222,18.235294,90,1305,1390,-85,0,1,0,0.058824,-27,18,17,-1.333333,0,2,3,4,false,true,true,0.997,0.003
186,113,73,20.666667,14.125,73,576,532,44,0,0,0,0,43,9,8,1.069767,1,0,8,16,false,true,true,0.978,0.022
304,263,41,20.266667,18.785714,41,838,786,52,0,1,0,0.071429,1,15,14,32,0,0,4,16,false,true,true,0.957,0.043
48,37,11,12,9.25,11,1281,1339,-58,0,0,0,0,75,4,4,0.546667,0,0,25,12,false,true,true,0.506,0.494
295,281,14,26.818182,25.545455,14,1885,1846,39,1,1,0.090909,0.090909,10,11,11,2.9,1,0,18,8,false,true,true,0.971,0.029
271,217,54,20.846154,16.692308,54,1045,1009,36,1,0,0.076923,0,15,13,13,2.533333,1,0,17,16,false,true,true,0.982,0.018
18,13,5,9,6.5,5,698,742,-44,0,0,0,0,94,2,2,0.43617,0,1,23,11,false,true,false,0.439,0.561
246,119,127,30.75,17,127,996,1063,-67,1,1,0.125,0.142857,37,8,7,0.864865,0,0,11,18,false,true,true,1,0
153,118,35,21.857143,16.857143,35,1127,1176,-49,0,0,0,0,49,7,7,0.857143,0,0,12,14,false,true,true,0.829,0.171
37,20,17,18.5,20,17,1550,1466,84,0,0,0,0,88,2,1,0.420455,1,0,6,15,false,true,true,0.837,0.163
163,187,-24,14.818182,18.7,-24,1176,1127,49,0,0,0,0,29,11,10,1.275862,0,0,14,16,false,true,false,0.106,0.894
46,18,28,15.333333,9,28,527,581,-54,0,0,0,0,83,3,2,0.506024,1,0,14,7,false,true,true,0.557,0.443
179,157,22,17.9,17.444444,22,613,549,64,0,0,0,0,35,10,9,1.257143,0,1,14,17,false,true,false,0.399,0.601
42,37,5,21,18.5,5,1022,1095,-73,0,0,0,0,85,2,2,0.388235,0,0,37,7,false,true,true,0.554,0.446
451,361,90,37.583333,32.818182,90,1770,1689,81,1,1,0.083333,0.090909,-10,12,11,-2.6,0,0,1,12,false,true,true,0.992,0.008
93,33,60,31,16.5,60,838,786,52,0,0,0,0,81,3,2,0.395062,0,0,8,10,false,true,true,0.882,0.118
141,119,22,15.666667,14.875,22,698,742,-44,0,0,0,0,56,9,8,0.732143,0,0,11,13,false,true,true,0.513,0.487
104,79,25,26,19.75,25,1803,1552,251,0,0,0,0,71,4,4,0.394366,0,1,11,7,false,true,true,0.978,0.022
324,288,36,17.052632,15.157895,36,1159,1031,128,1,0,0.052632,0,-29,19,19,-1.344828,0,0,3,1,false,true,true,0.999,0.001
151,100,51,21.571429,14.285714,51,1482,1554,-72,0,0,0,0,54,7,7,0.666667,0,0,13,13,false,true,true,0.806,0.194
42,52,-10,21,26,-10,1244,1361,-117,0,0,0,0,88,2,2,0.431818,0,0,15,11,false,true,false,0.233,0.767
196,195,1,16.333333,16.25,1,371,435,-64,0,0,0,0,14,12,12,3.142857,0,0,16,7,false,true,true,0.729,0.271
251,171,80,16.733333,12.214286,80,777,830,-53,0,0,0,0,12,15,14,3.416667,0,0,19,9,false,true,true,0.981,0.019
278,264,14,14.631579,14.666667,14,480,518,-38,0,0,0,0,-7,19,18,-6.571429,1,0,8,16,false,true,true,0.88,0.12
269,234,35,17.933333,15.6,35,609,620,-11,0,0,0,0,-3,15,15,-12.333333,0,1,7,6,false,true,true,0.997,0.003
98,94,4,16.333333,18.8,4,831,830,1,0,0,0,0,65,6,5,0.569231,1,0,21,12,false,true,true,0.522,0.478
150,114,36,25,19,36,1110,1039,71,0,0,0,0,57,6,6,0.631579,0,0,17,7,false,true,true,0.88,0.12
186,124,62,18.6,12.4,62,1011,921,90,0,0,0,0,36,10,10,1.361111,0,0,10,18,false,true,true,0.965,0.035
90,18,72,22.5,4.5,72,1033,1037,-4,0,0,0,0,74,4,4,0.608108,0,0,13,8,false,true,true,0.944,0.056
300,249,51,27.272727,22.636364,51,1210,1253,-43,0,1,0,0.090909,11,11,11,3.090909,0,0,10,18,false,true,true,0.996,0.004
265,221,44,22.083333,20.090909,44,1493,1513,-20,1,0,0.083333,0,21,12,11,1.571429,0,2,11,7,false,true,true,0.802,0.198
336,280,56,21,17.5,56,1406,1454,-48,0,2,0,0.125,-8,16,16,-4.25,0,0,2,11,false,true,true,0.99,0.01
159,71,88,31.8,17.75,88,1735,1770,-35,1,0,0.2,0,57,5,4,0.491228,1,0,9,9,false,true,true,0.972,0.028
352,194,158,16,8.818182,158,993,897,96,1,0,0.045455,0,-25,22,22,-1.88,0,0,3,25,false,true,true,1,0
108,91,17,13.5,13,17,218,86,132,0,0,0,0,47,8,7,0.851064,0,0,19,14,false,true,true,0.734,0.266
319,282,37,14.5,13.428571,37,804,683,121,0,0,0,0,-26,22,21,-1.730769,0,1,12,2,false,true,true,0.789,0.211
147,183,-36,13.363636,16.636364,-36,699,448,251,0,0,0,0,33,11,11,1.212121,0,0,15,8,false,true,false,0.433,0.567
377,299,78,19.842105,16.611111,78,1551,1550,1,0,0,0,0,-25,19,18,-1.68,0,1,3,3,false,true,true,0.998,0.002
368,314,54,21.647059,19.625,54,960,1070,-110,1,0,0.058824,0,-13,17,16,-2.692308,0,0,1,1,false,true,true,0.999,0.001
196,240,-44,19.6,24,-44,1554,1573,-19,0,0,0,0,37,10,10,0.918919,0,1,11,6,false,true,false,0.107,0.893
311,307,4,20.733333,20.466667,4,926,854,72,0,0,0,0,0,15,15,0,1,0,8,3,false,true,true,0.864,0.136
302,286,16,20.133333,20.428571,16,594,605,-11,0,0,0,0,-2,15,14,-18.5,0,0,10,9,false,true,true,0.794,0.206
63,118,-55,15.75,29.5,-55,1077,1094,-17,0,0,0,0,71,4,4,0.591549,0,0,22,14,false,true,false,0.114,0.886
289,242,47,20.642857,18.615385,47,1210,1253,-43,0,1,0,0.076923,4,14,13,8.75,1,0,6,18,false,true,true,0.997,0.003
199,163,36,24.875,20.375,36,866,949,-83,0,0,0,0,43,8,8,0.930233,0,0,12,16,false,true,true,0.736,0.264
299,180,119,19.933333,12.857143,119,1281,1339,-58,0,0,0,0,18,15,14,2.277778,0,0,20,10,false,true,true,0.989,0.011
185,115,70,30.833333,23,70,1237,1277,-40,0,0,0,0,54,6,5,0.537037,0,0,7,18,false,true,true,0.848,0.152
342,261,81,18,14.5,81,1253,1166,87,1,0,0.052632,0,-10,19,18,-4.3,0,0,5,11,false,true,true,1,0
233,177,56,21.181818,16.090909,56,939,913,26,0,1,0,0.090909,23,11,11,1.73913,0,0,7,10,false,true,true,0.98,0.02
232,239,-7,19.333333,19.916667,-7,1530,1550,-20,0,1,0,0.083333,14,12,12,2.428571,1,0,18,12,false,true,true,0.731,0.269
288,210,78,18,14,78,1048,1000,48,0,0,0,0,7,16,15,5.714286,1,1,9,16,false,true,true,0.996,0.004
329,286,43,19.352941,16.823529,43,1221,1258,-37,1,0,0.058824,0,-5,17,17,-7.8,1,0,7,7,false,true,true,0.999,0.001
318,271,47,21.2,18.066667,47,1452,1469,-17,1,1,0.066667,0.066667,-5,15,15,-7.6,0,0,8,19,false,true,true,0.999,0.001
298,220,78,19.866667,14.666667,78,1181,1069,112,0,0,0,0,1,15,15,37,1,0,8,12,false,true,true,0.991,0.009
244,149,95,22.181818,13.545455,95,1033,1037,-4,0,1,0,0.090909,29,11,11,1.551724,0,0,22,9,false,true,true,0.981,0.019
359,304,55,22.4375,19,55,1034,1040,-6,1,0,0.0625,0,-11,16,16,-3.181818,1,0,7,3,false,true,true,1,0
254,263,-9,18.142857,18.785714,-9,1388,1477,-89,1,0,0.071429,0,11,14,14,4.363636,1,0,10,15,false,true,false,0.237,0.763
310,103,207,19.375,6.4375,207,896,818,78,0,0,0,0,16,16,16,2.75,1,1,11,6,false,true,true,1,0
342,247,95,22.8,17.642857,95,901,1159,-258,2,0,0.133333,0,1,15,14,35,0,0,22,8,false,true,true,0.984,0.016
110,78,32,18.333333,15.6,32,1266,1247,19,0,0,0,0,60,6,5,0.533333,0,0,11,7,false,true,true,0.51,0.49
256,190,66,23.272727,19,66,1073,1177,-104,1,0,0.090909,0,22,11,10,1.454545,0,0,10,20,false,true,true,0.966,0.034
43,3,40,21.5,3,40,947,909,38,0,0,0,0,90,2,1,0.511111,1,0,7,25,false,true,true,0.731,0.269
199,170,29,16.583333,15.454545,29,908,859,49,0,0,0,0,26,12,11,1.5,0,1,13,12,false,true,false,0.399,0.601
161,86,75,20.125,12.285714,75,791,774,17,1,0,0.125,0,58,8,7,0.706897,1,0,7,20,false,true,true,0.977,0.023
136,59,77,19.428571,8.428571,77,1067,95,972,0,0,0,0,63,7,7,0.539683,0,0,15,7,false,true,true,1,0
210,147,63,17.5,12.25,63,346,231,115,0,0,0,0,5,12,12,8.2,0,0,10,14,false,true,true,0.985,0.015
334,207,127,23.857143,14.785714,127,554,342,212,0,0,0,0,-5,14,14,-7.2,0,0,7,19,false,true,true,1,0
257,269,-12,12.85,13.45,-12,1029,1075,-46,0,0,0,0,-9,20,20,-5.333333,2,0,10,8,false,true,true,0.693,0.307
24,12,12,12,6,12,896,818,78,0,0,0,0,88,2,2,0.5,0,0,18,11,false,true,true,0.533,0.467
305,248,57,30.5,27.555556,57,1826,1656,170,2,0,0.2,0,19,10,9,1.421053,1,0,13,15,false,true,true,0.991,0.009
319,260,59,29,26,59,1428,1452,-24,1,1,0.090909,0.1,21,11,10,1.47619,0,1,9,8,false,true,true,0.885,0.115
271,195,76,27.1,21.666667,76,1550,1466,84,1,0,0.1,0,33,10,9,1.121212,0,0,14,11,false,true,true,0.942,0.058
81,133,-52,13.5,22.166667,-52,892,788,104,0,0,0,0,66,6,6,0.651515,1,0,15,12,false,true,false,0.143,0.857
69,96,-27,13.8,19.2,-27,576,494,82,0,0,0,0,69,5,5,0.637681,0,0,10,18,false,true,false,0.173,0.827
363,298,65,17.285714,14.9,65,791,774,17,1,0,0.047619,0,-20,21,20,-2.05,0,0,1,1,true,true,true,1,0
367,309,58,21.588235,19.3125,58,1216,1228,-12,1,0,0.058824,0,-8,17,16,-4.125,0,0,7,1,true,true,true,0.999,0.001
205,199,6,17.083333,16.583333,6,725,771,-46,0,1,0,0.083333,25,12,12,1.84,1,0,6,15,false,true,true,0.906,0.094
8,32,-24,4,16,-24,539,632,-93,0,0,0,0,89,2,2,0.516854,0,0,14,14,false,true,false,0.124,0.876
120,53,67,30,17.666667,67,1890,2020,-130,0,0,0,0,72,4,3,0.402778,0,0,13,19,false,true,true,0.523,0.477
268,278,-10,22.333333,23.166667,-10,974,995,-21,0,1,0,0.083333,12,12,12,2.75,1,0,16,14,false,true,true,0.691,0.309
50,18,32,25,18,32,1645,1777,-132,1,0,0.5,0,83,2,1,0.301205,0,0,19,12,false,true,true,0.621,0.379
62,41,21,31,20.5,21,904,668,236,0,0,0,0,85,2,2,0.4,0,0,17,16,false,true,true,0.801,0.199
225,183,42,17.307692,15.25,42,801,807,-6,0,0,0,0,12,13,12,2.916667,1,0,6,21,false,true,true,0.917,0.083
123,87,36,30.75,21.75,36,1109,1065,44,0,0,0,0,73,4,4,0.452055,0,0,17,8,false,true,true,0.88,0.12
47,26,21,23.5,13,21,1413,1422,-9,0,0,0,0,85,2,2,0.670588,1,0,11,16,false,true,true,0.857,0.143
177,117,60,25.285714,16.714286,60,904,668,236,0,0,0,0,46,7,7,0.73913,0,0,10,12,false,true,true,0.944,0.056
337,241,96,37.444444,30.125,96,1824,1793,31,1,0,0.111111,0,34,9,8,0.823529,1,0,6,11,false,true,true,1,0
113,70,43,28.25,23.333333,43,1153,1065,88,0,1,0,0.333333,66,4,3,0.424242,0,0,21,16,false,true,true,0.883,0.117
324,300,24,13.5,13.043478,24,871,999,-128,0,0,0,0,-39,24,23,-1.230769,0,0,1,1,false,true,true,0.998,0.002
418,237,181,22,12.473684,181,1295,1477,-182,3,0,0.157895,0,-11,19,19,-4.181818,0,0,5,7,false,true,true,1,0
151,152,-1,18.875,19,-1,628,658,-30,0,0,0,0,44,8,8,1.045455,0,1,19,6,false,true,false,0.455,0.545
200,194,6,16.666667,17.636364,6,695,523,172,0,0,0,0,16,12,11,2.3125,0,0,24,20,false,true,true,0.732,0.268
159,95,64,17.666667,11.875,64,1128,889,239,0,1,0,0.125,46,9,8,1.021739,0,0,32,11,false,true,true,0.981,0.019
172,72,100,15.636364,7.2,100,1428,1302,126,0,0,0,0,40,11,10,1.325,0,1,17,15,false,true,true,0.992,0.008
358,318,40,25.571429,24.461538,40,907,752,155,0,1,0,0.076923,6,14,13,5.5,0,0,7,11,false,true,true,0.915,0.085
378,237,141,31.5,19.75,141,971,621,350,2,0,0.166667,0,2,12,12,16,1,0,13,8,false,true,true,1,0
353,340,13,25.214286,26.153846,13,1030,1144,-114,0,2,0,0.153846,7,14,13,5,1,0,14,7,false,true,true,0.988,0.012
286,214,72,19.066667,15.285714,72,1606,1544,62,0,0,0,0,20,15,14,2.25,0,1,16,8,false,true,true,0.948,0.052
161,195,-34,12.384615,15,-34,480,518,-38,0,0,0,0,27,13,13,1.703704,0,1,22,10,false,true,false,0.072,0.928
344,174,170,24.571429,12.428571,170,1413,1422,-9,0,0,0,0,13,14,14,4.384615,0,0,9,13,false,true,true,1,0
402,342,60,22.333333,19,60,1142,1176,-34,1,0,0.055556,0,-17,18,18,-2.117647,0,0,1,1,true,true,true,1,0
165,132,33,23.571429,22,33,804,988,-184,1,0,0.142857,0,49,7,6,0.673469,0,0,13,19,false,true,true,0.693,0.307
225,133,92,32.142857,19,92,1075,1027,48,2,0,0.285714,0,46,7,7,0.804348,0,0,8,10,false,true,true,0.983,0.017
59,66,-7,19.666667,22,-7,671,725,-54,0,0,0,0,77,3,3,0.480519,1,0,6,17,false,true,false,0.487,0.513
81,78,3,16.2,19.5,3,892,788,104,0,0,0,0,71,5,4,0.605634,1,0,13,20,false,true,false,0.461,0.539
312,264,48,22.285714,20.307692,48,1493,1513,-20,1,0,0.071429,0,9,14,13,3.666667,0,2,11,8,false,true,true,0.815,0.185
246,221,25,30.75,27.625,25,1659,1782,-123,1,0,0.125,0,27,8,8,1.074074,0,1,22,12,false,true,false,0.306,0.694
152,121,31,21.714286,17.285714,31,859,786,73,0,0,0,0,53,7,7,0.716981,0,0,22,8,false,true,true,0.88,0.12
382,205,177,31.833333,17.083333,177,820,783,37,1,0,0.083333,0,12,12,12,2.75,0,0,7,13,false,true,true,1,0
175,193,-18,17.5,21.444444,-18,721,689,32,0,0,0,0,20,10,9,1.7,0,0,23,12,false,true,false,0.314,0.686
387,230,157,24.1875,15.333333,157,778,758,20,0,1,0,0.066667,-12,16,15,-3.25,0,0,4,10,false,true,true,1,0
313,224,89,22.357143,17.230769,89,371,336,35,2,0,0.142857,0,-10,14,13,-3.8,0,0,7,18,false,true,true,0.999,0.001
210,137,73,26.25,19.571429,73,795,830,-35,1,1,0.125,0.142857,39,8,7,1.076923,1,0,15,16,false,true,true,0.982,0.018
128,177,-49,21.333333,35.4,-49,1075,1009,66,0,0,0,0,56,6,5,0.571429,0,0,7,14,false,true,false,0.106,0.894
249,249,0,24.9,24.9,0,1331,1399,-68,0,0,0,0,23,10,10,1.521739,0,0,19,12,false,true,true,0.532,0.468
162,66,96,54,22,96,1054,917,137,0,0,0,0,71,3,3,0.492958,0,0,7,12,false,true,true,0.999,0.001
321,277,44,22.928571,21.307692,44,976,965,11,1,0,0.071429,0,-5,14,13,-6.4,1,0,7,9,false,true,true,0.999,0.001
203,165,38,18.454545,16.5,38,786,976,-190,0,0,0,0,32,11,10,1,0,0,10,10,false,true,true,0.665,0.335
286,206,80,19.066667,14.714286,80,576,532,44,0,0,0,0,8,15,14,5.75,0,0,9,12,false,true,true,0.999,0.001
101,147,-46,20.2,36.75,-46,1076,1176,-100,0,1,0,0.25,62,5,4,0.516129,0,1,8,8,false,true,false,0.101,0.899
14,0,14,14,0,14,1177,1214,-37,0,0,0,0,96,1,0,0.364583,0,0,10,0,false,true,false,0.386,0.614
289,226,63,26.272727,20.545455,63,995,912,83,2,0,0.181818,0,30,11,11,1.466667,0,0,11,13,false,true,true,0.954,0.046
13,15,-2,6.5,15,-2,904,857,47,0,0,0,0,90,2,1,0.455556,0,0,25,7,false,true,true,0.506,0.494
110,98,12,22,24.5,12,758,796,-38,0,0,0,0,67,5,4,0.567164,0,0,7,10,false,true,false,0.268,0.732
118,57,61,23.6,14.25,61,960,1070,-110,1,0,0.2,0,69,5,4,0.507246,0,0,22,23,false,true,true,0.743,0.257
16,10,6,8,10,6,1507,1554,-47,0,0,0,0,92,2,1,0.315217,0,0,8,19,false,true,false,0.233,0.767
353,320,33,23.533333,21.333333,33,965,1013,-48,1,0,0.066667,0,-11,15,15,-3,0,1,6,3,false,true,true,0.998,0.002
116,117,-1,16.571429,16.714286,-1,864,808,56,1,0,0.142857,0,45,7,7,0.755556,1,0,7,7,false,true,true,0.577,0.423
381,243,138,29.307692,20.25,138,1519,1782,-263,2,0,0.153846,0,10,13,12,3.3,0,0,18,17,false,true,true,1,0
351,338,13,27,26,13,1762,1616,146,2,0,0.153846,0,-5,13,13,-6,1,0,11,4,false,true,true,0.981,0.019
307,256,51,16.157895,14.222222,51,416,306,110,0,0,0,0,-15,19,18,-2.8,1,0,4,4,false,true,true,0.999,0.001
174,162,12,21.75,20.25,12,1547,1439,108,1,0,0.125,0,47,8,8,0.787234,0,0,18,7,false,true,true,0.751,0.249
36,56,-20,12,18.666667,-20,539,632,-93,0,0,0,0,82,3,3,0.560976,0,0,11,12,false,true,false,0.137,0.863
242,78,164,24.2,7.8,164,896,818,78,0,0,0,0,46,10,10,0.956522,0,0,10,7,false,true,true,1,0
393,274,119,28.071429,21.076923,119,1004,840,164,1,0,0.071429,0,-8,14,13,-3.75,0,0,3,5,false,true,true,1,0
291,221,70,24.25,18.416667,70,1220,1261,-41,2,0,0.166667,0,27,12,12,1.666667,1,0,19,11,false,true,true,0.987,0.013
213,183,30,17.75,15.25,30,801,807,-6,0,0,0,0,15,12,12,2.333333,1,0,10,21,false,true,true,0.872,0.128
226,234,-8,18.833333,19.5,-8,971,658,313,0,0,0,0,15,12,12,2.4,0,0,19,7,false,true,false,0.304,0.696
104,58,46,20.8,14.5,46,1029,1075,-46,0,0,0,0,71,5,4,0.676056,0,0,8,11,false,true,true,0.625,0.375
254,155,99,21.166667,14.090909,99,954,1078,-124,0,1,0,0.090909,22,12,11,1.727273,1,0,11,15,false,true,true,0.998,0.002
24,26,-2,24,26,-2,518,448,70,0,0,0,0,93,1,1,0.365591,0,1,10,16,false,true,false,0.081,0.919
104,85,19,20.8,17,19,1094,1030,64,0,0,0,0,66,5,5,0.545455,0,0,7,9,false,true,true,0.565,0.435
125,188,-63,13.888889,20.888889,-63,1075,989,86,0,0,0,0,53,9,9,0.735849,0,0,26,15,false,true,false,0.101,0.899
12,0,12,12,0,12,527,581,-54,0,0,0,0,96,1,0,0.4375,1,0,17,0,false,true,true,0.549,0.451
360,360,0,22.5,24,0,809,868,-59,2,1,0.125,0.066667,-17,16,15,-1.882353,1,0,0,4,false,true,true,0.958,0.042
216,126,90,36,25.2,90,1245,1241,4,1,1,0.166667,0.2,55,6,5,0.527273,0,0,16,17,false,true,true,0.975,0.025
36,22,14,36,22,14,746,796,-50,0,1,0,1,87,1,1,0.551724,0,0,9,9,false,true,true,0.883,0.117
60,39,21,20,19.5,21,1040,925,115,0,0,0,0,81,3,2,0.530864,0,0,21,8,false,true,true,0.535,0.465
62,27,35,31,13.5,35,1586,1782,-196,0,0,0,0,84,2,2,0.47619,0,0,12,8,false,true,true,0.504,0.496
180,179,1,20,19.888889,1,1364,1093,271,0,1,0,0.111111,40,9,9,0.95,0,0,10,14,false,true,true,0.926,0.074
379,278,101,21.055556,15.444444,101,704,691,13,1,0,0.055556,0,-20,18,18,-1.9,0,0,2,2,false,true,true,1,0
409,323,86,22.722222,17.944444,86,995,912,83,2,0,0.111111,0,-13,18,18,-3.384615,0,0,3,12,false,true,true,0.999,0.001
166,74,92,23.714286,12.333333,92,1439,1413,26,0,0,0,0,60,7,6,0.6,0,0,20,7,false,true,true,0.958,0.042
190,246,-56,21.111111,27.333333,-56,1076,1176,-100,0,1,0,0.111111,34,9,9,0.941176,0,1,26,9,false,true,false,0.086,0.914
10,0,10,10,0,10,613,611,2,0,0,0,0,96,1,0,0.395833,0,0,10,0,false,true,true,0.504,0.496
409,394,15,29.214286,30.307692,15,2219,2106,113,2,0,0.142857,0,-17,14,13,-1.588235,0,0,7,3,true,true,true,0.887,0.113
310,207,103,17.222222,12.176471,103,218,86,132,0,0,0,0,-21,18,17,-1.904762,0,0,6,9,false,true,true,1,0
42,23,19,42,23,19,834,844,-10,0,0,0,0,92,1,1,0.391304,0,0,9,10,false,true,true,0.851,0.149
332,196,136,27.666667,17.818182,136,1550,1546,4,0,0,0,0,24,12,11,1.25,1,1,13,11,false,true,true,1,0
165,86,79,23.571429,14.333333,79,871,867,4,0,0,0,0,56,7,6,0.767857,0,0,7,11,false,true,true,0.915,0.085
169,184,-15,15.363636,18.4,-15,628,658,-30,0,0,0,0,35,11,10,1.314286,0,0,16,7,false,true,false,0.205,0.795
18,8,10,18,8,10,346,231,115,0,0,0,0,91,1,1,0.450549,0,1,17,12,false,true,true,0.53,0.47
333,323,10,19.588235,19,10,1334,1270,64,1,0,0.058824,0,-6,17,17,-6.166667,0,0,6,2,false,true,true,0.738,0.262
195,143,52,24.375,17.875,52,1036,1181,-145,0,0,0,0,53,8,8,0.641509,0,0,21,10,false,true,true,0.885,0.115
318,281,37,18.705882,17.5625,37,1176,1127,49,0,0,0,0,-12,17,16,-3.083333,0,0,2,4,false,true,true,0.991,0.009
187,135,52,12.466667,9,52,310,359,-49,0,0,0,0,3,15,15,16.333333,0,0,10,16,false,true,true,0.98,0.02
172,155,17,21.5,22.142857,17,1364,1093,271,0,1,0,0.142857,50,8,7,0.76,0,0,10,7,false,true,true,0.983,0.017
291,207,84,18.1875,12.9375,84,1253,1166,87,1,0,0.0625,0,4,16,16,10.75,0,0,10,17,false,true,true,0.999,0.001
36,22,14,18,11,14,859,719,140,0,0,0,0,85,2,2,0.623529,0,1,12,6,false,true,true,0.592,0.408
219,191,28,19.909091,19.1,28,349,315,34,0,0,0,0,14,11,10,2.428571,0,0,7,16,false,true,true,0.744,0.256
176,154,22,17.6,17.111111,22,864,808,56,1,0,0.1,0,26,10,9,1.307692,0,1,14,6,false,true,true,0.531,0.469
362,370,-8,27.846154,28.461538,-8,1419,1488,-69,1,1,0.076923,0.076923,-6,13,13,-4.666667,1,0,3,2,false,true,true,0.931,0.069
193,192,1,17.545455,17.454545,1,704,691,13,0,0,0,0,29,11,11,1.310345,1,0,9,7,false,true,true,0.608,0.392
139,113,26,17.375,16.142857,26,1011,921,90,0,0,0,0,49,8,7,1,0,0,12,20,false,true,true,0.533,0.467
52,24,28,26,24,28,921,1072,-151,0,0,0,0,86,2,1,0.44186,0,0,9,16,false,true,false,0.366,0.634
181,96,85,45.25,32,85,1348,1331,17,1,0,0.25,0,63,4,3,0.380952,0,0,9,21,false,true,true,0.911,0.089
23,32,-9,11.5,16,-9,1550,1546,4,0,0,0,0,86,2,2,0.348837,0,0,19,17,false,true,false,0.251,0.749
244,177,67,20.333333,16.090909,67,939,913,26,0,1,0,0.090909,21,12,11,1.904762,0,0,10,10,false,true,true,0.98,0.02
218,217,1,27.25,31,1,1075,1009,66,1,0,0.125,0,40,8,7,0.8,0,0,8,7,false,true,false,0.477,0.523
418,313,105,29.857143,22.357143,105,1216,1230,-14,1,0,0.071429,0,2,14,14,16,0,0,7,15,false,true,true,0.999,0.001
38,7,31,12.666667,3.5,31,719,614,105,0,0,0,0,84,3,2,0.511905,0,1,15,13,false,true,true,0.529,0.471
181,131,50,12.928571,10.076923,50,310,359,-49,0,0,0,0,7,14,13,7,0,0,7,18,false,true,true,0.941,0.059
215,205,10,16.538462,17.083333,10,1583,1422,161,0,0,0,0,31,13,12,1.645161,1,0,9,17,false,true,false,0.383,0.617
34,0,34,34,0,34,540,518,22,0,0,0,0,95,1,0,0.421053,0,0,10,0,false,true,true,0.873,0.127
257,274,-17,28.555556,30.444444,-17,1125,1227,-102,1,1,0.111111,0.111111,22,9,9,1.363636,1,0,9,10,false,true,false,0.451,0.549
327,291,36,16.35,14.55,36,1221,1438,-217,0,0,0,0,-11,20,20,-4.090909,0,0,7,3,false,true,true,0.983,0.017
22,0,22,22,0,22,1142,1176,-34,0,0,0,0,95,1,0,0.378947,0,0,8,0,false,true,false,0.486,0.514
310,257,53,20.666667,18.357143,53,948,933,15,1,0,0.066667,0,13,15,14,2.923077,0,0,16,10,false,true,true,0.947,0.053
110,106,4,15.714286,15.142857,4,859,822,37,0,0,0,0,50,7,7,0.76,0,0,20,12,false,true,true,0.519,0.481
29,32,-3,14.5,16,-3,1221,1266,-45,0,0,0,0,85,2,2,0.411765,0,0,12,11,false,true,false,0.389,0.611
284,246,38,17.75,16.4,38,95,360,-265,0,1,0,0.066667,-8,16,15,-5,0,0,13,9,false,true,true,0.973,0.027
18,0,18,18,0,18,361,493,-132,0,0,0,0,95,1,0,0.431579,0,0,12,0,false,true,true,0.53,0.47
91,81,10,18.2,16.2,10,786,757,29,0,0,0,0,67,5,5,0.58209,2,0,8,12,false,true,true,0.965,0.035
304,266,38,16.888889,15.647059,38,859,822,37,0,0,0,0,-14,18,17,-2.714286,2,0,2,8,false,true,true,0.996,0.004
364,249,115,22.75,15.5625,115,1029,1227,-198,1,0,0.0625,0,-25,16,16,-1.28,0,0,1,3,true,true,true,1,0
192,142,50,24,20.285714,50,1304,1040,264,1,0,0.125,0,46,8,7,0.717391,0,0,11,24,false,true,true,0.75,0.25
456,307,149,25.333333,18.058824,149,1270,1322,-52,1,0,0.055556,0,-18,18,17,-2.111111,0,0,2,4,false,true,true,1,0
340,189,151,21.25,12.6,151,786,757,29,1,0,0.0625,0,2,16,15,19.5,0,0,16,14,false,true,true,1,0
289,260,29,19.266667,18.571429,29,1572,1550,22,1,0,0.066667,0,7,15,14,5.571429,1,1,8,7,false,true,false,0.258,0.742
326,297,29,20.375,18.5625,29,290,416,-126,0,0,0,0,-14,16,16,-2.428571,0,0,1,1,false,true,true,0.997,0.003
361,275,86,20.055556,15.277778,86,844,821,23,0,0,0,0,2,18,18,21,0,1,8,9,false,true,true,1,0
181,157,24,22.625,19.625,24,613,569,44,0,0,0,0,40,8,8,0.975,2,0,14,7,false,true,true,0.977,0.023
189,80,109,21,8.888889,109,1067,95,972,0,0,0,0,48,9,9,0.708333,0,0,14,7,false,true,true,1,0
311,150,161,31.1,15,161,918,619,299,2,0,0.2,0,27,10,10,1.296296,2,0,8,14,false,true,true,1,0
370,266,104,33.636364,26.6,104,1633,1580,53,3,0,0.272727,0,13,11,10,2.153846,0,0,11,13,false,true,true,0.999,0.001
537,493,44,48.818182,49.3,44,1370,1431,-61,3,1,0.272727,0.1,0,11,10,0,0,0,10,4,false,true,true,0.914,0.086
258,142,116,32.25,20.285714,116,971,621,350,2,0,0.25,0,39,8,7,0.820513,0,0,17,11,false,true,true,0.985,0.015
360,259,101,30,23.545455,101,1349,1302,47,0,0,0,0,11,12,11,2.636364,0,0,22,7,false,true,true,0.999,0.001
22,23,-1,11,23,-1,947,810,137,0,0,0,0,89,2,1,0.47191,0,0,8,12,false,true,false,0.308,0.692
22,31,-9,11,15.5,-9,801,807,-6,0,0,0,0,84,2,2,0.416667,0,0,7,17,false,true,false,0.196,0.804
281,257,24,21.615385,19.769231,24,290,416,-126,0,0,0,0,9,13,13,3.777778,0,0,8,10,false,true,true,0.784,0.216
229,202,27,17.615385,16.833333,27,1452,1469,-17,0,1,0,0.083333,15,13,12,2.533333,1,0,9,23,false,true,true,0.627,0.373
382,330,52,18.190476,15.714286,52,580,620,-40,1,0,0.047619,0,-30,21,21,-1.433333,0,0,1,1,false,true,true,0.999,0.001
190,155,35,19,15.5,35,904,783,121,0,0,0,0,40,10,10,1.05,0,0,11,21,false,true,true,0.751,0.249
82,98,-16,27.333333,49,-16,834,844,-10,0,1,0,0.5,75,3,2,0.48,0,0,10,17,false,true,false,0.296,0.704
153,95,58,19.125,11.875,58,1069,917,152,0,0,0,0,51,8,8,0.666667,0,1,20,8,false,true,true,0.988,0.012
70,26,44,23.333333,13,44,771,754,17,0,0,0,0,79,3,2,0.405063,0,0,11,8,false,true,true,0.761,0.239
421,286,135,35.083333,26,135,1489,1405,84,3,0,0.25,0,6,12,11,4.666667,0,0,12,9,false,true,true,1,0
405,280,125,21.315789,15.555556,125,1394,1230,164,0,1,0,0.055556,-27,19,18,-1.407407,0,1,7,11,false,true,true,1,0
52,64,-12,17.333333,21.333333,-12,778,758,20,0,0,0,0,74,3,3,0.527027,0,0,10,7,false,true,false,0.424,0.576
84,51,33,21,17,33,1110,1039,71,0,0,0,0,78,4,3,0.461538,0,0,16,9,false,true,true,0.587,0.413
254,245,9,19.538462,18.846154,9,947,810,137,0,1,0,0.076923,15,13,13,2.8,1,0,7,15,false,true,true,0.879,0.121
107,67,40,35.666667,22.333333,40,992,1100,-108,1,0,0.333333,0,73,3,3,0.465753,1,0,6,16,false,true,true,0.7,0.3
329,213,116,15.666667,10.142857,116,1428,1302,126,0,0,0,0,-17,21,21,-3.117647,0,1,14,13,false,true,true,1,0
50,34,16,16.666667,17,16,1043,1055,-12,0,0,0,0,81,3,2,0.45679,0,0,20,12,false,true,false,0.487,0.513
253,190,63,25.3,19,63,1050,1144,-94,0,1,0,0.1,35,10,10,1.085714,1,0,10,9,false,true,true,0.993,0.007
328,297,31,19.294118,17.470588,31,290,416,-126,0,0,0,0,-16,17,17,-2.125,0,0,1,1,true,true,true,0.998,0.002
46,38,8,11.5,12.666667,8,801,807,-6,0,0,0,0,72,4,3,0.486111,0,0,13,17,false,true,false,0.243,0.757
208,142,66,23.111111,17.75,66,820,822,-2,0,0,0,0,39,9,8,1,0,0,14,10,false,true,true,0.896,0.104
304,290,14,17.882353,18.125,14,95,378,-283,0,0,0,0,-18,17,16,-1.944444,0,0,3,1,false,true,true,0.904,0.096
176,133,43,25.142857,22.166667,43,1170,1156,14,1,0,0.142857,0,55,7,6,0.690909,1,0,18,17,false,true,true,0.902,0.098
143,209,-66,20.428571,29.857143,-66,1501,1473,28,0,0,0,0,45,7,7,0.8,0,0,16,26,false,true,false,0.105,0.895
366,244,122,19.263158,13.555556,122,1281,1339,-58,0,0,0,0,-7,19,18,-5.857143,0,0,4,3,false,true,true,1,0
144,127,17,20.571429,21.166667,17,871,999,-128,0,0,0,0,53,7,6,0.90566,0,0,7,9,false,true,false,0.197,0.803
271,251,20,16.9375,15.6875,20,916,876,40,0,0,0,0,-17,16,16,-2,1,0,0,3,false,true,true,0.985,0.015
119,121,-2,19.833333,20.166667,-2,784,758,26,0,0,0,0,54,6,6,0.648148,0,0,7,9,false,true,false,0.335,0.665
140,137,3,17.5,17.125,3,500,567,-67,0,0,0,0,52,8,8,0.846154,0,0,8,24,false,true,true,0.504,0.496
146,121,25,29.2,30.25,25,1344,1209,135,1,1,0.2,0.25,59,5,4,0.576271,0,0,15,15,false,true,true,0.691,0.309
18,0,18,18,0,18,1489,1405,84,0,0,0,0,98,1,0,0.285714,1,0,16,0,false,true,true,0.86,0.14
265,171,94,17.666667,12.214286,94,872,818,54,0,1,0,0.071429,18,15,14,2.277778,1,0,17,7,false,true,true,0.981,0.019
336,248,88,16,11.809524,88,576,532,44,0,0,0,0,-30,21,21,-1.533333,1,0,8,18,false,true,true,1,0
63,33,30,21,16.5,30,1170,1156,14,0,0,0,0,84,3,2,0.452381,1,0,6,18,false,true,true,0.784,0.216
334,243,91,18.555556,13.5,91,1048,1000,48,0,0,0,0,-11,18,18,-3.636364,0,1,3,3,false,true,true,1,0
124,79,45,20.666667,15.8,45,904,783,121,0,0,0,0,64,6,5,0.65625,1,0,15,15,false,true,true,0.798,0.202
202,204,-2,13.466667,13.6,-2,1030,1045,-15,0,0,0,0,14,15,15,3.285714,0,0,7,8,false,true,true,0.591,0.409
91,99,-8,13,16.5,-8,699,448,251,0,0,0,0,60,7,6,0.666667,0,1,19,9,false,true,false,0.341,0.659
230,115,115,28.75,14.375,115,1144,1014,130,0,0,0,0,44,8,8,0.818182,0,1,17,9,false,true,true,0.994,0.006
205,214,-9,18.636364,19.454545,-9,491,398,93,0,0,0,0,26,11,11,1.384615,0,0,7,19,false,true,true,0.662,0.338
116,35,81,29,11.666667,81,1115,1078,37,0,0,0,0,73,4,3,0.465753,0,0,14,17,false,true,true,0.888,0.112
357,280,77,27.461538,23.333333,77,1428,1606,-178,1,0,0.076923,0,2,13,12,16,1,0,7,10,false,true,true,1,0
385,240,145,19.25,12.631579,145,786,757,29,1,0,0.05,0,-24,20,19,-1.625,0,0,19,4,true,true,true,1,0
290,213,77,29,21.3,77,1245,1232,13,1,0,0.1,0,14,10,10,2.071429,0,0,12,10,false,true,true,0.999,0.001
191,160,31,13.642857,12.307692,31,416,374,42,0,0,0,0,31,14,13,1.483871,0,1,11,13,false,true,true,0.809,0.191
326,292,34,20.375,19.466667,34,290,416,-126,0,0,0,0,-11,16,15,-3.090909,0,0,1,4,false,true,true,0.992,0.008
58,37,21,11.6,7.4,21,1281,1339,-58,0,0,0,0,73,5,5,0.561644,0,0,27,13,false,true,true,0.523,0.477
27,22,5,13.5,22,5,1572,1550,22,0,0,0,0,91,2,1,0.428571,0,0,8,10,false,true,false,0.258,0.742
163,132,31,16.3,14.666667,31,448,598,-150,0,0,0,0,35,10,9,1.028571,1,0,13,11,false,true,true,0.737,0.263
291,334,-43,22.384615,25.692308,-43,1762,1538,224,1,2,0.076923,0.153846,8,13,13,4.25,0,0,21,10,false,true,true,0.704,0.296
341,262,79,14.208333,11.391304,79,1128,889,239,0,1,0,0.043478,-33,24,23,-1.424242,0,0,3,1,true,true,true,1,0
290,273,17,16.111111,15.166667,17,500,567,-67,0,0,0,0,-4,18,18,-11,0,0,8,17,false,true,true,0.906,0.094
459,313,146,24.157895,17.388889,146,1270,1322,-52,1,0,0.052632,0,-22,19,18,-1.727273,0,0,2,2,false,true,true,1,0
198,178,20,15.230769,13.692308,20,1029,1075,-46,0,0,0,0,26,13,13,1.846154,2,0,9,23,false,true,true,0.944,0.056
249,180,69,35.571429,25.714286,69,1320,1339,-19,2,1,0.285714,0.142857,42,7,7,0.928571,0,0,7,22,false,true,true,0.991,0.009
436,328,108,31.142857,23.428571,108,1803,1552,251,2,2,0.142857,0.142857,-8,14,14,-3.5,0,0,11,15,true,true,true,0.991,0.009
312,309,3,22.285714,23.769231,3,1076,1176,-100,0,1,0,0.076923,1,14,13,32,0,0,10,8,false,true,false,0.482,0.518
362,306,56,24.133333,20.4,56,1210,1253,-43,0,1,0,0.066667,-18,15,15,-1.888889,0,0,3,12,false,true,true,0.999,0.001
109,37,72,36.333333,12.333333,72,371,336,35,1,0,0.333333,0,71,3,3,0.535211,0,0,14,10,false,true,true,0.944,0.056
129,123,6,25.8,24.6,6,1305,1242,63,1,0,0.2,0,63,5,5,0.539683,0,1,10,21,false,true,true,0.773,0.227
73,27,46,18.25,9,46,1030,1045,-15,0,0,0,0,81,4,3,0.567901,0,0,10,10,false,true,true,0.586,0.414
391,272,119,24.4375,18.133333,119,695,671,24,0,0,0,0,-7,16,15,-4.714286,0,1,4,4,false,true,true,1,0
185,142,43,16.818182,14.2,43,448,598,-150,0,0,0,0,27,11,10,1.333333,1,0,12,11,false,true,true,0.872,0.128
279,192,87,16.411765,11.294118,87,498,43,455,0,0,0,0,-12,17,17,-3.083333,0,0,6,3,false,true,true,1,0
328,272,56,21.866667,18.133333,56,306,169,137,0,0,0,0,-19,15,15,-1.789474,0,0,4,7,false,true,true,1,0
8,0,8,8,0,8,1096,1009,87,0,0,0,0,98,1,0,0.44898,1,0,29,0,false,true,true,0.735,0.265
164,162,2,16.4,16.2,2,871,999,-128,0,0,0,0,35,10,10,1.371429,0,0,8,19,false,true,false,0.197,0.803
170,71,99,42.5,17.75,99,1054,917,137,0,0,0,0,65,4,4,0.538462,0,0,7,9,false,true,true,0.997,0.003
421,394,27,46.777778,43.777778,27,1370,1431,-61,2,1,0.222222,0.111111,15,9,9,1.533333,1,0,9,10,false,true,true,0.999,0.001
435,286,149,16.111111,11,149,1176,1076,100,0,0,0,0,-26,27,26,-2.269231,0,0,3,4,false,true,true,1,0
374,249,125,31.166667,22.636364,125,1334,1477,-143,2,1,0.166667,0.090909,5,12,11,6,0,0,7,7,false,true,true,1,0
326,296,30,18.111111,16.444444,30,363,668,-305,0,0,0,0,-9,18,18,-4.777778,0,1,8,3,false,true,true,0.966,0.034
324,331,-7,20.25,20.6875,-7,1210,1252,-42,1,0,0.0625,0,-10,16,16,-3.2,1,0,2,4,true,true,true,0.631,0.369
106,51,55,26.5,17,55,838,786,52,0,0,0,0,76,4,3,0.421053,0,0,7,7,false,true,true,0.876,0.124
12,14,-2,12,14,-2,1055,1050,5,0,0,0,0,93,1,1,0.365591,0,0,8,8,false,true,false,0.447,0.553
178,108,70,25.428571,15.428571,70,1065,1030,35,0,0,0,0,52,7,7,0.653846,0,0,14,8,false,true,true,0.923,0.077
419,222,197,29.928571,15.857143,197,820,783,37,1,0,0.071429,0,-2,14,14,-16.5,0,0,7,7,false,true,true,1,0
204,108,96,25.5,15.428571,96,1065,1030,35,0,0,0,0,49,8,7,0.693878,1,0,8,8,false,true,true,0.988,0.012
57,66,-9,14.25,16.5,-9,539,632,-93,0,0,0,0,77,4,4,0.597403,0,0,8,9,false,true,false,0.22,0.78
249,140,109,24.9,15.555556,109,1397,1422,-25,2,0,0.2,0,40,10,9,0.9,0,2,7,19,false,true,true,1,0
291,181,110,36.375,22.625,110,1396,1454,-58,2,0,0.25,0,39,8,8,0.846154,0,0,12,10,false,true,true,0.999,0.001
359,245,114,22.4375,15.3125,114,526,370,156,0,0,0,0,-15,16,16,-2.333333,0,0,5,3,false,true,true,1,0
280,253,27,17.5,15.8125,27,739,480,259,1,0,0.0625,0,-4,16,16,-9,0,2,11,9,false,true,false,0.02,0.98
54,24,30,27,24,30,784,758,26,0,0,0,0,89,2,1,0.393258,0,0,13,11,false,true,true,0.637,0.363
172,130,42,24.571429,18.571429,42,758,796,-38,0,0,0,0,49,7,7,0.77551,0,0,12,10,false,true,true,0.875,0.125
210,198,12,16.153846,16.5,12,576,494,82,0,0,0,0,24,13,12,1.833333,0,0,8,10,false,true,true,0.523,0.477
402,298,104,26.8,21.285714,104,791,885,-94,1,1,0.066667,0.071429,-6,15,14,-6.333333,0,0,9,13,false,true,true,0.999,0.001
212,138,74,23.555556,17.25,74,1110,1039,71,0,0,0,0,39,9,8,0.923077,0,0,14,10,false,true,true,0.917,0.083
296,237,59,22.769231,18.230769,59,306,169,137,0,0,0,0,-5,13,13,-6.8,0,0,13,12,false,true,true,1,0
263,282,-19,16.4375,17.625,-19,316,306,10,0,2,0,0.125,-6,16,16,-6.333333,0,0,10,17,false,true,false,0.27,0.73
284,208,76,23.666667,18.909091,76,971,1180,-209,1,0,0.083333,0,19,12,11,1.684211,0,1,16,6,false,true,true,0.893,0.107
178,146,32,17.8,14.6,32,1164,1201,-37,0,0,0,0,37,10,10,1.135135,0,1,18,15,false,true,false,0.43,0.57
139,75,64,34.75,25,64,1489,1555,-66,1,0,0.25,0,68,4,3,0.426471,0,0,10,18,false,true,true,0.503,0.497
257,263,-6,17.133333,18.785714,-6,1388,1477,-89,1,0,0.066667,0,9,15,14,5.333333,1,0,10,15,false,true,false,0.169,0.831
346,313,33,21.625,19.5625,33,1304,1040,264,1,0,0.0625,0,-9,16,16,-3.666667,0,1,2,2,false,true,true,0.993,0.007
182,134,48,20.222222,16.75,48,885,719,166,0,0,0,0,45,9,8,0.844444,0,1,12,9,false,true,true,0.987,0.013
28,30,-2,28,30,-2,1050,1144,-94,0,0,0,0,92,1,1,0.413043,0,0,10,9,false,true,false,0.473,0.527
155,116,39,31,23.2,39,795,830,-35,1,1,0.2,0.2,54,5,5,0.777778,2,0,17,8,false,true,true,0.977,0.023
319,255,64,21.266667,17,64,691,473,218,0,0,0,0,-6,15,15,-6,1,0,7,4,false,true,true,1,0
208,180,28,20.8,20,28,1078,1130,-52,0,1,0,0.111111,35,10,9,1.114286,0,1,12,18,false,true,false,0.396,0.604
336,353,-17,28,29.416667,-17,1256,1232,24,1,0,0.083333,0,5,12,12,6,0,0,7,14,false,true,false,0.207,0.793
181,119,62,22.625,14.875,62,561,526,35,0,0,0,0,34,8,8,1.029412,0,0,16,10,false,true,true,0.934,0.066
177,197,-20,12.642857,14.071429,-20,611,584,27,0,0,0,0,20,14,14,2.2,0,0,11,15,false,true,false,0.427,0.573
210,185,25,26.25,23.125,25,1793,1897,-104,1,0,0.125,0,40,8,8,0.75,0,0,11,7,false,true,true,0.53,0.47
14,26,-12,14,26,-12,1109,1065,44,0,0,0,0,93,1,1,0.354839,0,0,15,16,false,true,false,0.267,0.733
101,111,-10,11.222222,13.875,-10,539,632,-93,0,0,0,0,51,9,8,0.901961,0,1,25,13,false,true,false,0.114,0.886
115,96,19,16.428571,16,19,1606,1544,62,0,0,0,0,66,7,6,0.681818,1,0,12,10,false,true,true,0.675,0.325
236,228,8,15.733333,15.2,8,272,238,34,0,0,0,0,-5,15,15,-8,0,1,24,6,false,true,true,0.815,0.185
162,169,-7,27,28.166667,-7,974,995,-21,0,1,0,0.166667,54,6,6,0.611111,0,0,15,11,false,true,true,0.728,0.272
268,218,50,22.333333,18.166667,50,1364,1093,271,0,1,0,0.083333,17,12,12,2.235294,0,0,16,10,false,true,true,0.989,0.011
170,85,85,34,21.25,85,1880,1777,103,1,0,0.2,0,62,5,4,0.451613,0,1,7,11,false,true,true,0.912,0.088
77,16,61,38.5,16,61,1348,1331,17,0,0,0,0,86,2,1,0.27907,1,0,14,9,false,true,true,0.864,0.136
69,34,35,13.8,8.5,35,1016,1037,-21,0,0,0,0,75,5,4,0.64,0,1,10,13,false,true,false,0.27,0.73
68,81,-13,13.6,16.2,-13,1221,1438,-217,0,0,0,0,70,5,5,0.642857,0,1,22,6,false,true,false,0.245,0.755
404,238,166,17.565217,10.818182,166,1033,1037,-4,0,1,0,0.045455,-27,23,22,-1.666667,0,1,2,1,true,true,true,1,0
193,173,20,24.125,21.625,20,1782,1512,270,1,1,0.125,0.125,48,8,8,0.875,0,0,10,10,false,true,true,0.991,0.009
184,186,-2,20.444444,20.666667,-2,809,868,-59,1,0,0.111111,0,33,9,9,0.969697,0,0,11,16,false,true,true,0.697,0.303
137,135,2,10.538462,10.384615,2,416,222,194,0,0,0,0,26,13,13,2.115385,1,0,10,24,false,true,true,0.842,0.158
86,44,42,28.666667,14.666667,42,1075,1027,48,1,0,0.333333,0,73,3,3,0.506849,0,0,17,15,false,true,true,0.581,0.419
426,237,189,21.3,12.473684,189,1295,1477,-182,3,0,0.15,0,-14,20,19,-3.285714,0,0,4,7,false,true,true,1,0
65,42,23,21.666667,21,23,871,999,-128,0,0,0,0,81,3,2,0.592593,0,0,7,14,false,true,false,0.319,0.681
308,303,5,51.333333,50.5,5,1370,1431,-61,2,1,0.333333,0.166667,39,6,6,0.589744,0,0,11,12,false,true,true,0.93,0.07
241,182,59,18.538462,15.166667,59,786,788,-2,0,0,0,0,7,13,12,4.857143,1,1,9,12,false,true,true,0.787,0.213
210,174,36,19.090909,17.4,36,719,785,-66,0,1,0,0.1,29,11,10,1.241379,0,0,16,16,false,true,true,0.855,0.145
183,121,62,22.875,15.125,62,1439,1413,26,0,0,0,0,52,8,8,0.692308,0,0,20,11,false,true,true,0.906,0.094
250,342,-92,22.727273,34.2,-92,1897,1793,104,1,3,0.090909,0.3,34,11,10,0.941176,0,0,10,14,false,true,false,0.272,0.728
326,311,15,19.176471,18.294118,15,613,611,2,0,0,0,0,-21,17,17,-1.809524,0,0,5,2,false,true,true,0.982,0.018
109,67,42,27.25,16.75,42,871,867,4,0,0,0,0,69,4,4,0.623188,0,0,11,9,false,true,true,0.879,0.121
143,61,82,35.75,15.25,82,986,856,130,1,0,0.25,0,68,4,4,0.455882,0,0,12,11,false,true,true,0.96,0.04
433,287,146,27.0625,19.133333,146,1270,1322,-52,1,0,0.0625,0,-8,16,15,-4.75,0,0,4,7,false,true,true,1,0
129,173,-44,16.125,21.625,-44,95,360,-265,0,1,0,0.125,39,8,8,1.025641,0,0,12,8,false,true,false,0.332,0.668
285,251,34,16.764706,14.764706,34,916,876,40,0,0,0,0,-22,17,17,-1.545455,1,0,0,3,true,true,true,0.998,0.002
77,67,10,12.833333,13.4,10,859,822,37,0,0,0,0,60,6,5,0.633333,0,0,29,13,false,true,false,0.36,0.64
354,291,63,22.125,18.1875,63,1047,1094,-47,1,1,0.0625,0.0625,-4,16,16,-9,1,0,8,5,false,true,true,1,0
409,299,110,27.266667,19.933333,110,1334,1477,-143,2,1,0.133333,0.066667,-15,15,15,-2,0,0,2,4,true,true,true,1,0
304,196,108,16,10.315789,108,1428,1302,126,0,0,0,0,-11,19,19,-4.818182,0,1,10,18,false,true,true,0.999,0.001
255,239,16,17,15.933333,16,808,812,-4,0,0,0,0,1,15,15,37,1,0,13,11,false,true,true,0.896,0.104
297,184,113,22.846154,14.153846,113,303,342,-39,0,0,0,0,17,13,13,2.235294,0,0,14,10,false,true,true,1,0
326,348,-22,23.285714,24.857143,-22,809,868,-59,2,1,0.142857,0.071429,-5,14,14,-6.4,1,0,1,7,false,true,true,0.518,0.482
409,280,129,15.148148,10.37037,129,1413,1422,-9,0,0,0,0,-30,27,27,-1.9,0,0,3,1,false,true,true,1,0
240,148,92,26.666667,18.5,92,371,336,35,2,0,0.222222,0,22,9,8,1.727273,0,0,12,16,false,true,true,0.996,0.004
123,112,11,17.571429,18.666667,11,831,830,1,0,0,0,0,58,7,6,0.637931,0,0,24,9,false,true,true,0.555,0.445
119,90,29,19.833333,18,29,349,315,34,0,0,0,0,55,6,5,0.618182,0,0,21,11,false,true,true,0.743,0.257
323,317,6,14.043478,13.782609,6,999,1011,-12,0,0,0,0,-33,23,23,-1.393939,1,0,1,5,true,true,true,0.986,0.014
98,111,-13,16.333333,22.2,-13,1519,1782,-263,0,0,0,0,63,6,5,0.52381,0,0,16,12,false,true,false,0.112,0.888
296,295,1,14.8,15.526316,1,576,494,82,0,0,0,0,-17,20,19,-2.588235,0,0,4,6,false,true,false,0.128,0.872
38,16,22,19,16,22,1344,1325,19,0,0,0,0,87,2,1,0.356322,0,0,11,8,false,true,true,0.5,0.5
439,358,81,33.769231,29.833333,81,1880,1777,103,1,1,0.076923,0.083333,-5,13,12,-5.6,0,0,3,8,false,true,true,0.988,0.012
311,220,91,25.916667,20,91,1050,1144,-94,0,1,0,0.090909,21,12,11,1.809524,0,1,11,9,false,true,true,0.999,0.001
119,60,59,23.8,15,59,1547,1439,108,1,0,0.2,0,68,5,4,0.544118,0,0,8,18,false,true,true,0.993,0.007
30,46,-16,15,23,-16,954,1078,-124,0,0,0,0,84,2,2,0.452381,0,0,26,13,false,true,false,0.27,0.73
138,92,46,23,18.4,46,1556,1591,-35,0,0,0,0,61,6,5,0.590164,1,0,18,10,false,true,true,0.867,0.133
285,239,46,25.909091,23.9,46,1320,1339,-19,2,1,0.181818,0.1,22,11,10,1.772727,0,0,21,13,false,true,true,0.944,0.056
194,162,32,14.923077,13.5,32,1016,1037,-21,0,0,0,0,24,13,12,2,1,0,18,19,false,true,true,0.797,0.203
46,14,32,23,14,32,804,683,121,0,0,0,0,87,2,1,0.517241,0,0,8,7,false,true,true,0.574,0.426
203,139,64,29,23.166667,64,1023,1070,-47,1,0,0.142857,0,49,7,6,0.653061,1,0,17,9,false,true,true,0.969,0.031
30,22,8,15,11,8,1027,856,171,0,0,0,0,83,2,2,0.39759,0,0,7,13,false,true,true,0.521,0.479
302,305,-3,17.764706,19.0625,-3,491,398,93,0,0,0,0,-6,17,16,-6,1,0,5,10,false,true,false,0.35,0.65
232,156,76,23.2,15.6,76,1065,1030,35,0,0,0,0,31,10,10,1.096774,1,0,10,7,false,true,true,0.979,0.021
137,47,90,34.25,11.75,90,371,336,35,1,0,0.25,0,61,4,4,0.622951,0,0,11,12,false,true,true,0.979,0.021
347,337,10,20.411765,21.0625,10,1100,1008,92,1,0,0.058824,0,-16,17,16,-2.25,0,0,1,2,false,true,true,0.782,0.218
346,310,36,15.727273,14.761905,36,1583,1422,161,1,0,0.045455,0,-10,22,21,-5.1,0,0,5,11,false,true,true,0.85,0.15
136,135,1,22.666667,22.5,1,1397,1195,202,0,0,0,0,54,6,6,0.648148,0,0,7,17,false,true,false,0.257,0.743
237,204,33,21.545455,20.4,33,315,294,21,0,1,0,0.1,18,11,10,1.944444,0,0,12,18,false,true,true,0.837,0.163
392,284,108,24.5,17.75,108,1069,917,152,1,1,0.0625,0.0625,-14,16,16,-2.428571,0,0,2,1,false,true,true,1,0
383,328,55,22.529412,20.5,55,880,952,-72,0,0,0,0,-11,17,16,-3.181818,0,0,1,2,false,true,true,0.998,0.002
360,326,34,16.363636,15.52381,34,1388,1477,-89,1,0,0.045455,0,-28,22,21,-1.714286,0,0,2,7,false,true,true,0.998,0.002
264,171,93,33,21.375,93,630,786,-156,1,0,0.125,0,40,8,8,0.875,0,0,10,23,false,true,true,0.998,0.002
347,279,68,24.785714,21.461538,68,1142,1095,47,1,0,0.071429,0,-3,14,13,-11.666667,0,0,16,11,false,true,true,0.999,0.001
309,297,12,19.3125,19.8,12,613,611,2,0,0,0,0,-12,16,15,-3.166667,0,0,10,5,false,true,true,0.68,0.32
354,286,68,16.857143,13.619048,68,416,374,42,0,0,0,0,-18,21,21,-2.555556,0,0,2,2,false,true,true,1,0
426,256,170,23.666667,14.222222,170,954,1078,-124,1,1,0.055556,0.055556,-22,18,18,-1.727273,0,0,1,2,false,true,true,1,0
162,140,22,16.2,14,22,758,750,8,0,0,0,0,29,10,10,1.275862,0,1,10,11,false,true,true,0.533,0.467
342,337,5,16.285714,16.047619,5,1164,1201,-37,0,0,0,0,-33,21,21,-1.272727,0,0,2,1,true,true,true,0.926,0.074
252,180,72,25.2,18,72,1093,1090,3,1,1,0.1,0.1,35,10,10,0.971429,0,1,16,11,false,true,true,0.89,0.11
290,251,39,24.166667,22.818182,39,1266,1144,122,0,0,0,0,14,12,11,2.428571,1,0,7,14,false,true,true,0.949,0.051
145,74,71,20.714286,12.333333,71,838,786,52,0,0,0,0,55,7,6,0.581818,1,1,9,11,false,true,true,0.826,0.174
48,22,26,24,11,26,901,889,12,0,0,0,0,91,2,2,0.472527,0,1,9,7,false,true,true,0.579,0.421
55,13,42,18.333333,6.5,42,527,503,24,0,0,0,0,85,3,2,0.482353,2,0,18,10,false,true,true,0.977,0.023
331,286,45,15.045455,13.619048,45,1030,1045,-15,1,0,0.045455,0,-26,22,21,-1.769231,0,0,1,5,false,true,true,0.999,0.001
411,296,115,31.615385,24.666667,115,1197,1127,70,0,0,0,0,-2,13,12,-15,0,0,7,11,false,true,true,1,0
63,64,-1,12.6,16,-1,448,598,-150,0,0,0,0,70,5,4,0.514286,0,0,11,7,false,true,false,0.199,0.801
218,231,-13,19.818182,21,-13,1530,1550,-20,0,1,0,0.090909,22,11,11,1.545455,1,0,24,10,false,true,true,0.851,0.149
292,262,30,15.368421,14.555556,30,371,435,-64,0,0,0,0,-21,19,18,-2.095238,0,0,3,3,false,true,true,0.993,0.007
86,72,14,21.5,24,14,758,796,-38,0,0,0,0,74,4,3,0.513514,0,0,10,14,false,true,false,0.278,0.722
90,28,62,22.5,9.333333,62,1413,1422,-9,0,0,0,0,74,4,3,0.77027,1,0,16,17,false,true,true,0.925,0.075
432,268,164,36,24.363636,164,1824,1793,31,1,0,0.083333,0,8,12,11,3.5,0,0,10,9,false,true,true,1,0
28,0,28,28,0,28,1394,1424,-30,0,0,0,0,95,1,0,0.336842,0,0,13,0,false,true,true,0.516,0.484
278,196,82,21.384615,16.333333,82,527,503,24,0,0,0,0,28,13,12,1.464286,0,0,10,9,false,true,true,0.985,0.015
58,53,5,19.333333,26.5,5,864,808,56,0,0,0,0,80,3,2,0.425,0,0,7,10,false,true,false,0.321,0.679
194,122,72,17.636364,12.2,72,346,231,115,0,0,0,0,16,11,10,2.5625,0,0,10,10,false,true,true,0.983,0.017
350,347,3,21.875,23.133333,3,1320,1339,-19,2,1,0.125,0.066667,-6,16,15,-6.5,0,0,7,11,false,true,false,0.281,0.719
224,189,35,18.666667,15.75,35,916,837,79,0,0,0,0,30,12,12,1.333333,1,0,6,11,false,true,true,0.944,0.056
162,162,0,18,18,0,808,812,-4,0,0,0,0,36,9,9,1.027778,1,0,13,9,false,true,true,0.535,0.465
231,161,70,17.769231,13.416667,70,498,43,455,0,0,0,0,13,13,12,2.846154,0,0,10,12,false,true,true,0.984,0.016
27,41,-14,9,20.5,-14,947,810,137,0,0,0,0,81,3,2,0.518519,0,0,11,10,false,true,false,0.232,0.768
54,36,18,18,12,18,916,876,40,0,0,0,0,76,3,3,0.447368,0,0,14,17,false,true,false,0.499,0.501
228,212,16,17.538462,17.666667,16,1090,1244,-154,0,0,0,0,16,13,12,2.3125,1,1,6,9,false,true,false,0.246,0.754
327,267,60,14.217391,12.136364,60,1016,1037,-21,0,0,0,0,-22,23,22,-2.181818,0,0,1,12,false,true,true,0.999,0.001
129,86,43,25.8,17.2,43,1550,1624,-74,0,0,0,0,64,5,5,0.46875,0,1,23,16,false,true,true,0.522,0.478
121,46,75,20.166667,9.2,75,777,830,-53,0,0,0,0,67,6,5,0.61194,1,0,14,11,false,true,true,0.904,0.096
282,231,51,18.8,15.4,51,1227,1060,167,0,1,0,0.066667,2,15,15,20,0,1,14,7,false,true,true,0.823,0.177
18,68,-50,18,68,-50,1762,1538,224,0,1,0,1,89,1,1,0.382022,0,0,9,24,false,true,true,0.814,0.186
371,279,92,18.55,14.684211,92,916,837,79,1,0,0.05,0,-26,20,19,-1.538462,0,0,1,2,false,true,true,1,0
358,265,93,22.375,16.5625,93,1073,1177,-104,1,0,0.0625,0,-14,16,16,-2.285714,0,0,2,1,true,true,true,1,0
286,218,68,23.833333,19.818182,68,1073,1177,-104,1,0,0.083333,0,16,12,11,2,0,0,18,17,false,true,true,0.907,0.093
97,81,16,19.4,16.2,16,500,567,-67,0,0,0,0,68,5,5,0.647059,0,0,7,7,false,true,true,0.813,0.187
198,135,63,22,15,63,1253,1166,87,1,0,0.111111,0,44,9,9,0.977273,0,0,12,22,false,true,true,0.941,0.059
369,249,120,20.5,14.647059,120,526,370,156,0,0,0,0,-19,18,17,-1.842105,0,0,1,3,true,true,true,1,0
204,120,84,25.5,17.142857,84,1270,1315,-45,0,0,0,0,44,8,7,0.818182,0,0,7,25,false,true,true,0.967,0.033
335,294,41,17.631579,15.473684,41,1040,925,115,0,0,0,0,-28,19,19,-1.535714,0,0,11,2,false,true,true,0.998,0.002
55,52,3,13.75,13,3,580,620,-40,0,0,0,0,72,4,4,0.597222,1,0,20,18,false,true,true,0.524,0.476
312,252,60,19.5,15.75,60,1270,1315,-45,0,0,0,0,-9,16,16,-4,0,0,2,28,false,true,true,0.997,0.003
155,53,102,31,13.25,102,1439,1294,145,1,0,0.2,0,65,5,4,0.553846,0,0,9,15,false,true,true,0.975,0.025
228,172,56,20.727273,15.636364,56,739,480,259,1,0,0.090909,0,27,11,11,1.333333,0,1,13,9,false,true,true,0.991,0.009
321,123,198,35.666667,15.375,198,1054,917,137,2,0,0.222222,0,25,9,8,1.4,0,0,15,14,false,true,true,1,0
248,192,56,27.555556,21.333333,56,1803,1552,251,1,1,0.111111,0.111111,34,9,9,0.823529,1,0,7,10,false,true,true,0.943,0.057
256,215,41,17.066667,15.357143,41,864,808,56,1,0,0.066667,0,-8,15,14,-4.25,0,1,15,19,false,true,true,0.851,0.149
252,230,22,16.8,16.428571,22,801,807,-6,0,0,0,0,1,15,14,35,1,0,10,11,false,true,true,0.822,0.178
255,232,23,21.25,21.090909,23,1270,1348,-78,0,0,0,0,24,12,11,1.583333,0,0,14,7,false,true,false,0.465,0.535
316,226,90,26.333333,18.833333,90,1034,1040,-6,1,0,0.083333,0,15,12,12,2.333333,1,0,6,19,false,true,true,1,0
342,166,176,28.5,15.090909,176,1211,1173,38,0,0,0,0,24,12,11,1.458333,0,1,10,10,false,true,true,1,0
47,66,-19,15.666667,22,-19,1227,1060,167,0,0,0,0,81,3,3,0.493827,0,1,14,8,false,true,false,0.328,0.672
132,88,44,22,17.6,44,1069,917,152,0,0,0,0,63,6,5,0.539683,0,1,7,7,false,true,true,0.949,0.051
143,159,-16,15.888889,19.875,-16,916,876,40,0,0,0,0,35,9,8,0.971429,1,0,13,7,false,true,false,0.433,0.567
207,179,28,15.923077,13.769231,28,871,999,-128,0,0,0,0,21,13,13,2.285714,0,0,10,19,false,true,false,0.498,0.502
221,204,17,17,17,17,1176,1127,49,0,0,0,0,12,13,12,3.083333,0,0,21,23,false,true,true,0.633,0.367
146,67,79,48.666667,33.5,79,1633,1580,53,1,0,0.333333,0,78,3,2,0.358974,0,0,17,13,false,true,true,0.951,0.049
163,64,99,40.75,16,99,925,801,124,1,0,0.25,0,73,4,4,0.547945,1,0,6,9,false,true,true,0.997,0.003
26,14,12,26,14,12,1277,1166,111,0,0,0,0,93,1,1,0.387097,0,0,18,13,false,true,true,0.531,0.469
145,151,-6,24.166667,25.166667,-6,1210,1253,-43,0,1,0,0.166667,50,6,6,0.68,0,0,19,16,false,true,true,0.651,0.349
10,12,-2,10,12,-2,1216,1228,-12,0,0,0,0,93,1,1,0.354839,0,0,15,18,false,true,false,0.312,0.688
80,86,-6,16,17.2,-6,1090,1244,-154,0,0,0,0,64,5,5,0.578125,0,0,12,16,false,true,false,0.119,0.881
169,171,-2,15.363636,15.545455,-2,576,494,82,0,0,0,0,35,11,11,1.257143,0,0,11,16,false,true,true,0.597,0.403
152,99,53,25.333333,19.8,53,971,906,65,0,0,0,0,55,6,5,0.581818,0,0,14,13,false,true,true,0.865,0.135
50,18,32,25,18,32,1216,1217,-1,0,0,0,0,88,2,1,0.386364,0,0,17,11,false,true,true,0.527,0.473
256,152,104,25.6,16.888889,104,539,500,39,0,0,0,0,25,10,9,1.6,0,0,11,10,false,true,true,1,0
34,48,-14,11.333333,24,-14,480,518,-38,0,0,0,0,87,3,2,0.528736,0,0,10,12,false,true,false,0.122,0.878
200,217,-17,16.666667,18.083333,-17,671,725,-54,0,0,0,0,18,12,12,2.055556,1,0,9,9,false,true,false,0.295,0.705
67,65,2,16.75,16.25,2,885,719,166,0,0,0,0,75,4,4,0.506667,0,1,23,9,false,true,true,0.526,0.474
240,154,86,21.818182,15.4,86,1253,1166,87,1,0,0.090909,0,34,11,10,1.264706,0,0,7,23,false,true,true,0.99,0.01
61,62,-1,20.333333,20.666667,-1,1513,1479,34,0,0,0,0,78,3,3,0.435897,1,0,22,7,false,true,true,0.859,0.141
59,5,54,19.666667,2.5,54,869,820,49,0,0,0,0,87,3,2,0.425287,0,1,15,6,false,true,true,0.71,0.29
148,110,38,18.5,13.75,38,1048,1000,48,0,0,0,0,49,8,8,0.816327,0,1,9,21,false,true,true,0.565,0.435
203,146,57,20.3,14.6,57,804,683,121,0,0,0,0,35,10,10,1.285714,0,1,18,13,false,true,true,0.992,0.008
140,99,41,20,14.142857,41,1181,1069,112,0,0,0,0,52,7,7,0.711538,0,0,24,11,false,true,true,0.885,0.115
377,338,39,22.176471,19.882353,39,1388,1506,-118,2,1,0.117647,0.058824,-12,17,17,-2.833333,0,0,1,3,true,true,true,0.997,0.003
43,37,6,14.333333,18.5,6,1156,1184,-28,0,0,0,0,79,3,2,0.35443,1,0,13,13,false,true,false,0.496,0.504
152,150,2,19,18.75,2,1266,1247,19,0,0,0,0,43,8,8,0.744186,0,0,10,16,false,true,false,0.188,0.812
31,52,-21,15.5,26,-21,363,668,-305,0,0,0,0,88,2,2,0.488636,0,0,14,10,false,true,false,0.116,0.884
256,257,-1,23.272727,25.7,-1,974,995,-21,0,1,0,0.1,21,11,10,1.571429,0,0,16,7,false,true,true,0.718,0.282
379,272,107,21.055556,16,107,704,691,13,1,0,0.055556,0,-17,18,17,-2.235294,0,0,2,3,false,true,true,1,0
40,15,25,13.333333,7.5,25,1091,1078,13,0,0,0,0,84,3,2,0.511905,0,0,13,11,false,true,false,0.49,0.51
249,184,65,20.75,16.727273,65,1170,1156,14,1,0,0.083333,0,22,12,11,1.727273,1,0,6,11,false,true,true,0.965,0.035
373,285,88,24.866667,19,88,1394,1118,276,0,1,0,0.066667,-2,15,15,-18.5,0,0,17,3,false,true,true,1,0
77,67,10,19.25,16.75,10,695,523,172,0,0,0,0,66,4,4,0.560606,0,1,10,6,false,true,true,0.84,0.16
131,13,118,65.5,13,118,1633,1580,53,1,0,0.5,0,87,2,1,0.321839,0,0,17,19,false,true,true,0.982,0.018
131,57,74,32.75,19,74,1270,1322,-52,1,0,0.25,0,76,4,3,0.5,1,0,18,16,false,true,true,0.954,0.046
409,272,137,24.058824,17,137,1211,1173,38,0,0,0,0,-13,17,16,-2.692308,0,0,5,3,false,true,true,1,0
301,229,72,16.722222,12.722222,72,892,768,124,0,0,0,0,1,18,18,43,0,0,10,13,false,true,true,0.982,0.018
128,117,11,21.333333,19.5,11,711,876,-165,0,0,0,0,57,6,6,0.754386,0,0,16,12,false,true,true,0.585,0.415
413,407,6,25.8125,27.133333,6,1428,1452,-24,1,2,0.0625,0.133333,-14,16,15,-2.214286,0,0,1,2,true,true,false,0.398,0.602
352,273,79,27.076923,21,79,1550,1546,4,0,1,0,0.076923,11,13,13,2.727273,1,0,12,7,false,true,true,1,0
159,130,29,19.875,16.25,29,808,639,169,0,0,0,0,41,8,8,1,1,0,24,10,false,true,true,0.887,0.113
102,79,23,14.571429,13.166667,23,498,43,455,0,0,0,0,56,7,6,0.660714,1,0,11,14,false,true,false,0.482,0.518
24,14,10,12,7,10,1519,1782,-263,0,0,0,0,92,2,2,0.358696,0,1,13,8,false,true,false,0.246,0.754
144,73,71,48,24.333333,71,971,621,350,1,0,0.333333,0,73,3,3,0.438356,0,0,13,10,false,true,true,0.907,0.093
192,152,40,24,19,40,1295,1281,14,0,0,0,0,53,8,8,0.716981,0,0,12,19,false,true,true,0.751,0.249
168,119,49,18.666667,13.222222,49,1011,921,90,0,0,0,0,43,9,9,1.139535,0,0,7,19,false,true,true,0.892,0.108
325,309,16,18.055556,18.176471,16,758,952,-194,0,0,0,0,-22,18,17,-1.818182,0,0,2,1,false,true,true,0.968,0.032
97,45,52,32.333333,22.5,52,1270,1315,-45,0,0,0,0,79,3,2,0.455696,0,0,7,8,false,true,true,0.577,0.423
129,81,48,25.8,20.25,48,1397,1195,202,0,0,0,0,67,5,4,0.522388,0,0,7,18,false,true,true,0.716,0.284
172,173,-1,17.2,19.222222,-1,1043,1055,-12,0,0,0,0,37,10,9,1,0,0,17,9,false,true,false,0.145,0.855
222,136,86,31.714286,22.666667,86,1396,1454,-58,1,0,0.142857,0,50,7,6,0.66,2,0,8,15,false,true,true,0.983,0.017
147,109,38,18.375,15.571429,38,527,581,-54,0,0,0,0,48,8,7,0.875,1,0,18,15,false,true,true,0.72,0.28
257,262,-5,28.555556,32.75,-5,1125,1227,-102,1,1,0.111111,0.125,25,9,8,1.2,1,0,9,12,false,true,true,0.518,0.482
352,194,158,15.304348,8.818182,158,993,897,96,1,0,0.043478,0,-25,23,22,-1.88,0,0,3,25,false,true,true,1,0
159,91,68,15.9,10.111111,68,584,565,19,0,0,0,0,40,10,9,1.15,1,0,9,18,false,true,true,0.96,0.04
194,133,61,17.636364,12.090909,61,346,231,115,0,0,0,0,13,11,11,3.153846,0,0,10,9,false,true,true,0.983,0.017
245,251,-6,17.5,17.928571,-6,95,378,-283,0,0,0,0,-3,14,14,-11.666667,0,0,16,10,false,true,false,0.49,0.51
330,225,105,25.384615,17.307692,105,1397,1422,-25,3,0,0.230769,0,23,13,13,1.565217,0,2,26,10,false,true,true,0.999,0.001
217,95,122,31,13.571429,122,1093,1100,-7,2,1,0.285714,0.142857,55,7,7,0.581818,0,1,11,13,false,true,true,1,0
104,50,54,26,16.666667,54,1826,1803,23,0,0,0,0,74,4,3,0.405405,0,0,8,8,false,true,true,0.518,0.482
243,255,-12,15.1875,15.9375,-12,540,518,22,0,0,0,0,-5,16,16,-8,0,0,9,13,false,true,false,0.385,0.615
166,176,-10,33.2,35.2,-10,1454,1531,-77,1,1,0.2,0.2,58,5,5,0.517241,0,0,12,10,false,true,false,0.355,0.645
307,233,74,20.466667,15.533333,74,620,658,-38,0,0,0,0,-1,15,15,-36,0,0,15,11,false,true,true,0.999,0.001
312,231,81,20.8,15.4,81,704,691,13,1,0,0.066667,0,-3,15,15,-12.666667,0,0,21,13,false,true,true,0.999,0.001
321,289,32,17.833333,17,32,942,976,-34,0,0,0,0,-16,18,17,-2.5,0,0,2,8,false,true,true,0.987,0.013
365,275,90,26.071429,19.642857,90,996,1063,-67,1,1,0.071429,0.071429,-3,14,14,-10.666667,1,0,7,9,false,true,true,1,0
339,295,44,18.833333,16.388889,44,448,598,-150,0,0,0,0,-18,18,18,-2,0,0,4,8,true,true,true,0.998,0.002
47,38,9,15.666667,12.666667,9,859,822,37,0,0,0,0,74,3,3,0.513514,0,0,20,9,false,true,true,0.533,0.467
121,44,77,40.333333,22,77,1489,1555,-66,1,0,0.333333,0,77,3,2,0.376623,0,0,11,17,false,true,true,0.591,0.409
166,133,33,16.6,13.3,33,363,668,-305,0,0,0,0,43,10,10,1,0,0,8,13,false,true,true,0.642,0.358
6,0,6,6,0,6,844,821,23,0,0,0,0,97,1,0,0.43299,0,0,23,0,false,true,true,0.52,0.48
382,247,135,16.608696,11.227273,135,595,543,52,0,0,0,0,-29,23,22,-1.62069,0,0,7,5,false,true,true,1,0
144,108,36,24,18,36,1127,1176,-49,0,0,0,0,55,6,6,0.763636,0,0,12,16,false,true,true,0.802,0.198
324,284,40,20.25,17.75,40,904,783,121,0,0,0,0,-3,16,16,-14,1,0,12,8,false,true,true,0.996,0.004
126,82,44,21,16.4,44,695,523,172,0,0,0,0,56,6,5,0.660714,0,1,11,10,false,true,true,0.964,0.036
97,14,83,48.5,14,83,1004,653,351,0,0,0,0,81,2,1,0.432099,0,0,10,12,false,true,true,0.992,0.008
186,275,-89,16.909091,27.5,-89,1265,1045,220,0,1,0,0.1,20,11,10,2.1,0,0,23,10,false,true,false,0.048,0.952
332,259,73,30.181818,23.545455,73,1349,1302,47,0,0,0,0,15,11,11,1.933333,0,0,15,7,false,true,true,0.993,0.007
314,300,14,18.470588,18.75,14,1181,1149,32,0,1,0,0.0625,1,17,16,45,1,0,13,15,false,true,true,0.908,0.092
317,226,91,13.782609,10.272727,91,416,222,194,0,0,0,0,-27,23,22,-2.037037,0,0,11,11,false,true,true,1,0
359,254,105,19.944444,14.111111,105,1413,1422,-9,0,0,0,0,-5,18,18,-11.4,0,0,13,7,false,true,true,1,0
138,132,6,27.6,26.4,6,1793,1897,-104,1,0,0.2,0,64,5,5,0.46875,0,0,10,12,false,true,false,0.197,0.803
170,104,66,28.333333,17.333333,66,371,336,35,2,0,0.333333,0,42,6,6,0.904762,1,0,15,22,false,true,false,0.159,0.841
280,255,25,16.470588,15.9375,25,719,614,105,0,1,0,0.0625,-7,17,16,-6.142857,0,0,10,7,false,true,true,0.908,0.092
332,228,104,19.529412,13.411765,104,925,801,124,1,0,0.058824,0,-5,17,17,-8,0,0,7,11,false,true,true,1,0
259,249,10,19.923077,20.75,10,901,889,12,0,1,0,0.083333,22,13,12,1.954545,0,0,17,8,false,true,true,0.693,0.307
95,58,37,15.833333,11.6,37,859,719,140,0,1,0,0.2,55,6,5,0.963636,0,2,19,5,false,true,true,0.596,0.404
203,138,65,16.916667,12.545455,65,872,818,54,0,1,0,0.090909,37,12,11,1.108108,0,0,9,8,false,true,true,0.981,0.019
155,198,-43,19.375,28.285714,-43,1305,1218,87,0,0,0,0,41,8,7,0.926829,1,0,7,9,false,true,false,0.136,0.864
325,287,38,15.47619,14.35,38,480,518,-38,0,0,0,0,-22,21,20,-2.090909,0,0,2,5,false,true,true,0.998,0.002
44,29,15,22,14.5,15,971,658,313,0,0,0,0,86,2,2,0.418605,0,0,12,12,false,true,true,0.729,0.271
38,8,30,19,8,30,272,288,-16,0,0,0,0,89,2,1,0.58427,1,0,9,10,false,true,true,0.559,0.441
105,147,-42,15,21,-42,95,360,-265,0,1,0,0.142857,44,7,7,0.909091,0,0,9,10,false,true,false,0.187,0.813
117,80,37,29.25,20,37,1270,1315,-45,0,0,0,0,68,4,4,0.529412,0,1,12,8,false,true,true,0.596,0.404
175,160,15,19.444444,17.777778,15,505,95,410,0,1,0,0.111111,49,9,9,0.897959,0,1,12,10,false,true,true,0.969,0.031
378,363,15,19.894737,20.166667,15,1096,1009,87,2,0,0.105263,0,-9,19,18,-4.888889,0,0,7,9,false,true,false,0.447,0.553
237,238,-1,21.545455,21.636364,-1,315,294,21,0,1,0,0.090909,13,11,11,2.692308,0,0,12,12,false,true,true,0.742,0.258
175,157,18,25,22.428571,18,1344,1209,135,1,1,0.142857,0.142857,44,7,7,0.772727,0,0,13,19,false,true,true,0.741,0.259
244,253,-9,18.769231,21.083333,-9,1181,1149,32,0,1,0,0.083333,29,13,12,1.551724,1,0,8,18,false,true,false,0.268,0.732
74,90,-16,18.5,22.5,-16,808,639,169,0,0,0,0,68,4,4,0.602941,0,0,26,11,false,true,false,0.338,0.662
215,158,57,30.714286,26.333333,57,2219,2106,113,1,0,0.142857,0,44,7,6,0.613636,0,0,9,13,false,true,true,0.534,0.466
230,172,58,19.166667,14.333333,58,1037,950,87,1,0,0.083333,0,22,12,12,1.409091,0,0,8,27,false,true,true,0.983,0.017
147,121,26,21,20.166667,26,1189,1266,-77,0,0,0,0,55,7,6,0.618182,1,0,9,15,false,true,true,0.514,0.486
46,27,19,23,13.5,19,691,675,16,0,0,0,0,88,2,2,0.420455,0,1,24,8,false,true,true,0.537,0.463
203,212,-9,22.555556,26.5,-9,1439,1397,42,0,2,0,0.25,31,9,8,1.096774,2,0,8,8,false,true,true,0.713,0.287
349,340,9,19.388889,18.888889,9,1100,1008,92,1,0,0.055556,0,-21,18,18,-1.714286,0,0,1,1,true,true,true,0.939,0.061
241,168,73,21.909091,16.8,73,746,796,-50,0,1,0,0.1,23,11,10,2.086957,0,0,23,7,false,true,true,0.981,0.019
245,117,128,40.833333,23.4,128,1983,2020,-37,1,0,0.166667,0,54,6,5,0.481481,0,1,12,9,false,true,true,0.999,0.001
141,171,-30,14.1,17.1,-30,450,412,38,0,0,0,0,28,10,10,1.357143,0,0,11,14,false,true,false,0.222,0.778
58,42,16,19.333333,14,16,272,288,-16,0,0,0,0,79,3,3,0.658228,1,0,13,9,false,true,true,0.542,0.458
185,149,36,30.833333,24.833333,36,1344,1325,19,1,0,0.166667,0,53,6,6,0.584906,0,0,8,13,false,true,true,0.745,0.255
142,183,-41,20.285714,26.142857,-41,942,976,-34,0,0,0,0,48,7,7,0.833333,1,0,12,8,false,true,false,0.196,0.804
12,6,6,12,6,6,1016,1037,-21,0,0,0,0,95,1,1,0.505263,0,0,13,12,false,true,false,0.486,0.514
131,149,-18,26.2,29.8,-18,1428,1452,-24,0,0,0,0,65,5,5,0.476923,0,0,15,10,false,true,false,0.168,0.832
196,156,40,16.333333,13,40,947,909,38,0,0,0,0,18,12,12,2.555556,0,0,9,32,false,true,true,0.821,0.179
14,0,14,7,0,14,1093,1100,-7,0,0,0,0,97,2,1,0.329897,0,1,8,11,false,true,false,0.319,0.681
26,6,20,26,6,20,1004,840,164,0,0,0,0,91,1,1,0.32967,1,0,10,22,false,true,true,0.857,0.143
163,200,-37,14.818182,18.181818,-37,1176,1127,49,0,0,0,0,25,11,11,1.48,0,0,14,23,false,true,false,0.107,0.893
14,0,14,14,0,14,1762,1582,180,0,0,0,0,97,1,0,0.329897,0,0,17,0,false,true,true,0.941,0.059
278,264,14,18.533333,18.857143,14,1782,1512,270,1,1,0.066667,0.071429,3,15,14,14,0,0,19,13,false,true,true,0.993,0.007
355,378,-23,23.666667,27,-23,834,844,-10,1,2,0.066667,0.142857,-14,15,14,-2.571429,0,0,3,9,false,true,false,0.107,0.893
22,25,-3,22,25,-3,1731,1691,40,0,0,0,0,91,1,1,0.373626,1,0,9,14,false,true,true,0.84,0.16
256,238,18,21.333333,21.636364,18,1027,856,171,1,1,0.083333,0.090909,7,12,11,4.714286,0,0,27,10,false,true,true,0.884,0.116
173,229,-56,15.727273,20.818182,-56,316,306,10,0,2,0,0.181818,22,11,11,1.727273,0,0,20,21,false,true,false,0.083,0.917
235,225,10,16.785714,16.071429,10,904,857,47,0,0,0,0,9,14,14,4.555556,1,0,13,9,false,true,true,0.859,0.141
16,28,-12,16,28,-12,804,988,-184,0,0,0,0,92,1,1,0.358696,0,0,10,12,false,true,false,0.146,0.854
331,147,184,36.777778,18.375,184,820,783,37,1,0,0.111111,0,36,9,8,0.916667,0,0,14,9,false,true,true,1,0
180,164,16,22.5,20.5,16,926,854,72,0,0,0,0,47,8,8,0.723404,0,1,16,7,false,true,true,0.691,0.309
317,214,103,35.222222,23.777778,103,1396,1454,-58,2,0,0.222222,0,32,9,9,1.03125,0,0,9,12,false,true,true,1,0
133,142,-9,22.166667,23.666667,-9,1161,1166,-5,1,0,0.166667,0,54,6,6,0.648148,0,1,8,14,false,true,false,0.138,0.862
397,298,99,26.466667,19.866667,99,1004,840,164,1,0,0.066667,0,-15,15,15,-2,0,0,3,3,true,true,true,1,0
129,62,67,18.428571,10.333333,67,777,830,-53,0,0,0,0,58,7,6,0.706897,0,1,14,15,false,true,true,0.806,0.194
146,131,15,12.166667,10.916667,15,892,768,124,0,0,0,0,36,12,12,1.194444,0,0,11,16,false,true,true,0.718,0.282
300,312,-12,23.076923,24,-12,1266,1144,122,0,0,0,0,5,13,13,6.8,1,0,9,18,false,true,true,0.592,0.408
323,258,65,17,14.333333,65,1091,1078,13,0,0,0,0,-9,19,18,-4.777778,1,0,8,8,false,true,true,0.999,0.001
363,280,83,24.2,20,83,1302,1234,68,1,1,0.066667,0.071429,-9,15,14,-3.444444,0,0,4,2,false,true,true,1,0
305,263,42,17.941176,15.470588,42,1159,1031,128,1,0,0.058824,0,-17,17,17,-2.294118,0,0,6,9,false,true,true,0.999,0.001
103,93,10,25.75,23.25,10,1645,1777,-132,1,0,0.25,0,63,4,4,0.396825,1,0,18,23,false,true,true,0.819,0.181
190,187,3,19,18.7,3,838,786,52,0,1,0,0.1,32,10,10,1,1,0,13,12,false,true,true,0.917,0.083
216,221,-5,15.428571,17,-5,361,493,-132,1,0,0.071429,0,-1,14,13,-41,1,0,6,23,false,true,true,0.856,0.144
266,188,78,22.166667,15.666667,78,1551,1550,1,0,0,0,0,16,12,12,2.625,0,1,16,18,false,true,true,0.991,0.009
80,38,42,20,12.666667,42,1550,1546,4,0,0,0,0,76,4,3,0.394737,0,0,18,17,false,true,true,0.519,0.481
407,381,26,29.071429,27.214286,26,1890,2020,-130,1,2,0.071429,0.142857,-16,14,14,-1.8125,0,0,2,1,false,true,true,0.998,0.002
65,21,44,32.5,21,44,1489,1405,84,0,0,0,0,90,2,1,0.311111,1,0,7,12,false,true,true,0.86,0.14
90,42,48,22.5,14,48,272,288,-16,0,0,0,0,74,4,3,0.702703,1,0,10,9,false,true,true,0.696,0.304
192,107,85,27.428571,15.285714,85,778,758,20,0,0,0,0,51,7,7,0.764706,0,0,19,8,false,true,true,0.972,0.028
190,104,86,23.75,13,86,1586,1782,-196,0,0,0,0,46,8,8,0.869565,1,0,10,7,false,true,true,0.949,0.051
62,105,-43,15.5,26.25,-43,334,446,-112,0,0,0,0,71,4,4,0.56338,0,0,9,10,false,true,false,0.114,0.886
76,138,-62,19,34.5,-62,1227,1060,167,0,1,0,0.25,71,4,4,0.56338,0,0,17,9,false,true,false,0.075,0.925
203,161,42,15.615385,12.384615,42,947,909,38,0,0,0,0,13,13,13,3.538462,0,0,9,34,false,true,true,0.938,0.062
387,298,89,24.1875,19.866667,89,1156,1114,42,1,0,0.0625,0,-19,16,15,-1.684211,0,0,3,3,false,true,true,1,0
18,14,4,9,14,4,847,952,-105,0,0,0,0,94,2,1,0.382979,0,0,24,15,false,true,false,0.219,0.781
34,11,23,17,11,23,272,238,34,0,0,0,0,87,2,1,0.45977,1,0,7,15,false,true,true,0.532,0.468
311,276,35,16.368421,15.333333,35,808,639,169,0,0,0,0,-17,19,18,-2.411765,0,0,4,3,false,true,true,0.986,0.014
184,151,33,23,21.571429,33,1170,1156,14,1,0,0.125,0,46,8,7,0.826087,1,0,15,17,false,true,true,0.709,0.291
315,174,141,19.6875,10.875,141,942,1003,-61,0,0,0,0,-3,16,16,-15,1,1,24,18,false,true,true,1,0
186,80,106,31,16,106,1735,1770,-35,1,0,0.166667,0,50,6,5,0.56,1,0,8,8,false,true,true,0.977,0.023
209,226,-17,23.222222,25.111111,-17,1023,1110,-87,1,1,0.111111,0.111111,25,9,9,1.2,0,0,19,16,false,true,true,0.728,0.272
366,339,27,24.4,22.6,27,1154,1062,92,2,0,0.133333,0,-1,15,15,-35,0,0,6,3,false,true,true,0.993,0.007
217,71,146,31,11.833333,146,1093,1100,-7,2,0,0.285714,0,62,7,6,0.516129,0,1,11,6,false,true,true,0.998,0.002
32,0,32,16,0,32,830,907,-77,0,0,0,0,90,2,1,0.433333,0,0,11,0,false,true,true,0.516,0.484
245,126,119,22.272727,11.454545,119,786,757,29,1,0,0.090909,0,28,11,11,1.392857,0,0,11,15,false,true,true,0.999,0.001
127,127,0,15.875,18.142857,0,611,584,27,0,0,0,0,56,8,7,0.785714,0,0,8,7,false,true,false,0.202,0.798
221,180,41,17,15,41,758,750,8,0,0,0,0,16,13,12,2.3125,0,1,17,6,false,true,true,0.906,0.094
126,76,50,25.2,19,50,1556,1591,-35,0,0,0,0,69,5,4,0.521739,1,0,21,10,false,true,true,0.866,0.134
48,45,3,24,22.5,3,1302,1082,220,0,0,0,0,82,2,2,0.365854,0,0,16,13,false,true,false,0.465,0.535
345,156,189,34.5,17.333333,189,820,783,37,1,0,0.1,0,28,10,9,1.178571,0,0,11,12,false,true,true,1,0
28,14,14,28,14,14,804,683,121,0,0,0,0,91,1,1,0.494505,0,0,7,7,false,true,true,0.603,0.397
83,52,31,16.6,13,31,856,897,-41,0,0,0,0,68,5,4,0.514706,1,0,11,10,false,true,true,0.546,0.454
343,153,190,34.3,15.3,190,1054,917,137,2,0,0.2,0,16,10,10,2.1875,0,0,14,18,false,true,true,1,0
153,104,49,25.5,17.333333,49,1045,1009,36,1,0,0.166667,0,58,6,6,0.655172,0,1,10,21,false,true,true,0.914,0.086
291,283,8,29.1,28.3,8,2219,2106,113,1,0,0.1,0,12,10,10,2.25,1,0,7,10,false,true,true,0.669,0.331
290,233,57,26.363636,23.3,57,1189,1266,-77,1,0,0.090909,0,20,11,10,1.7,1,0,6,9,false,true,true,0.985,0.015
204,243,-39,17,20.25,-39,316,306,10,0,2,0,0.166667,16,12,12,2.375,0,0,11,23,false,true,false,0.075,0.925
43,82,-39,14.333333,27.333333,-39,416,306,110,0,0,0,0,80,3,3,0.525,0,0,23,7,false,true,false,0.289,0.711
402,251,151,26.8,17.928571,151,1167,1216,-49,1,0,0.066667,0,9,15,14,4.555556,0,0,10,11,false,true,true,1,0
96,12,84,32,6,84,1115,1078,37,0,0,0,0,81,3,2,0.419753,0,0,16,15,false,true,true,0.897,0.103
330,307,23,17.368421,17.055556,23,1078,1130,-52,0,1,0,0.055556,-28,19,18,-1.392857,0,0,1,1,false,true,true,0.995,0.005
220,116,104,31.428571,19.333333,104,1270,1322,-52,1,0,0.142857,0,53,7,6,0.716981,0,0,12,20,false,true,true,0.976,0.024
238,229,9,21.636364,20.818182,9,1115,1078,37,0,1,0,0.090909,21,11,11,1.619048,1,0,11,9,false,true,true,0.908,0.092
378,260,118,18,13,118,539,632,-93,0,0,0,0,-17,21,20,-2.705882,0,0,3,6,false,true,true,1,0
22,7,15,22,7,15,1556,1591,-35,0,0,0,0,92,1,1,0.391304,0,0,24,16,false,true,true,0.521,0.479
320,270,50,24.615385,22.5,50,965,1013,-48,1,0,0.076923,0,3,13,12,11,0,1,8,11,false,true,true,0.988,0.012
89,104,-15,14.833333,20.8,-15,95,360,-265,0,1,0,0.2,55,6,5,0.727273,0,0,9,14,false,true,false,0.266,0.734
159,103,56,31.8,20.6,56,1256,1232,24,1,0,0.2,0,62,5,5,0.483871,0,1,10,12,false,true,true,0.623,0.377
290,268,22,24.166667,22.333333,22,992,1100,-108,2,0,0.166667,0,14,12,12,2.428571,0,0,16,25,false,true,true,0.647,0.353
348,179,169,38.666667,19.888889,169,1550,1624,-74,1,0,0.111111,0,36,9,9,0.833333,0,0,9,7,false,true,true,1,0
175,113,62,25,18.833333,62,1075,1152,-77,0,0,0,0,58,7,6,0.689655,0,1,7,7,false,true,true,0.863,0.137
200,185,15,16.666667,15.416667,15,613,502,111,0,0,0,0,20,12,12,2.45,0,1,7,19,false,true,true,0.797,0.203
50,61,-11,25,30.5,-11,1826,1656,170,0,0,0,0,81,2,2,0.333333,0,0,8,8,false,true,true,0.701,0.299
366,283,83,20.333333,15.722222,83,859,811,48,0,0,0,0,-20,18,18,-1.8,0,1,2,1,true,true,true,1,0
107,100,7,21.4,25,7,1355,1210,145,0,0,0,0,67,5,4,0.447761,1,0,20,20,false,true,true,0.809,0.191
258,203,55,19.846154,16.916667,55,1159,1051,108,0,0,0,0,22,13,12,1.818182,0,0,12,9,false,true,true,0.942,0.058
153,126,27,21.857143,21,27,902,866,36,0,0,0,0,46,7,6,0.695652,0,0,8,15,false,true,false,0.444,0.556
74,102,-28,14.8,20.4,-28,1100,1008,92,0,0,0,0,70,5,5,0.514286,2,0,6,15,false,true,true,0.777,0.223
290,190,100,29,21.111111,100,1245,1232,13,1,0,0.1,0,18,10,9,1.611111,0,0,12,7,false,true,true,0.999,0.001
107,63,44,17.833333,12.6,44,1091,1078,13,0,0,0,0,66,6,5,0.651515,0,0,13,20,false,true,true,0.701,0.299
313,230,83,20.866667,15.333333,83,719,651,68,0,1,0,0.066667,12,15,15,3.75,0,0,7,11,false,true,true,0.999,0.001
262,260,2,52.4,52,2,1370,1431,-61,2,1,0.4,0.2,46,5,5,0.5,0,0,13,14,false,true,true,0.892,0.108
141,154,-13,14.1,17.111111,-13,450,412,38,0,0,0,0,32,10,9,1.1875,0,0,11,12,false,true,false,0.196,0.804
306,270,36,15.3,14.210526,36,272,238,34,0,1,0,0.052632,-31,20,19,-1.290323,0,0,7,1,false,true,true,0.994,0.006
165,100,65,16.5,11.111111,65,415,518,-103,0,0,0,0,44,10,9,0.863636,1,0,13,27,false,true,true,0.978,0.022
244,259,-15,15.25,16.1875,-15,500,567,-67,0,0,0,0,11,16,16,4,0,0,10,12,false,true,false,0.112,0.888
402,265,137,26.8,17.666667,137,1167,1216,-49,1,0,0.066667,0,6,15,15,6.833333,0,0,10,10,false,true,true,1,0
192,150,42,21.333333,16.666667,42,1055,1050,5,0,0,0,0,42,9,9,0.809524,0,0,9,9,false,true,true,0.886,0.114
122,108,14,20.333333,18,14,1452,1469,-17,0,1,0,0.166667,53,6,6,0.716981,0,0,9,17,false,true,true,0.533,0.467
288,162,126,36,20.25,126,1093,1197,-104,2,0,0.25,0,37,8,8,0.837838,0,0,7,16,false,true,true,1,0
326,259,67,23.285714,19.923077,67,1302,1082,220,0,0,0,0,-8,14,13,-3.75,0,0,2,13,false,true,true,0.996,0.004
50,18,32,25,18,32,1826,1656,170,0,0,0,0,86,2,1,0.313953,0,0,8,14,false,true,true,0.525,0.475
4,0,4,4,0,4,596,595,1,0,0,0,0,98,1,0,0.408163,0,0,14,0,false,true,false,0.486,0.514
61,57,4,20.333333,28.5,4,1125,1227,-102,0,0,0,0,80,3,2,0.375,0,0,11,15,false,true,false,0.138,0.862
148,146,2,21.142857,20.857143,2,315,294,21,0,1,0,0.142857,41,7,7,0.853659,0,0,12,25,false,true,true,0.734,0.266
298,313,-15,24.833333,26.083333,-15,1762,1582,180,2,3,0.166667,0.25,6,12,12,5.333333,0,0,8,24,false,true,false,0.129,0.871
151,137,14,16.777778,17.125,14,1176,1127,49,0,0,0,0,38,9,8,0.973684,0,0,10,24,false,true,false,0.152,0.848
151,136,15,18.875,17,15,704,691,13,0,0,0,0,48,8,8,0.791667,1,0,10,9,false,true,true,0.613,0.387
310,170,140,25.833333,15.454545,140,1691,1692,-1,0,0,0,0,20,12,11,1.5,0,0,17,17,false,true,true,1,0
74,37,37,24.666667,18.5,37,1022,1095,-73,0,0,0,0,82,3,2,0.402439,0,0,28,7,false,true,true,0.723,0.277
315,294,21,21,19.6,21,1710,1636,74,1,1,0.066667,0.066667,2,15,15,18,1,0,10,14,false,true,true,0.982,0.018
341,322,19,17.05,16.947368,19,1388,1477,-89,1,0,0.05,0,-20,20,19,-2.4,1,0,3,8,false,true,true,0.988,0.012
40,34,6,13.333333,11.333333,6,1265,1045,220,0,0,0,0,75,3,3,0.56,0,1,20,20,false,true,true,0.859,0.141
305,256,49,16.052632,13.473684,49,299,315,-16,0,0,0,0,-30,19,19,-1.4,0,0,3,5,false,true,true,1,0
151,186,-35,18.875,23.25,-35,1177,1214,-37,0,0,0,0,45,8,8,0.777778,0,0,16,12,false,true,false,0.109,0.891
199,157,42,24.875,22.428571,42,1344,1209,135,1,1,0.125,0.142857,40,8,7,0.85,0,0,10,19,false,true,true,0.798,0.202
84,39,45,28,13,45,1295,1477,-182,1,0,0.333333,0,81,3,3,0.567901,1,0,10,10,false,true,true,0.729,0.271
307,212,95,25.583333,17.666667,95,801,925,-124,1,0,0.083333,0,13,12,12,2.692308,1,0,10,12,false,true,true,1,0
210,204,6,16.153846,17,6,272,238,34,0,0,0,0,14,13,12,2.857143,0,0,20,7,false,true,true,0.73,0.27
230,125,105,38.333333,25,105,1397,1361,36,1,0,0.166667,0,54,6,5,0.537037,0,0,11,8,false,true,true,0.939,0.061
200,166,34,18.181818,15.090909,34,620,513,107,0,0,0,0,28,11,11,1.607143,0,0,10,12,false,true,true,0.864,0.136
160,169,-9,16,16.9,-9,725,771,-46,0,1,0,0.1,37,10,10,1.243243,1,0,9,18,false,true,false,0.491,0.509
14,8,6,14,8,6,1181,1069,112,0,0,0,0,93,1,1,0.397849,1,0,8,10,false,true,true,0.629,0.371
328,297,31,19.294118,18.5625,31,290,416,-126,0,0,0,0,-16,17,16,-2.125,0,0,1,1,false,true,true,0.99,0.01
216,196,20,27,24.5,20,1004,840,164,1,0,0.125,0,37,8,8,0.810811,1,0,9,9,false,true,true,0.817,0.183
346,309,37,15.727273,14.714286,37,1221,1438,-217,0,0,0,0,-18,22,21,-2.5,0,0,2,1,false,true,true,0.998,0.002
409,278,131,17.041667,11.583333,131,1413,1422,-9,0,0,0,0,-28,24,24,-2.035714,0,0,3,2,false,true,true,1,0
262,138,124,52.4,34.5,124,1348,1331,17,2,0,0.4,0,52,5,4,0.461538,0,0,19,13,false,true,true,0.999,0.001
47,41,6,23.5,20.5,6,349,315,34,0,0,0,0,84,2,2,0.404762,0,0,7,8,false,true,true,0.698,0.302
293,283,10,16.277778,15.722222,10,719,614,105,0,1,0,0.055556,-18,18,18,-2.388889,0,0,15,11,false,true,true,0.883,0.117
254,150,104,28.222222,18.75,104,1156,1114,42,1,0,0.111111,0,29,9,8,1.103448,0,1,20,23,false,true,true,0.995,0.005
282,258,24,20.142857,18.428571,24,349,315,34,0,0,0,0,-9,14,14,-3.777778,0,0,8,9,false,true,true,0.967,0.033
336,248,88,14.608696,11.272727,88,576,532,44,0,0,0,0,-30,23,22,-1.533333,1,0,8,18,false,true,true,1,0
38,64,-26,19,32,-26,1333,1331,2,0,0,0,0,81,2,2,0.37037,1,0,12,14,false,true,true,0.809,0.191
110,12,98,55,12,98,539,500,39,0,0,0,0,83,2,1,0.481928,0,0,10,29,false,true,true,0.999,0.001
264,265,-1,17.6,17.666667,-1,859,786,73,0,0,0,0,1,15,15,38,0,0,20,12,false,true,true,0.703,0.297
361,343,18,17.190476,17.15,18,1181,1149,32,0,1,0,0.05,-20,21,20,-2.25,0,0,4,3,false,true,false,0.316,0.684
376,249,127,18.8,13.105263,127,1281,1339,-58,0,0,0,0,-12,20,19,-3.416667,0,0,1,1,false,true,true,1,0
289,174,115,26.272727,17.4,115,1014,948,66,1,0,0.090909,0,27,11,10,1.222222,0,0,18,20,false,true,true,0.999,0.001
79,95,-16,19.75,23.75,-16,871,999,-128,0,0,0,0,72,4,4,0.666667,0,0,10,7,false,true,false,0.168,0.832
107,93,14,13.375,11.625,14,880,952,-72,0,0,0,0,49,8,8,0.836735,0,0,16,8,false,true,true,0.575,0.425
44,35,9,44,35,9,991,996,-5,0,0,0,0,91,1,1,0.32967,0,0,12,10,false,true,true,0.643,0.357
279,228,51,23.25,19,51,1295,1281,14,0,0,0,0,27,12,12,1.407407,0,1,7,11,false,true,true,0.983,0.017
171,136,35,15.545455,12.363636,35,698,742,-44,0,0,0,0,43,11,11,0.953488,0,0,9,16,false,true,true,0.785,0.215
220,128,92,31.428571,18.285714,92,1270,1322,-52,1,0,0.142857,0,50,7,7,0.76,0,0,12,24,false,true,true,0.982,0.018
313,269,44,13.041667,11.208333,44,613,502,111,0,0,0,0,-30,24,24,-1.633333,0,0,3,15,false,true,true,0.998,0.002
246,207,39,27.333333,25.875,39,1428,1452,-24,0,1,0,0.125,39,9,8,0.794872,0,0,7,11,false,true,true,0.743,0.257
81,54,27,20.25,13.5,27,613,461,152,0,0,0,0,71,4,4,0.521127,0,1,7,15,false,true,true,0.923,0.077
39,33,6,13,16.5,6,658,817,-159,0,0,0,0,87,3,2,0.436782,0,0,21,7,false,true,false,0.395,0.605
332,315,17,30.181818,28.636364,17,1148,1164,-16,1,2,0.090909,0.181818,3,11,11,8.333333,0,0,7,2,false,true,true,0.929,0.071
165,110,55,41.25,36.666667,55,1571,1554,17,2,1,0.5,0.333333,65,4,3,0.507692,0,0,9,11,false,true,true,0.837,0.163
315,213,102,21,15.214286,102,939,913,26,0,1,0,0.071429,6,15,14,6.666667,1,0,6,15,false,true,true,1,0
339,293,46,21.1875,18.3125,46,820,822,-2,0,0,0,0,-6,16,16,-6.5,0,0,7,4,false,true,true,0.999,0.001
335,318,17,25.769231,26.5,17,1297,1606,-309,1,1,0.076923,0.083333,2,13,12,15,0,0,7,14,false,true,true,0.805,0.195
255,214,41,19.615385,16.461538,41,711,876,-165,0,0,0,0,14,13,13,3.071429,0,1,7,12,false,true,true,0.824,0.176
158,81,77,26.333333,16.2,77,1065,1030,35,0,0,0,0,65,6,5,0.523077,0,1,15,6,false,true,true,0.99,0.01
223,155,68,17.153846,11.923077,68,1069,1040,29,0,0,0,0,11,13,13,4,0,2,7,8,false,true,true,0.848,0.152
378,346,32,22.235294,20.352941,32,1305,1242,63,2,1,0.117647,0.058824,-16,17,17,-2.125,0,0,2,2,true,true,true,0.989,0.011
344,175,169,18.105263,9.722222,169,1176,1076,100,0,0,0,0,18,19,18,3.277778,0,0,9,14,false,true,true,1,0
326,305,21,19.176471,19.0625,21,613,611,2,0,0,0,0,-19,17,16,-2,0,0,5,3,false,true,true,0.971,0.029
240,197,43,24,19.7,43,892,819,73,0,1,0,0.1,29,10,10,1.172414,0,0,9,11,false,true,true,0.939,0.061
91,92,-1,13,15.333333,-1,1221,1438,-217,0,0,0,0,61,7,6,0.737705,0,1,19,6,false,true,false,0.245,0.755
320,247,73,16.842105,13.722222,73,566,542,24,0,0,0,0,-12,19,18,-3.416667,0,0,4,3,false,true,true,1,0
175,150,25,35,30,25,1770,1689,81,0,0,0,0,55,5,5,0.472727,0,1,10,8,false,true,false,0.341,0.659
307,217,90,20.466667,15.5,90,620,658,-38,0,0,0,0,3,15,14,12,0,0,15,9,false,true,true,0.998,0.002
117,119,-2,19.5,19.833333,-2,628,658,-30,0,0,0,0,58,6,6,0.793103,0,0,21,10,false,true,true,0.65,0.35
292,268,24,24.333333,22.333333,24,1434,1493,-59,1,0,0.083333,0,8,12,12,4.625,0,1,13,6,false,true,true,0.62,0.38
93,51,42,46.5,25.5,42,996,1063,-67,1,1,0.5,0.5,78,2,2,0.410256,0,0,13,10,false,true,true,0.826,0.174
314,237,77,20.933333,15.8,77,1170,1156,14,1,0,0.066667,0,-4,15,15,-9.5,0,0,7,11,false,true,true,1,0
87,70,17,14.5,14,17,416,222,194,0,0,0,0,60,6,5,0.916667,1,0,6,9,false,true,true,0.598,0.402
271,172,99,30.111111,19.111111,99,996,1063,-67,1,1,0.111111,0.111111,26,9,9,1.230769,0,0,12,17,false,true,true,0.999,0.001
190,92,98,14.615385,7.666667,98,859,719,140,0,1,0,0.083333,19,13,12,2.789474,0,2,17,12,false,true,true,0.91,0.09
195,179,16,21.666667,19.888889,16,971,906,65,0,0,0,0,30,9,9,1.066667,0,0,7,14,false,true,true,0.688,0.312
192,157,35,16,14.272727,35,691,675,16,0,0,0,0,22,12,11,1.727273,0,0,13,21,false,true,true,0.72,0.28
241,145,96,21.909091,13.181818,96,1606,1544,62,0,0,0,0,39,11,11,1.153846,0,1,12,9,false,true,true,0.994,0.006
200,160,40,16.666667,13.333333,40,1011,921,90,0,0,0,0,30,12,12,1.633333,1,0,7,17,false,true,true,0.921,0.079
283,265,18,21.769231,22.083333,18,1513,1479,34,0,0,0,0,12,13,12,2.833333,1,0,13,9,false,true,true,0.774,0.226
61,13,48,30.5,13,48,838,786,52,0,0,0,0,88,2,1,0.363636,0,0,9,13,false,true,true,0.863,0.137
72,93,-21,12,15.5,-21,1214,1176,38,0,0,0,0,60,6,6,0.6,1,1,15,6,false,true,false,0.265,0.735
18,18,0,18,18,0,1164,1201,-37,0,0,0,0,90,1,1,0.466667,0,1,18,13,false,true,false,0.434,0.566
284,247,37,20.285714,19,37,838,786,52,0,1,0,0.076923,9,14,13,3.555556,0,0,8,10,false,true,true,0.938,0.062
181,181,0,22.625,25.857143,0,1406,1454,-48,0,1,0,0.142857,36,8,7,0.944444,1,1,6,6,false,true,false,0.105,0.895
163,130,33,18.111111,14.444444,33,913,871,42,0,0,0,0,43,9,9,1,0,1,11,17,false,true,true,0.689,0.311
159,147,12,26.5,24.5,12,1782,1512,270,1,1,0.166667,0.166667,58,6,6,0.724138,0,0,13,7,false,true,true,0.988,0.012
140,124,16,20,17.714286,16,847,952,-105,0,0,0,0,59,7,7,0.610169,0,1,10,17,false,true,false,0.167,0.833
146,102,44,24.333333,20.4,44,1334,1270,64,1,0,0.166667,0,65,6,5,0.569231,0,0,22,12,false,true,true,0.846,0.154
64,21,43,21.333333,10.5,43,1030,1045,-15,0,0,0,0,87,3,2,0.528736,0,0,13,13,false,true,true,0.631,0.369
276,215,61,25.090909,21.5,61,834,758,76,0,1,0,0.1,20,11,10,1.8,0,0,7,12,false,true,true,0.968,0.032
91,54,37,15.166667,9,37,1428,1302,126,0,0,0,0,59,6,6,0.898305,0,1,12,15,false,true,true,0.685,0.315
24,20,4,24,20,4,500,567,-67,0,0,0,0,91,1,1,0.483516,0,0,12,19,false,true,false,0.347,0.653
142,128,14,17.75,16,14,1220,1261,-41,1,0,0.125,0,54,8,8,0.833333,0,0,12,11,false,true,true,0.652,0.348
226,168,58,22.6,16.8,58,808,639,169,0,0,0,0,28,10,10,1.464286,0,0,22,14,false,true,true,0.929,0.071
164,102,62,20.5,12.75,62,303,342,-39,0,0,0,0,49,8,8,0.77551,1,0,15,14,false,true,true,0.981,0.019
90,56,34,22.5,14,34,527,503,24,0,0,0,0,77,4,4,0.532468,0,0,16,11,false,true,true,0.881,0.119
245,245,0,15.3125,16.333333,0,628,658,-30,0,0,0,0,8,16,15,5.75,0,0,14,8,false,true,false,0.428,0.572
446,375,71,31.857143,26.785714,71,1880,1777,103,1,1,0.071429,0.071429,-13,14,14,-2.153846,0,0,3,1,true,true,true,0.998,0.002
88,93,-5,12.571429,15.5,-5,1214,1176,38,0,0,0,0,58,7,6,0.62069,1,1,15,6,false,true,false,0.253,0.747
96,61,35,24,15.25,35,576,532,44,0,0,0,0,70,4,4,0.657143,1,0,11,10,false,true,true,0.639,0.361
232,217,15,16.571429,16.692308,15,695,523,172,0,0,0,0,3,14,13,12.333333,0,0,20,21,false,true,true,0.737,0.263
337,288,49,28.083333,24,49,1408,1454,-46,1,0,0.083333,0,11,12,12,2.909091,0,0,15,11,false,true,true,0.902,0.098
285,192,93,15.833333,11.294118,93,498,43,455,0,0,0,0,-14,18,17,-2.642857,0,0,4,3,false,true,true,1,0
176,170,6,25.142857,28.333333,6,1659,1782,-123,1,0,0.142857,0,45,7,6,0.644444,1,0,7,9,false,true,true,0.663,0.337
261,199,62,26.1,22.111111,62,834,758,76,0,1,0,0.111111,26,10,9,1.384615,0,0,7,12,false,true,true,0.945,0.055
12,17,-5,12,17,-5,1548,1493,55,0,0,0,0,92,1,1,0.445652,0,0,10,13,false,true,false,0.357,0.643
93,36,57,18.6,9,57,896,818,78,0,0,0,0,77,5,4,0.571429,0,0,23,10,false,true,true,0.893,0.107
90,78,12,22.5,26,12,1406,1454,-48,0,1,0,0.333333,67,4,3,0.507463,1,0,14,18,false,true,true,0.846,0.154
131,119,12,32.75,29.75,12,2219,2106,113,0,0,0,0,67,4,4,0.402985,0,0,12,9,false,true,true,0.986,0.014
274,118,156,21.076923,9.833333,156,993,897,96,1,0,0.076923,0,13,13,12,3.615385,0,0,22,21,false,true,true,1,0
173,147,26,24.714286,24.5,26,1782,1512,270,1,1,0.142857,0.166667,54,7,6,0.777778,0,0,12,7,false,true,true,0.988,0.012
120,41,79,30,13.666667,79,993,897,96,1,0,0.25,0,69,4,3,0.681159,0,0,7,7,false,true,true,0.919,0.081
208,209,-1,12.235294,13.0625,-1,1030,1045,-15,0,0,0,0,8,17,16,5.75,1,0,9,8,false,true,true,0.621,0.379
238,194,44,19.833333,16.166667,44,1270,1315,-45,0,0,0,0,19,12,12,1.894737,1,0,9,28,false,true,true,0.96,0.04
153,94,59,21.857143,15.666667,59,1513,1479,34,0,0,0,0,56,7,6,0.607143,1,0,12,13,false,true,true,0.939,0.061
109,69,40,21.8,17.25,40,904,783,121,0,0,0,0,69,5,4,0.608696,1,0,11,18,false,true,true,0.742,0.258
109,24,85,54.5,24,85,971,621,350,1,0,0.5,0,84,2,1,0.380952,0,0,15,10,false,true,true,0.888,0.112
57,56,1,14.25,18.666667,1,539,632,-93,0,0,0,0,80,4,3,0.575,0,0,8,12,false,true,false,0.126,0.874
429,385,44,23.833333,22.647059,44,1030,1144,-114,0,2,0,0.117647,-18,18,17,-1.944444,1,0,1,1,true,true,true,0.999,0.001
71,112,-41,14.2,22.4,-41,596,595,1,0,0,0,0,69,5,5,0.57971,1,0,9,16,false,true,false,0.127,0.873
212,229,-17,16.307692,17.615385,-17,671,725,-54,0,0,0,0,10,13,13,3.7,1,0,15,7,false,true,false,0.431,0.569
495,256,239,29.117647,16,239,1054,917,137,2,0,0.117647,0,-31,17,16,-1.129032,0,0,15,6,false,true,true,1,0
69,49,20,17.25,16.333333,20,491,398,93,0,0,0,0,78,4,3,0.461538,0,1,9,16,false,true,false,0.433,0.567
265,234,31,26.5,26,31,1554,1716,-162,1,1,0.1,0.111111,25,10,9,1.4,0,0,16,15,false,true,true,0.734,0.266
180,141,39,11.25,9.4,39,416,222,194,0,0,0,0,13,16,15,4.230769,0,0,8,29,false,true,true,0.881,0.119
346,252,94,28.833333,21,94,1004,840,164,1,0,0.083333,0,-1,12,12,-30,0,0,23,10,false,true,true,0.999,0.001
437,237,200,29.133333,16.928571,200,1513,1482,31,1,0,0.066667,0,-8,15,14,-4.125,0,1,3,19,false,true,true,1,0
173,92,81,34.6,23,81,971,1180,-209,1,0,0.2,0,65,5,4,0.492308,0,0,8,7,false,true,true,0.884,0.116
371,281,90,21.823529,16.529412,90,1065,1030,35,0,1,0,0.058824,-17,17,17,-2,0,0,2,3,true,true,true,1,0
19,11,8,9.5,11,8,596,595,1,0,0,0,0,91,2,1,0.43956,0,1,18,13,false,true,false,0.397,0.603
80,153,-73,20,38.25,-73,1885,1793,92,0,0,0,0,68,4,4,0.397059,0,0,13,10,false,true,false,0.432,0.568
138,45,93,27.6,11.25,93,1004,653,351,0,0,0,0,62,5,4,0.564516,0,0,14,12,false,true,true,0.998,0.002
200,221,-21,14.285714,15.785714,-21,699,448,251,0,0,0,0,15,14,14,2.666667,0,0,16,13,false,true,true,0.599,0.401
64,2,62,32,2,62,1115,1078,37,0,0,0,0,88,2,1,0.386364,0,0,22,15,false,true,true,0.883,0.117
145,155,-10,20.714286,22.142857,-10,1364,1093,271,0,1,0,0.142857,54,7,7,0.703704,0,0,11,7,false,true,true,0.976,0.024
103,120,-17,20.6,24,-17,1731,1691,40,0,0,0,0,62,5,5,0.548387,0,0,21,10,false,true,false,0.274,0.726
230,176,54,23,19.555556,54,926,854,72,0,0,0,0,36,10,9,0.944444,0,1,10,10,false,true,true,0.991,0.009
324,288,36,16.2,15.157895,36,1159,1031,128,1,0,0.05,0,-29,20,19,-1.344828,0,0,3,1,true,true,true,0.999,0.001
363,247,116,27.923077,20.583333,116,1489,1555,-66,1,0,0.076923,0,5,13,12,5.8,0,0,14,13,false,true,true,1,0
276,201,75,23,16.75,75,1004,653,351,0,0,0,0,6,12,12,5.833333,0,0,14,25,false,true,true,0.997,0.003
18,0,18,18,0,18,1030,1045,-15,0,0,0,0,97,1,0,0.474227,0,0,16,0,false,true,true,0.516,0.484
350,309,41,19.444444,17.166667,41,795,830,-35,1,1,0.055556,0.055556,-17,18,18,-2.470588,0,0,2,6,false,true,true,0.998,0.002
340,217,123,13.076923,8.68,123,1428,1302,126,0,0,0,0,-29,26,25,-1.827586,0,1,12,11,false,true,true,0.999,0.001
48,86,-38,16,28.666667,-38,613,611,2,0,0,0,0,78,3,3,0.487179,0,0,10,10,false,true,false,0.164,0.836
298,207,91,17.529412,12.176471,91,218,86,132,0,0,0,0,-18,17,17,-2.222222,0,0,17,9,false,true,true,1,0
339,238,101,17.842105,13.222222,101,371,336,35,2,0,0.105263,0,-28,19,18,-1.357143,0,0,1,13,false,true,true,1,0
173,144,29,15.727273,14.4,29,777,830,-53,0,0,0,0,34,11,10,1.205882,0,0,14,11,false,true,true,0.735,0.265
270,281,-11,18,18.733333,-11,1078,1130,-52,0,1,0,0.066667,1,15,15,39,0,0,14,11,false,true,false,0.481,0.519
406,285,121,29,20.357143,121,1519,1782,-263,2,0,0.142857,0,1,14,14,33,0,0,10,8,false,true,true,1,0
145,155,-10,20.714286,25.833333,-10,1364,1093,271,0,1,0,0.166667,54,7,6,0.703704,0,0,11,7,false,true,true,0.882,0.118
356,279,77,20.941176,17.4375,77,1004,653,351,0,0,0,0,-23,17,16,-1.521739,0,0,1,1,false,true,true,1,0
231,130,101,21,11.818182,101,595,543,52,0,0,0,0,31,11,11,1.516129,0,0,9,9,false,true,true,0.996,0.004
121,115,6,17.285714,19.166667,6,808,639,169,0,0,0,0,47,7,6,0.87234,0,0,32,8,false,true,true,0.626,0.374
113,96,17,16.142857,13.714286,17,1030,1045,-15,0,0,0,0,58,7,7,0.793103,0,0,17,15,false,true,true,0.678,0.322
138,126,12,13.8,14,12,904,857,47,0,0,0,0,39,10,9,1.051282,0,0,13,22,false,true,false,0.245,0.755
242,197,45,22,19.7,45,926,854,72,0,0,0,0,30,11,10,1.133333,0,1,8,10,false,true,true,0.986,0.014
48,39,9,16,19.5,9,999,1011,-12,0,0,0,0,79,3,2,0.582278,0,0,11,14,false,true,false,0.291,0.709
337,309,28,16.85,16.263158,28,758,952,-194,0,0,0,0,-26,20,19,-1.538462,0,0,1,1,false,true,true,0.996,0.004
304,269,35,25.333333,22.416667,35,1670,1770,-100,1,1,0.083333,0.083333,12,12,12,2.666667,0,1,8,7,false,true,true,0.855,0.145
155,93,62,25.833333,15.5,62,1022,1095,-73,0,0,0,0,60,6,6,0.55,0,0,14,12,false,true,true,0.887,0.113
208,187,21,20.8,18.7,21,1078,1130,-52,0,1,0,0.1,32,10,10,1.21875,0,1,12,19,false,true,true,0.574,0.426
12,14,-2,12,14,-2,1210,1253,-43,0,0,0,0,93,1,1,0.365591,1,0,8,9,false,true,false,0.472,0.528
391,275,116,26.066667,19.642857,116,996,1063,-67,1,1,0.066667,0.071429,-7,15,14,-4.571429,1,0,2,9,false,true,true,1,0
74,69,5,12.333333,13.8,5,658,817,-159,0,0,0,0,69,6,5,0.550725,0,1,33,9,false,true,false,0.295,0.705
38,22,16,12.666667,11,16,1027,856,171,1,0,0.333333,0,76,3,2,0.434211,0,0,10,13,false,true,true,1,0
293,252,41,18.3125,15.75,41,808,639,169,0,0,0,0,-2,16,16,-20.5,0,1,10,7,false,true,true,0.973,0.027
109,80,29,21.8,16,29,1048,1000,48,0,0,0,0,66,5,5,0.606061,0,1,7,9,false,true,true,0.697,0.303
36,17,19,18,17,19,1037,950,87,0,0,0,0,90,2,1,0.344444,1,0,8,14,false,true,true,0.676,0.324
330,336,-6,17.368421,17.684211,-6,1782,1512,270,1,1,0.052632,0.052632,-21,19,19,-2,0,0,2,1,false,true,true,0.982,0.018
353,270,83,19.611111,15.882353,83,620,658,-38,0,0,0,0,-21,18,17,-1.714286,0,0,7,2,false,true,true,1,0
91,95,-4,18.2,23.75,-4,844,821,23,0,0,0,0,75,5,4,0.56,0,0,17,8,false,true,false,0.231,0.769
261,228,33,32.625,32.571429,33,2219,2029,190,0,0,0,0,31,8,7,0.83871,0,1,18,10,false,true,true,0.963,0.037
230,175,55,25.555556,19.444444,55,866,949,-83,0,0,0,0,37,9,9,1.081081,0,0,9,16,false,true,true,0.785,0.215
306,228,78,20.4,16.285714,78,505,95,410,0,1,0,0.071429,14,15,14,3.142857,0,0,12,10,false,true,true,0.988,0.012
168,177,-9,18.666667,22.125,-9,491,398,93,0,0,0,0,41,9,8,0.878049,0,0,16,19,false,true,true,0.686,0.314
397,270,127,23.352941,16.875,127,1110,1039,71,0,0,0,0,-17,17,16,-2.117647,0,0,2,6,false,true,true,1,0
157,109,48,26.166667,18.166667,48,1115,1078,37,0,0,0,0,57,6,6,0.596491,1,0,13,8,false,true,true,0.934,0.066
93,54,39,23.25,13.5,39,771,754,17,0,0,0,0,70,4,4,0.457143,0,0,10,7,false,true,true,0.872,0.128
84,27,57,28,13.5,57,1556,1591,-35,0,0,0,0,83,3,2,0.433735,0,0,23,18,false,true,true,0.69,0.31
347,247,100,24.785714,19,100,1034,1040,-6,1,0,0.071429,0,6,14,13,5.833333,1,0,7,13,false,true,true,1,0
327,267,60,14.217391,11.608696,60,1016,1037,-21,0,0,0,0,-22,23,23,-2.181818,0,0,1,12,false,true,true,0.999,0.001
111,85,26,15.857143,14.166667,26,303,342,-39,0,0,0,0,57,7,6,0.666667,1,0,22,11,false,true,true,0.653,0.347
338,232,106,24.142857,16.571429,106,1651,1691,-40,1,0,0.071429,0,1,14,14,34,1,0,6,10,false,true,true,1,0
376,314,62,28.923077,24.153846,62,1333,1331,2,1,0,0.076923,0,-8,13,13,-3.75,0,0,5,8,false,true,true,0.998,0.002
366,243,123,20.333333,13.5,123,1011,921,90,1,0,0.055556,0,-7,18,18,-7,0,0,11,14,false,true,true,1,0
337,285,52,16.85,15,52,1077,1094,-17,0,0,0,0,-17,20,19,-2.470588,1,0,2,6,false,true,true,0.999,0.001
363,261,102,22.6875,17.4,102,1030,998,32,1,0,0.0625,0,-8,16,15,-4.75,1,0,4,14,false,true,true,1,0
129,132,-3,18.428571,18.857143,-3,416,306,110,0,0,0,0,53,7,7,0.792453,0,0,11,12,false,true,true,0.723,0.277
187,151,36,23.375,18.875,36,1513,1479,34,0,0,0,0,44,8,8,0.772727,1,0,7,13,false,true,true,0.889,0.111
156,159,-3,12,12.230769,-3,892,768,124,0,0,0,0,29,13,13,1.482759,0,0,10,21,false,true,false,0.443,0.557
50,73,-23,16.666667,24.333333,-23,1583,1422,161,0,0,0,0,80,3,3,0.6375,0,0,17,9,false,true,true,0.516,0.484
244,261,-17,18.769231,20.076923,-17,1181,1149,32,0,1,0,0.076923,24,13,13,1.875,1,0,8,21,false,true,false,0.347,0.653
203,199,4,16.916667,16.583333,4,704,691,13,0,0,0,0,22,12,12,1.727273,1,0,9,7,false,true,true,0.729,0.271
225,124,101,20.454545,11.272727,101,421,306,115,0,1,0,0.090909,20,11,11,2.2,0,0,42,9,false,true,true,0.981,0.019
84,115,-31,21,28.75,-31,315,294,21,0,1,0,0.25,68,4,4,0.514706,0,0,13,22,false,true,true,0.723,0.277
409,278,131,22.722222,16.352941,131,1211,1173,38,0,0,0,0,-17,18,17,-2.058824,0,0,5,3,true,true,true,1,0
267,177,90,26.7,19.666667,90,1394,1118,276,0,1,0,0.111111,30,10,9,1.233333,0,0,11,15,false,true,true,0.902,0.098
279,237,42,17.4375,14.8125,42,299,315,-16,0,0,0,0,-11,16,16,-3.818182,0,0,10,19,false,true,true,0.999,0.001
101,59,42,25.25,19.666667,42,1302,1082,220,0,0,0,0,68,4,3,0.441176,0,0,12,10,false,true,true,0.603,0.397
86,77,9,14.333333,15.4,9,721,689,32,0,0,0,0,53,6,5,0.641509,0,0,23,19,false,true,false,0.318,0.682
96,134,-38,19.2,26.8,-38,1177,1214,-37,0,0,0,0,65,5,5,0.538462,0,0,26,8,false,true,false,0.183,0.817
83,46,37,20.75,11.5,37,939,913,26,0,0,0,0,77,4,4,0.519481,0,0,11,7,false,true,true,0.843,0.157
112,71,41,28,17.75,41,554,342,212,0,0,0,0,69,4,4,0.521739,0,1,10,6,false,true,true,0.993,0.007
354,179,175,16.090909,8.52381,175,859,719,140,0,1,0,0.047619,-31,22,21,-1.709677,0,1,14,9,false,true,true,1,0
47,20,27,15.666667,10,27,859,822,37,0,0,0,0,77,3,2,0.493506,0,0,20,7,false,true,true,0.533,0.467
209,190,19,23.222222,21.111111,19,1270,1348,-78,0,0,0,0,38,9,9,1,0,0,11,10,false,true,true,0.604,0.396
375,229,146,23.4375,14.3125,146,742,696,46,0,0,0,0,-18,16,16,-1.777778,0,0,6,2,true,true,true,1,0
51,88,-37,17,29.333333,-37,316,306,10,0,1,0,0.333333,78,3,3,0.487179,0,0,8,9,false,true,false,0.384,0.616
298,249,49,21.285714,19.153846,49,1094,1030,64,0,0,0,0,6,14,13,6,0,0,11,18,false,true,true,0.926,0.074
366,238,128,24.4,15.866667,128,939,907,32,1,0,0.066667,0,3,15,15,13.333333,0,0,11,9,false,true,true,1,0
293,236,57,17.235294,14.75,57,804,683,121,0,0,0,0,0,17,16,0,0,1,9,11,false,true,true,0.991,0.009
329,334,-5,18.277778,18.555556,-5,885,719,166,0,0,0,0,-18,18,18,-2.111111,0,0,3,3,false,true,false,0.19,0.81
130,37,93,43.333333,18.5,93,971,1180,-209,1,0,0.333333,0,80,3,2,0.4,0,0,9,14,false,true,true,0.883,0.117
138,112,26,19.714286,18.666667,26,1220,1261,-41,1,0,0.142857,0,61,7,6,0.737705,0,0,12,14,false,true,false,0.337,0.663
131,72,59,21.833333,14.4,59,1181,1069,112,0,0,0,0,61,6,5,0.606557,0,0,17,9,false,true,true,0.879,0.121
304,298,6,16,15.684211,6,628,658,-30,0,0,0,0,-9,19,19,-5.111111,0,0,8,10,false,true,false,0.305,0.695
8,0,8,8,0,8,1501,1622,-121,0,0,0,0,96,1,0,0.322917,0,0,22,0,false,true,false,0.298,0.702
106,118,-12,21.2,23.6,-12,995,912,83,1,0,0.2,0,72,5,5,0.611111,1,0,11,8,false,true,true,0.565,0.435
151,112,39,21.571429,18.666667,39,977,976,1,0,0,0,0,61,7,6,0.557377,0,0,13,9,false,true,true,0.862,0.138
300,219,81,27.272727,21.9,81,1210,1253,-43,0,1,0,0.1,14,11,10,2.428571,0,0,10,22,false,true,true,0.999,0.001
304,226,78,33.777778,25.111111,78,1735,1770,-35,2,1,0.222222,0.111111,20,9,9,1.4,0,1,14,14,false,true,true,0.993,0.007
169,93,76,24.142857,15.5,76,1022,1095,-73,0,0,0,0,58,7,6,0.568966,0,0,11,12,false,true,true,0.892,0.108
134,213,-79,19.142857,30.428571,-79,1265,1045,220,0,1,0,0.142857,43,7,7,0.976744,0,0,16,10,false,true,false,0.362,0.638
312,251,61,24,19.307692,61,613,569,44,0,0,0,0,8,13,13,4.875,1,0,10,12,false,true,true,0.999,0.001
267,277,-10,16.6875,17.3125,-10,725,771,-46,0,1,0,0.0625,1,16,16,46,1,0,10,7,false,true,true,0.893,0.107
138,93,45,27.6,23.25,45,1645,1777,-132,1,0,0.2,0,58,5,4,0.431034,2,0,10,23,false,true,true,0.938,0.062
266,259,7,20.461538,19.923077,7,804,988,-184,1,0,0.076923,0,8,13,13,4.125,1,0,6,12,false,true,true,0.628,0.372
118,57,61,29.5,14.25,61,960,1070,-110,1,0,0.25,0,69,4,4,0.507246,0,0,12,23,false,true,true,0.786,0.214
198,181,17,22,20.111111,17,1127,1134,-7,0,0,0,0,31,9,9,0.967742,0,1,14,7,false,true,true,0.526,0.474
168,124,44,24,17.714286,44,1550,1546,4,0,0,0,0,54,7,7,0.555556,1,0,13,7,false,true,true,0.925,0.075
413,331,82,19.666667,15.761905,82,995,912,83,2,0,0.095238,0,-20,21,21,-2.2,0,0,2,10,false,true,true,0.999,0.001
188,122,66,26.857143,17.428571,66,866,949,-83,0,0,0,0,49,7,7,0.816327,0,0,21,16,false,true,true,0.873,0.127
389,268,121,17.681818,12.181818,121,1011,921,90,1,0,0.045455,0,-20,22,22,-2.45,0,0,5,11,false,true,true,1,0
166,152,14,33.2,38,14,1454,1531,-77,1,1,0.2,0.25,62,5,4,0.483871,0,0,12,9,false,true,false,0.401,0.599
144,109,35,18,15.571429,35,580,620,-40,0,0,0,0,56,8,7,0.767857,1,0,7,13,false,true,true,0.679,0.321
59,43,16,14.75,10.75,16,310,359,-49,0,0,0,0,72,4,4,0.680556,0,0,7,13,false,true,true,0.736,0.264
111,81,30,15.857143,11.571429,30,801,807,-6,0,0,0,0,52,7,7,0.673077,0,0,10,16,false,true,true,0.834,0.166
64,0,64,64,0,64,809,868,-59,1,0,1,0,93,1,0,0.344086,0,0,12,0,false,true,true,0.535,0.465
276,319,-43,25.090909,29,-43,1030,1144,-114,0,2,0,0.181818,22,11,11,1.590909,0,0,15,7,false,true,false,0.079,0.921
322,275,47,20.125,17.1875,47,866,949,-83,0,0,0,0,-5,16,16,-8,1,0,6,10,false,true,true,1,0
189,65,124,37.8,16.25,124,1824,1793,31,1,0,0.2,0,68,5,4,0.411765,1,0,16,12,false,true,true,0.993,0.007
153,135,18,10.2,9.642857,18,416,222,194,0,0,0,0,21,15,14,2.619048,1,0,10,20,false,true,true,0.898,0.102
163,135,28,27.166667,27,28,1344,1209,135,1,1,0.166667,0.2,53,6,5,0.641509,0,0,8,21,false,true,true,0.691,0.309
323,222,101,26.916667,18.5,101,1305,1390,-85,0,1,0,0.083333,8,12,12,4.5,0,1,13,19,false,true,true,1,0
348,291,57,21.75,19.4,57,976,965,11,1,0,0.0625,0,-15,16,15,-2.133333,1,0,2,4,false,true,true,1,0
76,26,50,76,26,50,1762,1616,146,1,0,1,0,90,1,1,0.333333,0,0,17,12,false,true,true,0.98,0.02
290,287,3,15.263158,15.944444,3,1043,1055,-12,0,0,0,0,-18,19,18,-2.055556,0,0,4,3,true,true,false,0.145,0.855
312,216,96,20.8,15.428571,96,704,691,13,1,0,0.066667,0,1,15,14,38,0,0,21,7,false,true,true,0.981,0.019
376,260,116,17.904762,13,116,1281,1339,-58,0,0,0,0,-14,21,20,-2.928571,0,0,1,1,true,true,true,1,0
176,221,-45,17.6,22.1,-45,1177,1214,-37,0,0,0,0,31,10,10,1.129032,1,0,17,11,false,true,false,0.117,0.883
276,254,22,23,21.166667,22,1388,1506,-118,2,1,0.166667,0.083333,23,12,12,1.478261,0,0,11,21,false,true,true,0.924,0.076
67,104,-37,13.4,26,-37,1554,1622,-68,1,0,0.2,0,64,5,4,0.484375,0,1,9,7,false,true,true,0.75,0.25
200,124,76,22.222222,13.777778,76,421,306,115,0,1,0,0.111111,26,9,9,1.692308,0,0,44,10,false,true,true,0.98,0.02
112,84,28,18.666667,16.8,28,527,503,24,0,0,0,0,67,6,5,0.61194,0,0,24,8,false,true,true,0.856,0.144
195,220,-25,21.666667,27.5,-25,1434,1493,-59,1,0,0.111111,0,32,9,8,1.15625,1,1,7,6,false,true,false,0.241,0.759
257,165,92,23.363636,16.5,92,960,1070,-110,1,0,0.090909,0,28,11,10,1.25,0,0,17,16,false,true,true,0.982,0.018
330,163,167,27.5,14.818182,167,1413,1422,-9,0,0,0,0,24,12,11,2.375,0,0,7,7,false,true,true,1,0
336,285,51,19.764706,17.8125,51,306,169,137,0,0,0,0,-28,17,16,-1.214286,0,0,1,1,false,true,true,1,0
564,193,371,33.176471,12.0625,371,1431,825,606,2,1,0.117647,0.0625,-7,17,16,-4.857143,0,0,2,16,false,true,true,1,0
109,93,16,21.8,18.6,16,1216,1228,-12,0,0,0,0,63,5,5,0.52381,0,0,14,8,false,true,true,0.534,0.466
224,238,-14,13.176471,14,-14,1029,1075,-46,0,0,0,0,8,17,17,6,2,0,10,12,false,true,true,0.753,0.247
296,182,114,24.666667,16.545455,114,1014,1303,-289,1,0,0.083333,0,18,12,11,2.111111,0,0,10,11,false,true,true,1,0
240,261,-21,18.461538,20.076923,-21,613,611,2,0,0,0,0,2,13,13,19,0,0,9,7,false,true,false,0.49,0.51
275,193,82,25,17.545455,82,371,336,35,2,0,0.181818,0,3,11,11,12.666667,0,0,11,21,false,true,true,0.999,0.001
486,286,200,48.6,28.6,200,991,996,-5,3,0,0.3,0,16,10,10,1.875,0,0,11,9,false,true,true,1,0
155,138,17,17.222222,15.333333,17,872,818,54,0,1,0,0.111111,44,9,9,0.931818,0,0,12,8,false,true,true,0.931,0.069
58,52,6,14.5,17.333333,6,892,768,124,0,0,0,0,78,4,3,0.551282,0,0,11,17,false,true,false,0.258,0.742
219,140,79,24.333333,17.5,79,746,796,-50,0,1,0,0.125,35,9,8,1.371429,0,0,16,11,false,true,true,0.98,0.02
71,42,29,17.75,14,29,859,786,73,0,0,0,0,76,4,3,0.5,0,1,7,17,false,true,false,0.465,0.535
46,25,21,23,12.5,21,804,683,121,0,0,0,0,84,2,2,0.535714,0,0,8,8,false,true,true,0.657,0.343
244,174,70,30.5,21.75,70,1030,998,32,1,0,0.125,0,37,8,8,1.027027,0,0,15,10,false,true,true,0.938,0.062
153,165,-12,15.3,16.5,-12,908,859,49,0,0,0,0,35,10,10,1.114286,0,1,14,7,false,true,false,0.244,0.756
188,124,64,26.857143,17.714286,64,1110,1039,71,0,0,0,0,49,7,7,0.734694,0,0,17,10,false,true,true,0.897,0.103
392,381,11,21.777778,22.411765,11,1397,1195,202,1,0,0.055556,0,-17,18,17,-2.058824,0,0,3,2,true,true,false,0.282,0.718
374,364,10,26.714286,28,10,1256,1232,24,1,0,0.071429,0,-6,14,13,-5,1,0,2,9,false,true,true,0.979,0.021
200,144,56,22.222222,18,56,804,988,-184,1,0,0.111111,0,39,9,8,0.846154,0,0,10,26,false,true,true,0.752,0.248
180,226,-46,13.846154,17.384615,-46,1075,989,86,0,0,0,0,24,13,13,1.625,0,0,20,20,false,true,false,0.124,0.876
131,131,0,10.916667,10.916667,0,416,222,194,0,0,0,0,32,12,12,1.71875,1,0,12,24,false,true,true,0.798,0.202
134,86,48,26.8,17.2,48,939,907,32,0,0,0,0,68,5,5,0.588235,0,0,19,12,false,true,true,0.883,0.117
293,252,41,13.952381,12.6,41,584,565,19,0,0,0,0,-27,21,20,-1.703704,0,0,13,5,false,true,true,0.968,0.032
266,204,62,26.6,20.4,62,1023,1070,-47,1,0,0.1,0,26,10,10,1.230769,1,0,11,20,false,true,true,0.998,0.002
522,193,329,37.285714,13.785714,329,1431,825,606,2,1,0.142857,0.071429,5,14,14,6.8,0,0,9,16,false,true,true,1,0
52,38,14,17.333333,19,14,1670,1770,-100,1,0,0.333333,0,78,3,2,0.410256,0,0,28,9,false,true,false,0.488,0.512
188,120,68,26.857143,20,68,1210,1252,-42,1,0,0.142857,0,50,7,6,0.64,0,0,9,31,false,true,true,0.791,0.209
69,49,20,11.5,8.166667,20,310,359,-49,0,0,0,0,60,6,6,0.816667,1,0,9,21,false,true,true,0.725,0.275
29,12,17,14.5,12,17,1091,1078,13,0,0,0,0,90,2,1,0.477778,0,0,11,8,false,true,false,0.473,0.527
365,277,88,26.071429,19.785714,88,977,976,1,1,0,0.071429,0,4,14,14,8.5,1,0,10,9,false,true,true,1,0
382,290,92,22.470588,17.058824,92,769,527,242,1,0,0.058824,0,-22,17,17,-1.636364,0,0,2,2,false,true,true,1,0
279,200,79,16.411765,11.764706,79,1069,1040,29,0,0,0,0,-12,17,17,-3.666667,0,1,22,4,false,true,true,0.994,0.006
292,254,38,19.466667,16.933333,38,1045,1009,36,1,0,0.066667,0,1,15,15,38,1,0,15,15,false,true,true,0.981,0.019
89,59,30,17.8,11.8,30,1651,1691,-40,0,0,0,0,73,5,5,0.465753,1,0,12,17,false,true,true,0.831,0.169
107,39,68,35.666667,19.5,68,992,1100,-108,1,0,0.333333,0,77,3,2,0.441558,1,0,6,13,false,true,true,0.728,0.272
312,198,114,20.8,14.142857,114,831,830,1,0,0,0,0,4,15,14,9.25,0,0,10,9,false,true,true,1,0
154,101,53,25.666667,20.2,53,1331,1399,-68,0,0,0,0,58,6,5,0.603448,0,0,13,25,false,true,true,0.612,0.388
20,0,20,20,0,20,334,446,-112,0,0,0,0,97,1,0,0.412371,0,0,9,0,false,true,true,0.55,0.45
328,211,117,16.4,10.55,117,1069,1040,29,0,0,0,0,-26,20,20,-1.692308,0,0,2,1,false,true,true,1,0
132,69,63,22,13.8,63,808,812,-4,0,0,0,0,56,6,5,0.660714,0,1,15,9,false,true,true,0.898,0.102
198,93,105,24.75,13.285714,105,554,342,212,0,0,0,0,46,8,7,0.782609,0,0,12,19,false,true,true,0.998,0.002
46,40,6,15.333333,20,6,361,493,-132,0,0,0,0,79,3,2,0.518987,0,0,19,9,false,true,false,0.314,0.686
61,63,-2,20.333333,21,-2,1050,1144,-94,0,0,0,0,78,3,3,0.487179,0,0,7,9,false,true,false,0.341,0.659
155,100,55,17.222222,12.5,55,415,518,-103,0,0,0,0,47,9,8,0.808511,1,0,13,28,false,true,true,0.937,0.063
132,90,42,18.857143,15,42,1266,1247,19,0,0,0,0,54,7,6,0.592593,0,0,10,16,false,true,true,0.55,0.45
24,0,24,24,0,24,1510,1583,-73,0,0,0,0,95,1,0,0.336842,1,0,7,0,false,true,true,0.745,0.255
82,54,28,27.333333,18,28,1803,1552,251,0,0,0,0,81,3,3,0.345679,0,0,15,10,false,true,true,0.993,0.007
348,309,39,20.470588,19.3125,39,315,294,21,0,1,0,0.0625,-24,17,16,-1.458333,0,0,1,1,false,true,true,0.999,0.001
187,203,-16,20.777778,22.555556,-16,942,976,-34,0,0,0,0,35,9,9,1.142857,0,0,13,7,false,true,false,0.227,0.773
319,241,78,39.875,30.125,78,1824,1793,31,1,0,0.125,0,38,8,8,0.736842,1,0,7,11,false,true,true,1,0
239,181,58,29.875,22.625,58,1550,1466,84,1,0,0.125,0,43,8,8,0.860465,0,0,9,12,false,true,true,0.886,0.114
12,27,-15,12,27,-15,758,750,8,0,0,0,0,91,1,1,0.406593,0,0,10,7,false,true,false,0.403,0.597
51,87,-36,10.2,17.4,-36,450,412,38,0,0,0,0,66,5,5,0.575758,0,0,12,10,false,true,false,0.163,0.837
348,235,113,23.2,16.785714,113,596,595,1,1,0,0.066667,0,3,15,14,13.333333,0,0,7,23,false,true,true,0.999,0.001
182,158,24,20.222222,17.555556,24,885,719,166,0,0,0,0,41,9,9,0.926829,0,1,12,6,false,true,true,0.972,0.028
6,0,6,6,0,6,1297,1606,-309,0,0,0,0,97,1,0,0.309278,1,0,10,0,false,true,false,0.246,0.754
94,59,35,23.5,14.75,35,415,518,-103,0,0,0,0,70,4,4,0.542857,0,0,13,21,false,true,true,0.736,0.264
358,304,54,23.866667,20.266667,54,1530,1550,-20,1,1,0.066667,0.066667,-10,15,15,-3.4,0,0,7,5,false,true,true,0.999,0.001
33,15,18,16.5,15,18,1167,1216,-49,0,0,0,0,87,2,1,0.471264,1,0,8,20,false,true,true,0.535,0.465
26,0,26,26,0,26,1227,1060,167,0,0,0,0,97,1,0,0.412371,0,0,7,0,false,true,true,0.526,0.474
303,249,54,25.25,22.636364,54,1093,1090,3,1,2,0.083333,0.181818,21,12,11,1.619048,0,0,13,19,false,true,true,0.953,0.047
0,0,0,0,0,0,1547,1439,108,0,0,0,0,100,1,0,0.37,1,0,15,0,false,true,true,0.514,0.486
376,358,18,25.066667,25.571429,18,1125,1227,-102,2,1,0.133333,0.071429,-19,15,14,-1.578947,0,0,1,4,false,true,true,0.968,0.032
333,312,21,20.8125,19.5,21,1265,1045,220,0,1,0,0.0625,-10,16,16,-4.2,0,0,11,10,false,true,true,0.686,0.314
144,113,31,20.571429,16.142857,31,1691,1692,-1,0,0,0,0,48,7,7,0.625,0,0,12,10,false,true,true,0.515,0.485
140,105,35,20,17.5,35,526,370,156,0,0,0,0,54,7,6,0.648148,0,0,16,16,false,true,true,0.736,0.264
83,84,-1,11.857143,14,-1,892,768,124,0,0,0,0,64,7,6,0.671875,0,0,11,16,false,true,false,0.128,0.872
324,284,40,19.058824,16.705882,40,721,689,32,0,0,0,0,-27,17,17,-1.259259,0,0,1,1,true,true,true,1,0
194,198,-4,17.636364,18,-4,671,725,-54,0,0,0,0,23,11,11,1.608696,1,0,7,12,false,true,false,0.421,0.579
323,337,-14,17.944444,18.722222,-14,1439,1294,145,1,0,0.055556,0,-23,18,18,-1.565217,1,0,2,5,true,true,false,0.396,0.604
182,136,46,22.75,17,46,1014,948,66,0,0,0,0,51,8,8,0.647059,0,0,7,15,false,true,true,0.872,0.128
350,268,82,25,19.142857,82,1220,1261,-41,2,0,0.142857,0,13,14,14,3.461538,1,0,15,8,false,true,true,0.997,0.003
34,0,34,34,0,34,1094,1030,64,0,0,0,0,95,1,0,0.378947,0,0,11,0,false,true,true,0.604,0.396
236,137,99,26.222222,17.125,99,539,500,39,0,0,0,0,30,9,8,1.333333,0,0,13,10,false,true,true,0.995,0.005
451,344,107,34.692308,26.461538,107,1983,2020,-37,2,1,0.153846,0.076923,-1,13,13,-26,0,0,3,12,true,true,true,1,0
271,264,7,19.357143,18.857143,7,1782,1512,270,1,1,0.071429,0.071429,7,14,14,6,0,0,22,13,false,true,true,0.994,0.006
256,216,40,23.272727,21.6,40,948,933,15,1,0,0.090909,0,36,11,10,1.055556,0,0,7,13,false,true,true,0.742,0.258
257,209,48,17.133333,14.928571,48,346,231,115,0,0,0,0,-13,15,14,-3.153846,0,0,22,7,false,true,true,0.946,0.054
212,157,55,30.285714,26.166667,55,1710,1636,74,1,1,0.142857,0.166667,49,7,6,0.734694,1,0,11,11,false,true,true,0.979,0.021
378,340,38,22.235294,21.25,38,856,897,-41,0,1,0,0.0625,-22,17,16,-1.590909,0,0,3,1,false,true,true,0.999,0.001
296,221,75,26.909091,20.090909,75,695,671,24,0,0,0,0,14,11,11,2.357143,0,0,14,7,false,true,true,0.996,0.004
225,144,81,20.454545,14.4,81,1091,1078,13,0,0,0,0,40,11,10,1.075,0,0,12,11,false,true,true,0.975,0.025
304,206,98,33.777778,25.75,98,1735,1770,-35,2,1,0.222222,0.125,23,9,8,1.217391,0,1,14,11,false,true,true,0.994,0.006
149,43,106,29.8,10.75,106,976,965,11,0,0,0,0,65,5,4,0.492308,0,0,14,23,false,true,true,0.953,0.047
143,106,37,15.888889,11.777778,37,498,43,455,0,0,0,0,35,9,9,1.057143,0,0,12,7,false,true,true,0.955,0.045
10,20,-10,10,20,-10,613,611,2,0,0,0,0,92,1,1,0.413043,0,0,10,19,false,true,false,0.258,0.742
420,296,124,26.25,18.5,124,1101,1078,23,1,0,0.0625,0,-15,16,16,-2.2,0,1,1,1,false,true,true,1,0
400,323,77,22.222222,17.944444,77,1227,1060,167,0,2,0,0.111111,-24,18,18,-1.666667,0,0,4,5,false,true,true,0.995,0.005
409,262,147,18.590909,12.47619,147,1413,1422,-9,0,0,0,0,-22,22,21,-2.590909,0,0,3,7,false,true,true,1,0
374,323,51,23.375,20.1875,51,1530,1550,-20,1,1,0.0625,0.0625,-15,16,16,-2.266667,0,0,2,3,false,true,true,1,0
109,122,-13,15.571429,20.333333,-13,1244,1361,-117,0,0,0,0,65,7,6,0.584615,0,1,11,15,false,true,false,0.116,0.884
182,205,-23,15.166667,17.083333,-23,1214,1176,38,0,0,0,0,27,12,12,1.333333,0,0,14,11,false,true,false,0.118,0.882
30,47,-17,15,23.5,-17,613,549,64,0,0,0,0,83,2,2,0.53012,0,0,15,8,false,true,false,0.312,0.688
206,167,39,14.714286,11.928571,39,1016,1037,-21,0,0,0,0,19,14,14,2.526316,1,0,17,26,false,true,true,0.954,0.046
183,162,21,15.25,13.5,21,1016,1037,-21,0,0,0,0,27,12,12,1.777778,0,0,7,19,false,true,false,0.475,0.525
394,271,123,21.888889,15.941176,123,778,758,20,0,1,0,0.058824,-20,18,17,-1.95,0,0,2,3,false,true,true,1,0
136,98,38,19.428571,14,38,913,871,42,0,0,0,0,52,7,7,0.826923,0,0,7,17,false,true,true,0.855,0.145
218,192,26,21.8,21.333333,26,1530,1550,-20,0,1,0,0.111111,28,10,9,1.214286,0,0,7,16,false,true,true,0.538,0.462
161,165,-4,16.1,18.333333,-4,527,514,13,0,0,0,0,33,10,9,1.181818,0,0,7,14,false,true,false,0.226,0.774
144,96,48,20.571429,16,48,1691,1692,-1,0,0,0,0,51,7,6,0.588235,0,0,12,10,false,true,true,0.511,0.489
68,18,50,34,18,50,1144,1014,130,0,0,0,0,89,2,1,0.404494,1,0,18,9,false,true,true,0.864,0.136
186,88,98,26.571429,12.571429,98,1014,1303,-289,1,0,0.142857,0,48,7,7,0.791667,0,1,17,8,false,true,true,0.881,0.119
382,247,135,17.363636,11.227273,135,595,543,52,0,0,0,0,-29,22,22,-1.62069,0,0,7,5,false,true,true,1,0
332,238,94,19.529412,14,94,371,336,35,2,0,0.117647,0,-24,17,17,-1.583333,0,0,2,13,false,true,true,1,0
229,187,42,28.625,26.714286,42,1428,1452,-24,0,0,0,0,49,8,7,0.632653,0,1,9,9,false,true,true,0.595,0.405
373,299,74,21.941176,18.6875,74,1075,1152,-77,0,1,0,0.0625,-9,17,16,-4.444444,0,0,20,9,false,true,true,0.998,0.002
134,108,26,19.142857,18,26,1452,1469,-17,0,1,0,0.166667,50,7,6,0.76,0,0,8,17,false,true,false,0.438,0.562
28,0,28,28,0,28,804,683,121,0,0,0,0,94,1,0,0.478723,0,0,7,0,false,true,true,0.593,0.407
24,12,12,24,12,12,1396,1454,-58,0,0,0,0,93,1,1,0.354839,0,0,12,10,false,true,false,0.49,0.51
244,236,8,17.428571,16.857143,8,725,771,-46,0,1,0,0.071429,11,14,14,4.181818,1,0,6,13,false,true,true,0.949,0.051
132,84,48,22,16.8,48,526,370,156,0,0,0,0,62,6,5,0.564516,0,0,16,23,false,true,true,0.735,0.265
355,333,22,23.666667,23.785714,22,1554,1716,-162,1,1,0.066667,0.071429,-9,15,14,-3.888889,0,0,6,4,false,true,true,0.945,0.055
128,71,57,32,23.666667,57,948,933,15,1,0,0.25,0,73,4,3,0.520548,0,0,10,11,false,true,true,0.852,0.148
273,245,28,18.2,16.333333,28,739,480,259,1,0,0.066667,0,4,15,15,9,0,1,13,6,false,true,true,0.923,0.077
96,35,61,32,11.666667,61,1115,1078,37,0,0,0,0,78,3,3,0.435897,0,0,16,17,false,true,true,0.884,0.116
113,45,68,37.666667,22.5,68,1983,2020,-37,1,0,0.333333,0,76,3,2,0.342105,0,0,15,17,false,true,true,0.555,0.445
36,17,19,18,17,19,630,786,-156,0,0,0,0,85,2,1,0.411765,0,0,11,12,false,true,false,0.442,0.558
427,271,156,35.583333,22.583333,156,1571,1554,17,2,1,0.166667,0.083333,2,12,12,16.5,1,0,15,9,false,true,true,1,0
337,309,28,16.85,15.45,28,758,952,-194,0,0,0,0,-26,20,20,-1.538462,0,0,1,1,true,true,true,0.997,0.003
63,81,-18,15.75,27,-18,1077,1094,-17,0,0,0,0,74,4,3,0.567568,0,0,22,22,false,true,false,0.143,0.857
303,313,-10,25.25,26.083333,-10,908,1070,-162,1,0,0.083333,0,9,12,12,3.333333,0,0,11,8,false,true,false,0.348,0.652
83,98,-15,20.75,24.5,-15,613,549,64,0,0,0,0,65,4,4,0.676923,0,0,11,13,false,true,false,0.297,0.703
67,66,1,16.75,22,1,671,725,-54,0,0,0,0,73,4,3,0.506849,1,0,8,17,false,true,false,0.419,0.581
399,329,70,26.6,23.5,70,1333,1331,2,1,0,0.066667,0,-18,15,14,-1.666667,0,0,3,7,false,true,true,0.999,0.001
317,239,78,22.642857,18.384615,78,1439,1413,26,0,0,0,0,11,14,13,3.272727,1,0,12,7,false,true,true,0.996,0.004
32,59,-27,10.666667,29.5,-27,1305,1242,63,0,0,0,0,84,3,2,0.404762,0,0,8,11,false,true,false,0.108,0.892
47,15,32,23.5,15,32,349,315,34,0,0,0,0,88,2,1,0.386364,0,0,7,11,false,true,true,0.837,0.163
314,227,87,28.545455,20.636364,87,996,1063,-67,1,1,0.090909,0.090909,14,11,11,2.285714,1,0,11,9,false,true,true,1,0
88,25,63,29.333333,12.5,63,995,912,83,1,0,0.333333,0,82,3,2,0.536585,0,0,8,14,false,true,true,0.679,0.321
246,180,66,30.75,22.5,66,1093,1100,-7,2,2,0.25,0.25,45,8,8,0.711111,0,0,8,21,false,true,true,0.952,0.048
49,43,6,16.333333,21.5,6,1023,1070,-47,0,0,0,0,81,3,2,0.395062,1,0,21,8,false,true,true,0.589,0.411
211,167,44,21.1,18.555556,44,1161,1166,-5,1,0,0.1,0,28,10,9,1.25,0,1,10,13,false,true,true,0.557,0.443
150,103,47,25,20.6,47,1110,1039,71,0,0,0,0,60,6,5,0.6,0,0,17,8,false,true,true,0.873,0.127
40,58,-18,13.333333,19.333333,-18,1221,1438,-217,0,0,0,0,82,3,3,0.54878,0,0,16,10,false,true,false,0.202,0.798
24,0,24,24,0,24,976,965,11,0,0,0,0,94,1,0,0.340426,0,0,8,0,false,true,true,0.521,0.479
434,245,189,24.111111,14.411765,189,1482,1554,-72,1,0,0.055556,0,-22,18,17,-1.636364,0,1,3,2,false,true,true,1,0
175,201,-26,21.875,28.714286,-26,1023,1110,-87,1,1,0.125,0.142857,30,8,7,1,0,0,22,7,false,true,false,0.36,0.64
334,251,83,19.647059,15.6875,83,746,796,-50,0,1,0,0.0625,-3,17,16,-16,0,0,14,8,false,true,true,0.999,0.001
144,110,34,20.571429,15.714286,34,1055,1050,5,0,0,0,0,53,7,7,0.641509,0,0,13,12,false,true,true,0.868,0.132
149,116,33,21.285714,16.571429,33,830,907,-77,1,0,0.142857,0,50,7,7,0.78,0,0,16,18,false,true,true,0.738,0.262
340,260,80,24.285714,20,80,1530,1550,-20,1,1,0.071429,0.076923,-1,14,13,-34,0,0,11,10,false,true,true,0.999,0.001
106,84,22,21.2,21,22,1073,1177,-104,0,0,0,0,72,5,4,0.444444,1,1,12,19,false,true,false,0.28,0.72
16,34,-18,5.333333,17,-18,1897,1793,104,0,0,0,0,90,3,2,0.355556,0,0,11,9,false,true,true,0.534,0.466
125,98,27,15.625,14,27,448,598,-150,0,0,0,0,47,8,7,0.765957,1,0,20,9,false,true,true,0.62,0.38
20,0,20,20,0,20,695,523,172,0,0,0,0,95,1,0,0.389474,0,0,9,0,false,true,true,0.545,0.455
211,105,106,16.230769,8.75,106,1428,1302,126,0,0,0,0,23,13,12,2.304348,0,1,14,18,false,true,true,0.992,0.008
160,179,-19,22.857143,29.833333,-19,1023,1110,-87,1,1,0.142857,0.166667,38,7,6,0.789474,0,0,14,8,false,true,false,0.3,0.7
16,24,-8,16,24,-8,1482,1394,88,0,0,0,0,92,1,1,0.391304,0,0,16,23,false,true,false,0.254,0.746
14,0,14,14,0,14,448,598,-150,0,0,0,0,96,1,0,0.375,0,0,13,0,false,true,false,0.495,0.505
132,108,24,22,18,24,916,837,79,0,0,0,0,62,6,6,0.645161,0,0,11,10,false,true,true,0.867,0.133
234,198,36,23.4,22,36,907,752,155,0,0,0,0,33,10,9,1,0,1,10,10,false,true,true,0.968,0.032
58,49,9,19.333333,16.333333,9,808,639,169,0,0,0,0,76,3,3,0.539474,0,0,16,9,false,true,true,0.635,0.365
136,118,18,11.333333,9.833333,18,310,359,-49,0,0,0,0,18,12,12,2.722222,0,0,16,18,false,true,true,0.764,0.236
34,62,-28,17,31,-28,1428,1606,-178,0,0,0,0,84,2,2,0.380952,1,0,6,14,false,true,false,0.457,0.543
250,227,23,27.777778,25.222222,23,1142,1095,47,1,0,0.111111,0,30,9,9,1.166667,0,0,18,13,false,true,true,0.734,0.266
138,91,47,19.714286,15.166667,47,1069,917,152,0,0,0,0,56,7,6,0.607143,0,1,10,7,false,true,true,0.943,0.057
278,197,81,19.857143,15.153846,81,1221,1438,-217,0,0,0,0,22,14,13,2.045455,0,1,19,10,false,true,true,0.735,0.265
305,255,50,25.416667,23.181818,50,791,885,-94,1,1,0.083333,0.090909,20,12,11,1.9,0,0,10,10,false,true,true,0.949,0.051
67,40,27,22.333333,13.333333,27,1439,1397,42,0,0,0,0,79,3,3,0.43038,0,0,8,9,false,true,true,0.521,0.479
287,222,65,22.076923,18.5,65,901,1159,-258,2,0,0.153846,0,12,13,12,2.916667,1,0,16,7,false,true,true,0.982,0.018
211,98,113,23.444444,12.25,113,719,651,68,0,0,0,0,55,9,8,0.818182,0,0,13,8,false,true,true,0.992,0.008
311,197,114,20.733333,13.133333,114,925,801,124,1,0,0.066667,0,6,15,15,6.666667,0,0,7,7,false,true,true,1,0
210,226,-16,16.153846,17.384615,-16,576,494,82,0,0,0,0,20,13,13,2.2,0,0,8,9,false,true,false,0.465,0.535
326,226,100,27.166667,20.545455,100,1156,1184,-28,2,0,0.166667,0,12,12,11,2.333333,0,0,13,10,false,true,true,1,0
361,332,29,25.785714,23.714286,29,1075,1009,66,2,0,0.142857,0,-5,14,14,-6.4,0,0,6,6,false,true,true,0.993,0.007
71,42,29,23.666667,14,29,1210,1253,-43,0,0,0,0,77,3,3,0.454545,0,0,7,18,false,true,true,0.519,0.481
346,302,44,19.222222,16.777778,44,820,822,-2,0,0,0,0,-15,18,18,-2.6,0,0,4,1,false,true,true,0.999,0.001
101,77,24,14.428571,11,24,880,952,-72,0,0,0,0,56,7,7,0.732143,0,0,10,9,false,true,true,0.585,0.415
291,283,8,20.785714,20.214286,8,1439,1294,145,1,0,0.071429,0,1,14,14,36,1,0,8,26,false,true,true,0.7,0.3
247,212,35,17.642857,16.307692,35,704,691,13,0,0,0,0,12,14,13,3.166667,1,0,7,7,false,true,true,0.898,0.102
216,124,92,21.6,13.777778,92,421,306,115,0,1,0,0.111111,23,10,9,1.913043,0,0,42,10,false,true,true,0.981,0.019
191,101,90,31.833333,20.2,90,1826,1803,23,1,0,0.166667,0,54,6,5,0.555556,1,0,9,8,false,true,true,0.975,0.025
222,108,114,37,21.6,114,1396,1454,-58,1,0,0.166667,0,56,6,5,0.589286,1,0,6,11,false,true,true,1,0
39,18,21,19.5,18,21,1047,1094,-47,0,0,0,0,90,2,1,0.4,0,0,8,19,false,true,false,0.244,0.756
185,164,21,20.555556,20.5,21,926,854,72,0,0,0,0,45,9,8,0.755556,0,1,17,7,false,true,true,0.531,0.469
360,331,29,21.176471,20.6875,29,1177,1214,-37,0,0,0,0,-19,17,16,-1.842105,0,0,1,2,false,true,true,0.984,0.016
354,287,67,23.6,20.5,67,1142,1095,47,1,0,0.066667,0,-9,15,14,-3.888889,0,0,13,11,false,true,true,0.999,0.001
88,45,43,44,22.5,43,1983,2020,-37,1,0,0.5,0,80,2,2,0.325,0,0,12,17,false,true,true,0.695,0.305
314,236,78,22.428571,18.153846,78,1731,1691,40,1,0,0.071429,0,2,14,13,17,0,0,12,26,false,true,true,0.999,0.001
297,265,32,14.142857,13.25,32,371,435,-64,0,0,0,0,-29,21,20,-1.517241,0,0,1,2,false,true,true,0.998,0.002
123,67,56,20.5,13.4,56,1397,1422,-25,1,0,0.166667,0,65,6,5,0.553846,0,1,17,11,false,true,true,0.812,0.188
184,166,18,26.285714,27.666667,18,1434,1493,-59,1,0,0.142857,0,43,7,6,0.860465,1,0,9,16,false,true,true,0.73,0.27
351,317,34,20.647059,19.8125,34,1022,1095,-73,0,1,0,0.0625,-18,17,16,-1.833333,0,0,2,4,true,true,true,0.996,0.004
96,50,46,32,16.666667,46,1826,1803,23,0,0,0,0,79,3,3,0.379747,0,0,9,8,false,true,true,0.536,0.464
43,21,22,14.333333,10.5,22,1011,921,90,0,0,0,0,83,3,2,0.590361,0,0,11,18,false,true,false,0.436,0.564
231,187,44,21,18.7,44,1161,1166,-5,1,0,0.090909,0,21,11,10,1.666667,1,1,9,8,false,true,true,0.523,0.477
173,134,39,15.727273,13.4,39,880,952,-72,0,0,0,0,27,11,10,1.518519,0,0,12,11,false,true,true,0.82,0.18
83,20,63,16.6,5,63,1394,1230,164,0,0,0,0,67,5,4,0.567164,0,0,7,16,false,true,true,0.618,0.382
91,70,21,22.75,17.5,21,786,757,29,0,0,0,0,70,4,4,0.557143,0,0,7,12,false,true,true,0.729,0.271
221,174,47,24.555556,21.75,47,1093,1090,3,1,1,0.111111,0.125,44,9,8,0.772727,0,1,11,7,false,true,true,0.881,0.119
292,161,131,20.857143,12.384615,131,786,757,29,1,0,0.071429,0,13,14,13,3,0,0,9,16,false,true,true,1,0
334,314,20,18.555556,17.444444,20,1181,1149,32,0,1,0,0.055556,-6,18,18,-7.5,0,0,15,8,false,true,true,0.859,0.141
123,7,116,41,3.5,116,1935,2020,-85,0,0,0,0,80,3,2,0.3875,0,0,13,29,false,true,true,0.969,0.031
146,81,65,20.857143,13.5,65,609,620,-11,0,0,0,0,57,7,6,0.649123,0,0,15,14,false,true,true,0.895,0.105
190,173,17,23.75,24.714286,17,1431,802,629,0,0,0,0,38,8,7,0.842105,0,0,12,19,false,true,true,0.989,0.011
22,0,22,22,0,22,1067,95,972,0,0,0,0,96,1,0,0.354167,0,0,17,0,false,true,true,1,0
185,125,60,37,25,60,992,1100,-108,2,0,0.4,0,57,5,5,0.596491,0,0,7,10,false,true,true,0.841,0.159
208,174,34,20.8,17.4,34,830,907,-77,1,0,0.1,0,30,10,10,1.3,0,0,16,23,false,true,true,0.749,0.251
270,254,16,19.285714,19.538462,16,1572,1550,22,1,0,0.071429,0,13,14,13,3,1,1,11,7,false,true,false,0.254,0.746
143,132,11,23.833333,22,11,804,988,-184,1,0,0.166667,0,55,6,6,0.6,0,0,12,19,false,true,true,0.555,0.445
232,133,99,33.142857,22.166667,99,1148,1164,-16,1,1,0.142857,0.166667,42,7,6,0.595238,0,0,16,16,false,true,true,0.981,0.019
343,300,43,20.176471,17.647059,43,820,822,-2,0,0,0,0,-11,17,17,-3.545455,0,0,6,2,false,true,true,0.999,0.001
272,241,31,14.315789,12.684211,31,611,584,27,0,0,0,0,-12,19,19,-3.666667,1,0,4,12,false,true,true,0.996,0.004
170,126,44,21.25,18,44,691,473,218,0,0,0,0,45,8,7,0.8,0,0,16,7,false,true,true,0.883,0.117
369,367,2,21.705882,22.9375,2,1320,1339,-19,2,1,0.117647,0.0625,-13,17,16,-3,0,0,5,5,false,true,false,0.346,0.654
232,240,-8,15.466667,17.142857,-8,262,306,-44,0,0,0,0,6,15,14,7.666667,0,0,9,13,false,true,false,0.218,0.782
447,297,150,29.8,21.214286,150,1550,1546,4,0,1,0,0.071429,-6,15,14,-5,1,0,7,7,false,true,true,1,0
118,77,41,19.666667,15.4,41,739,480,259,1,0,0.166667,0,58,6,5,0.62069,0,0,10,12,false,true,true,0.856,0.144
229,205,24,17.615385,15.769231,24,334,446,-112,0,0,0,0,6,13,13,6.666667,0,1,9,16,false,true,true,0.664,0.336
72,92,-20,12,15.333333,-20,580,620,-40,0,0,0,0,64,6,6,0.671875,1,0,15,13,false,true,false,0.413,0.587
409,249,160,24.058824,14.647059,160,954,1078,-124,1,1,0.058824,0.058824,-15,17,17,-2.533333,0,0,4,4,false,true,true,1,0
289,284,5,26.272727,25.818182,5,1439,1397,42,1,2,0.090909,0.181818,9,11,11,3.777778,0,0,16,22,false,true,true,0.529,0.471
194,120,74,24.25,17.142857,74,1115,1078,37,0,0,0,0,49,8,7,0.693878,1,0,15,8,false,true,true,0.978,0.022
216,181,35,21.6,20.111111,35,1493,1513,-20,1,0,0.1,0,36,10,9,0.916667,0,2,19,13,false,true,false,0.41,0.59
355,271,84,22.1875,16.9375,84,902,866,36,0,0,0,0,-22,16,16,-1.454545,0,0,1,4,true,true,true,1,0
93,96,-3,13.285714,13.714286,-3,416,222,194,0,0,0,0,52,7,7,1.057692,1,0,9,7,false,true,true,0.614,0.386
217,150,67,24.111111,18.75,67,306,169,137,0,0,0,0,32,9,8,1.0625,0,0,10,11,false,true,true,0.926,0.074
351,204,147,19.5,12,147,595,543,52,0,0,0,0,-8,18,17,-5.875,0,0,10,9,false,true,true,1,0
138,109,29,27.6,21.8,29,1109,1065,44,0,0,0,0,64,5,5,0.515625,1,0,15,9,false,true,true,0.863,0.137
308,255,53,22,19.615385,53,1047,1094,-47,1,1,0.071429,0.076923,9,14,13,4,0,0,23,10,false,true,true,0.95,0.05
46,66,-20,23,33,-20,1302,1234,68,0,0,0,0,84,2,2,0.369048,0,0,12,10,false,true,false,0.274,0.726
142,86,56,17.75,12.285714,56,415,518,-103,0,0,0,0,54,8,7,0.703704,1,0,7,27,false,true,true,0.896,0.104
0,10,-10,0,10,-10,1197,1127,70,0,0,0,0,97,1,1,0.309278,0,0,7,23,false,true,false,0.435,0.565
174,156,18,29,31.2,18,1890,2020,-130,0,1,0,0.2,50,6,5,0.58,1,0,9,9,false,true,true,0.851,0.149
340,270,70,20,15.882353,70,580,620,-40,1,0,0.058824,0,-10,17,17,-4.3,0,0,12,20,false,true,true,0.999,0.001
364,249,115,22.75,16.6,115,1029,1227,-198,1,0,0.0625,0,-25,16,15,-1.28,0,0,1,3,false,true,true,1,0
54,45,9,27,22.5,9,784,758,26,0,0,0,0,86,2,2,0.406977,0,0,13,8,false,true,true,0.622,0.378
359,268,91,18.894737,14.888889,91,831,830,1,0,0,0,0,-18,19,18,-2.055556,0,0,8,6,true,true,true,1,0
251,212,39,22.818182,19.272727,39,1221,1266,-45,0,0,0,0,20,11,11,1.75,1,0,9,7,false,true,true,0.839,0.161
204,199,5,17,16.583333,5,527,581,-54,0,0,0,0,19,12,12,2.210526,0,0,17,16,false,true,true,0.702,0.298
214,141,73,23.777778,17.625,73,1489,1445,44,0,0,0,0,38,9,8,0.842105,0,1,11,19,false,true,true,0.935,0.065
359,212,147,19.944444,12.470588,147,1413,1422,-9,0,0,0,0,-1,18,17,-57,0,0,13,17,false,true,true,1,0
212,115,97,30.285714,19.166667,97,1826,1803,23,1,0,0.142857,0,48,7,6,0.625,1,0,9,7,false,true,true,0.977,0.023
208,213,-5,11.555556,12.529412,-5,1030,1045,-15,0,0,0,0,5,18,17,9.2,1,0,8,8,false,true,true,0.643,0.357
70,52,18,23.333333,26,18,1482,1394,88,0,0,0,0,84,3,2,0.428571,1,0,6,22,false,true,true,0.838,0.162
37,24,13,18.5,24,13,1090,1244,-154,0,0,0,0,86,2,1,0.430233,0,0,15,9,false,true,false,0.414,0.586
200,259,-59,22.222222,32.375,-59,1419,1488,-69,0,1,0,0.125,28,9,8,1,1,0,6,9,false,true,false,0.162,0.838
106,59,47,35.333333,19.666667,47,2219,2106,113,0,0,0,0,79,3,3,0.341772,0,1,10,7,false,true,true,0.641,0.359
100,166,-66,14.285714,23.714286,-66,1897,1793,104,0,1,0,0.142857,65,7,7,0.492308,0,0,11,8,false,true,true,0.671,0.329
52,23,29,26,23,29,834,844,-10,0,0,0,0,88,2,1,0.409091,0,0,10,10,false,true,true,0.541,0.459
71,118,-47,23.666667,39.333333,-47,1431,825,606,0,1,0,0.333333,73,3,3,0.465753,0,0,10,14,false,true,true,0.842,0.158
288,153,135,41.142857,21.857143,135,1571,1554,17,2,1,0.285714,0.142857,35,7,7,0.942857,0,0,28,18,false,true,true,0.999,0.001
212,174,38,30.285714,24.857143,38,1710,1636,74,1,1,0.142857,0.142857,47,7,7,0.765957,1,0,11,13,false,true,true,0.982,0.018
54,44,10,13.5,14.666667,10,1100,1008,92,0,0,0,0,80,4,3,0.45,2,0,7,9,false,true,true,0.929,0.071
295,283,12,19.666667,20.214286,12,1266,1247,19,0,0,0,0,1,15,14,32,2,0,3,12,false,true,true,0.94,0.06
342,306,36,19,17,36,1075,989,86,1,0,0.055556,0,-11,18,18,-3.545455,0,0,13,6,false,true,true,0.97,0.03
231,195,36,28.875,24.375,36,992,1100,-108,2,0,0.25,0,36,8,8,0.944444,0,0,10,11,false,true,true,0.734,0.266
37,48,-11,9.25,12,-11,416,374,42,0,0,0,0,81,4,4,0.567901,1,0,9,16,false,true,false,0.483,0.517
244,168,76,22.181818,16.8,76,1055,1050,5,0,0,0,0,31,11,10,1.096774,0,0,14,7,false,true,true,0.96,0.04
104,79,25,26,19.75,25,1826,1803,23,0,0,0,0,69,4,4,0.434783,0,0,8,14,false,true,false,0.498,0.502
291,278,13,19.4,19.857143,13,518,448,70,0,0,0,0,0,15,14,0,0,0,10,14,false,true,true,0.669,0.331
119,102,17,23.8,25.5,17,1334,1270,64,1,0,0.2,0,69,5,4,0.536232,0,0,24,9,false,true,false,0.338,0.662
329,300,29,29.909091,30,29,1265,1237,28,1,0,0.090909,0,12,11,10,2.5,0,1,7,21,false,true,true,0.989,0.011
77,59,18,19.25,14.75,18,1277,1166,111,0,0,0,0,72,4,4,0.5,0,2,11,8,false,true,true,0.755,0.245
24,15,9,24,15,9,1489,1445,44,0,0,0,0,90,1,1,0.355556,0,0,19,13,false,true,true,0.523,0.477
28,16,12,14,16,12,1221,1438,-217,0,0,0,0,91,2,1,0.494505,0,0,19,14,false,true,false,0.245,0.755
128,114,14,21.333333,22.8,14,505,95,410,0,1,0,0.2,69,6,5,0.637681,0,0,14,8,false,true,true,0.832,0.168
221,223,-2,27.625,27.875,-2,974,995,-21,0,1,0,0.125,35,8,8,0.942857,0,0,21,11,false,true,true,0.733,0.267
264,144,120,20.307692,11.076923,120,595,543,52,0,0,0,0,22,13,13,2.136364,0,0,8,14,false,true,true,1,0
208,255,-47,26,31.875,-47,1636,1576,60,0,2,0,0.25,32,8,8,1.0625,0,0,10,18,false,true,false,0.03,0.97
360,273,87,27.692308,21,87,1556,1591,-35,1,0,0.076923,0,7,13,13,5.142857,0,0,7,7,false,true,true,1,0
350,220,130,16.666667,10.47619,130,871,867,4,0,0,0,0,-18,21,21,-2.388889,0,0,6,9,false,true,true,1,0
369,309,60,41,38.625,60,1983,2020,-37,2,1,0.222222,0.125,21,9,8,1.238095,0,0,9,29,false,true,true,0.999,0.001
74,34,40,18.5,11.333333,40,1181,1069,112,0,0,0,0,74,4,3,0.5,1,0,12,17,false,true,true,0.736,0.264
409,314,95,24.058824,19.625,95,1331,1399,-68,1,0,0.058824,0,-21,17,16,-1.666667,0,0,2,2,false,true,true,1,0
32,14,18,16,14,18,371,435,-64,0,0,0,0,88,2,1,0.5,0,0,19,16,false,true,false,0.389,0.611
289,272,17,19.266667,18.133333,17,349,315,34,0,0,0,0,-14,15,15,-2.428571,0,0,3,7,false,true,true,0.989,0.011
144,81,63,36,20.25,63,1408,1454,-46,1,0,0.25,0,70,4,4,0.457143,0,0,8,19,false,true,true,0.859,0.141
322,250,72,12.88,10,72,416,222,194,0,0,0,0,-38,25,25,-1.447368,0,0,7,4,false,true,true,1,0
252,243,9,19.384615,18.692308,9,1266,1247,19,0,0,0,0,12,13,13,2.666667,1,0,11,16,false,true,true,0.528,0.472
240,152,88,24,15.2,88,1004,653,351,0,0,0,0,24,10,10,1.458333,0,0,8,19,false,true,true,0.999,0.001
134,78,56,22.333333,13,56,1394,1118,276,0,0,0,0,57,6,6,0.649123,1,0,19,7,false,true,true,0.976,0.024
0,0,0,0,0,0,523,480,43,0,0,0,0,100,1,0,0.33,0,0,7,0,false,true,false,0.371,0.629
129,148,-19,16.125,21.142857,-19,334,446,-112,0,0,0,0,46,8,7,0.869565,0,0,8,8,false,true,false,0.113,0.887
275,235,40,30.555556,26.111111,40,1454,1531,-77,1,1,0.111111,0.111111,23,9,9,1.304348,0,0,17,12,false,true,true,0.788,0.212
34,23,11,17,23,11,480,518,-38,0,0,0,0,90,2,1,0.511111,0,0,8,14,false,true,false,0.274,0.726
93,70,23,23.25,23.333333,23,892,819,73,0,1,0,0.333333,72,4,3,0.472222,1,0,22,12,false,true,true,0.898,0.102
14,8,6,14,8,6,1128,889,239,0,0,0,0,94,1,1,0.5,1,0,8,15,false,true,true,0.796,0.204
42,11,31,21,11,31,1022,1095,-73,0,0,0,0,89,2,1,0.370787,0,0,37,10,false,true,true,0.663,0.337
328,186,142,20.5,11.625,142,1067,95,972,1,0,0.0625,0,-10,16,16,-3.4,1,0,2,11,false,true,true,1,0
355,240,115,25.357143,18.461538,115,1014,948,66,1,0,0.071429,0,4,14,13,8.25,0,0,11,10,false,true,true,1,0
31,48,-17,7.75,12,-17,791,774,17,0,0,0,0,84,4,4,0.488095,1,0,7,14,false,true,false,0.266,0.734
111,96,15,37,32,15,1428,1606,-178,1,0,0.333333,0,71,3,3,0.450704,1,0,8,21,false,true,true,0.791,0.209
423,276,147,26.4375,17.25,147,1167,1216,-49,1,0,0.0625,0,1,16,16,41,0,0,7,7,false,true,true,1,0
38,34,4,12.666667,11.333333,4,719,614,105,0,0,0,0,80,3,3,0.5375,0,2,15,10,false,true,false,0.094,0.906
193,206,-13,19.3,20.6,-13,1027,856,171,1,1,0.1,0.1,20,10,10,1.65,1,0,13,10,false,true,true,0.756,0.244
298,266,32,17.529412,15.647059,32,808,639,169,0,0,0,0,-7,17,17,-5.857143,0,1,6,3,false,true,true,0.903,0.097
227,174,53,22.7,19.333333,53,1302,1082,220,0,0,0,0,22,10,9,1.363636,0,0,16,7,false,true,true,0.872,0.128
86,94,-8,28.666667,31.333333,-8,1075,1152,-77,0,0,0,0,76,3,3,0.526316,0,1,19,7,false,true,false,0.446,0.554
85,79,6,17,15.8,6,698,742,-44,0,0,0,0,73,5,5,0.561644,0,0,19,14,false,true,true,0.622,0.378
305,104,201,38.125,14.857143,201,1513,1482,31,1,0,0.125,0,38,8,7,0.868421,0,0,10,16,false,true,true,1,0
116,74,42,14.5,10.571429,42,584,565,19,0,0,0,0,51,8,7,0.901961,0,0,16,19,false,true,true,0.778,0.222
292,253,39,26.545455,25.3,39,1428,1606,-178,1,0,0.090909,0,19,11,10,1.684211,1,0,15,9,false,true,true,0.871,0.129
382,247,135,15.916667,10.73913,135,595,543,52,0,0,0,0,-29,24,23,-1.62069,0,0,7,5,true,true,true,1,0
365,224,141,20.277778,13.176471,141,554,342,212,0,0,0,0,-19,18,17,-1.894737,0,0,1,4,false,true,true,1,0
158,153,5,31.6,38.25,5,1885,1793,92,0,0,0,0,60,5,4,0.45,0,0,10,10,false,true,false,0.167,0.833
66,49,17,22,24.5,17,820,822,-2,0,0,0,0,82,3,2,0.47561,1,0,19,10,false,true,true,0.743,0.257
314,279,35,24.153846,21.461538,35,1142,1095,47,1,0,0.076923,0,3,13,13,11.666667,0,0,11,11,false,true,true,0.844,0.156
220,180,40,13.75,12,40,584,565,19,0,0,0,0,1,16,15,46,0,0,20,17,false,true,true,0.962,0.038
121,109,12,15.125,15.571429,12,908,859,49,0,0,0,0,50,8,7,0.78,1,0,12,15,false,true,true,0.501,0.499
165,127,38,23.571429,18.142857,38,1305,1242,63,1,0,0.142857,0,55,7,7,0.618182,0,1,7,19,false,true,true,0.974,0.026
10,0,10,10,0,10,584,565,19,0,0,0,0,97,1,0,0.474227,0,0,13,0,false,true,true,0.517,0.483
296,280,16,13.454545,13.333333,16,871,999,-128,0,0,0,0,-27,22,21,-1.777778,0,0,6,7,false,true,true,0.939,0.061
89,44,45,17.8,8.8,45,1030,1045,-15,0,0,0,0,71,5,5,0.647887,0,0,13,10,false,true,true,0.854,0.146
12,0,12,12,0,12,1156,1114,42,0,0,0,0,96,1,0,0.333333,0,0,7,0,false,true,false,0.413,0.587
120,52,68,30,13,68,993,897,96,1,0,0.25,0,67,4,4,0.701493,0,0,7,7,false,true,true,0.936,0.064
251,179,72,19.307692,14.916667,72,1221,1438,-217,0,0,0,0,28,13,12,1.607143,0,1,20,15,false,true,true,0.693,0.307
83,62,21,20.75,20.666667,21,1513,1479,34,0,0,0,0,75,4,3,0.453333,1,0,18,7,false,true,true,0.858,0.142
123,116,7,20.5,19.333333,7,1516,1397,119,0,1,0,0.166667,55,6,6,0.6,0,0,16,12,false,true,true,0.704,0.296
286,240,46,23.833333,20,46,1073,1177,-104,1,0,0.083333,0,12,12,12,2.666667,0,0,18,17,false,true,true,0.823,0.177
114,98,16,16.285714,14,16,448,598,-150,0,0,0,0,50,7,7,0.72,1,0,16,9,false,true,true,0.59,0.41
241,134,107,40.166667,26.8,107,1197,1127,70,0,0,0,0,52,6,5,0.576923,0,0,13,8,false,true,true,0.996,0.004
66,70,-4,33,35,-4,1489,1558,-69,0,1,0,0.5,79,2,2,0.35443,0,0,18,14,false,true,true,0.542,0.458
288,141,147,20.571429,10.071429,147,993,897,96,1,0,0.071429,0,6,14,14,7.833333,0,1,15,22,false,true,true,1,0
87,41,46,43.5,20.5,46,795,830,-35,1,1,0.5,0.5,77,2,2,0.545455,1,0,9,11,false,true,true,0.894,0.106
206,125,81,41.2,25,81,1397,1361,36,1,0,0.2,0,58,5,5,0.5,0,0,11,8,false,true,true,0.892,0.108
116,86,30,19.333333,17.2,30,1691,1692,-1,0,0,0,0,57,6,5,0.526316,0,0,12,8,false,true,false,0.451,0.549
58,88,-30,19.333333,44,-30,719,785,-66,0,1,0,0.5,80,3,2,0.45,0,0,9,15,false,true,false,0.255,0.745
394,236,158,26.266667,16.857143,158,1221,1266,-45,1,0,0.066667,0,-9,15,14,-3.888889,0,0,16,12,false,true,true,1,0
324,333,-9,21.6,22.2,-9,1266,1144,122,0,0,0,0,-6,15,15,-5.666667,1,0,7,16,false,true,false,0.395,0.605
12,0,12,12,0,12,1320,1339,-19,0,0,0,0,96,1,0,0.40625,0,0,10,0,false,true,false,0.332,0.668
363,300,63,18.15,15,63,505,95,410,0,1,0,0.05,-18,20,20,-2.444444,0,0,3,5,false,true,true,1,0
399,319,80,16.625,13.291667,80,1583,1422,161,1,0,0.041667,0,-18,24,24,-2.833333,0,0,2,7,false,true,true,0.995,0.005
135,132,3,15,16.5,3,1043,1055,-12,0,0,0,0,43,9,8,0.860465,1,0,19,14,false,true,false,0.426,0.574
238,195,43,17,15,43,371,435,-64,0,0,0,0,8,14,13,5.5,0,0,15,8,false,true,true,0.907,0.093
232,136,96,23.2,15.111111,96,1065,1030,35,0,0,0,0,35,10,9,0.971429,1,0,10,7,false,true,true,0.981,0.019
110,82,28,22,16.4,28,916,876,40,0,0,0,0,61,5,5,0.557377,1,0,9,9,false,true,true,0.568,0.432
211,218,-7,23.444444,27.25,-7,1331,1399,-68,0,0,0,0,34,9,8,1.029412,0,0,26,7,false,true,false,0.243,0.757
461,313,148,28.8125,19.5625,148,1571,1554,17,2,1,0.125,0.0625,-20,16,16,-1.65,1,0,0,2,false,true,true,1,0
285,213,72,21.923077,17.75,72,859,811,48,0,0,0,0,15,13,12,2.4,1,1,10,13,false,true,true,0.993,0.007
245,238,7,17.5,18.307692,7,892,788,104,2,0,0.142857,0,14,14,13,3.071429,0,0,11,22,false,true,true,0.847,0.153
20,0,20,20,0,20,1803,1552,251,0,0,0,0,95,1,1,0.294737,0,0,25,0,false,true,true,0.996,0.004
142,173,-31,15.777778,21.625,-31,95,360,-265,0,1,0,0.125,36,9,8,1.111111,0,0,13,8,false,true,false,0.333,0.667
377,367,10,25.133333,24.466667,10,1397,1195,202,1,0,0.066667,0,-5,15,15,-7,0,0,10,5,false,true,true,0.552,0.448
152,178,-26,21.714286,29.666667,-26,1431,825,606,0,1,0,0.166667,46,7,6,0.73913,1,0,13,13,false,true,true,0.969,0.031
67,106,-39,16.75,35.333333,-39,719,785,-66,0,1,0,0.333333,73,4,3,0.493151,0,0,9,9,false,true,false,0.139,0.861
241,160,81,40.166667,26.666667,81,1197,1127,70,0,0,0,0,48,6,6,0.625,0,0,13,16,false,true,true,0.986,0.014
165,170,-5,16.5,18.888889,-5,95,378,-283,0,0,0,0,31,10,9,1.129032,0,0,7,12,false,true,false,0.221,0.779
221,263,-42,15.785714,18.785714,-42,527,514,13,0,0,0,0,1,14,14,39,0,0,12,8,false,true,false,0.029,0.971
198,230,-32,15.230769,17.692308,-32,262,306,-44,0,0,0,0,19,13,13,2.421053,0,0,7,11,false,true,false,0.12,0.88
90,42,48,22.5,14,48,1101,1078,23,0,0,0,0,77,4,3,0.428571,0,1,12,9,false,true,true,0.629,0.371
14,12,2,14,12,2,902,866,36,0,0,0,0,89,1,1,0.359551,0,0,7,17,false,true,false,0.39,0.61
254,263,-9,23.090909,26.3,-9,1431,802,629,0,0,0,0,20,11,10,1.6,0,0,14,7,false,true,true,0.983,0.017
374,276,98,23.375,17.25,98,801,925,-124,1,0,0.0625,0,-16,16,16,-2.1875,0,0,5,1,false,true,true,1,0
334,314,20,18.555556,17.444444,20,1270,1348,-78,0,0,0,0,-14,18,18,-2.714286,0,0,2,4,false,true,true,0.984,0.016
329,315,14,25.307692,26.25,14,1102,1245,-143,2,0,0.153846,0,-18,13,12,-1.555556,0,0,1,2,false,true,true,0.99,0.01
396,255,141,28.285714,19.615385,141,986,856,130,1,0,0.071429,0,-10,14,13,-3.1,0,0,7,5,false,true,true,1,0
208,96,112,29.714286,16,112,539,500,39,0,0,0,0,45,7,6,0.888889,0,1,7,15,false,true,true,1,0
202,142,60,25.25,20.285714,60,306,169,137,0,0,0,0,40,8,7,0.85,0,0,16,7,false,true,true,0.881,0.119
124,119,5,20.666667,19.833333,5,872,818,54,0,1,0,0.166667,58,6,6,0.706897,0,0,9,8,false,true,true,0.86,0.14
252,178,74,36,25.428571,74,1762,1616,146,2,0,0.285714,0,37,7,7,0.810811,0,0,9,15,false,true,true,0.976,0.024
203,172,31,18.454545,15.636364,31,864,808,56,1,0,0.090909,0,18,11,11,1.888889,0,1,7,10,false,true,true,0.839,0.161
282,281,1,21.692308,21.615385,1,926,854,72,0,0,0,0,11,13,13,3.090909,1,0,9,11,false,true,false,0.467,0.533
27,18,9,13.5,18,9,1156,1184,-28,0,0,0,0,88,2,1,0.318182,0,0,15,10,false,true,false,0.435,0.565
142,166,-24,12.909091,15.090909,-24,611,584,27,0,0,0,0,35,11,11,1.257143,0,0,16,12,false,true,false,0.336,0.664
291,224,67,36.375,28,67,1197,1127,70,0,0,0,0,33,8,8,0.909091,0,0,9,11,false,true,true,0.994,0.006
238,175,63,19.833333,15.909091,63,1270,1315,-45,0,0,0,0,22,12,11,1.636364,1,0,9,26,false,true,true,0.982,0.018
240,254,-14,21.818182,23.090909,-14,758,952,-194,0,0,0,0,15,11,11,2.666667,1,0,8,16,false,true,false,0.138,0.862
251,228,23,27.888889,25.333333,23,1302,1234,68,1,1,0.111111,0.111111,31,9,9,1,0,0,13,10,false,true,true,0.781,0.219
162,132,30,14.727273,13.2,30,218,86,132,0,0,0,0,25,11,10,1.6,0,0,26,13,false,true,true,0.776,0.224
365,261,104,28.076923,20.076923,104,1334,1256,78,2,0,0.153846,0,3,13,13,10.333333,0,1,16,6,false,true,true,1,0
279,245,34,23.25,22.272727,34,1127,1075,52,1,1,0.083333,0.090909,15,12,11,2.066667,0,1,11,7,false,true,true,0.592,0.408
19,20,-1,9.5,10,-1,595,543,52,0,0,0,0,86,2,2,0.546512,0,0,17,7,false,true,true,0.525,0.475
295,185,110,21.071429,14.230769,110,539,500,39,0,0,0,0,4,14,13,10,0,0,11,8,false,true,true,1,0
73,44,29,24.333333,22,29,1501,1622,-121,0,0,0,0,81,3,2,0.382716,1,0,10,25,false,true,true,0.792,0.208
368,285,83,19.368421,15,83,844,821,23,0,0,0,0,-5,19,19,-8.4,0,0,6,4,false,true,true,1,0
318,258,60,22.714286,18.428571,60,1305,1218,87,1,0,0.071429,0,-1,14,14,-38,0,0,13,7,false,true,true,0.999,0.001
24,0,24,24,0,24,539,500,39,0,0,0,0,95,1,0,0.421053,0,0,10,0,false,true,true,0.63,0.37
169,242,-73,15.363636,22,-73,1100,1008,92,0,0,0,0,29,11,11,1.241379,2,0,7,10,false,true,true,0.634,0.366
146,124,22,18.25,17.714286,22,361,493,-132,0,0,0,0,43,8,7,0.953488,0,0,15,26,false,true,true,0.708,0.292
291,191,100,18.1875,12.733333,100,1253,1166,87,1,0,0.0625,0,7,16,15,6.142857,0,0,10,17,false,true,true,0.999,0.001
218,147,71,36.333333,29.4,71,1302,1349,-47,0,0,0,0,49,6,5,0.571429,0,0,13,9,false,true,true,0.882,0.118
298,249,49,21.285714,19.153846,49,948,933,15,1,0,0.071429,0,20,14,13,1.9,0,0,16,11,false,true,true,0.923,0.077
389,317,72,24.3125,19.8125,72,1556,1591,-35,2,0,0.125,0,-19,16,16,-1.894737,0,0,2,3,false,true,true,1,0
172,125,47,17.2,12.5,47,1069,1040,29,0,0,0,0,31,10,10,1.419355,0,2,14,5,false,true,true,0.947,0.053
345,313,32,18.157895,17.388889,32,613,611,2,0,0,0,0,-29,19,18,-1.310345,0,0,2,1,false,true,true,0.998,0.002
191,125,66,21.222222,13.888889,66,609,620,-11,0,0,0,0,42,9,9,0.880952,0,1,10,9,false,true,true,0.993,0.007
206,179,27,29.428571,25.571429,27,992,1100,-108,2,0,0.285714,0,44,7,7,0.772727,0,0,14,7,false,true,true,0.732,0.268
91,68,23,18.2,13.6,23,1394,1118,276,0,0,0,0,63,5,5,0.587302,1,0,17,9,false,true,true,0.889,0.111
395,286,109,28.214286,20.428571,109,1189,1266,-77,1,0,0.071429,0,-7,14,14,-4.857143,0,0,14,2,false,true,true,1,0
24,0,24,24,0,24,500,567,-67,0,0,0,0,95,1,0,0.463158,0,0,12,0,false,true,true,0.599,0.401
259,210,49,32.375,26.25,49,1237,1277,-40,0,0,0,0,31,8,8,0.935484,1,0,8,9,false,true,true,0.935,0.065
289,262,27,17,15.411765,27,468,542,-74,0,0,0,0,-9,17,17,-4.333333,0,0,15,3,false,true,true,0.956,0.044
406,381,25,29,29.307692,25,1428,1452,-24,1,2,0.071429,0.153846,-4,14,13,-7.75,0,0,2,7,false,true,true,0.967,0.033
307,227,80,21.928571,17.461538,80,1216,1217,-1,1,0,0.071429,0,7,14,13,4.857143,0,0,12,8,false,true,true,0.995,0.005
225,158,67,18.75,14.363636,67,1281,1339,-58,0,0,0,0,36,12,11,1.138889,0,0,20,7,false,true,true,0.955,0.045
85,111,-26,17,27.75,-26,613,611,2,0,0,0,0,65,5,4,0.584615,0,0,7,13,false,true,false,0.118,0.882
143,138,5,14.3,15.333333,5,1214,1176,38,0,0,0,0,44,10,9,0.818182,0,0,8,21,false,true,false,0.109,0.891
360,279,81,24,18.6,81,1127,1075,52,1,1,0.066667,0.066667,-10,15,15,-3.1,0,1,6,2,false,true,true,1,0
188,209,-21,15.666667,17.416667,-21,719,614,105,0,1,0,0.083333,19,12,12,2.263158,0,0,13,11,false,true,true,0.683,0.317
140,121,19,20,20.166667,19,1297,1606,-309,0,0,0,0,55,7,6,0.545455,2,0,10,25,false,true,true,0.665,0.335
114,129,-15,22.8,25.8,-15,1406,1454,-48,0,1,0,0.2,57,5,5,0.596491,1,0,7,10,false,true,true,0.721,0.279
105,62,43,17.5,12.4,43,786,847,-61,0,0,0,0,64,6,5,0.53125,0,1,12,8,false,true,false,0.478,0.522
379,288,91,23.6875,18,91,769,527,242,1,0,0.0625,0,-17,16,16,-2.117647,0,0,4,3,false,true,true,1,0
79,41,38,19.75,13.666667,38,1164,1201,-37,0,0,0,0,74,4,3,0.567568,0,1,11,13,false,true,false,0.404,0.596
106,54,52,35.333333,18,52,918,619,299,1,0,0.333333,0,76,3,3,0.460526,0,0,10,13,false,true,true,0.884,0.116
292,145,147,26.545455,14.5,147,778,758,20,0,1,0,0.1,17,11,10,2.294118,1,0,9,12,false,true,true,1,0
288,264,24,16,14.666667,24,808,812,-4,0,0,0,0,-19,18,18,-1.947368,1,0,6,1,false,true,true,0.946,0.054
264,142,122,33,20.285714,122,630,786,-156,1,0,0.125,0,43,8,7,0.813953,0,0,10,23,false,true,true,0.999,0.001
338,378,-40,24.142857,27,-40,834,844,-10,1,2,0.071429,0.142857,-11,14,14,-3.272727,0,0,6,9,false,true,false,0.09,0.91
321,248,73,16.894737,13.052632,73,272,288,-16,0,0,0,0,-2,19,19,-26,0,0,10,7,false,true,true,1,0
319,231,88,29,23.1,88,1004,840,164,1,0,0.090909,0,10,11,10,3,0,0,18,13,false,true,true,0.998,0.002
397,313,84,26.466667,22.357143,84,1349,1302,47,0,0,0,0,-10,15,14,-2.9,0,0,11,2,true,true,true,1,0
0,0,0,0,0,0,416,374,42,0,0,0,0,100,1,0,0.46,0,0,0,0,false,true,false,0.294,0.706
30,0,30,30,0,30,1826,1656,170,0,0,0,0,95,1,0,0.284211,0,0,11,0,false,true,true,0.678,0.322
241,245,-4,16.066667,16.333333,-4,628,658,-30,0,0,0,0,12,15,15,3.833333,0,0,14,8,false,true,false,0.455,0.545
148,120,28,24.666667,20,28,1501,1622,-121,0,0,0,0,59,6,6,0.525424,0,0,11,19,false,true,false,0.271,0.729
102,56,46,25.5,18.666667,46,939,907,32,0,0,0,0,77,4,3,0.519481,0,0,20,13,false,true,true,0.872,0.128
242,237,5,20.166667,19.75,5,804,988,-184,1,0,0.083333,0,16,12,12,2.0625,1,0,6,14,false,true,false,0.413,0.587
227,197,30,16.214286,15.153846,30,613,502,111,0,0,0,0,9,14,13,5.444444,1,1,7,18,false,true,true,0.527,0.473
78,118,-40,15.6,29.5,-40,1077,1094,-17,0,0,0,0,68,5,4,0.617647,0,0,28,14,false,true,false,0.121,0.879
372,321,51,23.25,20.0625,51,901,1159,-258,2,0,0.125,0,-14,16,16,-2.5,0,0,14,4,false,true,true,0.999,0.001
333,212,121,25.615385,16.307692,121,1651,1691,-40,1,0,0.076923,0,14,13,13,2.428571,1,0,6,10,false,true,true,1,0
170,110,60,28.333333,22,60,1493,1513,-20,1,0,0.166667,0,62,6,5,0.532258,0,1,8,6,false,true,true,0.527,0.473
46,37,9,23,18.5,9,1691,1692,-1,0,0,0,0,82,2,2,0.365854,0,0,8,7,false,true,false,0.463,0.537
136,91,45,15.111111,10.111111,45,584,565,19,0,0,0,0,43,9,9,1.069767,1,0,12,18,false,true,true,0.93,0.07
367,262,105,26.214286,20.153846,105,1394,1118,276,0,1,0,0.076923,5,14,13,7.4,0,0,18,10,false,true,true,1,0
304,264,40,21.714286,20.307692,40,1115,1078,37,0,1,0,0.076923,8,14,13,4.25,1,0,6,19,false,true,true,0.994,0.006
273,234,39,19.5,16.714286,39,1040,925,115,0,0,0,0,0,14,14,0,1,0,9,12,false,true,true,0.97,0.03
330,326,4,22,21.733333,4,974,995,-21,0,1,0,0.066667,-6,15,15,-5.5,0,0,11,1,false,true,true,0.803,0.197
140,69,71,35,23,71,996,1063,-67,1,1,0.25,0.333333,67,4,3,0.477612,0,0,12,7,false,true,true,0.957,0.043
34,25,9,11.333333,12.5,9,856,897,-41,0,0,0,0,80,3,2,0.4375,1,0,11,7,false,true,true,0.502,0.498
267,118,149,22.25,9.833333,149,993,897,96,1,0,0.083333,0,18,12,12,2.611111,0,0,14,21,false,true,true,1,0
171,227,-56,15.545455,20.636364,-56,95,360,-265,0,1,0,0.090909,18,11,11,2.222222,0,0,14,7,false,true,false,0.036,0.964
28,0,28,28,0,28,2219,2029,190,0,0,0,0,97,1,0,0.268041,1,0,10,0,false,true,true,0.996,0.004
89,86,3,22.25,28.666667,3,1710,1636,74,0,0,0,0,76,4,3,0.473684,0,0,7,12,false,true,false,0.191,0.809
90,78,12,22.5,19.5,12,1101,1078,23,0,0,0,0,72,4,4,0.458333,0,1,12,19,false,true,false,0.33,0.67
385,274,111,29.615385,22.833333,111,1189,1266,-77,1,0,0.076923,0,3,13,12,11.333333,0,0,19,11,false,true,true,1,0
332,166,166,30.181818,15.090909,166,1211,1173,38,0,0,0,0,28,11,11,1.25,0,1,8,10,false,true,true,1,0
32,76,-44,10.666667,25.333333,-44,1305,1242,63,0,0,0,0,82,3,3,0.414634,0,1,8,13,false,true,false,0.115,0.885
255,145,110,36.428571,24.166667,110,1397,1361,36,1,0,0.142857,0,45,7,6,0.644444,0,0,11,10,false,true,true,0.996,0.004
348,311,37,20.470588,18.294118,37,1513,1479,34,0,0,0,0,-14,17,17,-2.428571,0,0,1,3,true,true,true,0.998,0.002
226,104,122,22.6,11.555556,122,719,651,68,0,0,0,0,51,10,9,0.882353,0,0,12,8,false,true,true,0.996,0.004
188,164,24,15.666667,14.909091,24,540,518,22,0,0,0,0,26,12,11,1.538462,0,0,11,14,false,true,true,0.667,0.333
244,174,70,24.4,19.333333,70,976,965,11,1,0,0.1,0,26,10,9,1.230769,0,1,11,20,false,true,true,0.923,0.077
328,220,108,29.818182,22,108,1397,1361,36,1,0,0.090909,0,15,11,10,1.933333,1,0,15,13,false,true,true,1,0
255,265,-10,25.5,29.444444,-10,1762,1538,224,1,2,0.1,0.222222,28,10,9,1.214286,0,0,8,11,false,true,true,0.972,0.028
278,307,-29,14.631579,16.157895,-29,999,1011,-12,0,0,0,0,-21,19,19,-2.190476,1,0,9,7,false,true,false,0.331,0.669
115,114,1,16.428571,16.285714,1,527,514,13,0,0,0,0,48,7,7,0.8125,0,1,17,21,false,true,false,0.267,0.733
50,40,10,25,20,10,1014,948,66,0,0,0,0,84,2,2,0.392857,1,1,9,14,false,true,true,0.522,0.478
221,187,34,20.090909,18.7,34,838,786,52,0,1,0,0.1,30,11,10,1.066667,1,0,15,12,false,true,true,0.979,0.021
86,79,7,17.2,15.8,7,371,435,-64,0,0,0,0,59,5,5,0.745763,0,0,12,14,false,true,true,0.55,0.45
61,88,-27,15.25,22,-27,95,360,-265,0,1,0,0.25,65,4,4,0.615385,0,0,12,9,false,true,false,0.398,0.602
245,237,8,22.272727,23.7,8,1142,1176,-34,1,0,0.090909,0,25,11,10,1.44,1,0,28,9,false,true,true,0.555,0.445
358,270,88,22.375,18,88,613,569,44,0,0,0,0,-6,16,15,-6.5,0,0,3,8,false,true,true,1,0
103,95,8,14.714286,15.833333,8,1047,1094,-47,0,0,0,0,58,7,6,0.62069,0,1,8,10,false,true,false,0.245,0.755
36,6,30,18,6,30,965,1013,-48,0,0,0,0,90,2,1,0.366667,0,0,16,15,false,true,true,0.521,0.479
205,128,77,20.5,14.222222,77,566,542,24,0,0,0,0,35,10,9,1.171429,0,1,21,8,false,true,true,0.992,0.008
24,0,24,24,0,24,272,238,34,0,0,0,0,96,1,0,0.416667,1,0,8,0,false,true,true,0.621,0.379
32,15,17,32,15,17,1295,1281,14,0,0,0,0,92,1,1,0.413043,0,0,20,10,false,true,true,0.548,0.452
234,255,-21,16.714286,19.615385,-21,316,306,10,0,2,0,0.153846,8,14,13,4.75,0,0,13,22,false,true,false,0.098,0.902
337,313,24,16.047619,14.904762,24,719,614,105,0,1,0,0.047619,-33,21,21,-1.30303,0,0,2,2,false,true,true,0.954,0.046
22,11,11,22,11,11,1022,1095,-73,0,0,0,0,93,1,1,0.354839,0,0,20,10,false,true,true,0.526,0.474
314,287,27,16.526316,15.105263,27,859,822,37,0,0,0,0,-22,19,19,-1.727273,2,0,2,4,true,true,true,0.997,0.003
221,165,56,24.555556,20.625,56,1170,1156,14,1,0,0.111111,0,38,9,8,1,1,0,7,18,false,true,true,0.901,0.099
255,198,57,28.333333,24.75,57,965,1013,-48,1,0,0.111111,0,32,9,8,1.03125,0,1,13,9,false,true,true,0.856,0.144
35,18,17,17.5,9,17,527,581,-54,0,0,0,0,87,2,2,0.482759,1,0,14,7,false,true,true,0.546,0.454
179,214,-35,19.888889,23.777778,-35,869,820,49,0,1,0,0.111111,44,9,9,0.840909,0,1,10,8,false,true,false,0.037,0.963
56,30,26,28,15,26,1408,1454,-46,0,0,0,0,85,2,2,0.376471,2,0,5,22,false,true,true,0.89,0.11
380,351,29,25.333333,25.071429,29,1030,1144,-114,0,2,0,0.142857,-3,15,14,-11.666667,1,0,13,8,false,true,true,0.998,0.002
408,319,89,20.4,16.789474,89,1075,1152,-77,0,1,0,0.052632,-26,20,19,-1.538462,0,0,2,3,false,true,true,1,0
54,70,-16,18,23.333333,-16,1237,1277,-40,0,0,0,0,75,3,3,0.386667,0,0,8,24,false,true,false,0.116,0.884
233,80,153,23.3,8.888889,153,1067,95,972,0,0,0,0,42,10,9,0.809524,0,0,22,7,false,true,true,1,0
74,84,-10,18.5,21,-10,1073,1177,-104,0,0,0,0,75,4,4,0.426667,0,1,20,19,false,true,false,0.113,0.887
221,193,28,27.625,27.571429,28,416,282,134,1,0,0.125,0,44,8,7,0.772727,0,0,7,9,false,true,true,0.733,0.267
360,306,54,25.714286,23.538462,54,1154,1062,92,2,0,0.142857,0,8,14,13,4.375,0,0,10,7,false,true,true,0.975,0.025
160,126,34,20,15.75,34,1037,950,87,1,0,0.125,0,47,8,8,0.659574,0,0,10,9,false,true,true,0.898,0.102
354,320,34,22.125,20,34,1397,1422,-25,3,1,0.1875,0.0625,1,16,16,36,0,0,11,16,false,true,true,0.933,0.067
246,166,80,35.142857,27.666667,80,1770,1689,81,0,0,0,0,39,7,6,0.666667,0,1,10,7,false,true,true,0.795,0.205
286,179,107,15.888889,10.529412,107,1428,1302,126,0,0,0,0,-7,18,17,-7.571429,0,1,11,17,false,true,true,0.998,0.002
136,152,-16,17,21.714286,-16,1100,1008,92,0,0,0,0,53,8,7,0.679245,2,0,5,9,false,true,true,0.727,0.273
351,255,96,20.647059,15,96,1055,1050,5,0,0,0,0,-9,17,17,-3.777778,1,0,2,1,true,true,true,1,0
316,316,0,21.066667,21.066667,0,786,976,-190,0,0,0,0,-8,15,15,-4,0,0,4,2,false,true,true,0.65,0.35
192,201,-9,21.333333,25.125,-9,290,416,-126,0,0,0,0,41,9,8,0.829268,0,0,17,12,false,true,true,0.6,0.4
370,329,41,24.666667,21.933333,41,1142,1176,-34,1,0,0.066667,0,-1,15,15,-36,1,0,4,9,false,true,true,0.999,0.001
276,276,0,30.666667,34.5,0,1489,1558,-69,0,1,0,0.125,31,9,8,0.903226,0,0,14,10,false,true,true,0.659,0.341
34,0,34,17,0,34,801,925,-124,1,0,0.5,0,88,2,1,0.397727,1,0,6,9,false,true,true,0.758,0.242
279,238,41,17.4375,14.875,41,1583,1422,161,1,0,0.0625,0,21,16,16,2.428571,0,0,9,15,false,true,true,0.947,0.053
328,258,70,21.866667,18.428571,70,1004,653,351,0,0,0,0,-12,15,14,-2.916667,0,0,8,6,false,true,true,1,0
77,34,43,25.666667,17,43,1034,1040,-6,0,0,0,0,83,3,2,0.421687,0,0,25,10,false,true,true,0.841,0.159
334,271,63,20.875,18.066667,63,948,933,15,1,0,0.0625,0,9,16,15,4.222222,0,0,8,7,false,true,true,0.99,0.01
220,180,40,20,18,40,1227,1060,167,0,1,0,0.1,30,11,10,1.333333,0,0,11,16,false,true,true,0.582,0.418
163,176,-13,20.375,22,-13,995,912,83,1,0,0.125,0,53,8,8,0.830189,1,0,11,8,false,true,true,0.527,0.473
168,82,86,24,13.666667,86,1550,1546,4,0,0,0,0,59,7,6,0.508475,1,0,13,16,false,true,true,0.976,0.024
353,257,96,44.125,36.714286,96,1983,2020,-37,2,1,0.25,0.142857,27,8,7,0.962963,0,0,12,26,false,true,true,1,0
108,140,-32,15.428571,20,-32,999,1011,-12,0,0,0,0,53,7,7,0.867925,0,0,12,15,false,true,false,0.108,0.892
125,117,8,31.25,39,8,1434,1493,-59,1,0,0.25,0,63,4,3,0.587302,0,0,25,11,false,true,false,0.286,0.714
352,369,-17,22,23.0625,-17,1762,1538,224,1,2,0.0625,0.125,-11,16,16,-3.090909,0,0,1,2,false,true,true,0.924,0.076
232,213,19,25.777778,23.666667,19,1297,1606,-309,1,0,0.111111,0,33,9,9,0.909091,0,0,10,7,false,true,false,0.427,0.573
147,158,-11,21,22.571429,-11,1189,1266,-77,0,0,0,0,51,7,7,0.666667,1,0,9,13,false,true,false,0.372,0.628
108,101,7,21.6,20.2,7,859,786,73,0,0,0,0,65,5,5,0.584615,0,0,23,7,false,true,true,0.803,0.197
245,168,77,17.5,12,77,498,43,455,0,0,0,0,7,14,14,5.285714,0,0,10,19,false,true,true,0.992,0.008
404,226,178,20.2,11.3,178,1033,1037,-4,0,1,0,0.05,-20,20,20,-2.25,0,1,2,2,false,true,true,1,0
123,68,55,20.5,13.6,55,791,774,17,1,0,0.166667,0,70,6,5,0.585714,0,0,9,16,false,true,true,0.881,0.119
255,235,20,21.25,21.363636,20,1277,1166,111,0,1,0,0.090909,17,12,11,2.117647,0,0,17,17,false,true,true,0.566,0.434
59,71,-12,19.666667,23.666667,-12,1539,1537,2,0,0,0,0,82,3,3,0.390244,0,0,9,16,false,true,false,0.125,0.875
213,129,84,21.3,14.333333,84,561,526,35,0,0,0,0,23,10,9,1.521739,0,0,10,11,false,true,true,0.982,0.018
70,64,6,17.5,16,6,1089,1063,26,0,0,0,0,77,4,4,0.493506,1,0,12,19,false,true,true,0.696,0.304
175,138,37,17.5,15.333333,37,872,818,54,0,1,0,0.111111,42,10,9,0.97619,0,0,9,8,false,true,true,0.965,0.035
46,58,-12,11.5,19.333333,-12,1221,1438,-217,0,0,0,0,79,4,3,0.56962,0,0,19,10,false,true,false,0.166,0.834
47,48,-1,9.4,12,-1,416,374,42,0,0,0,0,79,5,4,0.582278,1,0,12,16,false,true,false,0.433,0.567
126,81,45,21,13.5,45,609,620,-11,0,0,0,0,60,6,6,0.616667,0,0,9,14,false,true,true,0.882,0.118
40,20,20,20,20,20,500,567,-67,0,0,0,0,89,2,1,0.494382,0,0,12,19,false,true,false,0.322,0.678
264,278,-14,18.857143,19.857143,-14,518,448,70,0,0,0,0,3,14,14,11.333333,0,0,8,14,false,true,false,0.372,0.628
38,82,-44,12.666667,27.333333,-44,1161,1166,-5,0,0,0,0,78,3,3,0.448718,0,0,7,8,false,true,false,0.109,0.891
196,56,140,39.2,14,140,1320,1339,-19,2,0,0.4,0,63,5,4,0.619048,0,0,9,8,false,true,true,0.989,0.011
333,319,14,17.526316,16.789474,14,1159,1051,108,0,0,0,0,-22,19,19,-1.818182,0,0,3,1,false,true,true,0.944,0.056
353,304,49,25.214286,21.714286,49,856,897,-41,0,1,0,0.071429,-7,14,14,-5,0,0,11,7,false,true,true,0.999,0.001
271,253,18,18.066667,16.866667,18,334,446,-112,0,0,0,0,-7,15,15,-5.714286,0,1,8,11,false,true,true,0.929,0.071
307,294,13,21.928571,21,13,795,830,-35,1,1,0.071429,0.071429,1,14,14,42,0,0,16,13,false,true,true,0.768,0.232
344,175,169,18.105263,9.210526,169,1176,1076,100,0,0,0,0,18,19,19,3.277778,0,0,9,14,false,true,true,1,0
0,14,-14,0,14,-14,786,847,-61,0,0,0,0,96,1,1,0.354167,0,1,8,9,false,true,false,0.246,0.754
76,72,4,15.2,18,4,272,238,34,0,0,0,0,64,5,4,0.625,0,0,22,19,false,true,true,0.633,0.367
315,131,184,35,16.375,184,1439,1353,86,1,0,0.111111,0,35,9,8,0.857143,0,0,7,10,false,true,true,1,0
282,187,95,28.2,18.7,95,769,527,242,1,0,0.1,0,21,10,10,1.714286,1,0,10,9,false,true,true,0.999,0.001
69,78,-9,13.8,19.5,-9,576,494,82,0,0,0,0,73,5,4,0.60274,0,0,10,14,false,true,false,0.177,0.823
302,254,48,15.894737,13.368421,48,698,742,-44,1,0,0.052632,0,-8,19,19,-5.125,0,0,7,3,false,true,true,0.989,0.011
406,323,83,25.375,21.533333,83,1075,1027,48,2,1,0.125,0.066667,-16,16,15,-2.3125,0,0,5,4,false,true,true,0.999,0.001
381,314,67,21.166667,18.470588,67,1482,1394,88,2,0,0.111111,0,-18,18,17,-2,0,0,2,2,false,true,true,1,0
352,273,79,27.076923,21,79,1203,1221,-18,2,0,0.153846,0,15,13,13,2.333333,0,0,7,9,false,true,true,1,0
74,48,26,18.5,16,26,1073,1177,-104,0,0,0,0,78,4,3,0.410256,0,1,20,25,false,true,false,0.136,0.864
266,236,30,26.6,23.6,30,1093,1100,-7,2,2,0.2,0.2,32,10,10,1,0,0,11,9,false,true,true,0.95,0.05
147,21,126,49,10.5,126,1396,1454,-58,1,0,0.333333,0,79,3,2,0.417722,0,0,11,7,false,true,true,0.976,0.024
233,199,34,25.888889,24.875,34,1670,1770,-100,1,1,0.111111,0.125,42,9,8,0.761905,0,0,10,8,false,true,true,0.812,0.188
350,330,20,23.333333,23.571429,20,1023,1110,-87,1,1,0.066667,0.071429,-18,15,14,-1.666667,0,0,3,1,false,true,true,0.995,0.005
302,297,5,18.875,18.5625,5,527,514,13,0,0,0,0,-10,16,16,-3.9,0,0,8,3,false,true,true,0.686,0.314
345,264,81,19.166667,14.666667,81,1606,1544,62,0,0,0,0,-4,18,18,-11.25,0,0,10,6,false,true,true,1,0
373,233,140,20.722222,12.944444,140,786,757,29,1,0,0.055556,0,-14,18,18,-2.785714,0,0,20,4,false,true,true,1,0
258,180,78,28.666667,22.5,78,1093,1100,-7,2,2,0.222222,0.25,41,9,8,0.780488,0,0,8,21,false,true,true,0.956,0.044
306,252,54,27.818182,22.909091,54,1203,1221,-18,2,0,0.181818,0,27,11,11,1.296296,0,0,19,7,false,true,true,0.945,0.055
20,11,9,20,11,9,771,754,17,0,0,0,0,93,1,1,0.344086,0,0,10,9,false,true,true,0.529,0.471
185,123,62,30.833333,20.5,62,820,783,37,0,0,0,0,55,6,6,0.6,1,0,10,10,false,true,true,0.992,0.008
100,110,-10,16.666667,22,-10,1885,1846,39,0,1,0,0.2,51,6,5,0.568627,1,0,11,14,false,true,true,0.593,0.407
90,79,11,18,19.75,11,1142,1176,-34,0,0,0,0,67,5,4,0.537313,1,0,11,7,false,true,false,0.491,0.509
281,190,91,25.545455,19,91,1050,1144,-94,0,1,0,0.1,32,11,10,1.1875,1,0,10,9,false,true,true,0.996,0.004
246,159,87,20.5,14.454545,87,1091,1078,13,0,0,0,0,35,12,11,1.228571,0,0,10,8,false,true,true,0.98,0.02
43,65,-22,14.333333,32.5,-22,416,306,110,0,0,0,0,84,3,2,0.5,0,0,23,10,false,true,false,0.288,0.712
212,173,39,19.272727,15.727273,39,804,683,121,0,0,0,0,29,11,11,1.551724,0,1,20,9,false,true,true,0.982,0.018
42,14,28,21,14,28,1636,1576,60,0,1,0,1,86,2,1,0.395349,0,1,10,8,false,true,true,0.999,0.001
61,91,-30,12.2,18.2,-30,778,758,20,0,0,0,0,63,5,5,0.619048,0,0,21,7,false,true,false,0.269,0.731
245,236,9,14.411765,14.75,9,480,518,-38,0,0,0,0,2,17,16,23,1,0,6,16,false,true,true,0.692,0.308
103,72,31,25.75,18,31,306,169,137,0,0,0,0,70,4,4,0.485714,0,1,11,12,false,true,true,0.99,0.01
18,11,7,9,11,7,1154,1062,92,0,0,0,0,93,2,1,0.376344,0,0,7,18,false,true,false,0.208,0.792
57,23,34,19,11.5,34,1045,1009,36,0,0,0,0,84,3,2,0.452381,0,0,10,15,false,true,true,0.525,0.475
248,223,25,24.8,22.3,25,1153,1065,88,0,1,0,0.1,11,10,10,2.545455,1,0,9,17,false,true,true,0.855,0.145
205,121,84,25.625,15.125,84,1216,1230,-14,1,0,0.125,0,47,8,8,0.680851,1,0,15,9,false,true,true,0.991,0.009
20,18,2,20,18,2,1047,1094,-47,0,0,0,0,93,1,1,0.387097,0,0,13,19,false,true,false,0.282,0.718
26,0,26,26,0,26,1004,840,164,0,0,0,0,94,1,0,0.319149,1,0,10,0,false,true,true,0.742,0.258
287,204,83,31.888889,25.5,83,1826,1656,170,2,0,0.222222,0,27,9,8,1,1,0,11,10,false,true,true,0.997,0.003
127,132,-5,21.166667,22,-5,1040,925,115,0,0,0,0,59,6,6,0.728814,1,0,22,9,false,true,true,0.843,0.157
23,66,-43,11.5,33,-43,505,95,410,0,1,0,0.5,88,2,2,0.5,0,0,17,12,false,true,true,0.559,0.441
354,326,28,16.857143,15.52381,28,1388,1477,-89,1,0,0.047619,0,-26,21,21,-1.846154,0,0,3,7,false,true,true,0.998,0.002
285,211,74,28.5,23.444444,74,992,1100,-108,2,0,0.2,0,27,10,9,1.259259,0,0,7,9,false,true,true,0.99,0.01
254,173,81,23.090909,17.3,81,825,907,-82,1,0,0.090909,0,26,11,10,1.538462,0,0,23,20,false,true,true,0.941,0.059
131,164,-33,18.714286,27.333333,-33,1076,1176,-100,0,1,0,0.166667,52,7,6,0.615385,0,1,21,15,false,true,false,0.106,0.894
230,182,48,15.333333,13,48,218,86,132,0,0,0,0,0,15,14,0,0,0,22,13,false,true,true,0.946,0.054
234,186,48,26,23.25,48,1101,1078,23,0,0,0,0,40,9,8,0.825,0,1,8,7,false,true,true,0.962,0.038
145,85,60,18.125,12.142857,60,954,1078,-124,0,1,0,0.142857,46,8,7,0.826087,1,0,14,12,false,true,true,0.913,0.087
226,179,47,16.142857,13.769231,47,871,999,-128,0,0,0,0,19,14,13,2.526316,0,0,7,19,false,true,true,0.573,0.427
49,27,22,16.333333,13.5,22,620,658,-38,0,0,0,0,82,3,2,0.439024,1,0,7,10,false,true,true,0.523,0.477
326,290,36,25.076923,22.307692,36,1670,1770,-100,1,1,0.076923,0.076923,2,13,13,16,0,1,9,6,false,true,true,0.875,0.125
111,90,21,22.2,22.5,21,804,988,-184,1,0,0.2,0,65,5,4,0.507692,0,0,10,26,false,true,false,0.218,0.782
351,317,34,21.9375,19.8125,34,1022,1095,-73,0,1,0,0.0625,-18,16,16,-1.833333,0,0,2,4,false,true,true,0.999,0.001
354,354,0,25.285714,25.285714,0,1265,1237,28,1,0,0.071429,0,-8,14,14,-3.75,0,0,4,7,false,true,true,0.958,0.042
14,12,2,14,12,2,739,480,259,0,0,0,0,92,1,1,0.391304,0,0,14,17,false,true,false,0.346,0.654
157,120,37,22.428571,20,37,1501,1622,-121,0,0,0,0,55,7,6,0.563636,1,0,7,19,false,true,true,0.712,0.288
251,240,11,16.733333,17.142857,11,613,549,64,0,0,0,0,5,15,14,8.8,1,0,13,8,false,true,true,0.859,0.141
105,64,41,21,16,41,739,480,259,1,0,0.2,0,64,5,4,0.5625,0,0,10,14,false,true,true,0.791,0.209
445,416,29,27.8125,27.733333,29,1897,1793,104,2,3,0.125,0.2,-4,16,15,-8,0,0,2,3,false,true,true,0.99,0.01
285,234,51,25.909091,23.4,51,992,1100,-108,2,0,0.181818,0,23,11,10,1.478261,0,0,14,13,false,true,true,0.805,0.195
68,67,1,13.6,16.75,1,1221,1438,-217,0,0,0,0,74,5,4,0.608108,0,1,22,9,false,true,false,0.245,0.755
254,231,23,19.538462,19.25,23,947,810,137,0,1,0,0.083333,19,13,12,2.210526,1,0,7,15,false,true,true,0.898,0.102
291,253,38,20.785714,19.461538,38,1027,856,171,1,1,0.071429,0.076923,-6,14,13,-5.5,0,0,17,9,false,true,true,0.91,0.09
289,265,24,19.266667,17.666667,24,1572,1550,22,1,0,0.066667,0,4,15,15,9.75,1,1,8,8,false,true,false,0.311,0.689
212,180,32,19.272727,16.363636,32,859,786,73,0,0,0,0,24,11,11,1.583333,0,0,24,12,false,true,true,0.789,0.211
213,132,81,23.666667,16.5,81,1022,1095,-73,0,0,0,0,40,9,8,0.825,0,0,16,12,false,true,true,0.92,0.08
264,216,48,20.307692,16.615385,48,505,95,410,0,1,0,0.076923,25,13,13,1.76,0,0,7,9,false,true,true,0.994,0.006
192,179,13,17.454545,16.272727,13,613,461,152,0,1,0,0.090909,17,11,11,2.176471,0,0,11,15,false,true,true,0.875,0.125
114,93,21,19,15.5,21,613,502,111,0,0,0,0,55,6,6,0.890909,0,0,12,16,false,true,true,0.739,0.261
342,293,49,20.117647,18.3125,49,825,907,-82,1,0,0.058824,0,-6,17,16,-6.666667,0,0,5,15,false,true,true,0.998,0.002
344,174,170,22.933333,12.428571,170,1413,1422,-9,0,0,0,0,13,15,14,4.384615,0,0,9,13,false,true,true,1,0
427,170,257,30.5,12.142857,257,1054,917,137,2,0,0.142857,0,-9,14,14,-3.888889,0,0,13,10,false,true,true,1,0
142,85,57,23.666667,17,57,1439,1397,42,0,1,0,0.2,58,6,5,0.586207,0,0,8,14,false,true,true,0.91,0.09
432,342,90,24,19,90,1397,1422,-25,4,1,0.222222,0.055556,-12,18,18,-3,0,0,8,14,true,true,true,1,0
137,103,34,19.571429,14.714286,34,620,658,-38,0,0,0,0,51,7,7,0.705882,0,0,23,10,false,true,true,0.877,0.123
121,144,-23,17.285714,20.571429,-23,916,876,40,0,0,0,0,45,7,7,0.755556,1,0,13,9,false,true,true,0.507,0.493
306,158,148,21.857143,11.285714,148,942,1003,-61,0,0,0,0,9,14,14,5,1,1,19,15,false,true,true,1,0
233,192,41,21.181818,17.454545,41,1394,1230,164,0,1,0,0.090909,23,11,11,1.652174,0,1,7,20,false,true,false,0.495,0.505
149,124,25,29.8,24.8,25,1762,1616,146,1,0,0.2,0,56,5,5,0.535714,0,0,7,11,false,true,true,0.501,0.499
450,308,142,23.684211,17.111111,142,1167,1216,-49,1,0,0.052632,0,-11,19,18,-3.727273,0,0,1,3,false,true,true,1,0
124,101,23,20.666667,20.2,23,872,818,54,0,1,0,0.2,60,6,5,0.683333,0,0,9,10,false,true,true,0.87,0.13
310,257,53,18.235294,16.0625,53,671,725,-54,0,0,0,0,-12,17,16,-3.083333,0,0,8,3,false,true,true,0.999,0.001
332,252,80,18.444444,14.823529,80,695,523,172,0,0,0,0,-17,18,17,-2.176471,0,0,1,7,false,true,true,1,0
229,190,39,20.818182,19,39,1334,1270,64,1,0,0.090909,0,34,11,10,1.088235,1,0,13,9,false,true,true,0.895,0.105
191,167,24,23.875,20.875,24,1493,1513,-20,1,0,0.125,0,45,8,8,0.733333,0,1,17,17,false,true,false,0.333,0.667
225,236,-11,28.125,29.5,-11,1256,1232,24,1,0,0.125,0,38,8,8,0.789474,0,0,13,19,false,true,true,0.639,0.361
224,203,21,17.230769,16.916667,21,695,523,172,0,0,0,0,9,13,12,4.111111,0,0,20,24,false,true,true,0.737,0.263
378,310,68,18.9,15.5,68,880,952,-72,0,0,0,0,-28,20,20,-1.464286,0,0,1,1,false,true,true,1,0
340,320,20,30.909091,29.090909,20,1489,1558,-69,0,1,0,0.090909,9,11,11,3.111111,0,0,17,15,false,true,true,0.781,0.219
58,23,35,19.333333,11.5,35,272,288,-16,0,0,0,0,83,3,2,0.626506,1,0,13,9,false,true,true,0.584,0.416
47,55,-8,23.5,27.5,-8,758,796,-38,0,0,0,0,84,2,2,0.452381,1,0,9,11,false,true,true,0.559,0.441
308,259,49,19.25,16.1875,49,1040,925,115,0,0,0,0,-13,16,16,-3.307692,0,0,16,12,false,true,true,0.991,0.009
98,69,29,32.666667,23,29,1256,1232,24,1,0,0.333333,0,73,3,3,0.410959,0,1,17,12,false,true,true,0.53,0.47
90,91,-1,22.5,22.75,-1,711,876,-165,0,0,0,0,69,4,4,0.623188,0,0,8,9,false,true,false,0.27,0.73
135,152,-17,22.5,25.333333,-17,1355,1210,145,0,0,0,0,57,6,6,0.526316,1,0,17,12,false,true,true,0.85,0.15
345,289,56,19.166667,16.055556,56,691,675,16,0,0,0,0,-17,18,18,-2.176471,0,0,1,1,false,true,true,1,0
378,284,94,17.181818,13.52381,94,719,651,68,0,1,0,0.047619,-29,22,21,-1.551724,0,0,1,1,false,true,true,1,0
176,112,64,25.142857,18.666667,64,691,675,16,0,0,0,0,55,7,6,0.672727,0,1,13,7,false,true,true,0.992,0.008
311,158,153,20.733333,11.285714,153,942,1003,-61,0,0,0,0,5,15,14,9,1,1,21,15,false,true,true,1,0
82,38,44,27.333333,19,44,704,691,13,0,0,0,0,82,3,2,0.463415,0,0,14,7,false,true,true,0.872,0.128
321,313,8,20.0625,19.5625,8,1244,1361,-117,2,1,0.125,0.0625,5,16,16,7.6,0,0,11,14,false,true,false,0.282,0.718
30,14,16,15,14,16,1334,1256,78,0,0,0,0,90,2,1,0.344444,1,0,10,15,false,true,true,0.806,0.194
245,120,125,22.272727,12,125,786,757,29,1,0,0.090909,0,31,11,10,1.258065,0,0,11,17,false,true,true,0.999,0.001
225,221,4,16.071429,15.785714,4,272,238,34,0,0,0,0,3,14,14,13.333333,0,0,22,7,false,true,true,0.759,0.241
96,110,-14,16,18.333333,-14,361,493,-132,0,0,0,0,56,6,6,0.732143,0,0,18,17,false,true,false,0.381,0.619
72,61,11,18,20.333333,11,864,808,56,0,0,0,0,72,4,3,0.472222,0,0,8,11,false,true,false,0.379,0.621
309,304,5,14.714286,15.2,5,576,494,82,0,0,0,0,-23,21,20,-1.913043,0,0,2,4,false,true,false,0.268,0.732
157,110,47,31.4,22,47,1762,1582,180,1,1,0.2,0.2,64,5,5,0.5,0,0,21,12,false,true,true,0.941,0.059
136,127,9,17,15.875,9,691,675,16,0,0,0,0,43,8,8,0.883721,0,0,14,12,false,true,true,0.7,0.3
291,250,41,20.785714,17.857143,41,1548,1493,55,1,0,0.071429,0,6,14,14,6.833333,0,0,7,18,false,true,true,0.96,0.04
358,313,45,27.538462,26.083333,45,1762,1582,180,2,3,0.153846,0.25,-2,13,12,-16,0,0,3,24,false,true,true,0.985,0.015
172,116,56,17.2,12.888889,56,346,231,115,0,0,0,0,24,10,9,1.708333,0,0,10,11,false,true,true,0.941,0.059
77,66,11,25.666667,22,11,880,952,-72,0,0,0,0,79,3,3,0.443038,0,1,21,6,false,true,true,0.521,0.479
82,14,68,41,14,68,1439,1353,86,1,0,0.5,0,85,2,1,0.352941,0,0,11,7,false,true,true,0.529,0.471
139,85,54,23.166667,14.166667,54,576,532,44,0,0,0,0,59,6,6,0.779661,1,0,16,8,false,true,true,0.97,0.03
39,31,8,13,15.5,8,801,807,-6,0,0,0,0,81,3,2,0.432099,0,0,10,17,false,true,false,0.215,0.785
212,170,42,19.272727,17,42,859,786,73,0,0,0,0,26,11,10,1.461538,0,0,24,7,false,true,true,0.878,0.122
233,148,85,21.181818,14.8,85,939,913,26,0,1,0,0.1,26,11,10,1.538462,0,0,7,14,false,true,true,0.987,0.013
401,235,166,30.846154,19.583333,166,1501,1622,-121,2,0,0.153846,0,6,13,12,5.166667,0,0,15,8,false,true,true,1,0
299,269,30,14.95,14.157895,30,613,502,111,0,0,0,0,-26,20,19,-1.884615,0,0,5,15,false,true,true,0.996,0.004
84,71,13,16.8,17.75,13,468,542,-74,0,0,0,0,74,5,4,0.527027,0,0,18,10,false,true,true,0.548,0.452
394,268,126,23.176471,15.764706,126,939,907,32,1,0,0.058824,0,-12,17,17,-3.333333,0,0,3,1,false,true,true,1,0
24,65,-41,8,21.666667,-41,1334,1270,64,0,0,0,0,81,3,3,0.45679,0,0,11,14,false,true,false,0.107,0.893
201,162,39,25.125,23.142857,39,892,819,73,0,1,0,0.142857,46,8,7,0.73913,0,0,7,7,false,true,true,0.868,0.132
139,58,81,34.75,19.333333,81,1334,1256,78,1,0,0.25,0,74,4,3,0.418919,0,0,11,11,false,true,true,0.886,0.114
197,233,-36,19.7,23.3,-36,1181,1149,32,0,1,0,0.1,39,10,10,1.153846,0,0,10,16,false,true,false,0.366,0.634
28,0,28,28,0,28,769,527,242,0,0,0,0,95,1,0,0.378947,0,0,7,0,false,true,true,0.759,0.241
292,201,91,16.222222,11.166667,91,1128,889,239,0,1,0,0.055556,-4,18,18,-11.75,0,1,16,15,false,true,true,0.999,0.001
309,272,37,25.75,24.727273,37,1554,1716,-162,1,1,0.083333,0.090909,10,12,11,3.5,0,0,15,15,false,true,true,0.781,0.219
298,264,34,17.529412,16.5,34,334,446,-112,0,0,0,0,-15,17,16,-2.666667,1,1,6,10,false,true,true,0.965,0.035
16,0,16,16,0,16,871,999,-128,0,0,0,0,96,1,0,0.5,0,0,14,0,false,true,false,0.462,0.538
324,242,82,18,14.235294,82,1253,1166,87,1,0,0.055556,0,-5,18,17,-8.6,0,0,10,17,false,true,true,0.999,0.001
209,188,21,23.222222,20.888889,21,892,819,73,0,1,0,0.111111,36,9,9,0.944444,0,0,10,7,false,true,true,0.818,0.182
145,125,20,20.714286,20.833333,20,1554,1622,-68,1,0,0.142857,0,50,7,6,0.62,0,1,14,11,false,true,false,0.315,0.685
233,224,9,21.181818,20.363636,9,1782,1512,270,1,1,0.090909,0.090909,28,11,11,1.5,0,0,13,12,false,true,true,0.986,0.014
286,296,-10,19.066667,19.733333,-10,1334,1270,64,1,0,0.066667,0,8,15,15,4.625,1,0,18,7,false,true,true,0.824,0.176
176,139,37,22,17.375,37,1127,1075,52,1,0,0.125,0,42,8,8,0.738095,0,1,15,9,false,true,true,0.699,0.301
42,36,6,14,12,6,1253,1166,87,0,0,0,0,80,3,3,0.5375,0,0,10,16,false,true,false,0.469,0.531
102,53,49,34,17.666667,49,1439,1353,86,1,0,0.333333,0,72,3,3,0.416667,0,0,13,9,false,true,true,0.541,0.459
221,205,16,20.090909,18.636364,16,838,786,52,0,1,0,0.090909,26,11,11,1.230769,1,0,15,13,false,true,true,0.977,0.023
275,106,169,34.375,15.142857,169,918,619,299,2,0,0.25,0,47,8,7,0.744681,1,0,9,14,false,true,true,1,0
191,170,21,19.1,17,21,1394,1230,164,0,1,0,0.1,30,10,10,1.266667,0,1,12,18,false,true,false,0.104,0.896
80,41,39,26.666667,20.5,39,820,783,37,0,0,0,0,84,3,2,0.392857,0,0,20,14,false,true,true,0.843,0.157
200,124,76,18.181818,12.4,76,1011,921,90,0,0,0,0,34,11,10,1.441176,1,0,6,18,false,true,true,0.955,0.045
247,252,-5,20.583333,21,-5,1304,1040,264,1,0,0.083333,0,18,12,12,1.833333,0,0,17,11,false,true,true,0.675,0.325
173,154,19,15.727273,14,19,880,952,-72,0,0,0,0,25,11,11,1.64,0,0,12,15,false,true,true,0.648,0.352
325,225,100,32.5,22.5,100,1245,1241,4,1,1,0.1,0.1,20,10,10,1.45,0,0,13,7,false,true,true,1,0
169,158,11,15.363636,14.363636,11,539,632,-93,0,0,0,0,36,11,11,1.277778,0,0,10,7,false,true,true,0.71,0.29
173,161,12,21.625,23,12,1530,1550,-20,0,1,0,0.142857,40,8,7,0.85,0,0,18,12,false,true,false,0.394,0.606
110,29,81,55,14.5,81,539,500,39,0,0,0,0,80,2,2,0.5,0,1,10,24,false,true,true,0.931,0.069
328,262,66,21.866667,17.466667,66,1364,1093,271,0,1,0,0.066667,1,15,15,38,0,0,12,13,false,true,true,0.969,0.031
228,252,-24,20.727273,22.909091,-24,971,761,210,0,0,0,0,20,11,11,1.5,0,0,8,14,false,true,false,0.497,0.503
312,242,70,18.352941,14.235294,70,1253,1166,87,1,0,0.058824,0,-2,17,17,-21.5,0,0,8,17,false,true,true,0.999,0.001
273,188,85,21,14.461538,85,1606,1544,62,0,0,0,0,28,13,13,1.607143,0,1,16,9,false,true,true,0.992,0.008
323,150,173,29.363636,15,173,918,619,299,2,0,0.181818,0,25,11,10,1.4,2,0,8,14,false,true,true,1,0
102,81,21,20.4,20.25,21,1266,1144,122,0,0,0,0,64,5,4,0.53125,1,0,15,10,false,true,true,0.813,0.187
334,278,56,20.875,17.375,56,948,933,15,1,0,0.0625,0,7,16,16,5.428571,0,0,8,11,false,true,true,0.995,0.005
133,90,43,22.166667,18,43,1073,1177,-104,0,0,0,0,62,6,5,0.516129,0,0,11,20,false,true,false,0.491,0.509
268,199,69,22.333333,18.090909,69,941,926,15,1,0,0.083333,0,25,12,11,1.52,1,0,13,10,false,true,true,0.982,0.018
260,212,48,32.5,30.285714,48,1454,1531,-77,1,1,0.125,0.142857,33,8,7,0.909091,0,0,16,8,false,true,true,0.752,0.248
330,300,30,15.714286,15,30,1583,1422,161,1,0,0.047619,0,-5,21,20,-10.2,0,0,16,15,false,true,true,0.768,0.232
45,59,-14,15,19.666667,-14,1312,1334,-22,0,0,0,0,79,3,3,0.493671,0,0,12,21,false,false,false,0.302,0.698
161,207,-46,17.888889,23,-46,450,624,-174,0,0,0,0,33,9,9,1,0,0,19,7,false,false,false,0.236,0.764
206,269,-63,20.6,26.9,-63,1636,1796,-160,0,0,0,0,23,10,10,1.173913,0,1,11,10,false,false,false,0.032,0.968
269,257,12,15.823529,15.117647,12,796,800,-4,1,0,0.058824,0,8,17,17,6,0,1,12,8,false,false,false,0.143,0.857
284,331,-47,16.705882,19.470588,-47,758,791,-33,0,0,0,0,-17,17,17,-2.294118,0,0,5,2,false,false,false,0,1
148,190,-42,18.5,23.75,-42,450,624,-174,0,0,0,0,38,8,8,0.868421,0,0,22,8,false,false,false,0.247,0.753
308,318,-10,28,28.909091,-10,1885,1842,43,0,2,0,0.181818,10,11,11,2.7,0,1,9,6,false,false,false,0.097,0.903
246,258,-12,15.375,17.2,-12,797,796,1,0,0,0,0,13,16,15,3.769231,1,0,8,13,false,false,false,0.186,0.814
261,390,-129,18.642857,30,-129,1315,1334,-19,0,2,0,0.153846,0,14,13,0,0,0,7,16,false,false,false,0,1
163,107,56,27.166667,17.833333,56,540,498,42,1,0,0.166667,0,58,6,6,0.793103,0,1,12,18,false,false,false,0.066,0.934
48,17,31,24,17,31,1428,1361,67,0,0,0,0,86,2,1,0.383721,0,0,12,17,false,false,true,0.681,0.319
39,25,14,13,12.5,14,306,361,-55,0,0,0,0,80,3,2,0.45,0,1,16,7,false,false,false,0.262,0.738
89,173,-84,14.833333,28.833333,-84,1195,1397,-202,0,1,0,0.166667,57,6,6,0.701754,0,0,11,16,false,false,false,0.038,0.962
159,184,-25,19.875,23,-25,1561,1495,66,1,0,0.125,0,34,8,8,0.970588,1,0,6,11,false,false,false,0.442,0.558
127,127,0,25.4,25.4,0,1055,1019,36,0,0,0,0,59,5,5,0.559322,0,0,8,13,false,false,true,0.649,0.351
45,195,-150,6.428571,27.857143,-150,1422,1510,-88,0,1,0,0.142857,63,7,7,0.619048,0,0,17,16,false,false,false,0,1
155,192,-37,11.071429,13.714286,-37,391,542,-151,1,0,0.071429,0,13,14,14,3.538462,0,0,14,20,false,false,false,0.048,0.952
72,50,22,14.4,12.5,22,450,427,23,0,0,0,0,69,5,4,0.536232,0,2,18,8,false,false,false,0.295,0.705
28,72,-44,7,24,-44,1473,1500,-27,0,1,0,0.333333,80,4,3,0.4875,0,1,7,8,false,false,false,0.143,0.857
262,308,-46,16.375,19.25,-46,360,371,-11,0,0,0,0,-19,16,16,-1.947368,0,0,7,2,false,false,false,0.001,0.999
286,297,-11,13.619048,14.85,-11,797,796,1,0,0,0,0,-19,21,20,-2.578947,0,0,7,5,false,false,false,0.008,0.992
154,185,-31,14,18.5,-31,568,570,-2,0,0,0,0,33,11,10,1.121212,0,0,10,17,false,false,false,0.039,0.961
184,373,-189,14.153846,28.692308,-189,1399,1210,189,0,1,0,0.076923,12,13,13,2.916667,0,0,20,7,false,false,false,0.036,0.964
42,103,-61,8.4,20.6,-61,95,453,-358,0,0,0,0,77,5,5,0.506494,0,0,16,7,false,false,false,0.07,0.93
208,339,-131,23.111111,42.375,-131,1539,1891,-352,0,2,0,0.25,26,9,8,0.961538,1,0,15,8,false,false,false,0,1
86,151,-65,10.75,21.571429,-65,651,567,84,0,0,0,0,50,8,7,1.1,0,0,9,9,false,false,false,0.184,0.816
247,306,-59,16.466667,20.4,-59,1432,1452,-20,0,1,0,0.066667,-4,15,15,-9,1,0,6,22,false,false,false,0.005,0.995
244,383,-139,16.266667,25.533333,-139,915,971,-56,0,0,0,0,-9,15,15,-3.666667,0,0,4,5,false,false,false,0,1
18,10,8,18,10,8,1037,913,124,0,0,0,0,94,1,1,0.404255,0,0,10,18,false,false,true,0.678,0.322
282,458,-176,18.8,32.714286,-176,842,926,-84,0,1,0,0.071429,-14,15,14,-2.142857,0,0,3,2,false,false,false,0,1
133,129,4,33.25,43,4,1689,1777,-88,1,0,0.25,0,60,4,3,0.5,0,0,11,19,false,false,true,0.634,0.366
244,288,-44,17.428571,20.571429,-44,568,570,-2,0,0,0,0,10,14,14,3.7,0,0,9,11,false,false,false,0.001,0.999
134,134,0,19.142857,19.142857,0,711,746,-35,0,0,0,0,55,7,7,0.690909,0,0,7,19,false,false,false,0.141,0.859
6,0,6,6,0,6,889,895,-6,0,0,0,0,97,1,0,0.381443,0,0,14,0,false,false,false,0.495,0.505
280,401,-121,16.470588,23.588235,-121,1193,1177,16,0,1,0,0.058824,-12,17,17,-2.916667,0,0,1,2,false,false,false,0,1
188,146,42,23.5,18.25,42,1691,1551,140,0,0,0,0,45,8,8,0.822222,0,1,7,28,false,false,false,0.37,0.63
236,212,24,18.153846,16.307692,24,1344,1314,30,0,1,0,0.076923,15,13,13,2.266667,0,2,16,6,false,false,true,0.894,0.106
155,198,-43,19.375,28.285714,-43,1315,1331,-16,0,0,0,0,45,8,7,0.733333,0,0,10,18,false,false,false,0.176,0.824
26,39,-13,26,39,-13,971,635,336,0,0,0,0,94,1,1,0.340426,0,0,10,10,false,false,false,0.242,0.758
65,35,30,16.25,11.666667,30,1188,1334,-146,0,0,0,0,77,4,3,0.38961,0,0,19,9,false,false,false,0.27,0.73
181,334,-153,13.923077,25.692308,-153,710,758,-48,0,1,0,0.076923,21,13,13,1.761905,0,0,9,11,false,false,false,0,1
128,141,-13,14.222222,17.625,-13,848,976,-128,0,0,0,0,48,9,8,0.833333,0,0,28,10,false,false,false,0.225,0.775
235,309,-74,13.823529,19.3125,-74,714,892,-178,0,2,0,0.125,-3,17,16,-14,0,0,12,10,false,false,false,0,1
47,53,-6,9.4,13.25,-6,999,1165,-166,0,0,0,0,73,5,4,0.630137,0,0,17,13,false,false,false,0.25,0.75
143,122,21,23.833333,20.333333,21,1078,1095,-17,1,0,0.166667,0,58,6,6,0.637931,0,1,17,12,false,false,false,0.414,0.586
296,448,-152,26.909091,40.727273,-152,1925,1885,40,1,2,0.090909,0.181818,-8,11,11,-3.125,0,0,2,1,false,false,false,0,1
196,365,-169,15.076923,28.076923,-169,1422,1510,-88,0,2,0,0.153846,21,13,13,1.857143,0,0,7,9,false,false,false,0,1
155,119,36,31,29.75,36,1436,1489,-53,1,0,0.2,0,68,5,4,0.544118,0,1,13,10,false,false,false,0.188,0.812
317,329,-12,13.782609,14.304348,-12,526,502,24,0,0,0,0,-36,23,23,-1.388889,0,0,13,13,false,false,true,0.644,0.356
90,81,9,18,20.25,9,1021,1094,-73,1,0,0.2,0,68,5,4,0.544118,0,0,14,15,false,false,false,0.254,0.746
134,184,-50,22.333333,30.666667,-50,1045,1100,-55,0,0,0,0,58,6,6,0.586207,0,1,9,14,false,false,false,0.003,0.997
99,152,-53,14.142857,21.714286,-53,595,540,55,0,0,0,0,48,7,7,0.895833,0,0,10,18,false,false,false,0.167,0.833
241,357,-116,24.1,35.7,-116,1689,1777,-88,1,1,0.1,0.1,17,10,10,1.764706,0,0,9,9,false,false,false,0,1
132,206,-74,18.857143,29.428571,-74,954,939,15,0,0,0,0,47,7,7,0.765957,0,1,8,11,false,false,false,0.003,0.997
93,73,20,18.6,18.25,20,704,523,181,0,0,0,0,66,5,4,0.530303,0,0,13,10,false,false,true,0.695,0.305
87,203,-116,9.666667,22.555556,-116,632,603,29,0,0,0,0,40,9,9,0.95,1,0,10,16,false,false,false,0.001,0.999
237,299,-62,11.85,14.95,-62,683,859,-176,0,0,0,0,2,20,20,22.5,0,0,9,17,false,false,false,0,1
159,189,-30,22.714286,31.5,-30,595,733,-138,1,1,0.142857,0.166667,43,7,6,0.906977,0,1,19,13,false,false,false,0.026,0.974
213,272,-59,17.75,22.666667,-59,1432,1452,-20,0,1,0,0.083333,14,12,12,2.571429,1,0,6,18,false,false,false,0.005,0.995
191,168,23,17.363636,16.8,23,1220,1185,35,0,0,0,0,40,11,10,1.175,0,1,18,8,false,false,false,0.458,0.542
163,198,-35,20.375,28.285714,-35,503,527,-24,0,1,0,0.142857,37,8,7,0.891892,0,0,7,9,false,false,false,0.209,0.791
77,35,42,38.5,35,42,1699,1580,119,1,0,0.5,0,87,2,1,0.344828,0,1,9,9,false,false,true,0.663,0.337
39,129,-90,5.571429,18.428571,-90,1078,983,95,0,0,0,0,62,7,7,0.774194,1,0,16,11,false,false,false,0.155,0.845
40,14,26,20,14,26,1399,1210,189,0,0,0,0,88,2,1,0.397727,0,1,11,13,false,false,true,0.658,0.342
297,290,7,18.5625,19.333333,7,540,498,42,1,0,0.0625,0,-5,16,15,-9.2,0,0,7,16,false,false,false,0.093,0.907
204,189,15,34,37.8,15,1699,1580,119,2,0,0.333333,0,52,6,5,0.576923,0,0,9,9,false,false,false,0.424,0.576
132,147,-15,18.857143,21,-15,1021,1094,-73,1,0,0.142857,0,50,7,7,0.74,1,0,6,10,false,false,false,0.363,0.637
174,290,-116,11.6,19.333333,-116,388,542,-154,0,0,0,0,2,15,15,18.5,0,1,8,6,false,false,false,0,1
214,219,-5,21.4,21.9,-5,694,658,36,0,1,0,0.1,29,10,10,1.275862,0,0,14,9,false,false,true,0.68,0.32
286,298,-12,26,29.8,-12,1344,1208,136,1,1,0.090909,0.1,19,11,10,1.578947,1,0,15,17,false,false,true,0.729,0.271
100,148,-48,14.285714,24.666667,-48,430,542,-112,0,1,0,0.166667,55,7,6,0.872727,0,0,19,10,false,false,false,0.053,0.947
24,15,9,12,15,9,1219,1216,3,0,1,0,1,88,2,1,0.306818,0,0,20,11,false,false,false,0.464,0.536
219,299,-80,16.846154,24.916667,-80,1305,1254,51,0,1,0,0.083333,7,13,12,4.571429,0,0,16,11,false,false,false,0,1
91,89,2,15.166667,17.8,2,1439,1428,11,0,0,0,0,66,6,5,0.606061,1,0,15,18,false,false,false,0.321,0.679
167,175,-8,16.7,17.5,-8,704,523,181,0,0,0,0,29,10,10,1.206897,0,0,11,10,false,false,false,0.231,0.769
237,269,-32,21.545455,26.9,-32,1397,1309,88,2,0,0.181818,0,35,11,10,1.028571,0,1,13,6,false,false,false,0.001,0.999
104,182,-78,20.8,36.4,-78,1537,1539,-2,0,1,0,0.2,56,5,5,0.607143,0,0,10,7,false,false,false,0.049,0.951
89,166,-77,22.25,55.333333,-77,1093,1100,-7,0,1,0,0.333333,67,4,3,0.522388,0,0,9,12,false,false,false,0.187,0.813
109,196,-87,12.111111,21.777778,-87,1071,1000,71,0,0,0,0,47,9,9,1,1,1,6,12,false,false,false,0,1
294,320,-26,21,22.857143,-26,742,868,-126,0,1,0,0.071429,3,14,14,11,0,0,8,17,false,false,false,0.037,0.963
270,264,6,18,18.857143,6,704,523,181,0,0,0,0,-9,15,14,-3.888889,0,0,7,12,false,false,false,0.496,0.504
14,0,14,14,0,14,721,757,-36,0,0,0,0,96,1,0,0.395833,0,0,12,0,false,false,false,0.27,0.73
279,248,31,23.25,22.545455,31,1488,1428,60,1,0,0.083333,0,23,12,11,1.608696,0,1,16,7,false,false,true,0.679,0.321
12,12,0,12,12,0,1161,1176,-15,0,0,0,0,92,1,1,0.413043,0,0,20,8,false,false,true,0.678,0.322
168,169,-1,15.272727,16.9,-1,1580,1629,-49,0,0,0,0,31,11,10,1.193548,0,0,12,10,false,false,false,0.202,0.798
12,66,-54,4,33,-54,1473,1500,-27,0,1,0,0.5,87,3,2,0.448276,0,1,10,8,false,false,false,0.13,0.87
132,169,-37,14.666667,18.777778,-37,951,976,-25,0,0,0,0,46,9,9,0.956522,0,0,19,16,false,false,false,0.04,0.96
65,89,-24,21.666667,44.5,-24,503,527,-24,0,1,0,0.5,77,3,2,0.428571,0,0,9,13,false,false,false,0.241,0.759
56,136,-80,9.333333,27.2,-80,1101,1130,-29,0,1,0,0.2,63,6,5,0.714286,0,0,7,16,false,false,false,0.052,0.948
197,148,49,24.625,21.142857,49,1274,1394,-120,0,0,0,0,39,8,7,0.769231,0,1,12,6,false,false,true,0.764,0.236
234,397,-163,16.714286,28.357143,-163,926,973,-47,0,0,0,0,2,14,14,17.5,0,0,10,5,false,false,false,0,1
272,291,-19,19.428571,20.785714,-19,907,910,-3,0,1,0,0.071429,20,14,14,2.15,0,0,17,7,false,false,false,0.3,0.7
37,138,-101,12.333333,46,-101,1583,1403,180,0,0,0,0,69,3,3,0.463768,0,0,12,16,false,false,false,0.005,0.995
100,20,80,50,20,80,1167,1245,-78,1,0,0.5,0,85,2,1,0.329412,0,0,16,13,false,false,true,0.729,0.271
109,91,18,27.25,22.75,18,1488,1428,60,1,0,0.25,0,67,4,4,0.552239,0,0,10,13,false,false,true,0.684,0.316
251,297,-46,13.210526,15.631579,-46,526,502,24,0,0,0,0,-11,19,19,-4.545455,1,0,17,17,false,false,false,0.011,0.989
345,320,25,19.166667,18.823529,25,907,910,-3,0,1,0,0.058824,-1,18,17,-43,0,0,7,9,false,false,true,0.662,0.338
241,259,-18,16.066667,18.5,-18,615,542,73,0,0,0,0,10,15,14,4.2,0,0,7,7,false,false,false,0.224,0.776
183,282,-99,20.333333,31.333333,-99,1606,1593,13,0,1,0,0.111111,29,9,9,1,0,0,10,13,false,false,false,0,1
310,348,-38,17.222222,19.333333,-38,824,830,-6,1,0,0.055556,0,-7,18,18,-6.285714,0,0,9,8,false,false,false,0,1
186,136,50,20.666667,17,50,1281,1268,13,0,0,0,0,44,9,8,0.954545,0,0,7,10,false,false,true,0.823,0.177
221,310,-89,15.785714,23.846154,-89,1075,878,197,0,1,0,0.076923,13,14,13,2.538462,0,0,17,9,false,false,false,0,1
244,319,-75,18.769231,24.538462,-75,1495,1531,-36,0,1,0,0.076923,13,13,13,2.846154,1,0,16,10,false,false,false,0.008,0.992
130,223,-93,18.571429,31.857143,-93,594,648,-54,1,1,0.142857,0.142857,48,7,7,0.833333,0,0,7,7,false,false,false,0.001,0.999
138,226,-88,17.25,32.285714,-88,1232,1281,-49,0,2,0,0.285714,37,8,7,0.837838,0,0,12,16,false,false,false,0.001,0.999
379,441,-62,23.6875,29.4,-62,1093,1100,-7,3,0,0.1875,0,-5,16,15,-6.2,0,0,6,9,true,false,false,0.003,0.997
20,0,20,20,0,20,954,939,15,0,0,0,0,95,1,0,0.378947,0,0,10,0,false,false,true,0.678,0.322
191,254,-63,17.363636,23.090909,-63,795,786,9,1,0,0.090909,0,31,11,11,1.225806,0,0,8,14,false,false,false,0,1
287,342,-55,16.882353,20.117647,-55,387,683,-296,0,0,0,0,-22,17,17,-1.545455,1,0,3,4,true,false,false,0.031,0.969
57,28,29,19,14,29,1043,1003,40,0,0,0,0,79,3,2,0.481013,1,0,18,12,false,false,true,0.695,0.305
282,295,-13,23.5,24.583333,-13,1341,1606,-265,1,0,0.083333,0,6,12,12,5.5,0,0,13,9,false,false,false,0.258,0.742
32,17,15,16,17,15,1193,1177,16,0,0,0,0,88,2,1,0.397727,0,0,11,16,false,false,true,0.676,0.324
156,170,-14,22.285714,28.333333,-14,1606,1593,13,0,0,0,0,54,7,6,0.537037,0,1,8,9,false,false,false,0.2,0.8
247,258,-11,14.529412,15.176471,-11,361,413,-52,0,0,0,0,-16,17,17,-2.5625,0,0,19,6,false,false,true,0.508,0.492
190,243,-53,21.111111,30.375,-53,1636,1796,-160,0,0,0,0,34,9,8,0.794118,0,0,8,19,false,false,false,0.038,0.962
357,403,-46,25.5,28.785714,-46,1793,1869,-76,1,1,0.071429,0.071429,-6,14,14,-5,0,0,1,3,false,false,false,0,1
339,370,-31,14.73913,16.086957,-31,540,498,42,1,0,0.043478,0,-41,23,23,-1.121951,0,0,2,1,true,false,true,0.653,0.347
86,64,22,21.5,21.333333,22,1770,1751,19,0,0,0,0,69,4,3,0.42029,0,1,9,7,false,false,true,0.671,0.329
22,0,22,22,0,22,1040,1091,-51,0,0,0,0,95,1,0,0.494737,0,0,8,0,false,false,true,0.504,0.496
297,395,-98,37.125,49.375,-98,2010,2219,-209,1,1,0.125,0.125,22,8,8,1.181818,0,0,13,7,false,false,false,0,1
241,299,-58,20.083333,27.181818,-58,1583,1403,180,0,0,0,0,18,12,11,1.777778,0,1,14,17,false,false,false,0,1
267,288,-21,16.6875,19.2,-21,500,509,-9,0,0,0,0,2,16,15,20.5,0,0,8,11,false,false,false,0.056,0.944
169,259,-90,15.363636,23.545455,-90,952,826,126,0,1,0,0.090909,35,11,11,1.228571,0,0,7,10,false,false,false,0,1
287,419,-132,15.105263,22.052632,-132,913,1037,-124,0,3,0,0.157895,-14,19,19,-2.928571,0,0,10,6,false,false,false,0,1
23,6,17,11.5,6,17,1452,1388,64,0,0,0,0,91,2,1,0.384615,0,0,12,15,false,false,true,0.665,0.335
27,30,-3,9,15,-3,1561,1495,66,0,0,0,0,83,3,2,0.39759,1,0,10,20,false,false,false,0.265,0.735
64,175,-111,9.142857,29.166667,-111,1101,1130,-29,0,1,0,0.166667,58,7,6,0.775862,0,0,9,13,false,false,false,0,1
268,301,-33,17.866667,20.066667,-33,576,602,-26,0,0,0,0,0,15,15,0,0,0,14,7,false,false,false,0.004,0.996
49,90,-41,16.333333,30,-41,1093,1173,-80,0,0,0,0,82,3,3,0.52439,0,0,23,8,false,false,false,0.298,0.702
247,254,-7,16.466667,16.933333,-7,480,518,-38,0,0,0,0,0,15,15,0,0,1,14,9,false,false,false,0.42,0.58
205,214,-9,13.666667,14.266667,-9,999,1071,-72,0,0,0,0,5,15,15,8,2,0,13,17,false,false,false,0.491,0.509
80,61,19,26.666667,20.333333,19,1071,1181,-110,0,0,0,0,78,3,3,0.435897,0,0,7,12,false,false,false,0.32,0.68
174,333,-159,7.565217,14.478261,-159,651,567,84,0,0,0,0,-17,23,23,-3.235294,0,0,7,13,false,false,false,0,1
148,143,5,21.142857,20.428571,5,985,1062,-77,0,0,0,0,47,7,7,0.787234,0,0,7,10,false,false,true,0.586,0.414
173,260,-87,19.222222,32.5,-87,842,926,-84,0,0,0,0,27,9,8,1.111111,0,0,12,14,false,false,false,0,1
166,223,-57,13.833333,20.272727,-57,278,1,277,0,0,0,0,18,12,11,2.055556,0,1,17,8,false,false,false,0.001,0.999
301,406,-105,13.681818,19.333333,-105,952,826,126,0,1,0,0.047619,-26,22,21,-1.653846,0,0,1,2,true,false,false,0,1
210,224,-14,19.090909,22.4,-14,595,733,-138,1,1,0.090909,0.1,22,11,10,1.772727,0,1,22,13,false,false,false,0.186,0.814
308,284,24,19.25,18.933333,24,1168,1062,106,0,0,0,0,6,16,15,7.166667,1,0,7,23,false,false,true,1,0
47,36,11,15.666667,18,11,700,820,-120,0,0,0,0,84,3,2,0.452381,0,0,17,9,false,false,false,0.252,0.748
220,308,-88,13.75,19.25,-88,907,878,29,0,0,0,0,11,16,16,3.909091,2,0,8,18,false,false,false,0.001,0.999
192,223,-31,12.8,15.928571,-31,163,346,-183,0,0,0,0,-1,15,14,-39,0,0,26,7,false,false,false,0.017,0.983
111,190,-79,11.1,21.111111,-79,595,662,-67,0,1,0,0.111111,34,10,9,1.294118,0,1,22,6,false,false,false,0.011,0.989
369,374,-5,19.421053,19.684211,-5,1156,1279,-123,2,0,0.105263,0,-17,19,19,-2.352941,0,0,2,1,false,false,true,0.617,0.383
324,369,-45,19.058824,23.0625,-45,1266,1339,-73,0,1,0,0.0625,-6,17,16,-5.833333,0,0,1,2,false,false,false,0,1
55,116,-61,18.333333,38.666667,-61,1422,1798,-376,0,1,0,0.333333,74,3,3,0.432432,1,0,16,10,false,false,false,0.241,0.759
110,51,59,22,12.75,59,1110,1123,-13,0,0,0,0,63,5,4,0.52381,0,0,10,10,false,false,true,0.835,0.165
19,13,6,9.5,13,6,566,742,-176,0,0,0,0,91,2,1,0.351648,0,0,8,8,false,false,false,0.251,0.749
21,75,-54,10.5,37.5,-54,1305,1194,111,0,0,0,0,86,2,2,0.383721,0,0,16,14,false,false,false,0.201,0.799
66,73,-7,16.5,18.25,-7,1495,1597,-102,0,0,0,0,74,4,4,0.432432,0,0,10,16,false,false,false,0.379,0.621
47,52,-5,11.75,13,-5,1452,1388,64,0,0,0,0,75,4,4,0.466667,0,0,10,22,false,false,false,0.206,0.794
60,39,21,20,19.5,21,595,538,57,0,0,0,0,83,3,2,0.457831,0,0,8,13,false,false,true,0.682,0.318
132,197,-65,16.5,24.625,-65,926,973,-47,0,0,0,0,40,8,8,0.875,0,1,11,19,false,false,false,0.007,0.993
29,33,-4,9.666667,11,-4,925,1000,-75,0,0,0,0,76,3,3,0.578947,0,0,11,13,false,false,false,0.333,0.667
368,381,-13,21.647059,23.8125,-13,1168,1216,-48,1,1,0.058824,0.0625,-6,17,16,-5.5,0,0,11,7,true,false,false,0.002,0.998
192,173,19,16,14.416667,19,1030,998,32,0,0,0,0,22,12,12,1.681818,0,1,8,17,false,false,false,0.404,0.596
269,271,-2,24.454545,24.636364,-2,804,1074,-270,0,0,0,0,15,11,11,2.133333,0,1,12,9,false,false,false,0.202,0.798
200,222,-22,16.666667,20.181818,-22,500,532,-32,0,0,0,0,21,12,11,1.952381,0,1,15,8,false,false,false,0.006,0.994
115,101,14,16.428571,16.833333,14,889,855,34,0,0,0,0,60,7,6,0.666667,0,0,28,8,false,false,true,0.693,0.307
56,124,-68,9.333333,24.8,-68,795,786,9,0,0,0,0,73,6,5,0.520548,0,0,7,16,false,false,false,0.037,0.963
350,355,-5,23.333333,25.357143,-5,1110,1123,-13,1,2,0.066667,0.142857,-7,15,14,-4.714286,0,0,6,9,false,false,false,0.103,0.897
40,43,-3,13.333333,14.333333,-3,721,757,-36,0,0,0,0,79,3,3,0.481013,0,0,14,17,false,false,false,0.277,0.723
145,183,-38,29,36.6,-38,820,718,102,0,2,0,0.4,55,5,5,0.509091,0,0,9,20,false,false,false,0.207,0.793
82,67,15,16.4,16.75,15,1094,1041,53,0,0,0,0,64,5,4,0.59375,1,0,13,14,false,false,true,0.679,0.321
44,31,13,14.666667,15.5,13,1093,1100,-7,0,0,0,0,84,3,2,0.369048,1,0,16,16,false,false,true,0.678,0.322
36,52,-16,12,17.333333,-16,720,437,283,0,0,0,0,85,3,3,0.494118,0,0,11,18,false,false,false,0.203,0.797
343,314,29,26.384615,26.166667,29,714,820,-106,1,0,0.076923,0,12,13,12,2.583333,0,0,7,9,false,false,true,0.99,0.01
168,221,-53,18.666667,24.555556,-53,561,633,-72,0,1,0,0.111111,38,9,9,0.921053,0,0,16,14,false,false,false,0.04,0.96
294,280,14,18.375,17.5,14,824,830,-6,1,0,0.0625,0,5,16,16,8.8,0,0,10,18,false,false,true,0.904,0.096
216,221,-5,18,18.416667,-5,500,509,-9,0,0,0,0,22,12,12,1.863636,0,0,9,16,false,false,false,0.214,0.786
120,408,-288,8.571429,29.142857,-288,1164,1149,15,0,2,0,0.142857,31,14,14,1.516129,0,0,12,8,false,false,false,0,1
109,91,18,21.8,22.75,18,1488,1428,60,1,0,0.2,0,67,5,4,0.552239,0,0,19,13,false,false,true,0.68,0.32
111,202,-91,12.333333,22.444444,-91,343,570,-227,0,0,0,0,30,9,9,1.2,1,0,25,10,false,false,false,0.017,0.983
172,135,37,24.571429,19.285714,37,1691,1551,140,0,0,0,0,52,7,7,0.711538,0,1,7,24,false,false,false,0.335,0.665
301,327,-26,15.05,16.35,-26,1203,1270,-67,1,0,0.05,0,-20,20,20,-2.2,1,0,4,3,false,false,false,0.468,0.532
12,0,12,12,0,12,632,603,29,0,0,0,0,96,1,0,0.395833,0,0,9,0,false,false,true,0.552,0.448
191,251,-60,17.363636,22.818182,-60,1071,1181,-110,0,0,0,0,32,11,11,1.0625,0,0,7,7,false,false,false,0.034,0.966
43,41,2,14.333333,13.666667,2,999,1165,-166,0,0,0,0,79,3,3,0.582278,0,0,15,13,false,false,false,0.252,0.748
204,236,-32,18.545455,21.454545,-32,917,856,61,0,1,0,0.090909,26,11,11,1.269231,0,1,7,19,false,false,false,0.054,0.946
190,256,-66,21.111111,28.444444,-66,1636,1796,-160,0,0,0,0,30,9,9,0.9,0,0,8,12,false,false,false,0.039,0.961
213,222,-9,16.384615,18.5,-9,306,468,-162,0,0,0,0,25,13,12,1.48,0,0,11,9,false,false,false,0.388,0.612
186,165,21,20.666667,20.625,21,566,742,-176,0,1,0,0.125,34,9,8,0.941176,0,0,9,15,false,false,true,0.722,0.278
41,43,-2,20.5,21.5,-2,603,721,-118,0,0,0,0,88,2,2,0.488636,0,0,19,10,false,false,false,0.252,0.748
245,211,34,35,35.166667,34,820,718,102,0,2,0,0.333333,38,7,6,0.736842,0,0,11,10,false,false,true,0.936,0.064
32,0,32,32,0,32,971,800,171,0,0,0,0,95,1,0,0.305263,0,0,7,0,false,false,true,0.722,0.278
264,396,-132,16.5,24.75,-132,1193,1177,16,0,1,0,0.0625,-5,16,16,-7,1,0,4,2,false,false,false,0,1
199,201,-2,18.090909,20.1,-2,615,542,73,0,0,0,0,35,11,10,1.2,0,1,13,8,false,false,false,0.017,0.983
12,46,-34,6,23,-34,1210,1162,48,0,0,0,0,85,2,2,0.376471,0,0,7,14,false,false,false,0.207,0.793
159,116,43,39.75,29,43,1167,1245,-78,1,0,0.25,0,62,4,4,0.451613,0,0,8,19,false,false,true,0.715,0.285
134,166,-32,22.333333,33.2,-32,1045,1100,-55,0,0,0,0,62,6,5,0.548387,0,1,9,14,false,false,false,0.002,0.998
220,130,90,20,13,90,1065,948,117,0,0,0,0,40,11,10,0.975,0,0,12,8,false,false,true,0.97,0.03
140,144,-4,23.333333,28.8,-4,1126,1277,-151,0,0,0,0,55,6,5,0.636364,0,0,8,10,false,false,false,0.255,0.745
213,240,-27,21.3,26.666667,-27,980,965,15,0,0,0,0,36,10,9,1.055556,1,0,6,8,false,false,false,0.098,0.902
136,182,-46,34,45.5,-46,2010,2219,-209,1,0,0.25,0,65,4,4,0.4,0,0,12,8,false,false,false,0.271,0.729
302,396,-94,15.1,20.842105,-94,848,976,-128,0,1,0,0.052632,-18,20,19,-2.222222,0,0,2,4,false,false,false,0,1
199,263,-64,24.875,32.875,-64,1253,1324,-71,0,1,0,0.125,36,8,8,0.805556,0,0,20,12,false,false,false,0.183,0.817
280,237,43,20,18.230769,43,742,594,148,0,0,0,0,12,14,13,3.25,1,0,7,11,false,false,true,0.883,0.117
281,291,-10,18.733333,19.4,-10,1021,1094,-73,1,0,0.066667,0,1,15,15,37,1,0,6,7,false,false,false,0.124,0.876
127,110,17,15.875,15.714286,17,1220,1185,35,0,0,0,0,56,8,7,0.839286,0,1,30,9,false,false,true,0.643,0.357
224,163,61,22.4,16.3,61,1652,1473,179,1,0,0.1,0,27,10,10,1.111111,0,2,7,16,false,false,true,0.957,0.043
273,393,-120,11.375,17.086957,-120,1248,1220,28,0,1,0,0.043478,-24,24,23,-2.166667,0,0,2,6,false,false,false,0,1
264,323,-59,12.571429,16.15,-59,595,662,-67,0,1,0,0.05,-25,21,20,-1.76,0,0,1,9,false,false,false,0,1
103,65,38,20.6,16.25,38,356,498,-142,0,0,0,0,68,5,4,0.514706,1,0,8,9,false,false,true,0.668,0.332
0,26,-26,0,26,-26,1173,1256,-83,0,0,0,0,95,1,1,0.326316,0,0,13,20,false,false,false,0.048,0.952
177,248,-71,12.642857,19.076923,-71,1248,1220,28,0,1,0,0.076923,25,14,13,2.08,1,0,6,13,false,false,false,0.003,0.997
322,339,-17,18.941176,21.1875,-17,1473,1500,-27,1,2,0.058824,0.125,-15,17,16,-2.6,1,0,3,13,false,false,false,0.063,0.937
358,457,-99,23.866667,32.642857,-99,2143,2219,-76,1,0,0.066667,0,-18,15,14,-1.722222,0,0,3,1,false,false,false,0,1
259,299,-40,11.772727,13.590909,-40,226,361,-135,0,0,0,0,-31,22,22,-1.419355,0,0,1,3,true,false,false,0,1
48,0,48,48,0,48,1071,1181,-110,0,0,0,0,95,1,0,0.357895,0,0,7,0,false,false,false,0.397,0.603
66,39,27,33,19.5,27,1495,1531,-36,0,0,0,0,85,2,2,0.435294,0,0,11,12,false,false,true,0.692,0.308
269,323,-54,16.8125,20.1875,-54,1422,1583,-161,0,1,0,0.0625,0,16,16,0,1,0,6,22,false,false,false,0.004,0.996
335,346,-11,15.227273,16.47619,-11,775,786,-11,1,0,0.045455,0,-23,22,21,-1.869565,0,0,12,15,true,false,true,0.82,0.18
94,88,6,15.666667,14.666667,6,1065,948,117,0,0,0,0,62,6,6,0.629032,1,0,19,10,false,false,true,0.711,0.289
312,322,-10,18.352941,20.125,-10,356,498,-142,0,1,0,0.0625,-12,17,16,-2.916667,0,0,5,5,false,false,false,0.043,0.957
256,306,-50,16,20.4,-50,1432,1452,-20,0,1,0,0.066667,-9,16,15,-4,1,0,2,22,false,false,false,0.005,0.995
208,130,78,20.8,13,78,1065,948,117,0,0,0,0,43,10,10,0.906977,0,0,12,8,false,false,true,0.97,0.03
265,273,-8,29.444444,34.125,-8,1047,1127,-80,0,1,0,0.125,24,9,8,1.125,0,0,14,9,false,false,false,0.248,0.752
292,282,10,19.466667,20.142857,10,664,786,-122,0,0,0,0,0,15,14,0,1,0,8,10,false,false,false,0.347,0.653
134,145,-11,13.4,14.5,-11,808,749,59,0,0,0,0,26,10,10,1.615385,0,0,25,7,false,false,true,0.63,0.37
217,363,-146,13.5625,24.2,-146,760,976,-216,0,1,0,0.066667,-11,16,15,-3.272727,0,0,4,20,false,false,false,0,1
211,269,-58,21.1,26.9,-58,1454,1479,-25,1,0,0.1,0,25,10,10,1.24,0,0,19,21,false,false,false,0.001,0.999
60,195,-135,7.5,27.857143,-135,1422,1510,-88,0,1,0,0.142857,61,8,7,0.639344,0,0,17,16,false,false,false,0,1
13,9,4,6.5,9,4,1176,1133,43,0,0,0,0,91,2,1,0.373626,2,0,10,25,false,false,true,0.951,0.049
162,206,-44,20.25,29.428571,-44,1305,1254,51,0,1,0,0.142857,38,8,7,0.842105,0,0,13,13,false,false,false,0.119,0.881
199,307,-108,16.583333,25.583333,-108,892,856,36,0,1,0,0.083333,12,12,12,2.916667,1,0,10,11,false,false,false,0,1
248,294,-46,13.052632,15.473684,-46,226,361,-135,0,0,0,0,-27,19,19,-1.62963,0,0,11,7,false,false,false,0,1
89,110,-21,14.833333,18.333333,-21,651,700,-49,0,0,0,0,61,6,6,0.918033,1,0,8,20,false,false,false,0.309,0.691
72,56,16,14.4,11.2,16,450,427,23,0,0,0,0,66,5,5,0.560606,0,2,18,11,false,false,true,0.615,0.385
212,213,-1,17.666667,19.363636,-1,615,542,73,0,0,0,0,28,12,11,1.5,0,0,13,10,false,false,false,0.397,0.603
53,49,4,17.666667,24.5,4,1266,1339,-73,0,0,0,0,85,3,2,0.411765,0,0,8,18,false,false,false,0.298,0.702
212,181,31,19.272727,18.1,31,1078,1095,-17,1,0,0.090909,0,31,11,10,1.193548,0,2,10,14,false,false,false,0.321,0.679
127,210,-83,14.111111,23.333333,-83,837,844,-7,0,0,0,0,48,9,9,0.854167,1,1,6,10,false,false,false,0.002,0.998
288,326,-38,22.153846,27.166667,-38,1699,1803,-104,1,1,0.076923,0.083333,25,13,12,1.4,0,0,15,22,false,false,false,0,1
47,52,-5,9.4,13,-5,595,662,-67,0,0,0,0,68,5,4,0.647059,0,0,18,16,false,false,false,0.25,0.75
88,101,-13,17.6,25.25,-13,954,939,15,0,0,0,0,66,5,4,0.545455,0,0,13,12,false,false,false,0.469,0.531
152,155,-3,16.888889,19.375,-3,711,746,-35,0,0,0,0,44,9,8,0.863636,0,0,7,19,false,false,false,0.042,0.958
125,155,-30,20.833333,31,-30,356,498,-142,0,1,0,0.2,58,6,5,0.603448,1,1,10,17,false,false,false,0.008,0.992
155,272,-117,15.5,27.2,-117,473,683,-210,0,0,0,0,34,10,10,1.117647,0,0,8,12,false,false,false,0,1
57,17,40,28.5,17,40,1885,1908,-23,0,0,0,0,89,2,1,0.258427,1,0,12,11,false,false,true,0.929,0.071
238,264,-26,15.866667,17.6,-26,306,468,-162,0,0,0,0,7,15,15,5.285714,0,0,11,14,false,false,false,0.044,0.956
210,267,-57,13.125,17.8,-57,813,698,115,1,0,0.0625,0,13,16,15,3.692308,0,0,15,10,false,false,false,0,1
200,281,-81,16.666667,23.416667,-81,736,791,-55,0,0,0,0,11,12,12,3.454545,0,0,11,10,false,false,false,0,1
61,25,36,30.5,25,36,1071,1181,-110,0,0,0,0,89,2,1,0.382022,0,0,8,9,false,false,false,0.491,0.509
12,12,0,12,12,0,1164,1161,3,0,0,0,0,91,1,1,0.252747,0,0,19,11,false,false,true,0.678,0.322
330,409,-79,25.384615,34.083333,-79,1770,1751,19,0,1,0,0.083333,-2,13,12,-14.5,0,0,4,10,false,false,false,0,1
192,344,-152,10.105263,19.111111,-152,651,996,-345,0,2,0,0.111111,-15,19,18,-3,0,0,14,5,false,false,false,0,1
0,40,-40,0,20,-40,1334,1439,-105,0,0,0,0,95,3,2,0.378947,2,0,12,15,false,false,false,0.25,0.75
127,110,17,18.142857,15.714286,17,1220,1185,35,0,0,0,0,56,7,7,0.839286,0,1,27,9,false,false,true,0.792,0.208
270,292,-22,14.210526,15.368421,-22,999,1165,-166,0,0,0,0,-7,19,19,-6.571429,1,1,6,8,false,false,false,0.219,0.781
31,70,-39,10.333333,23.333333,-39,651,996,-345,0,0,0,0,79,3,3,0.56962,0,0,9,18,false,false,false,0.25,0.75
174,247,-73,21.75,35.285714,-73,1436,1489,-53,1,1,0.125,0.142857,51,8,7,0.72549,0,0,10,7,false,false,false,0.022,0.978
316,387,-71,18.588235,22.764706,-71,771,668,103,2,0,0.117647,0,-24,17,17,-1.583333,0,0,2,4,false,false,false,0,1
100,174,-74,25,43.5,-74,1331,1432,-101,0,0,0,0,56,4,4,0.482143,0,0,10,13,false,false,false,0.184,0.816
75,60,15,25,20,15,1633,1556,77,0,0,0,0,74,3,3,0.445946,0,0,23,7,false,false,true,0.684,0.316
264,454,-190,16.5,30.266667,-190,1093,1100,-7,0,2,0,0.133333,-2,16,15,-17.5,0,0,26,10,false,false,false,0,1
343,362,-19,21.4375,22.625,-19,1070,814,256,1,1,0.0625,0.0625,-14,16,16,-2.357143,0,0,2,1,false,false,false,0.005,0.995
75,139,-64,15,27.8,-64,1305,1211,94,0,0,0,0,69,5,5,0.478261,0,0,11,17,false,false,false,0.197,0.803
229,246,-17,17.615385,18.923077,-17,804,766,38,0,1,0,0.076923,29,13,13,1.413793,0,1,9,10,false,false,false,0.075,0.925
90,114,-24,12.857143,19,-24,1000,960,40,0,0,0,0,59,7,6,0.762712,1,0,9,7,false,false,false,0.303,0.697
286,303,-17,15.052632,16.833333,-17,1123,1062,61,0,0,0,0,-15,19,18,-2.933333,0,0,3,12,false,false,false,0.001,0.999
411,501,-90,29.357143,35.785714,-90,1699,1580,119,3,2,0.214286,0.142857,-9,14,14,-3.333333,0,0,1,1,false,false,false,0,1
263,277,-14,15.470588,17.3125,-14,840,1055,-215,0,0,0,0,-11,17,16,-3.181818,0,0,9,2,false,false,false,0.045,0.955
207,327,-120,12.9375,21.8,-120,948,998,-50,0,0,0,0,-9,16,15,-4.111111,0,0,8,9,false,false,false,0,1
263,282,-19,16.4375,18.8,-19,1000,960,40,0,0,0,0,0,16,15,0,1,0,8,14,false,false,true,0.542,0.458
319,319,0,15.95,16.789474,0,430,542,-112,0,1,0,0.052632,-16,20,19,-3,0,0,6,11,false,false,false,0.001,0.999
264,327,-63,16.5,21.8,-63,594,648,-54,1,1,0.0625,0.066667,6,16,15,6.666667,0,0,7,12,false,false,false,0,1
323,340,-17,21.533333,24.285714,-17,1101,1237,-136,1,0,0.066667,0,3,15,14,11.333333,0,0,15,9,false,false,false,0,1
56,93,-37,14,23.25,-37,561,688,-127,0,0,0,0,71,4,4,0.647887,0,1,8,6,false,false,false,0.101,0.899
181,221,-40,25.857143,31.571429,-40,1793,1957,-164,0,0,0,0,45,7,7,0.644444,0,1,7,10,false,false,false,0.039,0.961
24,16,8,12,16,8,527,954,-427,0,0,0,0,88,2,1,0.397727,0,0,20,13,false,false,false,0.251,0.749
43,88,-45,14.333333,29.333333,-45,837,844,-7,0,0,0,0,83,3,3,0.493976,0,1,11,16,false,false,false,0.003,0.997
264,393,-129,11.478261,17.086957,-129,1248,1220,28,0,1,0,0.043478,-21,23,23,-2.47619,1,0,4,6,false,false,false,0,1
19,50,-31,6.333333,25,-31,1078,983,95,0,0,0,0,86,3,2,0.55814,1,0,10,9,false,false,false,0.229,0.771
223,242,-19,18.583333,22,-19,1422,1583,-161,0,1,0,0.090909,23,12,11,1.782609,1,1,7,14,false,false,false,0.035,0.965
214,315,-101,30.571429,45,-101,1689,1777,-88,1,1,0.142857,0.142857,33,7,7,0.909091,0,0,20,11,false,false,false,0,1
242,404,-162,12.1,20.2,-162,977,1100,-123,0,1,0,0.05,-19,20,20,-2.157895,0,0,3,2,false,false,false,0,1
152,178,-26,15.2,19.777778,-26,1047,1253,-206,1,0,0.1,0,41,10,9,0.902439,0,0,16,10,false,false,false,0.24,0.76
102,226,-124,10.2,25.111111,-124,530,683,-153,0,1,0,0.111111,48,10,9,0.833333,0,0,15,10,false,false,false,0,1
266,300,-34,22.166667,25,-34,1452,1388,64,0,1,0,0.083333,13,12,12,2.692308,0,0,11,15,false,false,false,0.01,0.99
56,56,0,18.666667,18.666667,0,1161,1176,-15,0,0,0,0,77,3,3,0.493506,0,0,10,7,false,false,true,0.679,0.321
14,0,14,14,0,14,1071,1000,71,0,0,0,0,96,1,0,0.489583,0,0,10,0,false,false,true,0.679,0.321
117,189,-72,23.4,47.25,-72,1388,1455,-67,0,0,0,0,57,5,4,0.491228,1,0,13,7,false,false,false,0.087,0.913
284,388,-104,25.818182,35.272727,-104,1770,1751,19,0,1,0,0.090909,8,11,11,3.625,0,0,15,13,false,false,false,0,1
168,216,-48,16.8,24,-48,1229,1220,9,0,1,0,0.111111,35,10,9,1.057143,0,0,12,8,false,false,false,0.157,0.843
74,92,-18,18.5,23,-18,939,969,-30,0,0,0,0,67,4,4,0.492537,0,0,9,10,false,false,true,0.667,0.333
146,310,-164,13.272727,31,-164,1422,1510,-88,0,2,0,0.2,38,11,10,1.026316,0,0,12,14,false,false,false,0,1
78,151,-73,13,30.2,-73,1793,1869,-76,0,1,0,0.2,63,6,5,0.47619,1,0,12,8,false,false,false,0.103,0.897
309,368,-59,22.071429,26.285714,-59,1071,1065,6,0,0,0,0,-11,14,14,-2.818182,0,0,3,1,false,false,false,0,1
74,162,-88,24.666667,54,-88,1633,1680,-47,0,1,0,0.333333,64,3,3,0.4375,0,0,13,21,false,false,false,0.099,0.901
0,0,0,0,0,0,1586,1633,-47,0,0,0,0,100,3,2,0.34,0,0,8,0,false,false,false,0.273,0.727
226,261,-35,17.384615,21.75,-35,595,733,-138,1,1,0.076923,0.083333,11,13,12,3.545455,0,1,19,18,false,false,false,0,1
96,129,-33,19.2,25.8,-33,1407,1473,-66,0,1,0,0.2,65,5,5,0.476923,0,0,10,9,false,false,false,0.21,0.79
288,383,-95,15.157895,21.277778,-95,1195,1397,-202,0,2,0,0.111111,-15,19,18,-2.666667,0,1,4,4,false,false,false,0,1
239,291,-52,19.916667,24.25,-52,954,939,15,1,0,0.083333,0,11,12,12,3.272727,0,1,8,13,false,false,false,0,1
232,250,-18,25.777778,27.777778,-18,1188,1334,-146,1,1,0.111111,0.111111,23,9,9,1.304348,1,0,16,13,false,false,true,0.915,0.085
69,101,-32,11.5,20.2,-32,913,1037,-124,0,1,0,0.2,73,6,5,0.561644,0,0,29,12,false,false,false,0.052,0.948
169,167,2,21.125,23.857143,2,1636,1702,-66,0,1,0,0.142857,52,8,7,0.557692,0,1,17,12,false,false,false,0.199,0.801
14,0,14,14,0,14,1633,1739,-106,0,0,0,0,96,1,0,0.354167,0,0,11,0,false,false,true,0.614,0.386
264,361,-97,16.5,24.066667,-97,1193,1177,16,0,1,0,0.066667,0,16,15,0,1,1,4,9,false,false,false,0,1
120,524,-404,6.315789,29.111111,-404,1164,1149,15,0,3,0,0.166667,14,19,18,3.357143,0,1,12,10,false,false,false,0.004,0.996
296,319,-23,18.5,19.9375,-23,758,904,-146,1,0,0.0625,0,-17,16,16,-2,0,0,2,3,false,false,false,0.045,0.955
285,312,-27,12.954545,14.181818,-27,999,1165,-166,0,0,0,0,-17,22,22,-2.705882,1,1,17,6,false,false,false,0.072,0.928
336,345,-9,15.272727,16.428571,-9,1168,1062,106,0,0,0,0,-16,22,21,-2.6875,0,0,2,1,true,false,false,0.049,0.951
187,300,-113,20.777778,37.5,-113,2143,2219,-76,0,0,0,0,33,9,8,0.939394,0,0,15,16,false,false,false,0,1
320,287,33,20,19.133333,33,1331,1374,-43,0,0,0,0,-10,16,15,-3.3,0,0,10,1,false,false,true,0.708,0.292
64,133,-69,16,33.25,-69,1885,1842,43,0,1,0,0.25,67,4,4,0.402985,0,0,11,8,false,false,false,0.099,0.901
74,116,-42,24.666667,58,-42,1331,1432,-101,0,0,0,0,72,3,2,0.375,0,0,10,13,false,false,false,0.016,0.984
166,218,-52,16.6,24.222222,-52,964,1003,-39,0,1,0,0.111111,35,10,9,1.114286,1,0,16,8,false,false,false,0.198,0.802
231,292,-61,15.4,19.466667,-61,402,448,-46,0,0,0,0,-2,15,15,-18.5,0,1,20,15,false,false,false,0,1
75,101,-26,18.75,33.666667,-26,1219,1216,3,0,1,0,0.333333,72,4,3,0.375,0,0,12,10,false,false,false,0.203,0.797
189,264,-75,15.75,22,-75,952,826,126,0,1,0,0.083333,26,12,12,1.653846,0,0,7,10,false,false,false,0,1
150,215,-65,12.5,17.916667,-65,1182,1075,107,0,1,0,0.083333,17,12,12,2.294118,0,1,21,10,false,false,false,0.004,0.996
229,234,-5,17.615385,19.5,-5,804,766,38,0,1,0,0.083333,31,13,12,1.322581,0,1,9,10,false,false,false,0.064,0.936
19,56,-37,9.5,28,-37,803,786,17,0,0,0,0,86,2,2,0.372093,0,0,17,9,false,false,true,0.608,0.392
173,135,38,24.714286,19.285714,38,1341,1606,-265,1,0,0.142857,0,43,7,7,0.767442,0,0,10,7,false,false,false,0.402,0.598
62,52,10,20.666667,17.333333,10,388,542,-154,0,0,0,0,74,3,3,0.5,0,0,16,17,false,false,false,0.268,0.732
217,171,46,21.7,19,46,1341,1606,-265,1,0,0.1,0,27,10,9,1.222222,0,0,20,14,false,false,true,0.64,0.36
316,401,-85,21.066667,28.642857,-85,1556,1616,-60,0,0,0,0,-8,15,14,-3.625,0,0,2,1,true,false,false,0,1
186,326,-140,16.909091,29.636364,-140,1699,1803,-104,1,1,0.090909,0.090909,36,11,11,0.972222,0,0,10,22,false,false,false,0,1
170,187,-17,28.333333,31.166667,-17,801,679,122,1,0,0.166667,0,48,6,6,0.604167,0,0,10,12,false,false,false,0.214,0.786
97,152,-55,19.4,30.4,-55,1167,1245,-78,0,0,0,0,54,5,5,0.425926,0,0,11,10,false,false,false,0.233,0.767
53,148,-95,10.6,37,-95,760,976,-216,0,1,0,0.25,65,5,4,0.553846,0,0,14,19,false,false,false,0.006,0.994
189,259,-70,15.75,23.545455,-70,952,826,126,0,1,0,0.090909,30,12,11,1.433333,0,0,7,10,false,false,false,0,1
34,27,7,17,13.5,7,1101,1237,-136,0,0,0,0,84,2,2,0.404762,0,1,9,7,false,false,false,0.254,0.746
215,183,32,35.833333,36.6,32,820,718,102,0,2,0,0.4,47,6,5,0.595745,0,0,15,20,false,false,true,0.766,0.234
178,194,-16,16.181818,19.4,-16,1040,1364,-324,0,0,0,0,23,11,10,1.565217,0,0,23,12,false,false,false,0.242,0.758
337,287,50,22.466667,19.133333,50,1093,1173,-80,1,0,0.066667,0,5,15,15,8.6,0,0,8,8,false,false,true,1,0
312,333,-21,19.5,22.2,-21,1075,878,197,0,1,0,0.066667,-5,16,15,-6.6,0,0,5,4,false,false,false,0.004,0.996
110,101,9,18.333333,20.2,9,700,820,-120,0,0,0,0,61,6,5,0.622951,0,0,14,8,false,false,false,0.252,0.748
154,157,-3,19.25,19.625,-3,1407,1473,-66,0,1,0,0.125,45,8,8,0.688889,0,0,7,11,false,false,false,0.234,0.766
79,62,17,15.8,15.5,17,720,437,283,0,0,0,0,75,5,4,0.56,0,0,17,19,false,false,false,0.238,0.762
14,0,14,14,0,14,1310,1477,-167,0,0,0,0,96,1,0,0.375,0,0,7,0,false,false,false,0.251,0.749
253,244,9,19.461538,18.769231,9,664,786,-122,0,0,0,0,9,13,13,3.666667,1,0,11,14,false,false,true,0.632,0.368
262,293,-31,15.411765,18.3125,-31,1176,1211,-35,0,1,0,0.0625,-18,17,16,-1.833333,0,0,3,1,true,false,false,0.001,0.999
37,172,-135,9.25,43,-135,1305,1307,-2,0,1,0,0.25,67,4,4,0.61194,0,0,8,14,false,false,false,0,1
112,154,-42,16,22,-42,1203,1270,-67,0,0,0,0,57,7,7,0.77193,1,0,10,11,false,false,false,0.05,0.95
76,62,14,15.2,15.5,14,1312,1334,-22,0,0,0,0,68,5,4,0.573529,0,0,22,24,false,false,false,0.472,0.528
275,352,-77,21.153846,27.076923,-77,1274,1394,-120,0,1,0,0.076923,-1,13,13,-30,0,0,18,5,false,false,false,0,1
266,316,-50,20.461538,24.307692,-50,1397,1309,88,2,0,0.153846,0,18,13,13,2,0,0,9,8,false,false,false,0,1
193,198,-5,32.166667,33,-5,1086,926,160,0,1,0,0.166667,50,6,6,0.56,0,0,12,11,false,false,false,0.21,0.79
111,170,-59,13.875,24.285714,-59,342,263,79,0,0,0,0,44,8,7,0.772727,0,0,11,19,false,false,false,0.026,0.974
217,188,29,21.7,20.888889,29,1691,1551,140,0,0,0,0,37,10,9,1,1,1,6,18,false,false,true,0.573,0.427
238,205,33,21.636364,18.636364,33,1168,1216,-48,0,0,0,0,39,11,11,0.846154,0,0,10,9,false,false,true,0.614,0.386
159,141,18,22.714286,23.5,18,689,804,-115,0,0,0,0,48,7,6,0.729167,0,0,7,23,false,false,false,0.261,0.739
297,265,32,33,29.444444,32,169,306,-137,2,1,0.222222,0.111111,15,9,9,2.066667,0,0,14,12,false,false,false,0.252,0.748
253,287,-34,18.071429,22.076923,-34,1210,1162,48,0,0,0,0,10,14,13,3.2,1,0,13,9,false,false,false,0.204,0.796
131,226,-95,32.75,56.5,-95,2147,2219,-72,0,2,0,0.5,60,4,4,0.4,0,0,11,10,false,false,true,0.71,0.29
199,246,-47,24.875,35.142857,-47,1253,1324,-71,0,1,0,0.142857,39,8,7,0.74359,0,0,20,7,false,false,false,0.2,0.8
215,246,-31,26.875,30.75,-31,1770,1751,19,0,1,0,0.125,34,8,8,0.852941,0,0,14,10,false,false,false,0.176,0.824
174,200,-26,15.818182,20,-26,360,371,-11,0,0,0,0,18,11,10,2.055556,1,0,9,7,false,false,true,0.798,0.202
41,51,-10,13.666667,17,-10,1047,1127,-80,0,0,0,0,76,3,3,0.355263,1,1,16,9,false,false,false,0.301,0.699
2,12,-10,1,12,-10,1793,1869,-76,0,0,0,0,95,2,1,0.315789,0,0,11,12,false,false,false,0.232,0.768
14,23,-9,14,23,-9,1633,1739,-106,0,0,0,0,93,1,1,0.365591,0,0,11,13,false,false,true,0.661,0.339
283,300,-17,16.647059,17.647059,-17,704,523,181,0,0,0,0,-26,17,17,-1.346154,0,0,1,3,false,false,false,0.012,0.988
146,138,8,20.857143,23,8,1168,1062,106,0,0,0,0,57,7,6,0.754386,0,0,11,16,false,false,false,0.205,0.795
309,310,-1,23.769231,25.833333,-1,1305,1211,94,2,0,0.153846,0,12,13,12,2.75,0,0,15,8,false,false,false,0.234,0.766
284,335,-51,15.777778,18.611111,-51,500,509,-9,0,0,0,0,-15,18,18,-2.733333,0,0,7,3,false,false,false,0,1
135,165,-30,16.875,20.625,-30,1484,1556,-72,0,1,0,0.125,37,8,8,0.837838,1,0,12,11,false,false,false,0.214,0.786
249,334,-85,24.9,33.4,-85,1556,1616,-60,0,0,0,0,18,10,10,1.611111,0,0,11,10,false,false,false,0,1
221,215,6,15.785714,16.538462,6,1580,1629,-49,0,0,0,0,12,14,13,3.083333,0,1,16,9,false,false,false,0.475,0.525
110,158,-48,13.75,22.571429,-48,1161,1176,-15,0,1,0,0.142857,46,8,7,0.826087,0,0,13,8,false,false,false,0.197,0.803
222,270,-48,18.5,22.5,-48,668,771,-103,0,0,0,0,24,12,12,1.666667,1,0,12,11,false,false,false,0.019,0.981
132,246,-114,18.857143,35.142857,-114,1576,1556,20,0,1,0,0.142857,44,7,7,0.681818,0,0,19,7,false,false,false,0,1
280,351,-71,14.736842,19.5,-71,1064,1397,-333,0,2,0,0.111111,-4,19,18,-10.75,1,1,9,8,false,false,false,0,1
12,0,12,12,0,12,1495,1597,-102,0,0,0,0,96,1,0,0.333333,0,0,24,0,false,false,true,0.602,0.398
38,57,-19,9.5,19,-19,951,976,-25,0,0,0,0,77,4,3,0.571429,1,1,18,29,false,false,false,0.005,0.995
173,87,86,57.666667,43.5,86,169,306,-137,2,1,0.666667,0.5,66,3,2,0.469697,0,0,12,16,false,false,false,0.401,0.599
181,212,-31,20.111111,26.5,-31,503,527,-24,0,1,0,0.125,30,9,8,1.1,0,0,10,11,false,false,false,0.208,0.792
65,153,-88,9.285714,25.5,-88,595,662,-67,0,1,0,0.166667,52,7,6,0.846154,0,0,23,7,false,false,false,0.035,0.965
124,145,-21,20.666667,24.166667,-21,921,1045,-124,0,0,0,0,57,6,6,0.614035,0,0,7,10,false,false,false,0.238,0.762
185,279,-94,11.5625,17.4375,-94,651,700,-49,0,0,0,0,-1,16,16,-56,1,1,7,13,false,false,false,0,1
246,257,-11,18.923077,21.416667,-11,450,624,-174,0,0,0,0,7,13,12,4.714286,0,0,10,7,false,false,false,0.424,0.576
247,279,-32,27.444444,34.875,-32,1086,926,160,0,1,0,0.125,29,9,8,0.965517,0,0,10,8,false,false,false,0.061,0.939
32,48,-16,10.666667,16,-16,526,502,24,0,0,0,0,81,3,3,0.617284,0,0,18,17,false,false,false,0.327,0.673
325,423,-98,23.214286,30.214286,-98,1537,1539,-2,0,1,0,0.071429,-4,14,14,-8.5,0,1,7,9,false,false,false,0,1
187,472,-285,18.7,47.2,-285,1632,2020,-388,0,2,0,0.2,18,10,10,1.722222,0,0,18,12,false,false,false,0,1
157,168,-11,15.7,16.8,-11,450,503,-53,0,0,0,0,34,10,10,1.147059,1,0,19,14,false,false,true,0.644,0.356
221,315,-94,18.416667,26.25,-94,1408,1539,-131,0,1,0,0.083333,6,12,12,5.666667,0,1,9,17,false,false,false,0,1
115,135,-20,16.428571,22.5,-20,803,786,17,0,0,0,0,59,7,6,0.542373,0,0,12,10,false,false,false,0.124,0.876
208,334,-126,18.909091,30.363636,-126,1606,1593,13,0,1,0,0.090909,15,11,11,1.933333,0,0,7,16,false,false,false,0,1
243,307,-64,22.090909,27.909091,-64,1176,1133,43,1,0,0.090909,0,29,11,11,1.172414,0,0,10,12,false,false,false,0,1
136,149,-13,17,18.625,-13,599,448,151,0,0,0,0,43,8,8,0.837209,0,1,23,9,false,false,false,0.328,0.672
264,367,-103,18.857143,28.230769,-103,1572,1777,-205,0,2,0,0.153846,-6,14,13,-5.5,0,0,17,15,false,false,false,0,1
123,131,-8,15.375,18.714286,-8,651,700,-49,0,0,0,0,50,8,7,1.12,1,0,9,21,false,false,false,0.257,0.743
8,25,-17,8,25,-17,840,1055,-215,0,0,0,0,93,1,1,0.376344,0,0,10,14,false,false,false,0.251,0.749
56,40,16,28,20,16,451,448,3,0,0,0,0,88,2,2,0.420455,0,1,16,9,false,false,false,0.291,0.709
128,229,-101,9.142857,17.615385,-101,651,567,84,0,0,0,0,20,14,13,2.75,0,0,7,18,false,false,false,0,1
166,271,-105,16.6,27.1,-105,965,1078,-113,0,1,0,0.1,31,10,10,1.193548,0,0,14,13,false,false,false,0,1
228,265,-37,20.727273,24.090909,-37,1691,1551,140,0,0,0,0,28,11,11,1.321429,1,0,6,13,false,false,false,0.037,0.963
208,212,-4,18.909091,21.2,-4,1331,1374,-43,0,0,0,0,24,11,10,1.375,1,0,15,7,false,false,false,0.311,0.689
308,297,11,23.692308,24.75,11,1563,1539,24,0,1,0,0.083333,4,13,12,8.75,0,0,10,11,false,false,false,0.156,0.844
293,445,-152,22.538462,34.230769,-152,786,848,-62,0,2,0,0.153846,5,13,13,6.2,0,0,8,9,false,false,false,0,1
133,192,-59,22.166667,32,-59,1003,1004,-1,0,1,0,0.166667,59,6,6,0.59322,0,1,18,9,false,false,false,0.166,0.834
253,333,-80,16.866667,23.785714,-80,935,995,-60,1,1,0.066667,0.071429,7,15,14,5.571429,0,0,16,14,false,false,false,0,1
73,66,7,24.333333,33,7,820,718,102,0,1,0,0.5,78,3,2,0.358974,0,1,17,8,false,false,true,0.56,0.44
247,313,-66,11.227273,14.227273,-66,1220,1202,18,0,0,0,0,-23,22,22,-2.173913,0,1,26,12,false,false,false,0,1
256,341,-85,18.285714,26.230769,-85,1315,1331,-16,0,0,0,0,2,14,13,16.5,0,0,8,7,false,false,false,0,1
26,0,26,26,0,26,726,818,-92,0,0,0,0,94,1,0,0.37234,0,0,7,0,false,false,false,0.259,0.741
202,215,-13,18.363636,21.5,-13,1432,1452,-20,0,1,0,0.1,27,11,10,1.333333,1,0,8,16,false,false,false,0.179,0.821
57,119,-62,19,39.666667,-62,907,910,-3,0,1,0,0.333333,81,3,3,0.530864,0,0,9,12,false,false,false,0.201,0.799
64,67,-3,12.8,16.75,-3,1269,1477,-208,0,0,0,0,73,5,4,0.479452,1,0,6,14,false,false,false,0.25,0.75
220,319,-99,11.578947,17.722222,-99,388,542,-154,0,0,0,0,-17,19,18,-2.176471,0,1,4,2,true,false,false,0,1
74,108,-34,14.8,27,-34,1633,1739,-106,0,0,0,0,75,5,4,0.453333,0,0,11,9,false,false,false,0.051,0.949
288,428,-140,20.571429,30.571429,-140,1636,1727,-91,0,2,0,0.142857,-9,14,14,-3.333333,0,0,2,6,false,false,false,0,1
339,425,-86,26.076923,35.416667,-86,2143,2219,-76,1,0,0.076923,0,-1,13,12,-31,0,0,7,7,false,false,false,0,1
134,129,5,33.5,32.25,5,714,820,-106,1,0,0.25,0,70,4,4,0.442857,0,0,11,10,false,false,false,0.023,0.977
285,392,-107,15,21.777778,-107,1003,1018,-15,0,0,0,0,-37,19,18,-1,0,0,1,2,true,false,false,0,1
46,39,7,15.333333,19.5,7,939,969,-30,0,0,0,0,80,3,2,0.4125,0,0,11,19,false,false,true,0.558,0.442
154,119,35,22,19.833333,35,1257,1176,81,1,0,0.142857,0,61,7,6,0.557377,1,0,15,8,false,false,true,0.924,0.076
87,96,-9,14.5,19.2,-9,451,448,3,0,0,0,0,66,6,5,0.560606,0,1,13,12,false,false,false,0.059,0.941
50,68,-18,12.5,22.666667,-18,980,965,15,0,0,0,0,78,4,3,0.487179,0,1,22,8,false,false,false,0.416,0.584
196,218,-22,16.333333,19.818182,-22,803,786,17,0,0,0,0,26,12,11,1.230769,1,0,8,10,false,false,false,0.306,0.694
208,214,-6,14.857143,16.461538,-6,1193,1220,-27,0,0,0,0,15,14,13,2.866667,1,0,6,12,false,false,false,0.283,0.717
63,52,11,21,26,11,642,952,-310,0,0,0,0,82,3,2,0.536585,0,0,11,7,false,false,false,0.251,0.749
118,130,-12,13.111111,14.444444,-12,808,749,59,0,0,0,0,33,9,9,1.272727,0,0,21,10,false,false,true,0.545,0.455
218,284,-66,12.823529,17.75,-66,1248,1220,28,0,1,0,0.0625,10,17,16,5.2,1,0,6,16,false,false,false,0.001,0.999
258,300,-42,23.454545,27.272727,-42,1331,1347,-16,1,1,0.090909,0.090909,7,11,11,4.571429,0,1,7,9,false,false,false,0.008,0.992
50,25,25,25,12.5,25,1305,1254,51,0,0,0,0,89,2,2,0.359551,0,1,10,6,false,false,true,0.753,0.247
242,299,-57,16.133333,21.357143,-57,344,315,29,1,1,0.066667,0.071429,-11,15,14,-3.636364,0,0,22,10,false,false,false,0,1
89,116,-27,17.8,23.2,-27,599,448,151,0,0,0,0,63,5,5,0.571429,0,0,7,10,false,false,false,0.271,0.729
330,405,-75,19.411765,23.823529,-75,1176,1133,43,1,0,0.058824,0,-5,17,17,-6.8,0,0,2,3,true,false,false,0,1
33,22,11,11,11,11,542,605,-63,0,0,0,0,81,3,2,0.444444,1,0,16,11,false,false,false,0.36,0.64
222,304,-82,18.5,25.333333,-82,1495,1531,-36,0,1,0,0.083333,22,12,12,1.681818,1,0,8,10,false,false,false,0.005,0.995
75,115,-40,15,28.75,-40,1488,1403,85,0,1,0,0.25,65,5,4,0.523077,0,0,21,13,false,false,false,0.208,0.792
0,0,0,0,0,0,1454,1479,-25,0,0,0,0,100,1,0,0.31,1,0,8,0,false,false,true,0.669,0.331
87,97,-10,21.75,24.25,-10,965,1078,-113,0,0,0,0,70,4,4,0.528571,0,0,8,16,false,false,false,0.25,0.75
197,327,-130,13.133333,21.8,-130,948,998,-50,0,0,0,0,-3,15,15,-12.333333,0,0,10,9,false,false,false,0,1
12,74,-62,12,74,-62,1554,1685,-131,0,1,0,1,90,1,1,0.355556,0,0,9,9,false,false,false,0.2,0.8
263,281,-18,14.611111,15.611111,-18,797,796,1,0,0,0,0,-2,18,18,-24.5,1,0,8,14,false,false,true,0.708,0.292
308,410,-102,23.692308,31.538462,-102,1415,1361,54,0,1,0,0.076923,1,13,13,31,0,1,13,10,false,false,false,0,1
270,347,-77,15.882353,21.6875,-77,341,416,-75,0,0,0,0,-9,17,16,-4.333333,0,1,7,6,false,false,false,0,1
153,261,-108,15.3,26.1,-108,480,739,-259,0,0,0,0,37,10,10,1.054054,1,0,15,11,false,false,false,0,1
208,401,-193,23.111111,44.555556,-193,1539,1891,-352,0,2,0,0.222222,18,9,9,1.388889,1,0,15,9,false,false,false,0,1
308,292,16,28,29.2,16,169,306,-137,2,1,0.181818,0.1,5,11,10,6.2,0,0,10,7,false,false,false,0.232,0.768
218,292,-74,16.769231,22.461538,-74,452,698,-246,0,1,0,0.076923,12,13,13,3.416667,0,0,21,10,false,false,false,0,1
106,77,29,26.5,25.666667,29,1495,1531,-36,0,0,0,0,76,4,3,0.486842,0,0,12,8,false,false,true,0.681,0.319
135,150,-15,13.5,15,-15,306,302,4,0,0,0,0,35,10,10,1.171429,0,1,9,15,false,false,false,0.031,0.969
236,252,-16,13.882353,14.823529,-16,999,1071,-72,0,0,0,0,-6,17,17,-6.666667,0,0,8,14,false,false,false,0.051,0.949
187,238,-51,14.384615,18.307692,-51,518,414,104,0,1,0,0.076923,18,13,13,2.111111,0,0,7,13,false,false,false,0.075,0.925
110,129,-19,15.714286,18.428571,-19,1159,1131,28,0,1,0,0.142857,54,7,7,0.685185,0,1,8,7,false,false,false,0.209,0.791
213,341,-128,16.384615,28.416667,-128,926,973,-47,0,0,0,0,12,13,12,2.916667,0,0,10,16,false,false,false,0,1
238,273,-35,14,17.0625,-35,500,532,-32,0,0,0,0,-9,17,16,-4.555556,0,2,28,5,false,false,false,0,1
207,240,-33,20.7,26.666667,-33,689,804,-115,0,0,0,0,28,10,9,1.25,0,0,10,14,false,false,false,0.03,0.97
45,52,-7,15,17.333333,-7,1075,1189,-114,0,0,0,0,77,3,3,0.519481,0,0,7,23,false,false,false,0.234,0.766
189,209,-20,17.181818,20.9,-20,889,895,-6,0,1,0,0.1,29,11,10,1.275862,0,1,10,21,false,false,false,0.044,0.956
258,279,-21,14.333333,15.5,-21,1182,1075,107,0,1,0,0.055556,-20,18,18,-1.95,0,1,15,3,false,false,false,0.013,0.987
130,95,35,26,23.75,35,1331,1347,-16,1,0,0.2,0,59,5,4,0.542373,0,0,11,21,false,false,true,0.686,0.314
313,352,-39,17.388889,20.705882,-39,727,820,-93,0,1,0,0.058824,-16,18,17,-2.1875,0,1,3,2,true,false,false,0,1
217,231,-14,19.727273,23.1,-14,971,635,336,0,0,0,0,23,11,10,1.391304,1,0,7,10,false,false,false,0.012,0.988
129,154,-25,21.5,25.666667,-25,1227,1189,38,0,0,0,0,52,6,6,0.673077,0,0,11,16,false,false,false,0.204,0.796
73,77,-4,14.6,19.25,-4,451,448,3,0,0,0,0,75,5,4,0.493333,0,1,13,9,false,false,false,0.113,0.887
76,70,6,15.2,17.5,6,999,1071,-72,0,0,0,0,67,5,4,0.597015,1,0,9,12,false,false,true,0.541,0.459
257,347,-90,14.277778,20.411765,-90,837,844,-7,0,0,0,0,-4,18,17,-10.25,1,0,4,7,false,false,false,0,1
290,352,-62,16.111111,20.705882,-62,1493,1453,40,0,0,0,0,-20,18,17,-1.75,0,2,1,2,true,false,false,0,1
174,135,39,24.857143,19.285714,39,1070,814,256,1,1,0.142857,0.142857,44,7,7,0.75,0,0,13,25,false,false,true,0.98,0.02
143,244,-101,14.3,27.111111,-101,595,412,183,0,1,0,0.111111,36,10,9,1.444444,0,0,10,12,false,false,false,0,1
41,54,-13,20.5,27,-13,341,416,-75,0,0,0,0,86,2,2,0.453488,0,0,8,20,false,false,false,0.145,0.855
79,110,-31,26.333333,55,-31,1925,1885,40,1,0,0.333333,0,74,3,2,0.337838,0,0,17,18,false,false,false,0.074,0.926
72,173,-101,24,57.666667,-101,1556,1656,-100,0,1,0,0.333333,70,3,3,0.428571,0,0,9,11,false,false,false,0.144,0.856
201,383,-182,20.1,38.3,-182,786,848,-62,0,2,0,0.2,26,10,10,1.192308,1,0,16,9,false,false,false,0,1
38,32,6,19,16,6,388,542,-154,0,0,0,0,80,2,2,0.4625,1,0,24,17,false,false,true,0.639,0.361
137,99,38,19.571429,16.5,38,691,704,-13,0,0,0,0,61,7,6,0.622951,0,0,7,9,false,false,true,0.572,0.428
280,363,-83,13.333333,18.15,-83,837,844,-7,0,0,0,0,-18,21,20,-2.277778,0,0,2,1,true,false,false,0,1
25,27,-2,12.5,27,-2,1572,1777,-205,0,0,0,0,87,2,1,0.37931,0,1,11,6,false,false,false,0.251,0.749
232,249,-17,19.333333,22.636364,-17,1078,1095,-17,1,1,0.083333,0.090909,21,12,11,1.761905,0,0,7,13,false,false,false,0.241,0.759
95,65,30,31.666667,21.666667,30,786,885,-99,1,0,0.333333,0,79,3,3,0.43038,0,1,7,16,false,false,false,0.026,0.974
309,340,-31,14.714286,16.190476,-31,1281,1268,13,0,0,0,0,-22,21,21,-1.909091,0,0,1,2,true,false,false,0,1
63,111,-48,12.6,22.2,-48,1210,1162,48,0,0,0,0,63,5,5,0.507937,0,0,7,16,false,false,false,0.2,0.8
56,13,43,28,13,43,387,683,-296,0,0,0,0,86,2,1,0.395349,1,0,9,8,false,false,true,0.615,0.385
88,114,-26,14.666667,19,-26,344,315,29,1,0,0.166667,0,48,6,6,0.833333,0,0,12,20,false,false,false,0.365,0.635
12,0,12,12,0,12,1043,1003,40,0,0,0,0,95,1,0,0.4,0,0,27,0,false,false,true,0.679,0.321
185,224,-39,16.818182,22.4,-39,1270,1424,-154,0,1,0,0.1,36,11,10,0.972222,0,2,26,5,false,false,false,0.266,0.734
111,114,-3,13.875,16.285714,-3,830,787,43,0,0,0,0,49,8,7,0.77551,0,0,16,13,false,false,false,0.324,0.676
6,0,6,6,0,6,917,856,61,0,0,0,0,97,1,0,0.340206,0,0,14,0,false,false,true,0.678,0.322
171,208,-37,17.1,20.8,-37,1037,1016,21,1,0,0.1,0,40,10,10,1.45,1,0,26,10,false,false,true,0.519,0.481
231,287,-56,13.588235,16.882353,-56,813,698,115,1,0,0.058824,0,2,17,17,24,0,0,8,22,false,false,false,0,1
227,354,-127,18.916667,29.5,-127,1101,1115,-14,0,1,0,0.083333,9,12,12,3.333333,0,0,9,8,false,false,false,0,1
112,96,16,12.444444,12,16,1045,948,97,0,0,0,0,42,9,8,0.809524,0,0,10,22,false,false,false,0.221,0.779
242,413,-171,13.444444,22.944444,-171,913,1037,-124,0,3,0,0.166667,-6,18,18,-6.833333,0,0,23,11,false,false,false,0.001,0.999
244,304,-60,18.769231,25.333333,-60,1495,1531,-36,0,1,0,0.083333,18,13,12,2.055556,1,0,16,10,false,false,false,0.022,0.978
156,180,-24,17.333333,22.5,-24,691,704,-13,0,1,0,0.125,46,9,8,0.826087,0,0,11,17,false,false,false,0.058,0.942
126,129,-3,15.75,18.428571,-3,1159,1131,28,0,1,0,0.142857,51,8,7,0.72549,0,1,7,7,false,false,false,0.211,0.789
112,52,60,37.333333,17.333333,60,1156,1279,-123,1,0,0.333333,0,75,3,3,0.533333,0,0,14,12,false,false,true,0.514,0.486
111,136,-25,22.2,34,-25,907,910,-3,0,1,0,0.25,70,5,4,0.614286,0,0,18,13,false,false,false,0.204,0.796
346,342,4,21.625,22.8,4,1563,1539,24,0,1,0,0.066667,-18,16,15,-1.944444,0,0,1,3,false,false,false,0.042,0.958
88,52,36,29.333333,26,36,1164,1149,15,0,0,0,0,82,3,2,0.573171,0,0,9,13,false,false,true,0.69,0.31
85,70,15,17,17.5,15,603,721,-118,0,0,0,0,74,5,4,0.581081,0,1,14,15,false,false,false,0.229,0.771
320,423,-103,11.034483,15.107143,-103,1037,1016,21,1,0,0.034483,0,-31,29,28,-1.870968,1,0,0,5,false,false,false,0,1
96,135,-39,12,19.285714,-39,1071,1000,71,0,0,0,0,57,8,7,0.824561,1,1,6,16,false,false,false,0.016,0.984
270,301,-31,16.875,18.8125,-31,599,448,151,0,0,0,0,-3,16,16,-12,0,1,8,13,false,false,false,0,1
225,253,-28,22.5,25.3,-28,1176,1133,43,1,0,0.1,0,37,10,10,0.918919,0,0,8,19,false,false,false,0.036,0.964
109,153,-44,18.166667,25.5,-44,1636,1796,-160,0,0,0,0,53,6,6,0.509434,0,0,12,16,false,false,false,0.049,0.951
82,130,-48,13.666667,26,-48,1030,1014,16,0,0,0,0,68,6,5,0.485294,1,0,9,11,false,false,false,0.119,0.881
163,241,-78,12.538462,18.538462,-78,1045,948,97,0,0,0,0,2,13,13,17,1,0,17,12,false,false,false,0.005,0.995
283,347,-64,15.722222,20.411765,-64,736,791,-55,0,0,0,0,-19,18,17,-2,0,0,4,3,false,false,false,0,1
102,123,-21,20.4,30.75,-21,1645,1636,9,0,1,0,0.25,60,5,4,0.55,0,0,17,17,false,false,false,0.201,0.799
258,331,-73,16.125,22.066667,-73,341,416,-75,0,0,0,0,-2,16,15,-19.5,0,1,9,9,false,false,false,0,1
0,0,0,0,0,0,2147,2219,-72,0,0,0,0,100,1,0,0.24,0,0,11,0,false,false,true,0.675,0.325
64,100,-36,9.142857,16.666667,-36,970,1030,-60,0,0,0,0,56,7,6,0.714286,0,0,27,10,false,false,false,0.138,0.862
288,355,-67,18,22.1875,-67,1047,1253,-206,1,1,0.0625,0.0625,-5,16,16,-7.4,1,0,8,16,false,false,false,0,1
170,218,-48,28.333333,36.333333,-48,1436,1489,-53,1,1,0.166667,0.166667,56,6,6,0.660714,0,0,10,10,false,false,false,0.248,0.752
319,420,-101,24.538462,32.307692,-101,1689,1777,-88,1,1,0.076923,0.076923,-7,13,13,-4.285714,0,0,8,6,false,false,false,0,1
266,276,-10,17.733333,19.714286,-10,518,461,57,0,0,0,0,-1,15,14,-36,0,1,7,8,false,false,false,0.281,0.719
276,281,-5,25.090909,28.1,-5,1793,1869,-76,0,1,0,0.1,19,11,10,1.578947,1,0,15,7,false,false,true,0.612,0.388
66,54,12,22,18,12,1793,1957,-164,0,0,0,0,80,3,3,0.3625,0,1,8,15,false,false,false,0.253,0.747
62,70,-8,15.5,17.5,-8,360,371,-11,0,0,0,0,72,4,4,0.513889,0,0,12,13,false,false,false,0.263,0.737
132,163,-31,14.666667,20.375,-31,951,976,-25,0,0,0,0,48,9,8,0.916667,0,0,19,16,false,false,false,0.039,0.961
265,335,-70,24.090909,30.454545,-70,1495,1597,-102,0,1,0,0.090909,17,11,11,1.882353,0,0,8,8,false,false,false,0,1
239,388,-149,18.384615,32.333333,-149,842,926,-84,0,1,0,0.083333,-4,13,12,-7.5,0,0,12,16,false,false,false,0,1
259,327,-68,14.388889,18.166667,-68,95,453,-358,0,0,0,0,-12,18,18,-3.25,0,0,2,4,false,false,false,0,1
141,147,-6,11.75,13.363636,-6,1278,1101,177,0,0,0,0,32,12,11,1.15625,1,1,18,11,false,false,false,0.218,0.782
83,79,4,16.6,15.8,4,1161,1176,-15,0,0,0,0,66,5,5,0.575758,0,2,10,5,false,false,false,0.34,0.66
263,343,-80,10.115385,13.192308,-80,818,826,-8,0,0,0,0,-45,26,26,-1.177778,0,0,2,4,false,false,false,0,1
12,8,4,6,8,4,710,758,-48,0,0,0,0,91,2,1,0.406593,0,0,19,11,false,false,false,0.253,0.747
118,116,2,23.6,29,2,1586,1633,-47,1,0,0.2,0,74,5,4,0.459459,0,0,17,9,false,false,true,0.615,0.385
57,188,-131,9.5,31.333333,-131,1305,1307,-2,0,1,0,0.166667,58,6,6,0.706897,0,0,11,13,false,false,false,0,1
324,348,-24,20.25,23.2,-24,917,856,61,1,1,0.0625,0.066667,-6,16,15,-5.5,0,0,1,2,false,false,false,0,1
33,103,-70,11,34.333333,-70,1803,1658,145,0,0,0,0,73,3,3,0.452055,1,0,8,13,false,false,false,0.033,0.967
96,216,-120,16,36,-120,1232,1281,-49,0,2,0,0.333333,44,6,6,0.704545,0,0,12,18,false,false,false,0,1
78,118,-40,15.6,29.5,-40,1633,1620,13,0,0,0,0,69,5,4,0.521739,0,0,13,11,false,false,false,0.201,0.799
323,359,-36,20.1875,22.4375,-36,721,757,-36,0,2,0,0.125,-6,16,16,-6.333333,0,0,3,6,false,false,false,0,1
267,342,-75,20.538462,28.5,-75,732,868,-136,0,1,0,0.083333,5,13,12,6.4,0,0,10,20,false,false,false,0,1
0,40,-40,0,20,-40,1334,1439,-105,0,0,0,0,95,2,2,0.378947,2,0,12,15,false,false,false,0.496,0.504
297,355,-58,18.5625,23.666667,-58,1126,1277,-151,0,0,0,0,-16,16,15,-2.1875,0,0,1,8,false,false,false,0,1
259,327,-68,14.388889,19.235294,-68,95,453,-358,0,0,0,0,-12,18,17,-3.25,0,0,2,4,false,false,false,0,1
237,223,14,21.545455,20.272727,14,1803,1658,145,1,0,0.090909,0,17,11,11,1.941176,0,0,14,19,false,false,false,0.271,0.729
125,116,9,17.857143,19.333333,9,758,791,-33,0,0,0,0,53,7,6,0.735849,0,1,12,12,false,false,false,0.244,0.756
29,50,-21,14.5,25,-21,1030,1014,16,0,0,0,0,89,2,2,0.370787,1,0,6,14,false,false,true,0.645,0.355
220,308,-88,12.941176,19.25,-88,907,878,29,0,0,0,0,11,17,16,3.909091,2,0,6,18,false,false,false,0,1
41,21,20,20.5,21,20,1245,1148,97,0,0,0,0,89,2,1,0.393258,0,0,16,20,false,false,true,0.654,0.346
143,99,44,23.833333,19.8,44,967,856,111,0,0,0,0,57,6,5,0.578947,0,0,9,24,false,false,true,0.674,0.326
250,307,-57,15.625,19.1875,-57,889,855,34,0,1,0,0.0625,-2,16,16,-20,0,1,11,7,false,false,false,0,1
223,256,-33,18.583333,21.333333,-33,1422,1583,-161,0,1,0,0.083333,20,12,12,2.05,1,1,7,14,false,false,false,0.03,0.97
186,267,-81,13.285714,19.071429,-81,907,878,29,0,0,0,0,28,14,14,1.535714,1,0,8,8,false,false,false,0.017,0.983
119,183,-64,13.222222,22.875,-64,948,998,-50,0,0,0,0,40,9,8,0.925,1,0,7,14,false,false,false,0.038,0.962
177,256,-79,12.642857,18.285714,-79,1248,1220,28,0,1,0,0.071429,23,14,14,2.26087,1,0,6,14,false,false,false,0.003,0.997
223,314,-91,11.736842,16.526316,-91,595,662,-67,0,1,0,0.052632,-17,19,19,-2.588235,0,0,5,10,false,false,false,0,1
86,83,3,21.5,20.75,3,621,786,-165,0,0,0,0,64,4,4,0.46875,0,0,13,14,false,false,false,0.252,0.748
21,22,-1,10.5,11,-1,542,605,-63,0,0,0,0,84,2,2,0.428571,1,0,12,11,false,false,false,0.314,0.686
214,277,-63,17.833333,23.083333,-63,452,698,-246,0,1,0,0.083333,19,12,12,2.157895,0,0,21,10,false,false,false,0,1
209,313,-104,23.222222,34.777778,-104,1793,1957,-164,0,1,0,0.111111,30,9,9,0.966667,0,0,11,7,false,false,false,0,1
250,270,-20,17.857143,19.285714,-20,1000,960,40,0,0,0,0,8,14,14,5.625,0,0,7,10,false,false,false,0.209,0.791
285,318,-33,13.571429,15.142857,-33,526,502,24,0,0,0,0,-23,21,21,-2.173913,1,0,18,15,false,false,false,0.006,0.994
349,363,-14,24.928571,25.928571,-14,714,820,-106,1,0,0.071429,0,-1,14,14,-31,0,0,4,2,false,false,false,0.001,0.999
0,14,-14,0,14,-14,1636,1702,-66,0,0,0,0,97,1,1,0.298969,0,0,17,12,false,false,true,0.542,0.458
160,205,-45,16,20.5,-45,518,414,104,0,1,0,0.1,35,10,10,1.085714,0,1,11,10,false,false,false,0.179,0.821
238,234,4,19.833333,21.272727,4,566,742,-176,0,1,0,0.090909,14,12,11,2.285714,0,0,10,23,false,false,false,0.214,0.786
31,29,2,10.333333,14.5,2,1101,1130,-29,0,0,0,0,84,3,2,0.535714,0,1,7,13,false,false,false,0.236,0.764
281,312,-31,20.071429,24,-31,621,786,-165,0,0,0,0,-10,14,13,-3,0,0,1,3,false,false,false,0.035,0.965
177,219,-42,22.125,27.375,-42,1388,1366,22,0,1,0,0.125,38,8,8,0.842105,0,0,11,19,false,false,false,0.164,0.836
249,282,-33,15.5625,17.625,-33,970,1030,-60,0,1,0,0.0625,-6,16,16,-6.666667,0,0,13,11,false,false,false,0.042,0.958
279,293,-14,17.4375,18.3125,-14,518,461,57,0,0,0,0,-12,16,16,-3,0,0,6,4,false,false,true,0.601,0.399
271,316,-45,19.357143,24.307692,-45,1397,1309,88,2,0,0.142857,0,16,14,13,2.25,0,0,9,8,false,false,false,0,1
231,232,-1,16.5,17.846154,-1,306,468,-162,0,0,0,0,18,14,13,2.055556,0,0,11,9,false,false,false,0.456,0.544
112,73,39,14,10.428571,39,670,576,94,0,0,0,0,49,8,7,0.836735,1,0,12,10,false,false,true,0.948,0.052
170,233,-63,12.142857,17.923077,-63,226,361,-135,0,0,0,0,6,14,13,7.333333,0,0,8,11,false,false,false,0,1
142,127,15,23.666667,25.4,15,1055,1019,36,0,0,0,0,54,6,5,0.611111,0,0,11,13,false,false,true,0.647,0.353
209,263,-54,20.9,29.222222,-54,1110,1399,-289,0,1,0,0.111111,36,10,9,0.944444,0,0,15,9,false,false,false,0.026,0.974
115,142,-27,19.166667,23.666667,-27,1003,1018,-15,0,0,0,0,57,6,6,0.649123,0,0,14,15,false,false,false,0.21,0.79
194,183,11,21.555556,22.875,11,1633,1739,-106,1,0,0.111111,0,44,9,8,0.772727,0,0,9,18,false,false,false,0.111,0.889
307,326,-19,16.157895,18.111111,-19,451,448,3,0,0,0,0,-18,19,18,-2.055556,0,0,4,1,true,false,false,0,1
297,277,20,21.214286,21.307692,20,921,1045,-124,0,0,0,0,13,14,13,2.692308,0,1,10,6,false,false,false,0.361,0.639
127,108,19,21.166667,18,19,742,594,148,0,0,0,0,57,6,6,0.684211,0,1,30,6,false,false,true,0.833,0.167
101,140,-39,12.625,20,-39,668,363,305,0,0,0,0,54,8,7,0.87037,0,0,8,10,false,false,false,0.144,0.856
49,27,22,16.333333,13.5,22,1101,1237,-136,0,0,0,0,81,3,2,0.419753,0,1,11,7,false,false,false,0.255,0.745
24,29,-5,12,14.5,-5,1219,1216,3,0,1,0,0.5,85,2,2,0.317647,0,0,20,10,false,false,true,0.653,0.347
123,138,-15,20.5,27.6,-15,1645,1636,9,0,1,0,0.2,52,6,5,0.634615,0,1,17,13,false,false,false,0.197,0.803
131,202,-71,14.555556,25.25,-71,342,263,79,0,0,0,0,35,9,8,0.971429,0,0,7,16,false,false,false,0.011,0.989
156,216,-60,17.333333,24,-60,1229,1220,9,0,1,0,0.111111,39,9,9,0.948718,0,0,14,8,false,false,false,0.181,0.819
213,192,21,23.666667,24,21,1245,1148,97,0,0,0,0,40,9,8,0.875,0,0,19,11,false,false,false,0.24,0.76
16,35,-19,8,17.5,-19,206,346,-140,0,0,0,0,87,2,2,0.494253,0,0,16,17,false,false,false,0.253,0.747
91,60,31,18.2,12,31,1193,1220,-27,0,0,0,0,66,5,5,0.651515,1,1,9,20,false,false,true,0.62,0.38
145,84,61,36.25,21,61,1777,1689,88,1,0,0.25,0,61,4,4,0.442623,0,0,21,9,false,false,true,0.842,0.158
84,124,-40,12,17.714286,-40,503,668,-165,0,0,0,0,54,7,7,0.685185,0,0,7,16,false,false,false,0.14,0.86
260,274,-14,17.333333,19.571429,-14,1310,1477,-167,0,0,0,0,-8,15,14,-4.5,0,0,16,10,false,false,false,0.05,0.95
274,300,-26,30.444444,33.333333,-26,1761,1770,-9,1,1,0.111111,0.111111,21,9,9,1.238095,0,1,17,6,false,false,false,0.197,0.803
186,240,-54,16.909091,21.818182,-54,344,315,29,1,0,0.090909,0,14,11,11,2.857143,0,0,21,18,false,false,false,0,1
242,230,12,14.235294,14.375,12,306,302,4,0,0,0,0,-8,17,16,-5.125,0,0,7,16,false,false,false,0.357,0.643
253,369,-116,18.071429,26.357143,-116,1229,1220,9,0,1,0,0.071429,7,14,14,5.285714,0,0,7,9,false,false,false,0,1
187,304,-117,20.777778,33.777778,-117,2143,2219,-76,0,0,0,0,30,9,9,1.033333,0,0,15,18,false,false,false,0,1
255,505,-250,18.214286,38.846154,-250,1632,2020,-388,0,2,0,0.153846,-7,14,13,-4.428571,0,0,9,8,false,false,false,0,1
78,132,-54,13,22,-54,818,826,-8,0,0,0,0,70,6,6,0.757143,1,1,6,13,false,false,false,0.002,0.998
129,179,-50,21.5,29.833333,-50,503,527,-24,0,1,0,0.166667,49,6,6,0.673469,0,0,12,7,false,false,false,0.313,0.687
159,165,-6,15.9,16.5,-6,595,538,57,0,0,0,0,33,10,10,1.151515,0,1,14,16,false,false,false,0.095,0.905
312,329,-17,14.181818,15.666667,-17,1203,1270,-67,1,0,0.045455,0,-27,22,21,-1.62963,0,0,1,2,false,false,false,0,1
248,247,1,17.714286,19,1,1310,1477,-167,0,0,0,0,1,14,13,36,0,0,17,7,false,false,false,0.249,0.751
303,333,-30,17.823529,20.8125,-30,1439,1428,11,0,0,0,0,0,17,16,0,1,0,6,7,false,false,false,0.032,0.968
229,208,21,25.444444,26,21,824,830,-6,1,0,0.111111,0,41,9,8,1.073171,0,0,10,15,false,false,false,0.286,0.714
219,342,-123,15.642857,24.428571,-123,342,263,79,0,0,0,0,-7,14,14,-4.857143,1,0,12,6,false,false,false,0,1
206,232,-26,22.888889,25.777778,-26,1606,1890,-284,0,0,0,0,30,9,9,0.933333,0,0,8,8,false,false,false,0.124,0.876
253,285,-32,21.083333,25.909091,-32,1030,1014,16,0,1,0,0.090909,23,12,11,1.434783,0,0,18,15,false,false,false,0.108,0.892
167,179,-12,20.875,22.375,-12,999,1283,-284,0,0,0,0,48,8,8,0.6875,0,1,10,8,false,false,false,0.235,0.765
313,270,43,20.866667,19.285714,43,1488,1428,60,1,0,0.066667,0,7,15,14,5.285714,0,1,25,6,false,false,true,0.929,0.071
272,344,-72,17,21.5,-72,1493,1453,40,0,0,0,0,-12,16,16,-2.916667,0,2,4,2,false,false,false,0,1
270,288,-18,20.769231,24,-18,1245,1148,97,0,0,0,0,6,13,12,5.833333,0,0,19,7,false,false,false,0.195,0.805
305,324,-19,16.052632,18,-19,1030,998,32,0,0,0,0,-15,19,18,-2.466667,0,1,13,9,true,false,false,0,1
90,104,-14,22.5,26,-14,1102,1245,-143,0,0,0,0,65,4,4,0.446154,1,0,13,12,false,false,false,0.393,0.607
311,443,-132,31.1,49.222222,-132,1885,1908,-23,1,3,0.1,0.333333,-2,10,9,-11.5,0,0,11,12,false,false,false,0,1
354,358,-4,17.7,18.842105,-4,804,766,38,0,1,0,0.052632,-15,20,19,-2.733333,0,0,2,1,false,false,false,0.006,0.994
27,42,-15,9,14,-15,1606,1890,-284,0,0,0,0,79,3,3,0.35443,1,0,15,21,false,false,false,0.251,0.749
329,373,-44,25.307692,28.692308,-44,1344,1208,136,1,1,0.076923,0.076923,3,13,13,10,1,0,7,5,false,false,false,0.035,0.965
110,97,13,27.5,24.25,13,1055,1019,36,0,0,0,0,66,4,4,0.5,0,0,9,16,false,false,true,0.681,0.319
185,90,95,30.833333,18,95,1563,1539,24,0,0,0,0,54,6,5,0.648148,0,1,9,8,false,false,true,0.849,0.151
203,201,2,20.3,22.333333,2,1488,1428,60,1,0,0.1,0,35,10,9,1.057143,0,0,19,14,false,false,false,0.22,0.78
249,288,-39,16.6,20.571429,-39,1040,1364,-324,0,0,0,0,-3,15,14,-12,0,0,10,19,false,false,false,0,1
53,107,-54,26.5,53.5,-54,1071,1065,6,0,0,0,0,76,2,2,0.407895,1,0,17,13,false,false,false,0.208,0.792
121,81,40,30.25,27,40,1078,1095,-17,1,0,0.25,0,73,4,3,0.506849,0,0,16,12,false,false,true,0.699,0.301
159,165,-6,15.9,18.333333,-6,595,538,57,0,0,0,0,33,10,9,1.151515,0,1,14,16,false,false,false,0.067,0.933
137,153,-16,17.125,21.857143,-16,803,786,17,0,0,0,0,52,8,7,0.615385,0,0,13,7,false,false,false,0.216,0.784
119,130,-11,17,18.571429,-11,1094,1041,53,0,0,0,0,46,7,7,0.826087,1,0,16,16,false,false,false,0.455,0.545
354,362,-8,17.7,18.1,-8,804,766,38,0,1,0,0.05,-17,20,20,-2.411765,0,0,2,1,false,false,false,0.02,0.98
181,196,-15,15.083333,16.333333,-15,913,1037,-124,0,1,0,0.083333,35,12,12,1.171429,0,0,18,15,false,false,false,0.156,0.844
242,318,-76,16.133333,21.2,-76,344,315,29,1,1,0.066667,0.066667,-13,15,15,-3.076923,0,0,22,7,false,false,false,0,1
98,67,31,24.5,22.333333,31,1417,1482,-65,0,0,0,0,77,4,3,0.428571,0,0,22,12,false,false,true,0.682,0.318
144,251,-107,18,31.375,-107,1576,1556,20,0,1,0,0.125,36,8,8,0.833333,0,0,20,12,false,false,false,0,1
278,275,3,19.857143,21.153846,3,1803,1658,145,1,0,0.071429,0,-2,14,13,-16.5,0,0,10,9,false,false,false,0.046,0.954
138,88,50,19.714286,14.666667,50,1065,948,117,0,0,0,0,58,7,6,0.672414,0,0,11,10,false,false,true,0.839,0.161
20,38,-18,10,19,-18,775,786,-11,0,0,0,0,85,2,2,0.505882,0,0,10,18,false,false,false,0.345,0.655
275,379,-104,25,34.454545,-104,1537,1539,-2,0,1,0,0.090909,14,11,11,2.428571,0,1,13,17,false,false,false,0,1
126,139,-13,15.75,17.375,-13,1159,1131,28,0,1,0,0.125,48,8,8,0.770833,0,1,7,7,false,false,false,0.227,0.773
310,341,-31,18.235294,21.3125,-31,1488,1403,85,0,1,0,0.0625,-19,17,16,-1.789474,1,0,8,3,false,false,false,0.006,0.994
216,239,-23,18,21.727273,-23,1037,1016,21,1,0,0.083333,0,33,12,11,1.757576,1,0,16,13,false,false,false,0.019,0.981
258,324,-66,17.2,21.6,-66,1078,1095,-17,1,1,0.066667,0.066667,0,15,15,0,0,0,9,11,false,false,false,0,1
86,226,-140,9.555556,25.111111,-140,1101,1130,-29,0,1,0,0.111111,47,9,9,0.957447,0,1,9,7,false,false,false,0,1
86,55,31,17.2,13.75,31,889,855,34,0,0,0,0,74,5,4,0.540541,0,0,16,11,false,false,true,0.734,0.266
302,311,-9,13.727273,14.136364,-9,671,638,33,0,0,0,0,-32,22,22,-1.53125,0,0,2,2,false,false,true,0.606,0.394
41,59,-18,10.25,19.666667,-18,342,53,289,0,0,0,0,77,4,3,0.532468,0,0,11,17,false,false,false,0.202,0.798
224,231,-7,14,15.4,-7,814,830,-16,0,0,0,0,-1,16,15,-41,0,1,10,23,false,false,false,0.231,0.769
269,327,-58,19.214286,23.357143,-58,1205,1216,-11,0,0,0,0,3,14,14,11,1,0,8,12,false,false,false,0.02,0.98
10,17,-7,10,17,-7,1606,1593,13,0,0,0,0,92,1,1,0.315217,0,0,20,14,false,false,true,0.647,0.353
97,241,-144,16.166667,40.166667,-144,786,848,-62,0,1,0,0.166667,61,6,6,0.508197,1,0,17,11,false,false,false,0,1
230,204,26,16.428571,14.571429,26,897,996,-99,0,0,0,0,13,14,14,3,0,1,15,15,false,false,true,0.671,0.329
234,282,-48,23.4,31.333333,-48,1164,1261,-97,0,1,0,0.111111,37,10,9,1.135135,0,0,10,7,false,false,false,0.035,0.965
299,334,-35,23,25.692308,-35,804,1074,-270,0,0,0,0,3,13,13,10.666667,0,0,10,11,false,false,false,0.004,0.996
105,115,-10,26.25,38.333333,-10,576,602,-26,0,0,0,0,76,4,3,0.552632,0,0,8,7,false,false,false,0.032,0.968
139,136,3,15.444444,15.111111,3,1030,998,32,0,0,0,0,36,9,9,1.027778,0,0,7,8,false,false,true,0.567,0.433
306,342,-36,15.3,18,-36,480,518,-38,0,0,0,0,-22,20,19,-1.818182,0,0,2,1,false,false,false,0,1
21,8,13,10.5,8,13,542,605,-63,0,0,0,0,88,2,1,0.409091,1,0,12,7,false,false,false,0.282,0.718
236,298,-62,13.111111,17.529412,-62,651,700,-49,0,0,0,0,-10,18,17,-5.6,0,1,12,12,false,false,false,0,1
63,124,-61,21,41.333333,-61,1045,1100,-55,0,0,0,0,76,3,3,0.447368,0,1,12,14,false,false,false,0.002,0.998
167,238,-71,12.846154,18.307692,-71,613,525,88,0,0,0,0,23,13,13,1.826087,0,1,10,6,false,false,false,0,1
259,299,-40,12.333333,14.95,-40,226,361,-135,0,0,0,0,-31,21,20,-1.419355,0,0,1,3,false,false,false,0,1
292,306,-14,17.176471,18,-14,822,845,-23,0,0,0,0,-13,17,17,-2.692308,0,0,9,2,false,false,false,0.38,0.62
163,214,-51,16.3,21.4,-51,711,746,-35,0,0,0,0,34,10,10,1.117647,0,0,9,16,false,false,false,0.037,0.963
318,273,45,19.875,18.2,45,1488,1428,60,1,0,0.0625,0,1,16,15,37,0,1,27,6,false,false,true,0.935,0.065
67,99,-32,11.166667,16.5,-32,977,1100,-123,0,0,0,0,65,6,6,0.630769,1,0,13,8,false,false,false,0.247,0.753
167,111,56,23.857143,18.5,56,1197,1156,41,0,0,0,0,55,7,6,0.636364,0,1,12,6,false,false,true,0.844,0.156
304,292,12,30.4,29.2,12,169,306,-137,2,1,0.2,0.1,8,10,10,3.875,0,0,11,7,false,false,false,0.241,0.759
67,99,-32,9.571429,14.142857,-32,977,1100,-123,0,0,0,0,65,7,7,0.630769,1,0,16,15,false,false,false,0.129,0.871
175,253,-78,14.583333,21.083333,-78,714,892,-178,0,1,0,0.083333,25,12,12,1.68,0,0,8,8,false,false,false,0,1
281,382,-101,16.529412,23.875,-101,563,523,40,0,0,0,0,-9,17,16,-4.111111,0,0,4,5,false,false,false,0,1
270,256,14,20.769231,19.692308,14,824,830,-6,1,0,0.076923,0,17,13,13,2.588235,0,0,7,20,false,false,false,0.41,0.59
133,194,-61,19,27.714286,-61,1633,1620,13,0,0,0,0,44,7,7,0.818182,0,0,11,8,false,false,false,0.175,0.825
223,267,-44,18.583333,22.25,-44,1302,1351,-49,0,0,0,0,22,12,12,1.681818,0,0,10,11,false,false,false,0.043,0.957
167,224,-57,16.7,22.4,-57,1270,1424,-154,0,1,0,0.1,39,10,10,0.897436,0,2,26,5,false,false,false,0.129,0.871
139,140,-1,12.636364,12.727273,-1,1045,948,97,0,0,0,0,22,11,11,1.545455,0,0,12,11,false,false,false,0.272,0.728
44,49,-5,22,49,-5,576,602,-26,0,0,0,0,90,2,1,0.466667,0,0,12,11,false,false,false,0.103,0.897
45,57,-12,11.25,19,-12,1656,1580,76,0,0,0,0,76,4,3,0.434211,0,0,16,10,false,false,false,0.214,0.786
27,75,-48,9,37.5,-48,1305,1194,111,0,0,0,0,83,3,2,0.39759,0,0,22,14,false,false,false,0.201,0.799
240,308,-68,20,25.666667,-68,980,965,15,0,0,0,0,16,12,12,2.375,1,0,6,16,false,false,false,0.003,0.997
202,170,32,25.25,21.25,32,540,498,42,1,0,0.125,0,43,8,8,1.069767,0,0,10,20,false,false,true,0.846,0.154
0,66,-66,0,33,-66,1473,1500,-27,0,1,0,0.5,93,2,2,0.419355,0,1,12,8,false,false,false,0.137,0.863
223,282,-59,13.9375,18.8,-59,306,361,-55,0,0,0,0,-13,16,15,-2.769231,0,0,7,18,false,false,false,0,1
211,255,-44,16.230769,19.615385,-44,360,371,-11,0,0,0,0,-1,13,13,-37,1,0,6,9,false,false,false,0.455,0.545
137,139,-2,19.571429,19.857143,-2,1047,1253,-206,1,0,0.142857,0,56,7,7,0.660714,0,0,7,15,false,false,false,0.256,0.744
232,284,-52,21.090909,28.4,-52,1126,1277,-151,0,0,0,0,10,11,10,3.5,0,0,10,28,false,false,false,0.001,0.999
274,449,-175,16.117647,26.411765,-175,1399,1210,189,0,1,0,0.058824,-14,17,17,-2.5,0,0,2,2,false,false,false,0.041,0.959
259,231,28,21.583333,21,28,921,1045,-124,0,0,0,0,22,12,11,1.590909,0,0,10,12,false,false,true,0.526,0.474
92,124,-32,11.5,17.714286,-32,503,668,-165,0,0,0,0,52,8,7,0.711538,0,0,7,16,false,false,false,0.075,0.925
319,348,-29,22.785714,26.769231,-29,1331,1347,-16,1,1,0.071429,0.076923,-13,14,13,-2.461538,0,0,4,5,false,false,false,0.001,0.999
194,224,-30,12.125,14,-30,342,53,289,0,0,0,0,-10,16,16,-4.1,0,0,16,19,false,false,false,0.184,0.816
170,255,-85,17,28.333333,-85,935,995,-60,1,1,0.1,0.111111,37,10,9,1.054054,0,0,10,18,false,false,false,0,1
159,195,-36,22.714286,27.857143,-36,595,733,-138,1,1,0.142857,0.142857,40,7,7,0.975,0,1,19,13,false,false,false,0.102,0.898
279,325,-46,12.681818,15.47619,-46,1071,1000,71,0,0,0,0,-29,22,21,-1.62069,0,0,1,1,false,false,false,0,1
52,50,2,13,16.666667,2,805,918,-113,0,0,0,0,73,4,3,0.493151,0,1,32,7,false,false,false,0.252,0.748
144,78,66,28.8,15.6,66,1274,1394,-120,0,0,0,0,63,5,5,0.47619,0,0,13,14,false,false,true,0.841,0.159
60,43,17,20,21.5,17,668,363,305,0,0,0,0,81,3,2,0.580247,0,0,8,24,false,false,false,0.217,0.783
166,246,-80,13.833333,20.5,-80,977,1100,-123,0,1,0,0.083333,30,12,12,1.366667,0,0,9,13,false,false,false,0,1
210,236,-26,21,26.222222,-26,1428,1361,67,0,0,0,0,28,10,9,1.178571,0,0,11,9,false,false,false,0.193,0.807
78,135,-57,11.142857,19.285714,-57,1071,1000,71,0,0,0,0,60,7,7,0.783333,1,1,6,16,false,false,false,0.019,0.981
247,282,-35,16.466667,20.142857,-35,1432,1452,-20,0,1,0,0.071429,1,15,14,36,1,0,6,22,false,false,false,0.007,0.993
237,398,-161,13.166667,22.111111,-161,473,683,-210,0,0,0,0,-21,18,18,-1.809524,0,0,1,1,false,false,false,0,1
230,365,-135,25.555556,40.555556,-135,1777,1500,277,1,2,0.111111,0.222222,22,9,9,1.272727,0,0,18,11,false,false,false,0.049,0.951
75,85,-10,18.75,21.25,-10,1493,1453,40,0,0,0,0,73,4,4,0.479452,0,0,9,24,false,false,false,0.202,0.798
344,438,-94,22.933333,29.2,-94,1699,1803,-104,1,1,0.066667,0.066667,5,15,15,7,0,0,11,10,false,false,false,0,1
92,130,-38,23,43.333333,-38,964,1003,-39,0,1,0,0.333333,73,4,3,0.534247,0,0,11,11,false,false,false,0.202,0.798
58,80,-22,14.5,20,-22,306,361,-55,0,0,0,0,68,4,4,0.529412,0,1,12,9,false,false,false,0.095,0.905
35,31,4,11.666667,15.5,4,226,361,-135,0,0,0,0,81,3,2,0.54321,0,1,20,6,false,false,false,0.228,0.772
16,19,-3,16,19,-3,391,542,-151,0,0,0,0,92,1,1,0.5,0,1,7,9,false,false,false,0.207,0.793
240,316,-76,13.333333,17.555556,-76,306,361,-55,0,0,0,0,-26,18,18,-1.384615,0,0,1,3,true,false,false,0,1
299,442,-143,23,36.833333,-143,1556,1656,-100,0,2,0,0.166667,-4,13,12,-7.5,0,0,5,8,false,false,false,0,1
186,212,-26,20.666667,23.555556,-26,694,658,36,0,1,0,0.111111,36,9,9,1.027778,0,0,25,10,false,false,false,0.337,0.663
295,299,-4,22.692308,24.916667,-4,1070,814,256,1,1,0.076923,0.083333,5,13,12,6.6,0,0,12,14,false,false,false,0.079,0.921
227,220,7,28.375,31.428571,7,1556,1513,43,0,0,0,0,38,8,7,0.815789,0,0,8,9,false,false,false,0.208,0.792
62,36,26,31,18,26,1563,1539,24,0,0,0,0,85,2,2,0.411765,0,0,12,8,false,false,true,0.697,0.303
97,181,-84,12.125,22.625,-84,795,786,9,0,0,0,0,56,8,8,0.678571,0,0,8,13,false,false,false,0.033,0.967
26,0,26,26,0,26,1110,1123,-13,0,0,0,0,94,1,0,0.351064,0,0,17,0,false,false,true,0.684,0.316
62,100,-38,20.666667,33.333333,-38,1556,1616,-60,0,0,0,0,80,3,3,0.3625,0,0,11,16,false,false,false,0.2,0.8
8,0,8,8,0,8,1021,1094,-73,0,0,0,0,96,1,0,0.385417,0,0,16,0,false,false,false,0.273,0.727
277,414,-137,18.466667,29.571429,-137,976,995,-19,1,2,0.066667,0.142857,0,15,14,0,1,0,6,12,false,false,false,0,1
93,79,14,31,26.333333,14,1055,840,215,0,0,0,0,75,3,3,0.48,0,0,10,12,false,false,true,0.684,0.316
232,248,-16,17.846154,19.076923,-16,356,498,-142,0,1,0,0.076923,12,13,13,2.916667,1,0,15,18,false,false,false,0.252,0.748
63,132,-69,15.75,44,-69,1576,1556,20,0,1,0,0.333333,72,4,3,0.416667,0,0,18,15,false,false,false,0.161,0.839
12,33,-21,12,33,-21,1770,1751,19,0,0,0,0,90,1,1,0.322222,0,1,13,9,false,false,false,0.254,0.746
290,371,-81,18.125,23.1875,-81,1493,1413,80,0,1,0,0.0625,-15,16,16,-2.4,0,0,6,2,false,false,false,0,1
357,357,0,25.5,27.461538,0,1793,1869,-76,1,1,0.071429,0.076923,-2,14,13,-15,0,0,1,14,false,false,true,0.998,0.002
51,34,17,17,11.333333,17,1220,1185,35,0,0,0,0,78,3,3,0.602564,0,1,23,9,false,false,true,0.729,0.271
156,186,-30,22.285714,26.571429,-30,1063,1134,-71,1,0,0.142857,0,57,7,7,0.77193,1,0,15,14,false,false,false,0.062,0.938
264,275,-11,13.2,13.75,-11,999,1071,-72,0,0,0,0,-20,20,20,-2,0,0,2,3,true,false,false,0.098,0.902
112,185,-73,14,23.125,-73,1220,1202,18,0,0,0,0,46,8,8,1.086957,0,0,26,7,false,false,false,0.198,0.802
314,333,-19,14.272727,15.857143,-19,1000,960,40,0,0,0,0,-27,22,21,-1.666667,0,0,1,1,false,false,false,0,1
171,259,-88,9.5,15.235294,-88,818,826,-8,0,0,0,0,3,18,17,17.666667,0,0,7,26,false,false,false,0,1
12,0,12,12,0,12,1305,1307,-2,0,0,0,0,96,1,0,0.427083,0,0,7,0,false,false,true,0.677,0.323
129,202,-73,16.125,25.25,-73,822,845,-23,0,0,0,0,48,8,8,0.729167,0,0,26,8,false,false,false,0.034,0.966
275,419,-144,17.1875,27.933333,-144,1045,1100,-55,0,1,0,0.066667,-8,16,15,-4.25,0,0,2,7,false,false,false,0,1
14,0,14,14,0,14,1344,1208,136,0,0,0,0,96,1,0,0.3125,0,0,11,0,false,false,true,0.679,0.321
206,242,-36,25.75,30.25,-36,1495,1597,-102,0,1,0,0.125,38,8,8,0.842105,0,0,7,12,false,false,false,0.199,0.801
313,357,-44,14.904762,17.85,-44,1037,1009,28,0,0,0,0,-18,21,20,-2.444444,0,0,1,1,false,false,false,0,1
191,275,-84,15.916667,25,-84,480,739,-259,0,0,0,0,26,12,11,1.5,1,0,11,14,false,false,false,0,1
128,246,-118,18.285714,35.142857,-118,1253,1324,-71,0,1,0,0.142857,47,7,7,0.617021,1,0,6,7,false,false,false,0.005,0.995
325,368,-43,20.3125,24.533333,-43,1021,897,124,0,2,0,0.133333,-16,16,15,-2.3125,0,0,10,3,false,false,false,0,1
69,105,-36,11.5,21,-36,907,878,29,0,0,0,0,74,6,5,0.581081,0,0,8,14,false,false,false,0.04,0.96
141,123,18,20.142857,20.5,18,758,904,-146,1,0,0.142857,0,52,7,6,0.653846,0,0,16,9,false,false,false,0.334,0.666
86,70,16,21.5,17.5,16,1770,1751,19,0,0,0,0,66,4,4,0.439394,0,1,9,9,false,false,true,0.679,0.321
172,240,-68,14.333333,20,-68,1064,1397,-333,0,2,0,0.166667,35,12,12,1.228571,1,0,30,7,false,false,false,0.153,0.847
223,222,1,17.153846,17.076923,1,704,523,181,0,0,0,0,1,13,13,35,0,0,16,12,false,false,true,0.69,0.31
77,179,-102,15.4,35.8,-102,1777,1500,277,0,1,0,0.2,60,5,5,0.466667,1,0,9,12,false,false,false,0.425,0.575
85,106,-21,21.25,26.5,-21,1245,1148,97,0,0,0,0,69,4,4,0.507246,0,1,21,16,false,false,false,0.212,0.788
68,100,-32,13.6,25,-32,1580,1629,-49,0,0,0,0,69,5,4,0.536232,0,0,15,10,false,false,false,0.205,0.795
95,109,-14,19,21.8,-14,1432,1452,-20,0,0,0,0,63,5,5,0.571429,0,0,10,7,false,false,true,0.612,0.388
349,380,-31,19.388889,22.352941,-31,1237,1265,-28,1,0,0.055556,0,-28,18,17,-1.285714,0,0,2,2,false,false,false,0,1
296,309,-13,18.5,20.6,-13,1245,1148,97,0,0,0,0,-13,16,15,-2.692308,0,0,11,3,false,false,false,0.069,0.931
258,268,-10,21.5,22.333333,-10,786,885,-99,1,1,0.083333,0.083333,23,12,12,1.478261,0,0,10,26,false,false,false,0.198,0.802
245,254,-9,27.222222,28.222222,-9,1556,1513,43,0,0,0,0,27,9,9,1.148148,0,0,14,14,false,false,false,0.201,0.799
281,233,48,28.1,23.3,48,1552,1803,-251,2,0,0.2,0,26,10,10,1.269231,0,1,13,7,false,false,false,0.254,0.746
66,115,-49,22,38.333333,-49,576,602,-26,0,0,0,0,79,3,3,0.531646,0,0,13,7,false,false,false,0.026,0.974
220,328,-108,12.222222,19.294118,-108,1305,1307,-2,0,1,0,0.058824,-11,18,17,-3.727273,0,1,17,9,false,false,false,0,1
267,273,-6,22.25,22.75,-6,1397,1405,-8,1,0,0.083333,0,7,12,12,4.142857,0,1,10,9,false,false,false,0.25,0.75
35,38,-3,11.666667,19,-3,503,668,-165,0,0,0,0,82,3,2,0.45122,0,0,7,13,false,false,false,0.251,0.749
183,156,27,16.636364,15.6,27,1344,1314,30,0,1,0,0.1,32,11,10,1.0625,0,0,9,24,false,false,false,0.387,0.613
169,264,-95,24.142857,37.714286,-95,1334,1486,-152,1,0,0.142857,0,53,7,7,0.54717,0,0,11,20,false,false,false,0,1
290,291,-1,16.111111,17.117647,-1,970,1030,-60,0,1,0,0.058824,-15,18,17,-2.666667,1,0,3,17,false,false,true,0.56,0.44
109,108,1,21.8,21.6,1,1691,1551,140,0,0,0,0,65,5,5,0.569231,0,0,11,17,false,false,false,0.205,0.795
170,224,-54,12.142857,16,-54,814,830,-16,0,0,0,0,9,14,14,4.555556,0,1,19,23,false,false,false,0,1
151,195,-44,16.777778,24.375,-44,1270,1424,-154,0,1,0,0.125,49,9,8,0.714286,0,0,14,8,false,false,false,0.039,0.961
264,304,-40,16.5,19,-40,1037,1009,28,0,0,0,0,9,16,16,4.888889,1,0,13,15,false,false,false,0.196,0.804
337,380,-43,19.823529,23.75,-43,1417,1482,-65,0,1,0,0.0625,-3,17,16,-11,0,1,2,3,true,false,false,0,1
44,33,11,22,33,11,965,1078,-113,0,0,0,0,89,2,1,0.41573,0,0,21,19,false,false,false,0.274,0.726
287,261,26,19.133333,17.4,26,824,830,-6,1,0,0.066667,0,12,15,15,3.666667,0,0,10,20,false,false,true,0.943,0.057
119,199,-80,19.833333,33.166667,-80,1397,1309,88,1,0,0.166667,0,64,6,6,0.5625,0,1,8,10,false,false,false,0.002,0.998
101,120,-19,14.428571,20,-19,952,826,126,0,0,0,0,65,7,6,0.661538,0,0,14,7,false,false,false,0.204,0.796
281,364,-83,10.407407,13.481481,-83,651,700,-49,0,0,0,0,-49,27,27,-1.142857,0,0,14,9,false,false,false,0,1
80,100,-20,26.666667,33.333333,-20,1126,1277,-151,0,0,0,0,74,3,3,0.472973,0,0,14,8,false,false,false,0.306,0.694
191,211,-20,17.363636,21.1,-20,451,448,3,0,0,0,0,29,11,10,1.275862,0,0,12,10,false,false,false,0.051,0.949
16,0,16,16,0,16,897,996,-99,0,0,0,0,95,1,0,0.410526,0,0,12,0,false,false,false,0.253,0.747
239,259,-20,26.555556,32.375,-20,1164,1161,3,0,1,0,0.125,20,9,8,1.15,0,0,16,9,false,false,false,0.202,0.798
260,279,-19,20,23.25,-19,967,856,111,0,0,0,0,16,13,12,2.0625,0,1,16,6,false,false,false,0.335,0.665
125,170,-45,15.625,24.285714,-45,452,698,-246,0,1,0,0.142857,54,8,7,0.759259,0,1,20,7,false,false,false,0.14,0.86
115,164,-49,12.777778,18.222222,-49,830,787,43,0,0,0,0,38,9,9,1,0,0,17,16,false,false,false,0.196,0.804
313,397,-84,18.411765,23.352941,-84,1269,1477,-208,1,0,0.058824,0,-13,17,17,-2.692308,0,0,4,1,false,false,false,0,1
230,235,-5,17.692308,19.583333,-5,599,448,151,0,0,0,0,14,13,12,2.571429,0,0,12,14,false,false,false,0.488,0.512
224,238,-14,17.230769,19.833333,-14,1040,1364,-324,0,0,0,0,11,13,12,3.272727,0,1,10,10,false,false,false,0.167,0.833
25,63,-38,12.5,63,-38,1803,1658,145,0,0,0,0,86,2,1,0.383721,1,0,9,12,false,false,false,0.033,0.967
377,375,2,22.176471,23.4375,2,1305,1194,111,1,1,0.058824,0.0625,-17,17,16,-1.941176,0,0,3,5,true,false,true,0.882,0.118
202,165,37,25.25,20.625,37,804,1074,-270,0,0,0,0,41,8,8,0.780488,0,1,12,9,false,false,true,0.556,0.444
266,434,-168,19,33.384615,-168,1636,1796,-160,0,1,0,0.076923,-8,14,13,-3.375,0,1,6,6,true,false,false,0,1
0,18,-18,0,18,-18,664,786,-122,0,0,0,0,97,1,1,0.340206,0,0,0,10,false,false,false,0.25,0.75
107,161,-54,21.4,32.2,-54,503,527,-24,0,1,0,0.2,57,5,5,0.578947,0,0,11,10,false,false,false,0.231,0.769
335,307,28,22.333333,21.928571,28,964,1003,-39,0,1,0,0.071429,3,15,14,13,0,0,12,15,false,false,true,0.975,0.025
178,243,-65,13.692308,18.692308,-65,1064,1397,-333,0,2,0,0.153846,29,13,13,1.482759,1,0,27,7,false,false,false,0.165,0.835
172,118,54,21.5,16.857143,54,664,786,-122,0,0,0,0,51,8,7,0.647059,0,0,12,15,false,false,true,0.822,0.178
221,223,-2,14.733333,15.928571,-2,995,965,30,0,0,0,0,10,15,14,4,0,0,13,10,false,false,false,0.233,0.767
14,0,14,14,0,14,1075,878,197,0,0,0,0,96,1,0,0.34375,0,0,19,0,false,false,true,0.682,0.318
222,285,-63,10.090909,13.571429,-63,595,540,55,0,0,0,0,-10,22,21,-4.3,0,0,7,15,true,false,false,0,1
0,40,-40,0,40,-40,1334,1439,-105,0,0,0,0,95,2,1,0.378947,2,0,12,10,false,false,false,0.098,0.902
216,281,-65,15.428571,20.071429,-65,620,698,-78,1,0,0.071429,0,9,14,14,4.555556,0,0,21,17,false,false,false,0,1
133,208,-75,12.090909,20.8,-75,388,542,-154,0,0,0,0,26,11,10,1.423077,0,0,10,18,false,false,false,0,1
141,159,-18,23.5,31.8,-18,1554,1685,-131,0,1,0,0.2,59,6,5,0.542373,0,0,18,9,false,false,false,0.23,0.77
150,152,-2,18.75,21.714286,-2,874,868,6,0,0,0,0,41,8,7,0.804878,0,0,12,22,false,false,false,0.204,0.796
125,163,-38,13.888889,20.375,-38,388,542,-154,0,0,0,0,35,9,8,1.057143,0,0,10,24,false,false,false,0.036,0.964
246,338,-92,14.470588,21.125,-92,837,844,-7,0,0,0,0,3,17,16,13.666667,1,0,10,9,false,false,false,0,1
224,222,2,24.888889,24.666667,2,1344,1208,136,1,1,0.111111,0.111111,35,9,9,0.857143,0,1,9,9,false,false,false,0.346,0.654
301,415,-114,20.066667,27.666667,-114,1576,1556,20,0,1,0,0.066667,-9,15,15,-3.333333,0,0,3,4,true,false,false,0,1
100,53,47,20,13.25,47,675,570,105,0,0,0,0,65,5,4,0.538462,0,0,12,30,false,false,true,0.914,0.086
0,0,0,0,0,0,1064,1397,-333,0,0,0,0,100,1,1,0.43,0,0,25,8,false,false,false,0.251,0.749
111,190,-79,10.090909,19,-79,595,662,-67,0,1,0,0.1,34,11,10,1.294118,0,1,20,13,false,false,false,0,1
175,219,-44,19.444444,24.333333,-44,1349,1203,146,0,1,0,0.111111,35,9,9,0.914286,0,0,7,17,false,false,false,0.008,0.992
196,221,-25,19.6,24.555556,-25,561,633,-72,0,1,0,0.111111,34,10,9,1.029412,0,0,17,14,false,false,false,0.087,0.913
82,82,0,16.4,16.4,0,388,542,-154,0,0,0,0,60,5,5,0.616667,0,0,19,15,false,false,false,0.276,0.724
349,332,17,18.368421,17.473684,17,907,910,-3,0,1,0,0.052632,-9,19,19,-4.777778,0,0,7,9,false,false,true,0.999,0.001
56,91,-35,14,22.75,-35,1071,1000,71,0,0,0,0,76,4,4,0.618421,1,0,6,9,false,false,false,0.3,0.7
316,317,-1,18.588235,19.8125,-1,206,346,-140,1,0,0.058824,0,-14,17,16,-3.071429,0,1,18,8,false,false,false,0,1
206,238,-32,12.875,14.875,-32,1220,1202,18,0,0,0,0,6,16,16,8.333333,0,1,29,11,false,false,false,0.415,0.585
313,357,-44,14.904762,17,-44,1037,1009,28,0,0,0,0,-18,21,21,-2.444444,0,0,1,1,false,false,false,0,1
158,109,49,31.6,21.8,49,1770,1751,19,0,0,0,0,54,5,5,0.537037,0,2,14,6,false,false,true,0.975,0.025
199,167,32,19.9,18.555556,32,1078,1095,-17,1,0,0.1,0,37,10,9,1,0,2,14,16,false,false,false,0.373,0.627
223,242,-19,17.153846,18.615385,-19,595,538,57,0,0,0,0,14,13,13,2.714286,0,1,10,9,false,false,false,0.071,0.929
34,45,-11,8.5,11.25,-11,925,1000,-75,0,0,0,0,70,4,4,0.628571,0,1,11,9,false,false,false,0.253,0.747
247,170,77,35.285714,28.333333,77,1777,1689,88,1,1,0.142857,0.166667,40,7,6,0.675,0,0,18,19,false,false,true,0.966,0.034
87,109,-22,17.4,21.8,-22,1248,1220,28,0,1,0,0.2,67,5,5,0.776119,0,0,17,22,false,false,false,0.201,0.799
157,99,58,13.083333,9,58,491,651,-160,0,0,0,0,34,12,11,0.882353,1,1,9,6,false,false,true,0.918,0.082
91,146,-55,18.2,29.2,-55,835,786,49,0,0,0,0,58,5,5,0.586207,0,1,19,10,false,false,false,0.045,0.955
216,263,-47,15.428571,20.230769,-47,620,698,-78,1,0,0.071429,0,13,14,13,3.153846,0,0,21,14,false,false,false,0,1
162,163,-1,18,18.111111,-1,599,448,151,0,0,0,0,36,9,9,1,0,1,14,10,false,false,false,0.33,0.67
104,156,-52,20.8,39,-52,1537,1539,-2,0,1,0,0.25,60,5,4,0.566667,0,0,10,14,false,false,false,0.157,0.843
160,201,-41,12.307692,15.461538,-41,814,830,-16,0,0,0,0,15,13,13,2.733333,0,1,22,25,false,false,false,0.052,0.948
355,439,-84,25.357143,33.769231,-84,2143,2219,-76,1,0,0.071429,0,-11,14,13,-2.818182,0,0,5,6,false,false,false,0,1
73,63,10,24.333333,21,10,1691,1510,181,0,0,0,0,78,3,3,0.384615,0,0,17,22,false,false,false,0.23,0.77
18,28,-10,9,14,-10,361,413,-52,0,0,0,0,85,2,2,0.482353,0,0,26,13,false,false,false,0.254,0.746
26,35,-9,13,17.5,-9,948,998,-50,0,0,0,0,82,2,2,0.45122,1,1,12,8,false,false,false,0.412,0.588
330,399,-69,17.368421,22.166667,-69,1495,1531,-36,0,1,0,0.055556,-13,19,18,-2.846154,0,0,1,2,true,false,false,0,1
34,24,10,17,24,10,999,1165,-166,0,0,0,0,90,2,1,0.511111,0,0,16,10,false,false,false,0.251,0.749
96,135,-39,16,22.5,-39,803,786,17,0,0,0,0,63,6,6,0.507937,0,0,7,10,false,false,false,0.074,0.926
270,294,-24,19.285714,22.615385,-24,967,856,111,0,0,0,0,11,14,13,3,0,1,16,6,false,false,false,0.373,0.627
316,394,-78,22.571429,30.307692,-78,1556,1616,-60,0,0,0,0,-6,14,13,-4.833333,0,0,2,1,false,false,false,0,1
257,314,-57,15.117647,18.470588,-57,889,855,34,0,1,0,0.058824,-10,17,17,-4,0,1,10,3,false,false,false,0,1
242,333,-91,13.444444,18.5,-91,714,892,-178,0,2,0,0.111111,-11,18,18,-3.818182,0,0,12,7,false,false,false,0,1
203,316,-113,22.555556,35.111111,-113,1586,1633,-47,1,0,0.111111,0,41,9,9,0.829268,0,1,17,6,false,false,false,0,1
284,250,34,23.666667,22.727273,34,1102,1245,-143,0,0,0,0,10,12,11,2.9,0,1,7,7,false,false,true,0.584,0.416
170,302,-132,21.25,43.142857,-132,1556,1656,-100,0,2,0,0.285714,31,8,7,0.967742,0,0,10,18,false,false,false,0,1
284,393,-109,14.947368,20.684211,-109,595,733,-138,1,1,0.052632,0.052632,-26,19,19,-1.5,0,1,20,2,false,false,false,0,1
77,75,2,25.666667,37.5,2,1636,1727,-91,0,1,0,0.5,78,3,2,0.384615,0,0,14,11,false,false,false,0.377,0.623
297,310,-13,24.75,25.833333,-13,1305,1211,94,2,0,0.166667,0,15,12,12,2.2,0,0,18,8,false,false,false,0.395,0.605
180,224,-44,12.857143,17.230769,-44,668,363,305,0,0,0,0,21,14,13,2.238095,1,0,18,13,false,false,false,0.143,0.857
231,272,-41,17.769231,22.666667,-41,1432,1452,-20,0,1,0,0.083333,11,13,12,3.272727,1,0,7,18,false,false,false,0.006,0.994
150,140,10,16.666667,17.5,10,450,503,-53,0,0,0,0,42,9,8,0.928571,1,0,19,10,false,false,true,0.674,0.326
34,15,19,17,15,19,668,363,305,0,0,0,0,88,2,1,0.534091,0,0,10,8,false,false,true,0.693,0.307
12,0,12,12,0,12,599,448,151,0,0,0,0,96,1,0,0.375,0,0,13,0,false,false,true,0.683,0.317
298,309,-11,17.529412,19.3125,-11,907,1070,-163,0,0,0,0,0,17,16,0,0,2,6,7,false,false,false,0.008,0.992
168,172,-4,18.666667,19.111111,-4,527,954,-427,0,0,0,0,43,9,9,0.813953,0,2,25,12,false,false,false,0.223,0.777
0,30,-30,0,30,-30,2147,2219,-72,0,0,0,0,95,1,1,0.252632,0,0,11,9,false,false,false,0.202,0.798
220,313,-93,15.714286,22.357143,-93,804,1080,-276,0,0,0,0,9,14,14,3.777778,1,0,9,9,false,false,false,0,1
247,316,-69,10.291667,13.73913,-69,1220,1202,18,0,0,0,0,-26,24,23,-1.923077,0,1,26,11,false,false,false,0,1
348,433,-85,21.75,27.0625,-85,724,398,326,1,1,0.0625,0.0625,-3,16,16,-13,0,0,9,11,false,false,false,0,1
147,218,-71,13.363636,21.8,-71,1037,913,124,1,1,0.090909,0.1,39,11,10,0.974359,0,0,16,11,false,false,false,0,1
91,182,-91,10.111111,22.75,-91,651,996,-345,0,1,0,0.125,40,9,8,1.125,0,1,13,9,false,false,false,0.006,0.994
60,73,-13,30,73,-13,976,995,-19,0,1,0,1,86,2,1,0.44186,0,0,7,14,false,false,false,0.202,0.798
243,265,-22,12.789474,14.722222,-22,163,346,-183,0,0,0,0,-29,19,18,-1.344828,0,0,1,4,false,false,false,0.095,0.905
23,28,-5,11.5,14,-5,651,567,84,0,0,0,0,86,2,2,0.639535,0,0,11,14,false,false,true,0.676,0.324
320,358,-38,16,18.842105,-38,1220,1185,35,0,1,0,0.052632,-15,20,19,-3.133333,0,0,10,6,false,false,false,0,1
278,319,-41,17.375,21.266667,-41,1633,1620,13,0,0,0,0,-14,16,15,-2.571429,0,0,4,8,false,false,false,0.001,0.999
242,253,-11,16.133333,16.866667,-11,840,1055,-215,0,0,0,0,-3,15,15,-11.666667,0,0,19,8,false,false,false,0.281,0.719
170,268,-98,13.076923,20.615385,-98,977,1100,-123,0,1,0,0.076923,24,13,13,1.708333,0,1,12,16,false,false,false,0,1
46,35,11,23,17.5,11,691,704,-13,0,0,0,0,86,2,2,0.44186,1,0,16,9,false,false,true,0.703,0.297
16,0,16,16,0,16,1003,1004,-1,0,0,0,0,96,1,0,0.364583,0,0,19,0,false,false,true,0.673,0.327
202,206,-4,18.363636,20.6,-4,206,346,-140,1,0,0.090909,0,26,11,10,1.653846,0,0,11,9,false,false,false,0.12,0.88
18,14,4,18,14,4,1777,1689,88,0,0,0,0,93,1,1,0.290323,0,0,10,13,false,false,true,0.646,0.354
220,427,-207,22,42.7,-207,1539,1891,-352,0,2,0,0.2,8,10,10,3.125,1,1,16,11,false,false,false,0,1
126,117,9,25.2,23.4,9,1003,1004,-1,0,0,0,0,69,5,5,0.507246,0,0,15,8,false,false,true,0.682,0.318
290,315,-25,26.363636,28.636364,-25,691,695,-4,1,0,0.090909,0,16,11,11,2,0,0,7,12,false,false,false,0.011,0.989
243,398,-155,22.090909,36.181818,-155,1633,1680,-47,0,2,0,0.181818,4,11,11,7,0,0,13,13,false,false,false,0,1
160,147,13,16,16.333333,13,720,437,283,0,0,0,0,47,10,9,0.893617,0,0,10,9,false,false,false,0.326,0.674
46,6,40,23,6,40,1636,1727,-91,0,0,0,0,88,2,1,0.340909,0,0,17,9,false,false,true,0.688,0.312
295,412,-117,19.666667,29.428571,-117,999,1283,-284,0,2,0,0.142857,-5,15,14,-6.6,0,0,4,6,false,false,false,0,1
114,122,-8,12.666667,15.25,-8,163,346,-183,0,0,0,0,40,9,8,0.975,0,1,16,18,false,false,false,0.029,0.971
10,38,-28,10,38,-28,1045,1100,-55,0,0,0,0,94,1,1,0.361702,0,0,8,11,false,false,true,0.524,0.476
312,329,-17,14.181818,14.954545,-17,1203,1270,-67,1,0,0.045455,0,-27,22,22,-1.62963,0,0,1,2,true,false,false,0.186,0.814
180,220,-40,16.363636,22,-40,907,910,-3,0,1,0,0.1,43,11,10,1,0,1,10,18,false,false,false,0.034,0.966
307,357,-50,18.058824,22.3125,-50,668,771,-103,0,0,0,0,-6,17,16,-6.666667,0,1,1,3,false,false,false,0,1
120,122,-2,17.142857,20.333333,-2,451,448,3,0,0,0,0,59,7,6,0.627119,0,1,10,6,false,false,false,0.071,0.929
295,337,-42,16.388889,19.823529,-42,568,570,-2,0,0,0,0,-11,18,17,-3.363636,0,0,1,1,false,false,false,0,1
10,14,-4,10,14,-4,1164,1149,15,0,0,0,0,92,1,1,0.51087,0,0,19,9,false,false,true,0.678,0.322
181,167,14,36.2,41.75,14,1699,1580,119,2,0,0.4,0,60,5,4,0.5,0,0,10,15,false,false,false,0.121,0.879
204,169,35,17,14.083333,35,670,576,94,0,0,0,0,21,12,12,1.952381,1,1,8,18,false,false,true,0.903,0.097
149,183,-34,14.9,20.333333,-34,306,361,-55,0,0,0,0,29,10,9,1.241379,0,1,7,6,false,false,false,0.006,0.994
27,99,-72,13.5,49.5,-72,1270,1424,-154,0,1,0,0.5,84,2,2,0.416667,0,0,7,8,false,false,false,0.199,0.801
258,257,1,23.454545,25.7,1,1354,1210,144,0,1,0,0.1,22,11,10,1.5,0,0,17,12,false,false,false,0.213,0.787
181,245,-64,15.083333,20.416667,-64,642,952,-310,0,0,0,0,24,12,12,1.833333,0,0,8,12,false,false,false,0.002,0.998
143,97,46,23.833333,19.4,46,1078,1095,-17,1,0,0.166667,0,60,6,5,0.616667,0,1,17,15,false,false,true,0.527,0.473
171,247,-76,17.1,27.444444,-76,954,939,15,0,0,0,0,32,10,9,1.125,1,1,18,7,false,false,false,0.003,0.997
311,362,-51,19.4375,24.133333,-51,1164,1261,-97,0,1,0,0.066667,1,16,15,42,0,0,12,7,false,false,false,0,1
66,88,-22,13.2,22,-22,952,826,126,0,0,0,0,76,5,4,0.565789,0,0,11,10,false,false,false,0.204,0.796
297,355,-58,18.5625,22.1875,-58,1126,1277,-151,0,0,0,0,-16,16,16,-2.1875,0,0,1,8,false,false,false,0,1
260,298,-38,13,14.9,-38,500,532,-32,0,0,0,0,-25,20,20,-1.64,0,1,16,1,false,false,false,0,1
104,143,-39,13,17.875,-39,1075,1189,-114,0,0,0,0,48,8,8,0.833333,0,0,8,15,false,false,false,0.039,0.961
37,26,11,18.5,26,11,1432,1452,-20,0,0,0,0,86,2,1,0.418605,0,0,16,11,false,false,true,0.677,0.323
284,362,-78,14.2,19.052632,-78,341,416,-75,0,0,0,0,-23,20,19,-1.695652,0,0,1,1,true,false,false,0,1
151,249,-98,11.615385,20.75,-98,632,603,29,0,1,0,0.083333,9,13,12,4.222222,0,0,18,7,false,false,false,0,1
177,242,-65,12.642857,18.615385,-65,683,859,-176,0,0,0,0,24,14,13,1.875,0,0,11,13,false,false,false,0,1
62,20,42,20.666667,10,42,1203,1270,-67,0,0,0,0,87,3,2,0.505747,1,0,6,16,false,false,false,0.41,0.59
173,208,-35,19.222222,26,-35,1315,1331,-16,0,0,0,0,37,9,8,0.891892,0,0,15,18,false,false,false,0.195,0.805
56,57,-1,18.666667,28.5,-1,971,635,336,0,0,0,0,80,3,2,0.4,0,0,12,9,false,false,false,0.217,0.783
31,6,25,10.333333,3,25,1037,1016,21,0,0,0,0,90,3,2,0.644444,0,1,7,10,false,false,false,0.292,0.708
246,263,-17,15.375,17.533333,-17,450,503,-53,0,0,0,0,-2,16,15,-19.5,0,0,17,10,false,false,false,0.023,0.977
113,144,-31,16.142857,24,-31,518,414,104,0,1,0,0.166667,56,7,6,0.678571,0,0,19,13,false,false,false,0.208,0.792
85,72,13,21.25,24,13,1388,1366,22,0,0,0,0,73,4,3,0.438356,0,0,14,10,false,false,true,0.671,0.329
24,89,-65,12,44.5,-65,1583,1403,180,0,0,0,0,77,2,2,0.415584,0,0,7,19,false,false,false,0.007,0.993
195,239,-44,24.375,34.142857,-44,1388,1455,-67,0,0,0,0,35,8,7,0.8,1,1,11,10,false,false,false,0.068,0.932
20,21,-1,20,21,-1,613,525,88,0,0,0,0,91,1,1,0.461538,0,1,18,11,false,false,true,0.679,0.321
297,395,-98,14.85,19.75,-98,952,826,126,0,1,0,0.05,-20,20,20,-2.15,0,0,4,2,false,false,false,0,1
177,244,-67,12.642857,17.428571,-67,595,540,55,0,0,0,0,13,14,14,3.307692,0,0,12,11,false,false,false,0,1
10,13,-3,10,13,-3,566,742,-176,0,0,0,0,94,1,1,0.340426,0,0,7,8,false,false,false,0.251,0.749
85,153,-68,9.444444,19.125,-68,1078,983,95,0,0,0,0,55,9,8,0.872727,1,1,8,15,false,false,false,0,1
275,191,84,17.1875,12.733333,84,1065,948,117,0,0,0,0,15,16,15,2.6,0,0,8,10,false,false,true,0.997,0.003
111,129,-18,18.5,25.8,-18,1407,1473,-66,0,1,0,0.2,62,6,5,0.5,0,0,12,9,false,false,false,0.208,0.792
70,119,-49,17.5,29.75,-49,1315,1334,-19,0,1,0,0.25,67,4,4,0.537313,0,0,21,19,false,false,false,0.201,0.799
230,265,-35,20.909091,24.090909,-35,1428,1361,67,0,0,0,0,19,11,11,1.736842,1,0,10,9,false,false,false,0.328,0.672
324,362,-38,20.25,24.133333,-38,1417,1482,-65,0,1,0,0.066667,4,16,15,8.25,0,1,5,7,false,false,false,0,1
263,367,-104,18.785714,26.214286,-104,1094,1159,-65,0,0,0,0,-5,14,14,-7.6,1,0,6,8,false,false,false,0,1
298,319,-21,18.625,19.9375,-21,971,635,336,0,0,0,0,-18,16,16,-1.777778,0,0,2,3,true,false,false,0.009,0.991
149,102,47,24.833333,20.4,47,1070,814,256,1,1,0.166667,0.2,54,6,5,0.611111,0,0,14,19,false,false,true,0.991,0.009
320,367,-47,20,22.9375,-47,980,965,15,0,0,0,0,-6,16,16,-6.333333,0,0,8,5,false,false,false,0,1
273,398,-125,21,30.615385,-125,1636,1702,-66,0,1,0,0.076923,2,13,13,14.5,0,0,7,8,false,false,false,0,1
129,102,27,14.333333,12.75,27,1193,1220,-27,0,0,0,0,40,9,8,1.075,1,1,8,18,false,false,true,0.558,0.442
305,450,-145,16.944444,26.470588,-145,976,995,-19,1,2,0.055556,0.117647,-17,18,17,-2.235294,1,0,0,4,false,false,false,0,1
184,277,-93,18.4,27.7,-93,1305,1254,51,0,1,0,0.1,22,10,10,1.454545,0,0,15,13,false,false,false,0,1
347,377,-30,21.6875,23.5625,-30,1110,1399,-289,0,1,0,0.0625,-6,16,16,-5.666667,0,0,1,4,false,false,false,0,1
221,287,-66,27.625,41,-66,1537,1539,-2,0,1,0,0.142857,32,8,7,1.0625,0,0,16,25,false,false,false,0.002,0.998
224,263,-39,24.888889,29.222222,-39,1793,1869,-76,0,1,0,0.111111,31,9,9,0.967742,0,0,24,8,false,false,false,0.201,0.799
290,352,-62,19.333333,23.466667,-62,1205,1216,-11,0,0,0,0,-4,15,15,-8.25,0,0,5,5,false,false,false,0,1
264,321,-57,16.5,21.4,-57,1159,1131,28,0,2,0,0.133333,-4,16,15,-9.25,0,1,5,16,false,false,false,0,1
93,87,6,46.5,43.5,6,169,306,-137,1,1,0.5,0.5,73,2,2,0.424658,0,0,10,16,false,false,true,0.659,0.341
163,157,6,16.3,17.444444,6,1037,1009,28,0,0,0,0,43,10,9,1.023256,0,1,16,9,false,false,false,0.102,0.898
218,281,-63,16.769231,23.416667,-63,736,791,-55,0,0,0,0,8,13,12,4.75,0,0,8,10,false,false,false,0,1
46,52,-6,15.333333,26,-6,1055,1019,36,0,0,0,0,80,3,2,0.4125,1,0,6,17,false,false,true,0.582,0.418
307,356,-49,18.058824,22.25,-49,804,1080,-276,1,0,0.058824,0,-15,17,16,-2.266667,0,0,4,2,false,false,false,0,1
36,8,28,18,8,28,1552,1803,-251,0,0,0,0,91,2,1,0.362637,0,0,7,9,false,false,false,0.251,0.749
70,35,35,35,17.5,35,804,1074,-270,0,0,0,0,85,2,2,0.376471,0,0,7,17,false,false,false,0.29,0.71
18,35,-17,18,35,-17,480,518,-38,0,0,0,0,91,1,1,0.43956,0,1,10,15,false,false,false,0.02,0.98
74,160,-86,10.571429,22.857143,-86,632,603,29,0,0,0,0,52,7,7,0.730769,1,0,6,14,false,false,false,0.018,0.982
266,155,111,17.733333,11.071429,111,1065,948,117,0,0,0,0,19,15,14,2.052632,0,0,8,15,false,false,true,1,0
201,284,-83,20.1,28.4,-83,1101,1115,-14,0,0,0,0,26,10,10,1.153846,0,1,9,14,false,false,false,0,1
334,364,-30,13.916667,15.826087,-30,1220,1185,35,0,1,0,0.043478,-25,24,23,-1.88,0,0,8,4,true,false,false,0,1
99,110,-11,12.375,13.75,-11,542,390,152,0,0,0,0,62,8,8,0.806452,0,0,13,16,false,false,false,0.247,0.753
224,259,-35,17.230769,21.583333,-35,725,668,57,0,0,0,0,18,13,12,1.944444,0,0,7,12,false,false,false,0.071,0.929
311,387,-76,31.1,38.7,-76,1777,1500,277,1,2,0.1,0.2,13,10,10,2.153846,0,0,13,10,false,false,false,0.055,0.945
20,0,20,20,0,20,613,525,88,0,0,0,0,94,1,0,0.446809,0,0,18,0,false,false,true,0.692,0.308
58,32,26,14.5,8,26,491,651,-160,0,0,0,0,76,4,4,0.394737,0,1,12,11,false,false,false,0.421,0.579
281,427,-146,17.5625,26.6875,-146,1315,1334,-19,0,2,0,0.125,-13,16,16,-2.769231,0,0,2,4,false,false,false,0,1
21,28,-7,10.5,28,-7,1078,1095,-17,0,0,0,0,91,2,1,0.406593,0,0,7,15,false,false,false,0.466,0.534
170,195,-25,21.25,27.857143,-25,595,733,-138,1,1,0.125,0.142857,37,8,7,1.054054,0,1,17,13,false,false,false,0.065,0.935
60,120,-60,10,20,-60,813,698,115,0,0,0,0,62,6,6,0.774194,1,1,8,7,false,false,false,0.057,0.943
259,299,-40,12.95,14.95,-40,226,361,-135,0,0,0,0,-31,20,20,-1.419355,0,0,1,3,false,false,false,0,1
231,266,-35,13.588235,15.647059,-35,999,1165,-166,0,0,0,0,4,17,17,11.5,1,1,15,7,false,false,false,0.11,0.89
216,192,24,18,17.454545,24,561,688,-127,0,0,0,0,32,12,11,1.4375,0,0,16,9,false,false,true,0.778,0.222
98,95,3,19.6,19,3,615,542,73,0,0,0,0,69,5,5,0.608696,0,0,9,15,false,false,true,0.661,0.339
244,272,-28,13.555556,16,-28,526,502,24,0,0,0,0,-3,18,17,-16.666667,1,0,17,19,false,false,true,0.534,0.466
70,80,-10,17.5,20,-10,694,658,36,0,0,0,0,71,4,4,0.521127,0,0,26,8,false,false,true,0.679,0.321
282,273,9,23.5,24.818182,9,1341,1606,-265,1,0,0.083333,0,8,12,11,4.125,0,0,13,12,false,false,false,0.285,0.715
54,99,-45,10.8,24.75,-45,795,786,9,0,0,0,0,79,5,4,0.481013,0,0,7,7,false,false,false,0.04,0.96
213,373,-160,16.384615,28.692308,-160,926,973,-47,0,0,0,0,7,13,13,5,0,0,10,8,false,false,false,0,1
154,275,-121,12.833333,22.916667,-121,1075,1189,-114,0,0,0,0,21,12,12,1.904762,0,0,7,15,false,false,false,0,1
285,326,-41,12.954545,15.52381,-41,951,976,-25,0,0,0,0,-27,22,21,-1.62963,0,0,1,1,false,false,false,0,1
377,456,-79,18.85,24,-79,724,398,326,1,1,0.05,0.052632,-28,20,19,-1.392857,0,0,5,5,true,false,false,0,1
280,365,-85,18.666667,24.333333,-85,1493,1413,80,0,1,0,0.066667,-8,15,15,-4.5,0,0,10,4,false,false,false,0,1
181,158,23,13.923077,13.166667,23,1193,1220,-27,0,0,0,0,23,13,12,1.869565,1,1,8,16,false,false,false,0.292,0.708
249,357,-108,14.647059,22.3125,-108,711,746,-35,0,0,0,0,-3,17,16,-12.666667,0,0,4,7,false,false,false,0,1
108,183,-75,13.5,22.875,-75,948,998,-50,0,0,0,0,42,8,8,0.880952,1,0,8,14,false,false,false,0.042,0.958
285,318,-33,17.8125,21.2,-33,1210,1162,48,0,0,0,0,-3,16,15,-10.666667,0,0,6,13,false,false,false,0,1
80,161,-81,11.428571,23,-81,1270,1424,-154,0,1,0,0.142857,58,7,7,0.603448,0,0,18,15,false,false,false,0.037,0.963
25,0,25,12.5,0,25,913,1037,-124,0,0,0,0,94,2,1,0.43617,0,0,25,12,false,false,false,0.257,0.743
127,142,-15,25.4,28.4,-15,576,602,-26,0,0,0,0,64,5,5,0.65625,0,0,10,10,false,false,false,0.267,0.733
46,32,14,23,32,14,804,1080,-276,0,0,0,0,86,2,1,0.395349,1,0,7,22,false,false,false,0.029,0.971
146,189,-43,20.857143,27,-43,907,910,-3,0,1,0,0.142857,57,7,7,0.754386,1,0,6,22,false,false,false,0.23,0.77
236,312,-76,13.111111,17.333333,-76,830,787,43,0,0,0,0,-19,18,18,-2,0,0,2,1,false,false,false,0,1
24,35,-11,12,17.5,-11,727,820,-93,0,1,0,0.5,80,2,2,0.4375,0,0,11,21,false,false,true,0.593,0.407
127,61,66,42.333333,20.333333,66,691,695,-4,1,0,0.333333,0,74,3,3,0.432432,0,0,11,19,false,false,true,0.953,0.047
190,221,-31,19,24.555556,-31,621,786,-165,0,0,0,0,21,10,9,1.428571,0,0,14,19,false,false,false,0.042,0.958
85,90,-5,21.25,30,-5,1439,1314,125,0,0,0,0,77,4,3,0.363636,0,0,25,7,false,false,false,0.378,0.622
136,139,-3,17,19.857143,-3,599,448,151,0,0,0,0,46,8,7,0.782609,0,1,23,6,false,false,false,0.455,0.545
169,209,-40,15.363636,19,-40,1075,878,197,0,0,0,0,34,11,11,0.970588,0,1,13,8,false,false,false,0.075,0.925
255,293,-38,18.214286,20.928571,-38,343,570,-227,0,0,0,0,-4,14,14,-9,0,1,10,6,false,false,false,0.004,0.996
242,221,21,18.615385,18.416667,21,500,509,-9,0,0,0,0,19,13,12,2.157895,0,0,7,16,false,false,false,0.301,0.699
252,292,-40,21,24.333333,-40,689,804,-115,0,0,0,0,12,12,12,2.916667,0,1,7,7,false,false,false,0.003,0.997
200,266,-66,16.666667,24.181818,-66,736,791,-55,0,0,0,0,14,12,11,2.714286,0,0,11,9,false,false,false,0.001,0.999
214,233,-19,26.75,29.125,-19,1331,1347,-16,1,0,0.125,0,30,8,8,1.066667,0,0,7,10,false,false,true,0.645,0.355
263,294,-31,17.533333,21,-31,1302,1351,-49,0,0,0,0,3,15,14,12.333333,0,0,11,14,false,false,false,0.02,0.98
301,323,-22,17.705882,20.1875,-22,775,786,-11,1,0,0.058824,0,-4,17,16,-10.75,1,0,18,18,false,false,false,0.001,0.999
278,325,-47,21.384615,27.083333,-47,1266,1339,-73,0,1,0,0.083333,15,13,12,2.333333,0,0,7,9,false,false,false,0.001,0.999
310,336,-26,20.666667,22.4,-26,1428,1361,67,0,0,0,0,-8,15,15,-4.125,1,0,9,1,false,false,false,0.05,0.95
293,414,-121,36.625,51.75,-121,2147,2219,-72,1,2,0.125,0.25,19,8,8,1.263158,1,0,9,11,false,false,false,0,1
247,306,-59,13,17,-59,651,700,-49,0,0,0,0,-15,19,18,-3.733333,0,1,12,10,false,false,false,0,1
65,112,-47,10.833333,18.666667,-47,651,567,84,0,0,0,0,59,6,6,0.932203,0,1,7,17,false,false,false,0.055,0.945
72,57,15,18,14.25,15,671,638,33,0,0,0,0,70,4,4,0.7,0,0,11,19,false,false,true,0.706,0.294
189,294,-105,14.538462,24.5,-105,530,683,-153,0,1,0,0.083333,23,13,12,1.73913,0,0,17,12,false,false,false,0,1
277,358,-81,27.7,35.8,-81,1770,1751,19,0,1,0,0.1,17,10,10,1.705882,0,0,8,14,false,false,false,0,1
268,205,63,22.333333,18.636364,63,1168,1216,-48,0,0,0,0,36,12,11,0.916667,0,0,7,9,false,false,true,0.817,0.183
226,316,-90,22.6,35.111111,-90,1586,1633,-47,1,0,0.1,0,37,10,9,0.918919,0,1,17,6,false,false,false,0,1
332,338,-6,27.666667,28.166667,-6,1047,1127,-80,0,1,0,0.083333,-2,12,12,-13.5,0,0,21,6,false,false,true,0.63,0.37
41,27,14,20.5,27,14,341,416,-75,0,0,0,0,89,2,1,0.438202,0,0,8,10,false,false,false,0.243,0.757
120,160,-40,15,22.857143,-40,430,542,-112,0,1,0,0.142857,49,8,7,0.979592,0,0,20,10,false,false,false,0.065,0.935
228,350,-122,11.4,18.421053,-122,1248,1220,28,0,1,0,0.052632,-1,20,19,-52,1,0,8,10,false,false,false,0,1
178,109,69,29.666667,21.8,69,1770,1751,19,0,0,0,0,50,6,5,0.58,0,2,11,6,false,false,true,0.967,0.033
172,201,-29,19.111111,25.125,-29,892,856,36,0,1,0,0.125,37,9,8,0.945946,1,0,7,16,false,false,false,0.327,0.673
198,245,-47,18,22.272727,-47,691,704,-13,0,1,0,0.090909,27,11,11,1.407407,0,0,10,12,false,false,false,0.077,0.923
99,103,-4,14.142857,17.166667,-4,595,540,55,0,0,0,0,53,7,6,0.811321,0,1,10,16,false,false,false,0.107,0.893
328,385,-57,25.230769,29.615385,-57,1086,926,160,0,2,0,0.153846,-8,13,13,-3.5,0,0,5,1,false,false,false,0,1
331,362,-31,22.066667,24.133333,-31,1656,1580,76,1,1,0.066667,0.066667,-5,15,15,-6.6,0,0,6,2,false,false,false,0,1
115,61,54,38.333333,30.5,54,824,830,-6,1,0,0.333333,0,78,3,2,0.564103,1,0,19,17,false,false,true,0.577,0.423
146,95,51,24.333333,19,51,1281,1268,13,0,0,0,0,60,6,5,0.7,0,0,8,10,false,false,true,0.798,0.202
294,337,-43,22.615385,28.083333,-43,801,679,122,1,0,0.076923,0,-3,13,12,-9.666667,0,0,6,14,false,false,false,0,1
34,35,-1,11.333333,17.5,-1,951,976,-25,0,0,0,0,83,3,2,0.53012,1,1,16,21,false,false,false,0.209,0.791
187,244,-57,12.466667,17.428571,-57,1278,1101,177,0,1,0,0.071429,16,15,14,2.3125,0,0,23,9,false,false,true,0.584,0.416
254,281,-27,15.875,17.5625,-27,595,538,57,0,0,0,0,-5,16,16,-7.6,0,0,6,4,false,false,false,0.298,0.702
97,179,-82,12.125,22.375,-82,95,453,-358,0,0,0,0,54,8,8,0.722222,0,0,11,16,false,false,false,0.001,0.999
329,380,-51,27.416667,34.545455,-51,1431,1399,32,0,2,0,0.181818,-5,12,11,-5,0,0,10,3,false,false,false,0,1
282,334,-52,16.588235,20.875,-52,1633,1620,13,0,0,0,0,-19,17,16,-1.894737,0,0,1,4,false,false,false,0,1
340,402,-62,26.153846,30.923077,-62,1331,1432,-101,0,1,0,0.076923,-6,13,13,-4.5,0,1,7,7,false,false,false,0,1
124,201,-77,20.666667,33.5,-77,1266,1339,-73,0,1,0,0.166667,59,6,6,0.59322,0,0,11,14,false,false,false,0.11,0.89
156,129,27,31.2,25.8,27,1397,1405,-8,1,0,0.2,0,57,5,5,0.508772,0,0,12,12,false,false,true,0.707,0.293
378,376,2,23.625,25.066667,2,1110,1123,-13,1,2,0.0625,0.133333,-15,16,15,-2.2,0,0,3,3,false,false,false,0.43,0.57
120,371,-251,10,33.727273,-251,1164,1149,15,0,2,0,0.181818,40,12,11,1.175,0,0,12,9,false,false,false,0,1
50,151,-101,12.5,37.75,-101,1220,1202,18,0,0,0,0,71,4,4,0.704225,0,0,23,9,false,false,false,0.189,0.811
164,180,-16,16.4,18,-16,907,1070,-163,0,0,0,0,37,10,10,0.945946,0,0,11,16,false,false,false,0.055,0.945
20,10,10,10,10,10,925,1000,-75,0,0,0,0,88,2,1,0.5,0,0,9,8,false,false,false,0.276,0.724
160,199,-39,16,22.111111,-39,518,414,104,0,1,0,0.111111,38,10,9,1,0,1,11,9,false,false,false,0.177,0.823
191,249,-58,21.222222,27.666667,-58,1173,1256,-83,1,0,0.111111,0,36,9,9,0.861111,1,1,8,13,false,false,false,0.003,0.997
254,303,-49,16.933333,20.2,-49,1281,1268,13,0,0,0,0,9,15,15,4.666667,1,0,6,14,false,false,false,0.015,0.985
202,355,-153,9.619048,17.75,-153,651,996,-345,0,2,0,0.1,-25,21,20,-1.8,0,0,5,3,false,false,false,0,1
273,330,-57,15.166667,19.411765,-57,1101,1130,-29,1,1,0.055556,0.058824,-3,18,17,-15,0,1,8,9,false,false,false,0,1
45,74,-29,15,24.666667,-29,1176,1211,-35,0,0,0,0,73,3,3,0.452055,1,0,8,14,false,false,true,0.647,0.353
258,250,8,23.454545,25,8,1237,1265,-28,1,0,0.090909,0,15,11,10,2.4,0,0,7,14,false,false,false,0.428,0.572
166,307,-141,13.833333,25.583333,-141,760,976,-216,0,1,0,0.083333,12,12,12,3,0,1,15,19,false,false,false,0,1
94,130,-36,15.666667,21.666667,-36,1203,1270,-67,0,0,0,0,63,6,6,0.698413,1,0,12,18,false,false,false,0.045,0.955
308,423,-115,11.407407,15.666667,-115,1037,1016,21,1,0,0.037037,0,-24,27,27,-2.416667,1,0,1,5,false,false,false,0,1
267,299,-32,20.538462,24.916667,-32,1101,1237,-136,1,0,0.076923,0,15,13,12,2.266667,1,0,18,10,false,false,false,0.018,0.982
102,138,-36,14.571429,19.714286,-36,951,976,-25,0,0,0,0,56,7,7,0.785714,1,1,15,21,false,false,false,0.004,0.996
232,260,-28,12.210526,13.684211,-28,342,53,289,0,0,0,0,-27,19,19,-1.518519,0,0,3,1,false,false,false,0.03,0.97
146,150,-4,20.857143,21.428571,-4,1168,1062,106,0,0,0,0,54,7,7,0.796296,0,0,11,18,false,false,false,0.203,0.797
18,0,18,18,0,18,620,698,-78,0,0,0,0,95,1,0,0.431579,0,0,10,0,false,false,false,0.254,0.746
112,171,-59,12.444444,19,-59,1075,1189,-114,0,0,0,0,42,9,9,0.952381,0,0,11,17,false,false,false,0.038,0.962
53,34,19,17.666667,17,19,1493,1453,40,0,0,0,0,84,3,2,0.416667,0,0,9,23,false,false,false,0.331,0.669
175,248,-73,17.5,27.555556,-73,1583,1403,180,0,0,0,0,30,10,9,1.066667,0,1,14,9,false,false,false,0.004,0.996
279,358,-79,17.4375,22.375,-79,954,939,15,1,0,0.0625,0,-14,16,16,-2.571429,0,1,4,2,false,false,false,0,1
348,413,-65,21.75,27.533333,-65,724,398,326,1,1,0.0625,0.066667,0,16,15,0,0,0,9,9,false,false,false,0,1
13,69,-56,6.5,69,-56,518,414,104,0,1,0,1,86,2,1,0.44186,0,0,20,9,false,false,false,0.142,0.858
258,350,-92,11.727273,16.666667,-92,642,952,-310,0,0,0,0,-23,22,21,-1.913043,0,0,1,2,false,false,false,0,1
67,78,-11,22.333333,26,-11,1245,1148,97,0,0,0,0,78,3,3,0.448718,0,0,19,17,false,false,false,0.379,0.621
234,326,-92,39,54.333333,-92,2147,2219,-72,1,2,0.166667,0.333333,34,6,6,0.705882,0,0,11,17,false,false,false,0,1
149,196,-47,13.545455,19.6,-47,1220,1202,18,0,0,0,0,30,11,10,1.666667,0,0,29,9,false,false,false,0.197,0.803
34,34,0,17,17,0,1065,948,117,0,0,0,0,85,2,2,0.458824,1,0,15,11,false,false,true,0.73,0.27
102,92,10,20.4,23,10,939,969,-30,0,0,0,0,63,5,4,0.52381,0,0,10,10,false,false,true,0.676,0.324
194,204,-10,19.4,20.4,-10,1495,1531,-36,0,0,0,0,38,10,10,0.973684,1,0,6,9,false,false,false,0.223,0.777
107,57,50,35.666667,28.5,50,1331,1347,-16,1,0,0.333333,0,75,3,2,0.426667,0,0,8,26,false,false,true,0.684,0.316
138,157,-19,17.25,22.428571,-19,775,786,-11,0,0,0,0,48,8,7,0.895833,1,0,12,14,false,false,false,0.17,0.83
150,160,-10,18.75,22.857143,-10,527,954,-427,0,0,0,0,51,8,7,0.686275,0,1,23,13,false,false,false,0.044,0.956
28,21,7,14,10.5,7,450,427,23,0,0,0,0,85,2,2,0.435294,0,1,17,10,false,false,false,0.297,0.703
64,49,15,21.333333,24.5,15,1161,1030,131,0,0,0,0,79,3,2,0.481013,0,0,11,19,false,false,false,0.473,0.527
106,78,28,17.666667,15.6,28,720,437,283,0,0,0,0,70,6,5,0.6,0,0,12,17,false,false,false,0.348,0.652
114,152,-38,16.285714,25.333333,-38,1193,1177,16,0,0,0,0,59,7,6,0.59322,0,0,13,8,false,false,false,0.196,0.804
45,63,-18,9,15.75,-18,342,53,289,0,0,0,0,70,5,4,0.585714,0,0,11,22,false,false,false,0.202,0.798
102,103,-1,20.4,20.6,-1,450,503,-53,0,0,0,0,64,5,5,0.609375,0,0,13,17,false,false,false,0.272,0.728
143,162,-19,20.428571,27,-19,835,786,49,0,0,0,0,46,7,6,0.73913,0,1,24,7,false,false,false,0.328,0.672
30,38,-8,7.5,12.666667,-8,1344,1208,136,0,0,0,0,81,4,3,0.37037,0,0,21,19,false,false,false,0.202,0.798
220,411,-191,20,41.1,-191,1219,1216,3,1,3,0.090909,0.3,6,11,10,4.5,0,0,14,7,false,false,false,0,1
158,83,75,31.6,16.6,75,1101,1237,-136,1,0,0.2,0,62,5,5,0.548387,0,1,8,8,false,false,false,0.471,0.529
121,87,34,20.166667,14.5,34,1633,1556,77,0,0,0,0,56,6,6,0.589286,0,0,18,7,false,false,true,0.808,0.192
14,23,-9,14,23,-9,503,668,-165,0,0,0,0,92,1,1,0.402174,0,0,10,14,false,false,false,0.251,0.749
235,314,-79,19.583333,26.166667,-79,653,1004,-351,0,0,0,0,6,12,12,4.833333,0,0,16,16,false,false,false,0,1
127,94,33,25.4,23.5,33,1495,1531,-36,0,0,0,0,70,5,4,0.528571,0,0,13,8,false,false,true,0.686,0.314
255,344,-89,13.421053,18.105263,-89,714,892,-178,0,2,0,0.105263,-17,19,19,-2.470588,0,0,8,6,false,false,false,0,1
104,91,13,20.8,18.2,13,387,683,-296,0,0,0,0,61,5,5,0.557377,1,0,8,10,false,false,true,0.649,0.351
20,17,3,20,17,3,344,315,29,0,0,0,0,90,1,1,0.444444,0,0,9,10,false,false,true,0.617,0.383
195,221,-26,16.25,20.090909,-26,1310,1477,-167,0,0,0,0,14,12,11,2.571429,1,0,9,10,false,false,false,0.05,0.95
129,142,-13,21.5,23.666667,-13,999,1283,-284,0,0,0,0,59,6,6,0.559322,0,1,13,14,false,false,false,0.213,0.787
145,83,62,20.714286,13.833333,62,771,668,103,0,0,0,0,46,7,6,0.826087,0,0,12,7,false,false,true,0.882,0.118
105,154,-49,17.5,25.666667,-49,642,952,-310,0,0,0,0,58,6,6,0.758621,0,0,7,24,false,false,false,0.039,0.961
276,309,-33,18.4,20.6,-33,1037,913,124,2,1,0.133333,0.066667,6,15,15,6.333333,0,0,14,10,false,false,false,0.001,0.999
197,314,-117,14.071429,24.153846,-117,530,683,-153,0,1,0,0.076923,17,14,13,2.352941,0,0,17,14,false,false,false,0,1
76,77,-1,15.2,15.4,-1,1312,1334,-22,0,0,0,0,64,5,5,0.609375,0,0,22,19,false,false,true,0.601,0.399
163,275,-112,23.285714,45.833333,-112,1556,1616,-60,0,0,0,0,49,7,6,0.591837,0,0,20,10,false,false,false,0,1
46,57,-11,15.333333,19,-11,1003,1018,-15,0,0,0,0,78,3,3,0.474359,0,0,15,10,false,false,true,0.674,0.326
131,162,-31,14.555556,18,-31,907,1070,-163,0,0,0,0,41,9,9,0.853659,0,0,17,16,false,false,false,0.057,0.943
62,61,1,12.4,15.25,1,542,605,-63,0,0,0,0,66,5,4,0.545455,1,1,12,13,false,false,false,0.103,0.897
323,366,-43,19,21.529412,-43,1452,1388,64,0,1,0,0.058824,-13,17,17,-2.692308,0,0,6,1,false,false,false,0,1
293,361,-68,19.533333,25.785714,-68,1269,1477,-208,1,0,0.066667,0,4,15,14,8.75,0,0,7,10,false,false,false,0,1
140,168,-28,17.5,21,-28,1047,1253,-206,1,0,0.125,0,51,8,8,0.72549,0,0,7,11,false,false,false,0.249,0.751
259,356,-97,19.923077,27.384615,-97,1583,1403,180,0,0,0,0,4,13,13,8,0,0,10,8,false,false,false,0,1
118,175,-57,23.6,35,-57,595,733,-138,1,1,0.2,0.2,54,5,5,0.722222,0,1,14,10,false,false,false,0.023,0.977
210,249,-39,21,24.9,-39,1428,1361,67,0,0,0,0,25,10,10,1.32,0,0,11,10,false,false,false,0.179,0.821
57,103,-46,14.25,34.333333,-46,1803,1658,145,0,0,0,0,70,4,3,0.471429,2,0,15,13,false,false,false,0.231,0.769
323,327,-4,20.1875,20.4375,-4,1341,1606,-265,1,0,0.0625,0,-15,16,16,-2.2,0,0,3,1,false,false,true,0.575,0.425
180,190,-10,18,21.111111,-10,1021,1094,-73,1,0,0.1,0,36,10,9,1.027778,1,0,9,12,false,false,false,0.441,0.559
63,70,-7,21,23.333333,-7,642,952,-310,0,0,0,0,77,3,3,0.571429,0,1,11,19,false,false,false,0.038,0.962
70,68,2,14,17,2,568,570,-2,0,0,0,0,71,5,4,0.521127,0,0,7,24,false,false,false,0.099,0.901
189,224,-35,18.9,22.4,-35,620,698,-78,1,0,0.1,0,35,10,10,1.171429,0,0,21,16,false,false,false,0.056,0.944
18,24,-6,18,24,-6,451,448,3,0,0,0,0,94,1,1,0.393617,0,1,22,6,false,false,false,0.165,0.835
82,78,4,20.5,19.5,4,711,746,-35,0,0,0,0,73,4,4,0.520548,1,0,13,12,false,false,true,0.644,0.356
62,41,21,20.666667,13.666667,21,1065,948,117,0,0,0,0,78,3,3,0.5,1,0,17,20,false,false,true,0.788,0.212
140,127,13,20,18.142857,13,1417,1482,-65,0,0,0,0,58,7,7,0.568966,0,0,19,13,false,false,true,0.626,0.374
287,367,-80,13.045455,17.47619,-80,1101,1130,-29,1,1,0.045455,0.047619,-19,22,21,-2.368421,0,1,3,1,false,false,false,0,1
114,235,-121,16.285714,33.571429,-121,710,758,-48,0,1,0,0.142857,53,7,7,0.698113,0,0,9,7,false,false,false,0,1
311,350,-39,22.214286,25,-39,1388,1366,22,0,1,0,0.071429,-1,14,14,-32,0,0,12,7,false,false,false,0,1
95,220,-125,10.555556,27.5,-125,1368,1452,-84,0,0,0,0,50,9,8,0.64,1,0,7,7,false,false,false,0.001,0.999
166,189,-23,23.714286,31.5,-23,1173,1256,-83,1,0,0.142857,0,54,7,6,0.574074,0,1,10,6,false,false,false,0.019,0.981
10,14,-4,10,14,-4,595,540,55,0,0,0,0,92,1,1,0.467391,0,0,15,16,false,false,true,0.663,0.337
184,129,55,30.666667,25.8,55,1397,1405,-8,1,0,0.166667,0,53,6,5,0.54717,0,0,13,12,false,false,true,0.806,0.194
292,253,39,20.857143,19.461538,39,1168,1216,-48,0,0,0,0,18,14,13,1.833333,1,1,6,9,false,false,false,0.295,0.705
69,88,-19,13.8,17.6,-19,360,371,-11,0,0,0,0,63,5,5,0.587302,0,0,15,11,false,false,false,0.291,0.709
255,387,-132,36.428571,55.285714,-132,1398,1431,-33,0,0,0,0,26,7,7,1.076923,0,1,10,12,false,false,false,0,1
123,142,-19,20.5,23.666667,-19,1645,1636,9,0,1,0,0.166667,49,6,6,0.673469,0,1,17,16,false,false,false,0.197,0.803
223,193,30,24.777778,24.125,30,1770,1745,25,1,0,0.111111,0,44,9,8,0.75,0,1,7,10,false,false,true,0.517,0.483
177,184,-7,14.75,16.727273,-7,450,503,-53,0,0,0,0,24,12,11,1.625,1,1,20,10,false,false,false,0.146,0.854
160,216,-56,17.777778,27,-56,1656,1649,7,0,0,0,0,39,9,8,0.820513,0,0,16,13,false,false,false,0.179,0.821
297,295,2,22.846154,24.583333,2,1645,1636,9,0,1,0,0.083333,1,13,12,33,0,0,9,11,false,false,false,0.012,0.988
252,307,-55,18,21.928571,-55,889,895,-6,0,1,0,0.071429,8,14,14,4.625,0,1,11,22,false,false,false,0,1
98,93,5,24.5,23.25,5,1417,1482,-65,0,0,0,0,73,4,4,0.452055,0,0,22,10,false,false,true,0.678,0.322
39,15,24,19.5,7.5,24,1195,1397,-202,0,0,0,0,89,2,2,0.449438,0,1,7,15,false,false,false,0.271,0.729
264,342,-78,11.478261,14.869565,-78,651,700,-49,0,0,0,0,-34,23,23,-1.647059,0,0,18,11,false,false,false,0,1
130,152,-22,18.571429,21.714286,-22,874,868,6,0,0,0,0,43,7,7,0.767442,0,0,15,22,false,false,false,0.208,0.792
249,327,-78,19.153846,27.25,-78,1131,1030,101,0,0,0,0,4,13,12,7.5,0,0,5,8,false,false,false,0,1
95,135,-40,10.555556,15,-40,1045,1082,-37,0,0,0,0,43,9,9,1.046512,1,0,17,7,false,false,false,0.305,0.695
74,87,-13,12.333333,17.4,-13,595,540,55,0,0,0,0,61,6,5,0.704918,0,1,12,17,false,false,false,0.057,0.943
272,306,-34,16,19.125,-34,952,826,126,0,1,0,0.0625,4,17,16,10.75,0,0,12,17,false,false,false,0,1
328,348,-20,21.866667,24.857143,-20,1188,1334,-146,1,1,0.066667,0.071429,-11,15,14,-2.727273,1,0,4,5,false,false,false,0.351,0.649
246,417,-171,12.947368,23.166667,-171,1075,1189,-114,0,0,0,0,-16,19,18,-2.5,0,0,1,2,false,false,false,0,1
52,67,-15,17.333333,22.333333,-15,1606,1593,13,0,0,0,0,78,3,3,0.371795,0,0,22,12,false,false,true,0.564,0.436
19,14,5,9.5,14,5,595,662,-67,0,0,0,0,89,2,1,0.494382,0,0,15,22,false,false,false,0.25,0.75
129,123,6,32.25,41,6,801,679,122,1,0,0.25,0,69,4,3,0.42029,0,0,10,8,false,false,false,0.113,0.887
313,397,-84,17.388889,23.352941,-84,1269,1477,-208,1,0,0.055556,0,-13,18,17,-2.692308,0,0,4,1,true,false,false,0,1
240,279,-39,20,23.25,-39,967,856,111,0,0,0,0,19,12,12,1.736842,0,1,20,6,false,false,false,0.271,0.729
63,34,29,21,17,29,1040,1091,-51,0,0,0,0,83,3,2,0.566265,0,0,8,18,false,false,false,0.434,0.566
324,472,-148,21.6,31.466667,-148,1554,1685,-131,0,2,0,0.133333,-9,15,15,-3.555556,0,0,1,2,false,false,false,0,1
150,182,-32,15,20.222222,-32,651,700,-49,0,0,0,0,37,10,9,1.513514,1,0,6,15,false,false,false,0.044,0.956
252,425,-173,12.6,22.368421,-173,1075,1189,-114,0,0,0,0,-22,20,19,-1.818182,0,0,1,1,false,false,false,0,1
57,28,29,19,14,29,306,468,-162,0,0,0,0,88,3,2,0.420455,0,0,11,19,false,false,false,0.378,0.622
210,202,8,21,22.444444,8,576,602,-26,0,0,0,0,42,10,9,1,1,0,6,15,false,false,false,0.039,0.961
77,91,-14,19.25,22.75,-14,1691,1510,181,0,0,0,0,69,4,4,0.434783,0,0,18,16,false,false,false,0.246,0.754
264,222,42,26.4,24.666667,42,1563,1539,24,0,1,0,0.111111,22,10,9,1.590909,0,0,10,17,false,false,false,0.369,0.631
239,236,3,18.384615,19.666667,3,1633,1556,77,0,0,0,0,8,13,12,4.125,0,1,10,11,false,false,false,0.025,0.975
120,371,-251,10.909091,33.727273,-251,1164,1149,15,0,2,0,0.181818,40,11,11,1.175,0,0,12,9,false,false,false,0,1
91,117,-26,15.166667,19.5,-26,1439,1428,11,0,0,0,0,63,6,6,0.634921,1,0,15,17,false,false,false,0.28,0.72
88,39,49,22,13,49,1110,1123,-13,0,0,0,0,69,4,3,0.478261,0,0,12,7,false,false,true,0.792,0.208
256,263,-7,18.285714,20.230769,-7,387,683,-296,0,0,0,0,-4,14,13,-8.5,1,1,6,19,false,false,false,0.147,0.853
22,0,22,22,0,22,653,820,-167,0,0,0,0,95,1,0,0.4,0,0,9,0,false,false,false,0.254,0.746
234,305,-71,15.6,21.785714,-71,341,416,-75,0,0,0,0,5,15,14,7.8,0,0,12,19,false,false,false,0,1
138,209,-71,9.857143,14.928571,-71,925,1000,-75,0,0,0,0,15,14,14,2.933333,0,0,19,14,false,false,false,0,1
202,214,-12,16.833333,17.833333,-12,480,518,-38,0,0,0,0,18,12,12,2.222222,0,0,18,10,false,false,false,0.402,0.598
311,367,-56,19.4375,22.9375,-56,1164,1261,-97,0,1,0,0.0625,-2,16,16,-21,0,0,12,7,false,false,false,0,1
173,193,-20,13.307692,16.083333,-20,999,1165,-166,0,0,0,0,25,13,12,1.84,1,0,15,16,false,false,false,0.109,0.891
222,212,10,22.2,21.2,10,1197,1156,41,0,1,0,0.1,30,10,10,1.166667,0,0,12,11,false,false,false,0.388,0.612
77,38,39,38.5,19,39,1055,840,215,0,0,0,0,84,2,2,0.428571,0,1,8,18,false,false,true,0.832,0.168
91,253,-162,11.375,36.142857,-162,940,947,-7,0,2,0,0.285714,45,8,7,0.777778,0,0,8,12,false,false,false,0,1
214,219,-5,19.454545,21.9,-5,694,658,36,0,1,0,0.1,29,11,10,1.275862,0,0,17,9,false,false,true,0.503,0.497
126,138,-12,31.5,46,-12,1761,1770,-9,0,1,0,0.333333,69,4,3,0.376812,0,0,11,12,false,false,false,0.203,0.797
36,73,-37,18,73,-37,503,527,-24,0,1,0,1,85,2,1,0.388235,0,0,10,15,false,false,false,0.221,0.779
0,0,0,0,0,0,1168,1216,-48,0,0,0,0,100,1,1,0.33,0,0,23,28,false,false,false,0.18,0.82
274,352,-78,14.421053,18.526316,-78,1161,1176,-15,1,1,0.052632,0.052632,-28,19,19,-1.357143,0,0,1,5,true,false,false,0,1
176,208,-32,22,26,-32,1452,1388,64,0,1,0,0.125,43,8,8,0.813953,0,0,8,10,false,false,false,0.157,0.843
369,325,44,23.0625,21.666667,44,1156,1279,-123,2,0,0.125,0,-8,16,15,-5,0,0,2,6,false,false,true,1,0
184,254,-70,18.4,25.4,-70,892,856,36,0,1,0,0.1,27,10,10,1.296296,1,0,7,13,false,false,false,0.014,0.986
321,301,20,17.833333,16.722222,20,897,996,-99,0,0,0,0,-11,18,18,-3.545455,0,0,5,7,false,false,true,0.998,0.002
216,214,2,27,26.75,2,1354,1210,144,0,1,0,0.125,42,8,8,0.785714,0,0,10,8,false,false,false,0.242,0.758
96,24,72,48,24,72,1156,1279,-123,1,0,0.5,0,84,2,1,0.47619,0,0,9,13,false,false,false,0.33,0.67
22,17,5,22,17,5,1885,1908,-23,0,0,0,0,94,1,1,0.244681,0,0,12,11,false,false,true,0.677,0.323
205,251,-46,22.777778,27.888889,-46,1388,1366,22,0,1,0,0.111111,30,9,9,1.066667,0,0,11,13,false,false,false,0.114,0.886
80,0,80,80,0,80,1436,1489,-53,1,0,1,0,93,1,0,0.397849,0,0,15,0,false,false,true,0.594,0.406
50,16,34,25,16,34,1633,1680,-47,0,0,0,0,84,2,1,0.333333,0,0,10,9,false,false,true,0.681,0.319
277,332,-55,17.3125,20.75,-55,568,570,-2,0,0,0,0,-4,16,16,-9.25,0,0,5,4,false,false,false,0,1
85,79,6,17,19.75,6,653,820,-167,0,0,0,0,66,5,4,0.575758,0,0,14,23,false,false,false,0.251,0.749
259,312,-53,19.923077,24,-53,621,786,-165,0,0,0,0,-6,13,13,-5,0,0,8,3,false,false,false,0.003,0.997
219,224,-5,12.882353,14,-5,342,53,289,0,0,0,0,-12,17,16,-3.416667,0,0,10,19,false,false,false,0.403,0.597
174,287,-113,11.6,20.5,-113,388,542,-154,0,0,0,0,5,15,14,7.4,0,1,8,6,false,false,false,0,1
146,135,11,20.857143,22.5,11,1636,1702,-66,0,1,0,0.166667,60,7,6,0.483333,0,1,7,7,false,false,false,0.223,0.777
133,209,-76,19,29.857143,-76,1408,1539,-131,0,1,0,0.142857,46,7,7,0.73913,0,0,8,9,false,false,false,0.139,0.861
223,376,-153,13.9375,23.5,-153,473,683,-210,0,0,0,0,-6,16,16,-6.333333,0,0,5,8,false,false,false,0,1
31,50,-19,10.333333,25,-19,980,965,15,0,0,0,0,86,3,2,0.44186,0,1,15,13,false,false,false,0.071,0.929
18,35,-17,18,35,-17,1302,1351,-49,0,0,0,0,91,1,1,0.406593,1,0,6,9,false,false,true,0.839,0.161
236,273,-37,18.153846,22.75,-37,1691,1551,140,0,0,0,0,21,13,12,1.761905,1,0,6,12,false,false,false,0.021,0.979
258,332,-74,18.428571,25.538462,-74,1127,995,132,0,1,0,0.076923,4,14,13,8.25,0,0,20,9,false,false,false,0,1
18,0,18,18,0,18,1161,1030,131,0,0,0,0,95,1,0,0.4,0,0,12,0,false,false,true,0.681,0.319
369,339,30,23.0625,21.1875,30,1156,1279,-123,2,0,0.125,0,-10,16,16,-4,0,0,2,4,false,false,true,1,0
10,70,-60,10,70,-60,1086,926,160,0,1,0,1,90,1,1,0.311111,0,0,11,13,false,false,false,0.136,0.864
189,333,-144,7,12.333333,-144,651,567,84,0,0,0,0,-23,27,27,-2.391304,0,0,4,13,false,false,false,0,1
270,352,-82,15,19.555556,-82,1161,1176,-15,1,1,0.055556,0.055556,-26,18,18,-1.461538,0,0,1,5,false,false,false,0,1
77,78,-1,12.833333,15.6,-1,830,787,43,0,0,0,0,62,6,5,0.612903,0,0,23,13,false,false,true,0.644,0.356
296,352,-56,18.5,23.466667,-56,1205,1216,-11,0,0,0,0,-7,16,15,-4.714286,0,0,3,5,false,false,false,0,1
95,166,-71,10.555556,18.444444,-71,1037,1016,21,0,0,0,0,51,9,9,1.137255,0,0,8,20,false,false,false,0.036,0.964
112,167,-55,18.666667,33.4,-55,976,995,-19,0,1,0,0.2,59,6,5,0.644068,0,0,16,18,false,false,false,0.198,0.802
349,306,43,31.727273,27.818182,43,1777,1689,88,1,1,0.090909,0.090909,6,11,11,4.5,0,1,18,9,false,false,true,0.996,0.004
367,456,-89,21.588235,28.5,-89,1699,1803,-104,1,1,0.058824,0.0625,-4,17,16,-8.75,0,0,6,3,false,false,false,0,1
115,111,4,16.428571,15.857143,4,889,855,34,0,0,0,0,56,7,7,0.714286,0,0,28,10,false,false,true,0.711,0.289
73,175,-102,12.166667,29.166667,-102,1473,1500,-27,0,2,0,0.333333,61,6,6,0.639344,0,0,10,9,false,false,false,0.006,0.994
162,175,-13,27,29.166667,-13,1885,1842,43,0,1,0,0.166667,49,6,6,0.55102,0,0,15,13,false,false,false,0.295,0.705
210,111,99,26.25,15.857143,99,1188,1334,-146,1,0,0.125,0,40,8,7,0.75,1,1,18,10,false,false,true,0.918,0.082
310,299,11,18.235294,18.6875,11,907,910,-3,0,1,0,0.0625,6,17,16,7.166667,0,0,8,7,false,false,false,0.481,0.519
22,41,-19,11,20.5,-19,1101,1115,-14,0,0,0,0,90,2,2,0.333333,0,0,10,16,false,false,false,0.352,0.648
167,184,-17,18.555556,23,-17,1561,1495,66,1,0,0.111111,0,31,9,8,1.064516,1,0,6,11,false,false,false,0.243,0.757
110,159,-49,15.714286,22.714286,-49,683,859,-176,0,0,0,0,56,7,7,0.803571,1,0,15,10,false,false,false,0.152,0.848
335,346,-11,15.952381,16.47619,-11,775,786,-11,1,0,0.047619,0,-23,21,21,-1.869565,0,0,12,15,false,false,true,0.923,0.077
14,32,-18,7,32,-18,813,698,115,0,0,0,0,91,2,1,0.527473,0,0,12,7,false,false,false,0.375,0.625
18,0,18,18,0,18,651,567,84,0,0,0,0,96,1,0,0.572917,0,0,14,0,false,false,true,0.686,0.314
253,219,34,21.083333,19.909091,34,1493,1413,80,0,0,0,0,24,12,11,1.5,0,1,7,8,false,false,false,0.376,0.624
184,179,5,23,25.571429,5,1101,1237,-136,1,0,0.125,0,43,8,7,0.790698,0,0,7,15,false,false,false,0.247,0.753
127,235,-108,18.142857,39.166667,-108,1093,1100,-7,0,1,0,0.166667,50,7,6,0.7,0,0,7,12,false,false,false,0,1
136,202,-66,17,25.25,-66,1229,1220,9,0,1,0,0.125,44,8,8,0.840909,0,0,16,8,false,false,false,0.189,0.811
53,78,-25,10.6,15.6,-25,830,787,43,0,0,0,0,67,5,5,0.567164,0,0,27,13,false,false,true,0.58,0.42
291,422,-131,16.166667,23.444444,-131,1229,1220,9,0,1,0,0.055556,-13,18,18,-2.846154,0,0,1,2,false,false,false,0,1
270,359,-89,20.769231,27.615385,-89,991,1063,-72,0,1,0,0.076923,8,13,13,4.75,0,0,12,9,false,false,false,0,1
195,187,8,17.727273,18.7,8,306,468,-162,0,0,0,0,36,11,10,1.027778,1,0,7,11,false,false,false,0.14,0.86
180,225,-45,18,22.5,-45,691,704,-13,0,1,0,0.1,34,10,10,1.117647,0,1,7,6,false,false,false,0.04,0.96
145,127,18,20.714286,21.166667,18,1495,1531,-36,0,0,0,0,63,7,6,0.587302,0,0,10,16,false,false,false,0.202,0.798
98,102,-4,16.333333,20.4,-4,613,525,88,0,0,0,0,61,6,5,0.688525,0,1,10,6,false,false,true,0.606,0.394
202,311,-109,15.538462,25.916667,-109,771,668,103,0,0,0,0,10,13,12,3.8,0,0,7,21,false,false,false,0,1
103,139,-36,14.714286,19.857143,-36,561,688,-127,0,0,0,0,57,7,7,0.807018,0,0,13,7,false,false,false,0.24,0.76
196,245,-49,19.6,24.5,-49,561,633,-72,0,1,0,0.1,31,10,10,1.129032,0,0,17,10,false,false,false,0.045,0.955
250,249,1,25,24.9,1,1093,1100,-7,2,0,0.2,0,32,10,10,0.96875,0,0,15,14,false,false,false,0.187,0.813
124,95,29,17.714286,13.571429,29,671,638,33,0,0,0,0,48,7,7,1.020833,0,0,16,25,false,false,true,0.95,0.05
61,59,2,15.25,14.75,2,542,390,152,0,0,0,0,82,4,4,0.609756,0,0,8,18,false,false,false,0.48,0.52
77,94,-17,12.833333,15.666667,-17,830,787,43,0,0,0,0,60,6,6,0.633333,0,0,23,10,false,false,true,0.643,0.357
180,197,-17,20,21.888889,-17,1093,1100,-7,1,0,0.111111,0,41,9,9,0.756098,0,0,7,20,false,false,false,0.046,0.954
63,110,-47,15.75,27.5,-47,1003,1004,-1,0,0,0,0,75,4,4,0.466667,0,0,24,8,false,false,false,0.352,0.648
178,232,-54,17.8,23.2,-54,1488,1403,85,0,1,0,0.1,25,10,10,1.36,0,0,11,9,false,false,false,0.007,0.993
79,129,-50,13.166667,21.5,-50,561,688,-127,0,0,0,0,63,6,6,0.730159,0,0,11,7,false,false,false,0.209,0.791
179,194,-15,12.785714,13.857143,-15,342,53,289,0,0,0,0,6,14,14,6.833333,0,0,7,21,false,false,true,0.516,0.484
284,357,-73,15.777778,21,-73,1159,1131,28,0,2,0,0.117647,-15,18,17,-2.466667,0,0,1,2,false,false,false,0,1
89,140,-51,17.8,28,-51,1182,1075,107,0,1,0,0.2,62,5,5,0.629032,0,1,24,8,false,false,false,0.199,0.801
186,219,-33,16.909091,21.9,-33,450,624,-174,0,0,0,0,23,11,10,1.434783,0,0,18,8,false,false,false,0.177,0.823
36,28,8,12,14,8,1439,1428,11,0,0,0,0,86,3,2,0.465116,0,0,9,14,false,false,true,0.588,0.412
300,303,-3,20,21.642857,-3,1257,1176,81,2,0,0.133333,0,8,15,14,4.25,0,0,9,11,false,false,false,0.063,0.937
149,196,-47,13.545455,17.818182,-47,1220,1202,18,0,0,0,0,30,11,11,1.666667,0,0,29,9,false,false,false,0.199,0.801
264,332,-68,13.2,16.6,-68,813,698,115,1,0,0.05,0,-19,20,20,-2.526316,0,0,3,10,false,false,false,0,1
226,220,6,16.142857,16.923077,6,480,518,-38,0,0,0,0,9,14,13,4.444444,0,0,17,19,false,false,false,0.234,0.766
71,70,1,17.75,23.333333,1,971,635,336,0,0,0,0,74,4,3,0.432432,0,0,12,7,false,false,false,0.227,0.773
246,246,0,16.4,16.4,0,897,996,-99,0,0,0,0,6,15,15,6.5,0,0,14,10,false,false,false,0.261,0.739
36,13,23,18,13,23,732,868,-136,0,0,0,0,89,2,1,0.359551,0,1,10,15,false,false,false,0.255,0.745
297,250,47,24.75,20.833333,47,1373,1334,39,1,1,0.083333,0.083333,18,12,12,1.777778,0,1,7,12,false,false,true,0.653,0.347
263,308,-45,16.4375,20.533333,-45,1040,1364,-324,0,0,0,0,-10,16,15,-3.6,0,0,6,14,false,false,false,0,1
351,356,-5,21.9375,22.25,-5,1354,1210,144,0,1,0,0.0625,-14,16,16,-2.357143,0,0,2,4,false,false,false,0.44,0.56
198,167,31,24.75,23.857143,31,1245,1148,97,0,0,0,0,46,8,7,0.76087,0,0,21,22,false,false,false,0.234,0.766
41,71,-30,13.666667,35.5,-30,615,542,73,0,0,0,0,84,3,2,0.5,0,0,17,15,false,false,false,0.051,0.949
62,82,-20,15.5,20.5,-20,1003,1018,-15,0,0,0,0,71,4,4,0.521127,0,2,15,14,false,false,false,0.029,0.971
294,283,11,24.5,25.727273,11,1563,1539,24,0,1,0,0.090909,11,12,11,3.181818,0,0,11,10,false,false,false,0.199,0.801
289,303,-14,18.0625,20.2,-14,952,870,82,0,0,0,0,-7,16,15,-5.285714,0,0,7,19,false,false,false,0.052,0.948
157,156,1,15.7,17.333333,1,450,503,-53,0,0,0,0,37,10,9,1.054054,1,0,19,10,false,false,true,0.656,0.344
60,74,-14,20,24.666667,-14,1110,1399,-289,0,0,0,0,77,3,3,0.441558,0,1,15,9,false,false,false,0.25,0.75
323,412,-89,35.888889,45.777778,-89,2010,2219,-209,1,1,0.111111,0.111111,15,9,9,1.733333,0,0,11,10,false,false,false,0,1
180,238,-58,20,29.75,-58,1101,1115,-14,0,0,0,0,39,9,8,0.769231,0,1,12,11,false,false,false,0.003,0.997
119,171,-52,19.833333,28.5,-52,1422,1798,-376,0,1,0,0.166667,52,6,6,0.615385,0,1,19,17,false,false,false,0.05,0.95
6,22,-16,6,22,-16,1580,1629,-49,0,0,0,0,93,1,1,0.397849,0,0,12,23,false,false,false,0.209,0.791
117,182,-65,19.5,30.333333,-65,1315,1331,-16,0,0,0,0,54,6,6,0.611111,0,0,16,13,false,false,false,0.199,0.801
287,398,-111,16.882353,23.411765,-111,935,995,-60,1,1,0.058824,0.058824,-12,17,17,-3.25,0,0,12,2,false,false,false,0,1
346,395,-49,15.727273,18.809524,-49,824,830,-6,1,0,0.045455,0,-27,22,21,-1.62963,0,0,2,2,false,false,false,0,1
235,263,-28,12.368421,14.611111,-28,808,749,59,0,0,0,0,-23,19,18,-1.826087,0,0,5,7,false,false,false,0.007,0.993
259,327,-68,13.631579,18.166667,-68,95,453,-358,0,0,0,0,-12,19,18,-3.25,0,0,2,4,false,false,false,0,1
285,315,-30,15,16.578947,-30,450,503,-53,0,0,0,0,-22,19,19,-1.772727,0,0,3,3,false,false,false,0,1
174,213,-39,17.4,21.3,-39,668,771,-103,0,0,0,0,39,10,10,1.025641,1,0,18,11,false,false,false,0.133,0.867
290,317,-27,26.363636,28.818182,-27,1331,1432,-101,0,0,0,0,8,11,11,3.375,0,0,18,8,false,false,false,0.201,0.799
197,286,-89,17.909091,28.6,-89,724,398,326,1,1,0.090909,0.1,39,11,10,1,1,0,9,8,false,false,false,0,1
284,290,-6,21.846154,22.307692,-6,786,885,-99,1,1,0.076923,0.076923,17,13,13,2,1,0,6,17,false,false,false,0.206,0.794
25,38,-13,12.5,19,-13,503,668,-165,0,0,0,0,85,2,2,0.435294,0,0,7,13,false,false,false,0.251,0.749
14,0,14,14,0,14,742,594,148,0,0,0,0,94,1,1,0.414894,0,0,19,7,false,false,true,0.724,0.276
294,386,-92,16.333333,21.444444,-92,691,704,-13,0,1,0,0.055556,-21,18,18,-1.809524,0,0,1,1,false,false,false,0,1
282,293,-11,21.692308,24.416667,-11,1237,1265,-28,1,0,0.076923,0,2,13,12,18,0,0,7,13,false,false,false,0.207,0.793
286,371,-85,13.619048,18.55,-85,595,412,183,0,1,0,0.05,-16,21,20,-3.25,0,0,10,11,false,false,false,0,1
120,61,59,30,20.333333,59,724,398,326,1,0,0.25,0,74,4,3,0.527027,0,0,23,21,false,false,true,0.969,0.031
148,196,-48,16.444444,21.777778,-48,1071,1181,-110,0,0,0,0,44,9,9,0.772727,0,1,11,12,false,false,false,0.036,0.964
278,382,-104,18.533333,27.285714,-104,726,818,-92,0,1,0,0.071429,-3,15,14,-11.666667,0,0,14,8,false,false,false,0,1
91,128,-37,18.2,32,-37,835,786,49,0,0,0,0,63,5,4,0.539683,0,0,19,11,false,false,false,0.222,0.778
67,61,6,16.75,20.333333,6,818,826,-8,0,0,0,0,82,4,3,0.646341,1,0,8,19,false,false,false,0.292,0.708
61,119,-58,10.166667,19.833333,-58,907,1070,-163,0,0,0,0,58,6,6,0.603448,0,0,19,18,false,false,false,0.043,0.957
128,158,-30,21.333333,26.333333,-30,804,766,38,0,1,0,0.166667,62,6,6,0.66129,0,1,8,19,false,false,false,0.09,0.91
202,290,-88,18.363636,26.363636,-88,1305,1254,51,0,1,0,0.090909,17,11,11,1.882353,0,0,8,10,false,false,false,0,1
149,140,9,12.416667,12.727273,9,1045,948,97,0,0,0,0,18,12,11,1.888889,0,0,14,11,false,false,false,0.252,0.748
294,349,-55,16.333333,19.388889,-55,452,698,-246,0,1,0,0.055556,-16,18,18,-2.5625,0,0,5,2,false,false,false,0,1
185,223,-38,20.555556,27.875,-38,1645,1636,9,0,1,0,0.125,32,9,8,1.03125,0,0,13,7,false,false,false,0.069,0.931
354,354,0,27.230769,27.230769,0,1885,1842,43,0,2,0,0.153846,-9,13,13,-3,0,1,7,5,false,false,false,0.113,0.887
142,167,-25,20.285714,23.857143,-25,1227,1189,38,0,0,0,0,47,7,7,0.744681,0,0,11,25,false,false,false,0.201,0.799
209,398,-189,11,20.947368,-189,977,1100,-123,0,1,0,0.052632,-12,19,19,-3.416667,0,0,9,2,false,false,false,0,1
14,0,14,14,0,14,1349,1203,146,0,0,0,0,96,1,0,0.333333,0,0,15,0,false,false,true,0.679,0.321
202,263,-61,15.538462,20.230769,-61,620,698,-78,1,0,0.076923,0,16,13,13,2.5625,0,0,21,14,false,false,false,0,1
156,175,-19,13,15.909091,-19,999,1165,-166,0,0,0,0,30,12,11,1.533333,1,0,18,12,false,false,false,0.096,0.904
208,247,-39,20.8,24.7,-39,1110,1123,-13,0,1,0,0.1,27,10,10,1.222222,0,1,8,17,false,false,false,0.081,0.919
116,91,25,19.333333,18.2,25,387,683,-296,0,0,0,0,57,6,5,0.596491,1,0,9,10,false,false,true,0.646,0.354
191,248,-57,14.692308,19.076923,-57,1195,1397,-202,0,1,0,0.076923,22,13,13,1.818182,0,0,8,7,false,false,false,0.03,0.97
0,8,-8,0,8,-8,786,885,-99,0,0,0,0,97,1,1,0.350515,0,0,13,20,false,false,false,0.248,0.752
234,290,-56,21.272727,29,-56,1164,1261,-97,0,1,0,0.1,35,11,10,1.2,0,0,16,10,false,false,false,0.001,0.999
297,285,12,22.846154,21.923077,12,1397,1405,-8,1,0,0.076923,0,0,13,13,0,0,1,10,7,false,false,true,0.629,0.371
47,30,17,11.75,10,17,808,749,59,0,0,0,0,71,4,3,0.591549,0,1,11,19,false,false,true,0.658,0.342
172,257,-85,14.333333,23.363636,-85,503,668,-165,0,1,0,0.090909,23,12,11,1.608696,1,0,10,18,false,false,false,0.027,0.973
41,51,-10,13.666667,17,-10,727,820,-93,0,1,0,0.333333,75,3,3,0.466667,0,0,12,18,false,false,true,0.56,0.44
22,16,6,22,16,6,1030,998,32,0,0,0,0,90,1,1,0.411111,0,0,13,12,false,false,true,0.68,0.32
47,58,-11,15.666667,19.333333,-11,527,954,-427,0,0,0,0,80,3,3,0.4375,0,0,21,10,false,false,false,0.251,0.749
133,223,-90,12.090909,20.272727,-90,388,542,-154,0,0,0,0,24,11,11,1.541667,0,0,10,15,false,false,false,0,1
194,411,-217,19.4,41.1,-217,1219,1216,3,1,3,0.1,0.3,9,10,10,3,0,0,20,7,false,false,false,0,1
164,252,-88,14.909091,25.2,-88,944,1095,-151,0,1,0,0.1,38,11,10,1.026316,0,1,7,6,false,false,false,0,1
117,170,-53,16.714286,24.285714,-53,736,791,-55,0,0,0,0,51,7,7,0.745098,0,0,9,8,false,false,false,0.045,0.955
124,45,79,31,15,79,1552,1803,-251,1,0,0.25,0,76,4,3,0.434211,0,0,10,14,false,false,false,0.45,0.55
20,0,20,20,0,20,1539,1891,-352,0,0,0,0,97,1,0,0.257732,0,0,12,0,false,false,false,0.251,0.749
181,174,7,20.111111,21.75,7,758,904,-146,1,0,0.111111,0,33,9,8,1.030303,0,0,13,7,false,false,false,0.307,0.693
85,60,25,14.166667,10,25,491,651,-160,0,0,0,0,65,6,6,0.461538,0,1,12,9,false,false,false,0.448,0.552
66,106,-40,16.5,35.333333,-40,594,648,-54,0,1,0,0.333333,76,4,3,0.526316,0,1,13,11,false,false,false,0.041,0.959
266,191,75,17.733333,12.733333,75,1065,948,117,0,0,0,0,17,15,15,2.294118,0,0,8,10,false,false,true,0.982,0.018
210,227,-17,23.333333,25.222222,-17,1439,1314,125,0,0,0,0,33,9,9,0.848485,0,1,10,15,false,false,false,0.16,0.84
17,51,-34,8.5,25.5,-34,500,509,-9,0,0,0,0,86,2,2,0.476744,0,0,9,22,false,false,false,0.058,0.942
338,388,-50,19.882353,22.823529,-50,700,820,-120,0,1,0,0.058824,-19,17,17,-2,0,0,3,4,false,false,false,0,1
358,394,-36,23.866667,28.142857,-36,1344,1208,136,1,1,0.066667,0.071429,-9,15,14,-3.333333,1,0,3,2,false,false,false,0.032,0.968
246,425,-179,12.947368,22.368421,-179,1075,1189,-114,0,0,0,0,-20,19,19,-2,0,0,1,1,false,false,false,0,1
55,63,-8,27.5,63,-8,1093,1100,-7,0,0,0,0,83,2,1,0.421687,0,0,11,12,false,false,false,0.081,0.919
184,252,-68,15.333333,21,-68,568,570,-2,0,0,0,0,20,12,12,1.85,0,0,18,12,false,false,false,0,1
377,375,2,23.5625,23.4375,2,1305,1194,111,1,1,0.0625,0.0625,-17,16,16,-1.941176,0,0,3,5,false,false,true,0.999,0.001
105,84,21,21,16.8,21,1232,1448,-216,0,0,0,0,61,5,5,0.57377,0,0,7,16,false,false,false,0.258,0.742
51,50,1,12.75,16.666667,1,530,683,-153,0,0,0,0,80,4,3,0.5,0,0,7,13,false,false,false,0.251,0.749
63,132,-69,15.75,44,-69,1656,1649,7,0,0,0,0,67,4,3,0.477612,0,0,11,15,false,false,false,0.163,0.837
34,33,1,17,33,1,952,826,126,0,0,0,0,92,2,1,0.467391,1,0,7,13,false,false,true,0.616,0.384
122,177,-55,11.090909,17.7,-55,226,361,-135,0,0,0,0,28,11,10,1.571429,0,0,8,10,false,false,false,0.041,0.959
261,320,-59,11.347826,14.545455,-59,391,542,-151,1,0,0.043478,0,-41,23,22,-1.121951,0,0,1,4,false,false,false,0,1
131,160,-29,16.375,20,-29,595,538,57,0,0,0,0,42,8,8,0.904762,0,1,13,10,false,false,false,0.132,0.868
291,317,-26,12.125,13.782609,-26,796,800,-4,1,0,0.041667,0,-16,24,23,-3,0,0,12,3,false,false,false,0.001,0.999
163,225,-62,20.375,28.125,-62,980,965,15,0,0,0,0,43,8,8,0.883721,0,0,8,9,false,false,false,0.155,0.845
99,200,-101,9.9,20,-101,651,996,-345,0,1,0,0.1,29,10,10,1.551724,0,1,13,6,false,false,false,0,1
72,149,-77,24,74.5,-77,1556,1656,-100,0,1,0,0.5,73,3,2,0.410959,0,0,9,12,false,false,false,0.187,0.813
22,11,11,22,11,11,1047,1127,-80,0,0,0,0,90,1,1,0.3,1,1,15,12,false,false,false,0.379,0.621
80,88,-8,20,29.333333,-8,804,1080,-276,0,0,0,0,71,4,3,0.478873,0,0,11,14,false,false,false,0.249,0.751
151,271,-120,11.615385,20.846154,-120,632,603,29,0,1,0,0.076923,4,13,13,9.5,0,0,18,9,false,false,false,0,1
311,341,-30,17.277778,18.944444,-30,775,786,-11,1,0,0.055556,0,-13,18,18,-3.307692,1,0,13,16,false,false,false,0.001,0.999
232,306,-74,16.571429,21.857143,-74,1037,1016,21,1,0,0.071429,0,20,14,14,2.9,1,0,19,8,false,false,false,0,1
214,233,-19,23.777778,29.125,-19,1331,1347,-16,1,0,0.111111,0,30,9,8,1.066667,0,0,13,10,false,false,false,0.393,0.607
224,300,-76,20.363636,27.272727,-76,835,786,49,0,0,0,0,10,11,11,3.4,0,0,7,14,false,false,false,0,1
234,243,-9,21.272727,22.090909,-9,786,885,-99,1,1,0.090909,0.090909,29,11,11,1.172414,0,0,8,33,false,false,false,0.215,0.785
244,298,-54,24.4,29.8,-54,1344,1208,136,1,1,0.1,0.1,24,10,10,1.25,0,0,10,17,false,false,false,0.001,0.999
38,0,38,38,0,38,1164,1261,-97,0,0,0,0,95,1,0,0.442105,0,0,20,0,false,false,true,0.567,0.433
253,294,-41,23,26.727273,-41,1388,1366,22,0,1,0,0.090909,16,11,11,2,0,0,11,13,false,false,false,0.04,0.96
261,253,8,23.727273,23,8,1070,814,256,1,1,0.090909,0.090909,17,11,11,1.941176,0,1,9,11,false,false,false,0.081,0.919
123,106,17,20.5,21.2,17,985,1062,-77,0,0,0,0,58,6,5,0.637931,0,1,12,15,false,false,false,0.252,0.748
226,305,-79,16.142857,21.785714,-79,653,820,-167,0,0,0,0,-3,14,14,-12.666667,0,0,7,19,false,false,false,0,1
288,335,-47,15.157895,18.611111,-47,500,509,-9,0,0,0,0,-18,19,18,-2.277778,0,0,5,3,false,false,false,0,1
117,218,-101,16.714286,31.142857,-101,971,800,171,0,1,0,0.142857,33,7,7,0.878788,1,0,13,9,false,false,false,0.005,0.995
254,370,-116,18.142857,28.461538,-116,726,818,-92,0,1,0,0.076923,3,14,13,11.666667,0,0,25,11,false,false,false,0,1
111,214,-103,18.5,42.8,-103,1093,1100,-7,0,1,0,0.2,56,6,5,0.625,0,0,7,11,false,false,false,0.001,0.999
146,173,-27,24.333333,28.833333,-27,907,910,-3,0,1,0,0.166667,60,6,6,0.716667,0,0,11,19,false,false,false,0.195,0.805
281,448,-167,11.708333,18.666667,-167,1078,983,95,1,0,0.041667,0,-35,24,24,-1.371429,0,0,1,1,true,false,false,0,1
180,251,-71,22.5,31.375,-71,1127,995,132,0,1,0,0.125,38,8,8,0.868421,0,0,7,10,false,false,false,0.006,0.994
299,359,-60,14.95,18.894737,-60,1305,1307,-2,0,1,0,0.052632,-24,20,19,-1.708333,0,1,1,3,false,false,false,0,1
169,281,-112,13,23.416667,-112,563,523,40,0,0,0,0,15,13,12,2.466667,0,0,18,23,false,false,false,0,1
284,337,-53,16.705882,19.823529,-53,568,570,-2,0,0,0,0,-8,17,17,-4.625,0,0,3,1,false,false,false,0,1
240,325,-85,15,21.666667,-85,837,844,-7,0,0,0,0,8,16,15,5.125,1,0,10,7,false,false,false,0,1
20,0,20,20,0,20,694,658,36,0,0,0,0,95,1,0,0.389474,0,0,9,0,false,false,true,0.673,0.327
261,309,-48,17.4,20.6,-48,568,570,-2,0,0,0,0,2,15,15,18.5,0,0,9,9,false,false,false,0,1
137,95,42,22.833333,19,42,1197,1156,41,0,0,0,0,61,6,5,0.57377,0,1,15,8,false,false,true,0.803,0.197
156,158,-2,22.285714,26.333333,-2,1126,1277,-151,0,0,0,0,49,7,6,0.714286,0,0,7,12,false,false,false,0.227,0.773
113,148,-35,14.125,18.5,-35,1000,960,40,0,0,0,0,50,8,8,0.9,1,0,9,16,false,false,false,0.198,0.802
255,298,-43,18.214286,21.285714,-43,1488,1403,85,0,1,0,0.071429,-4,14,14,-8.5,1,0,23,14,false,false,false,0.013,0.987
218,234,-16,19.818182,21.272727,-16,566,742,-176,0,1,0,0.090909,17,11,11,1.882353,0,0,14,23,false,false,false,0.204,0.796
111,164,-53,12.333333,20.5,-53,595,540,55,0,0,0,0,43,9,8,1,0,0,16,20,false,false,false,0.052,0.948
122,139,-17,12.2,13.9,-17,163,346,-183,0,0,0,0,31,10,10,1.258065,0,1,17,15,false,false,false,0.139,0.861
185,355,-170,15.416667,29.583333,-170,1422,1510,-88,0,2,0,0.166667,28,12,12,1.392857,0,0,9,7,false,false,false,0,1
300,318,-18,23.076923,26.5,-18,1454,1479,-25,1,0,0.076923,0,6,13,12,5.166667,0,0,12,19,false,false,false,0.027,0.973
135,155,-20,12.272727,14.090909,-20,342,53,289,0,0,0,0,27,11,11,1.518519,1,1,10,8,false,false,false,0.069,0.931
25,55,-30,12.5,27.5,-30,1110,1399,-289,0,0,0,0,84,2,2,0.404762,0,0,12,7,false,false,false,0.251,0.749
268,358,-90,15.764706,22.375,-90,1580,1629,-49,0,1,0,0.0625,-11,17,16,-3.363636,0,0,4,6,false,false,false,0,1
10,0,10,10,0,10,1270,1424,-154,0,0,0,0,97,1,0,0.360825,0,0,10,0,false,false,false,0.251,0.749
246,257,-11,17.571429,19.769231,-11,803,786,17,1,0,0.071429,0,5,14,13,6.4,0,0,11,16,false,false,false,0.289,0.711
46,57,-11,23,28.5,-11,971,635,336,0,0,0,0,85,2,2,0.376471,0,0,7,9,false,false,false,0.244,0.756
288,423,-135,12.521739,19.227273,-135,1037,1016,21,1,0,0.043478,0,-18,23,22,-3.222222,1,0,7,5,false,false,false,0,1
44,33,11,22,16.5,11,675,570,105,0,0,0,0,86,2,2,0.406977,0,0,9,21,false,false,true,0.686,0.314
261,308,-47,18.642857,22,-47,1633,1620,13,0,0,0,0,-4,14,14,-9,0,0,18,9,false,false,false,0.007,0.993
44,34,10,14.666667,11.333333,10,670,576,94,0,0,0,0,75,3,3,0.546667,0,0,19,13,false,false,true,0.705,0.295
37,40,-3,18.5,20,-3,595,412,183,0,0,0,0,86,2,2,0.604651,0,0,10,19,false,false,true,0.611,0.389
79,107,-28,13.166667,21.4,-28,561,688,-127,0,0,0,0,65,6,5,0.707692,0,1,11,13,false,false,false,0.017,0.983
76,88,-12,19,22,-12,796,800,-4,0,0,0,0,74,4,4,0.648649,0,0,18,7,false,false,true,0.654,0.346
75,81,-6,15,20.25,-6,1176,1211,-35,0,0,0,0,64,5,4,0.515625,1,0,7,16,false,false,true,0.618,0.382
24,17,7,24,17,7,889,855,34,0,0,0,0,92,1,1,0.434783,0,0,12,11,false,false,true,0.681,0.319
302,327,-25,18.875,20.4375,-25,1037,913,124,2,1,0.125,0.0625,-1,16,16,-38,0,0,7,9,false,false,false,0,1
297,358,-61,17.470588,22.375,-61,954,939,15,1,0,0.058824,0,-17,17,16,-2.117647,0,1,1,2,false,false,false,0,1
275,291,-16,16.176471,17.117647,-16,970,1030,-60,0,1,0,0.058824,-12,17,17,-3.333333,1,0,6,17,false,false,false,0.482,0.518
279,194,85,27.9,19.4,85,1156,1279,-123,2,0,0.2,0,27,10,10,1.481481,0,1,11,9,false,false,false,0.427,0.573
371,407,-36,30.916667,37,-36,1777,1500,277,2,2,0.166667,0.181818,-2,12,11,-14,0,0,4,17,false,false,false,0.019,0.981
17,14,3,8.5,14,3,500,509,-9,0,0,0,0,91,2,1,0.450549,0,0,9,24,false,false,false,0.238,0.762
20,21,-1,10,21,-1,951,976,-25,0,0,0,0,89,2,1,0.494382,1,1,14,19,false,false,false,0.15,0.85
58,112,-54,19.333333,37.333333,-54,1021,897,124,0,1,0,0.333333,78,3,3,0.474359,0,0,7,13,false,false,false,0.195,0.805
404,452,-48,23.764706,28.25,-48,1770,1745,25,2,1,0.117647,0.0625,-11,17,16,-3,0,0,2,1,true,false,false,0.001,0.999
34,0,34,34,0,34,1093,1100,-7,0,0,0,0,95,1,0,0.368421,0,0,10,0,false,false,true,0.7,0.3
155,164,-9,17.222222,20.5,-9,1094,1041,53,0,0,0,0,39,9,8,0.974359,1,0,9,14,false,false,false,0.212,0.788
298,333,-35,21.285714,25.615385,-35,1030,1014,16,0,1,0,0.076923,7,14,13,4.714286,0,0,11,8,false,false,false,0.003,0.997
245,360,-115,27.222222,40,-115,1537,1539,-2,0,1,0,0.111111,23,9,9,1.478261,0,1,9,19,false,false,false,0,1
312,362,-50,20.8,24.133333,-50,1417,1482,-65,0,1,0,0.066667,6,15,15,5.5,0,1,7,7,false,false,false,0,1
188,201,-13,15.666667,18.272727,-13,402,448,-46,0,0,0,0,26,12,11,1.423077,0,2,11,15,false,false,false,0.032,0.968
131,262,-131,13.1,26.2,-131,760,976,-216,0,1,0,0.1,29,10,10,1.241379,0,1,13,8,false,false,false,0,1
211,206,5,21.1,22.888889,5,921,1045,-124,0,0,0,0,32,10,9,1.09375,0,0,18,12,false,false,false,0.198,0.802
48,24,24,12,8,24,1168,1216,-48,0,0,0,0,85,4,3,0.388235,0,0,19,30,false,false,false,0.153,0.847
239,267,-28,19.916667,22.25,-28,1063,1134,-71,1,0,0.083333,0,28,12,12,1.571429,0,0,10,22,false,false,false,0.013,0.987
255,320,-65,11.590909,14.545455,-65,391,542,-151,1,0,0.045455,0,-37,22,22,-1.243243,0,0,1,4,false,false,false,0,1
345,333,12,24.642857,23.785714,12,1407,1473,-66,1,2,0.071429,0.142857,-7,14,14,-4.428571,0,0,12,6,false,false,true,0.856,0.144
132,125,7,22,25,7,689,804,-115,0,0,0,0,54,6,5,0.648148,0,0,15,19,false,false,false,0.251,0.749
132,150,-18,16.5,21.428571,-18,889,895,-6,0,1,0,0.142857,47,8,7,0.787234,0,1,20,8,false,false,false,0.213,0.787
166,140,26,20.75,20,26,1257,1176,81,1,0,0.125,0,54,8,7,0.62963,1,1,14,9,false,false,false,0.301,0.699
162,244,-82,11.571429,17.428571,-82,1182,1075,107,0,1,0,0.071429,4,14,14,9.75,0,1,24,6,false,false,false,0,1
160,200,-40,26.666667,33.333333,-40,724,398,326,1,1,0.166667,0.166667,56,6,6,0.696429,0,0,9,9,false,false,false,0.187,0.813
75,103,-28,15,20.6,-28,306,361,-55,0,0,0,0,63,5,5,0.571429,0,1,9,9,false,false,false,0.037,0.963
276,328,-52,21.230769,25.230769,-52,1093,1100,-7,2,0,0.153846,0,15,13,13,2.066667,0,0,11,15,false,false,false,0,1
132,270,-138,18.857143,38.571429,-138,1539,1891,-352,0,1,0,0.142857,41,7,7,0.609756,1,0,10,10,false,false,false,0.006,0.994
204,328,-124,14.571429,23.428571,-124,1064,1397,-333,0,2,0,0.142857,18,14,14,2.388889,1,0,24,10,false,false,false,0,1
302,396,-94,15.1,19.8,-94,848,976,-128,0,1,0,0.05,-18,20,20,-2.222222,0,0,2,4,true,false,false,0,1
66,60,6,22,20,6,451,448,3,0,0,0,0,82,3,3,0.45122,0,1,15,6,false,false,false,0.25,0.75
148,269,-121,14.8,26.9,-121,1397,1309,88,1,0,0.1,0,42,10,10,0.857143,0,1,10,6,false,false,false,0,1
44,20,24,22,20,24,675,570,105,0,0,0,0,88,2,1,0.397727,0,0,9,20,false,false,true,0.683,0.317
305,450,-145,16.944444,25,-145,976,995,-19,1,2,0.055556,0.111111,-17,18,18,-2.235294,1,0,0,4,false,false,false,0,1
87,90,-3,21.75,22.5,-3,1428,1361,67,0,0,0,0,69,4,4,0.478261,0,1,9,17,false,false,false,0.235,0.765
111,136,-25,15.857143,19.428571,-25,388,542,-154,0,0,0,0,44,7,7,0.840909,0,0,8,14,false,false,false,0.25,0.75
86,125,-39,17.2,31.25,-39,452,698,-246,0,1,0,0.25,69,5,4,0.594203,0,0,22,7,false,false,false,0.25,0.75
190,274,-84,12.666667,18.266667,-84,1078,983,95,1,0,0.066667,0,13,15,15,3.692308,0,1,7,10,false,false,false,0,1
8,10,-2,8,10,-2,342,53,289,0,0,0,0,92,1,1,0.445652,0,0,7,24,false,false,false,0.281,0.719
131,141,-10,14.555556,17.625,-10,907,1070,-163,0,0,0,0,44,9,8,0.795455,0,0,17,19,false,false,false,0.073,0.927
201,266,-65,22.333333,33.25,-65,1021,897,124,0,2,0,0.25,31,9,8,1.193548,0,0,21,10,false,false,false,0.003,0.997
159,181,-22,15.9,20.111111,-22,1484,1556,-72,0,1,0,0.111111,28,10,9,1.107143,1,0,16,14,false,false,false,0.199,0.801
104,101,3,20.8,20.2,3,1493,1413,80,0,0,0,0,67,5,5,0.537313,0,0,23,9,false,false,true,0.623,0.377
337,282,55,22.466667,20.142857,55,1093,1173,-80,1,0,0.066667,0,8,15,14,5.375,0,0,8,9,false,false,true,1,0
266,206,60,22.166667,18.727273,60,1652,1473,179,1,0,0.083333,0,18,12,11,1.666667,0,1,10,8,false,false,true,0.632,0.368
226,274,-48,25.111111,30.444444,-48,1495,1597,-102,0,1,0,0.111111,32,9,9,1,0,0,10,10,false,false,false,0.193,0.807
41,47,-6,20.5,23.5,-6,1245,1148,97,0,0,0,0,86,2,2,0.406977,0,0,16,13,false,false,true,0.651,0.349
97,198,-101,16.166667,33,-101,561,633,-72,0,1,0,0.166667,62,6,6,0.564516,1,0,9,8,false,false,false,0.031,0.969
96,56,40,19.2,14,40,897,996,-99,0,0,0,0,71,5,4,0.549296,0,0,9,9,false,false,false,0.34,0.66
100,52,48,25,17.333333,48,991,1063,-72,0,0,0,0,79,4,3,0.481013,0,0,7,19,false,false,false,0.338,0.662
128,109,19,16,15.571429,19,797,796,1,0,0,0,0,58,8,7,0.844828,0,0,12,11,false,false,false,0.349,0.651
317,324,-7,13.782609,14.727273,-7,526,502,24,0,0,0,0,-34,23,22,-1.470588,0,0,13,14,false,false,false,0.294,0.706
196,383,-187,14,27.357143,-187,1422,1510,-88,0,2,0,0.142857,15,14,14,2.6,0,0,15,7,false,false,false,0,1
78,130,-52,13,21.666667,-52,1210,1162,48,0,0,0,0,57,6,6,0.561404,0,0,16,17,false,false,false,0.201,0.799
16,17,-1,16,17,-1,1493,1453,40,0,0,0,0,94,1,1,0.37234,0,0,14,24,false,false,false,0.402,0.598
86,206,-120,10.75,29.428571,-120,1101,1130,-29,0,1,0,0.142857,52,8,7,0.865385,0,0,8,10,false,false,false,0,1
347,475,-128,24.785714,36.538462,-128,1586,1633,-47,1,1,0.071429,0.076923,3,14,13,11.333333,0,0,9,10,false,false,false,0,1
198,294,-96,19.8,29.4,-96,842,926,-84,0,0,0,0,18,10,10,1.666667,0,0,9,7,false,false,false,0,1
175,169,6,21.875,24.142857,6,1093,1100,-7,1,0,0.125,0,48,8,7,0.645833,0,0,9,27,false,false,false,0.057,0.943
77,98,-21,25.666667,32.666667,-21,1636,1727,-91,0,1,0,0.333333,75,3,3,0.4,0,0,14,8,false,false,false,0.493,0.507
151,256,-105,13.727273,23.272727,-105,563,523,40,0,0,0,0,27,11,11,1.37037,0,0,7,15,false,false,false,0,1
197,279,-82,11.588235,17.4375,-82,651,700,-49,0,0,0,0,-3,17,16,-18.666667,1,1,9,13,false,false,false,0,1
83,127,-44,8.3,12.7,-44,288,359,-71,0,0,0,0,50,10,10,0.54,0,0,14,15,false,false,false,0.043,0.957
169,201,-32,15.363636,18.272727,-32,402,448,-46,0,0,0,0,29,11,11,1.275862,0,2,11,15,false,false,false,0.031,0.969
98,94,4,24.5,23.5,4,921,1045,-124,0,0,0,0,72,4,4,0.486111,0,0,11,11,false,false,false,0.253,0.747
126,130,-4,25.2,32.5,-4,1126,1277,-151,0,0,0,0,63,5,4,0.555556,0,0,11,9,false,false,false,0.266,0.734
152,189,-37,19,27,-37,907,910,-3,0,1,0,0.142857,53,8,7,0.811321,1,0,6,22,false,false,false,0.167,0.833
145,187,-42,14.5,20.777778,-42,813,698,115,1,0,0.1,0,41,10,9,1.170732,0,1,9,12,false,false,false,0.003,0.997
124,171,-47,20.666667,28.5,-47,1315,1334,-19,0,1,0,0.166667,56,6,6,0.642857,0,0,11,10,false,false,false,0.201,0.799
346,344,2,20.352941,21.5,2,1563,1539,24,0,1,0,0.0625,-20,17,16,-1.75,0,0,1,2,false,false,false,0.036,0.964
312,354,-42,22.285714,25.285714,-42,1439,1314,125,0,0,0,0,-4,14,14,-7,0,1,3,3,true,false,false,0,1
121,197,-76,30.25,49.25,-76,1431,1399,32,0,1,0,0.25,60,4,4,0.416667,0,0,10,10,false,false,false,0.156,0.844
297,377,-80,16.5,22.176471,-80,889,895,-6,0,1,0,0.058824,-13,18,17,-2.846154,0,1,3,6,false,false,false,0,1
231,309,-78,11.55,15.45,-78,391,542,-151,1,0,0.05,0,-26,20,20,-1.769231,0,0,7,9,false,false,false,0,1
25,18,7,12.5,9,7,1045,948,97,0,0,0,0,82,2,2,0.414634,0,0,17,16,false,false,true,0.681,0.319
148,154,-6,16.444444,19.25,-6,1203,1270,-67,0,0,0,0,52,9,8,0.846154,1,0,11,11,false,false,false,0.062,0.938
8,14,-6,8,14,-6,1656,1580,76,0,0,0,0,94,1,1,0.351064,0,0,7,10,false,false,false,0.484,0.516
193,269,-76,14.846154,20.692308,-76,714,892,-178,0,2,0,0.153846,13,13,13,3.230769,0,0,9,7,false,false,false,0,1
298,374,-76,11.92,14.96,-76,595,412,183,0,1,0,0.04,-22,25,25,-2.363636,0,0,10,11,false,false,false,0,1
243,230,13,22.090909,23,13,1488,1428,60,1,0,0.090909,0,29,11,10,1.275862,0,1,11,9,false,false,false,0.236,0.764
167,183,-16,16.7,18.3,-16,1094,1041,53,0,0,0,0,30,10,10,1.266667,1,1,6,13,false,false,false,0.19,0.81
80,53,27,16,13.25,27,1065,948,117,0,0,0,0,70,5,4,0.557143,1,0,19,20,false,false,true,0.769,0.231
202,270,-68,15.538462,20.769231,-68,95,453,-358,0,0,0,0,13,13,13,3,0,1,10,20,false,false,false,0,1
230,176,54,28.75,25.142857,54,1373,1334,39,1,1,0.125,0.142857,46,8,7,0.695652,0,0,12,19,false,false,true,0.968,0.032
39,65,-26,9.75,16.25,-26,1101,1130,-29,0,0,0,0,75,4,4,0.6,0,1,14,7,false,false,false,0.235,0.765
17,19,-2,8.5,19,-2,568,570,-2,0,0,0,0,91,2,1,0.406593,0,0,10,18,false,false,false,0.25,0.75
259,338,-79,13.631579,18.777778,-79,907,878,29,0,0,0,0,-2,19,18,-21.5,0,0,7,11,false,false,false,0,1
144,184,-40,18,26.285714,-40,804,766,38,0,1,0,0.142857,58,8,7,0.706897,0,1,10,10,false,false,false,0.041,0.959
106,98,8,17.666667,19.6,8,736,791,-55,0,0,0,0,63,6,5,0.603175,1,1,10,15,false,false,false,0.026,0.974
144,168,-24,16,21,-24,1047,1253,-206,1,0,0.111111,0,48,9,8,0.770833,0,0,7,11,false,false,false,0.238,0.762
132,120,12,18.857143,20,12,1021,1094,-73,1,0,0.142857,0,55,7,6,0.672727,1,0,6,12,false,false,true,0.541,0.459
234,230,4,29.25,28.75,4,714,820,-106,1,0,0.125,0,41,8,8,0.756098,0,0,12,9,false,false,false,0.117,0.883
254,307,-53,18.142857,21.928571,-53,1078,1095,-17,1,1,0.071429,0.071429,6,14,14,6.166667,0,0,7,19,false,false,false,0,1
314,346,-32,22.428571,26.615385,-32,1556,1513,43,0,0,0,0,-2,14,13,-15.5,0,0,6,4,false,false,false,0.005,0.995
146,263,-117,14.6,26.3,-117,915,971,-56,0,0,0,0,25,10,10,1.32,0,0,11,28,false,false,false,0,1
257,267,-10,25.7,26.7,-10,1167,1245,-78,1,0,0.1,0,14,10,10,2,1,0,6,13,false,false,true,0.75,0.25
24,0,24,24,0,24,842,926,-84,0,0,0,0,95,1,0,0.315789,0,0,17,0,false,false,false,0.266,0.734
99,133,-34,14.142857,22.166667,-34,726,818,-92,0,0,0,0,57,7,6,0.614035,0,0,13,11,false,false,false,0.07,0.93
252,285,-33,16.8,19,-33,599,448,151,0,0,0,0,2,15,15,18,0,1,11,14,false,false,false,0.003,0.997
312,321,-9,18.352941,20.0625,-9,1803,1658,145,1,0,0.058824,0,-15,17,16,-2.2,0,0,3,3,true,false,false,0.187,0.813
125,170,-45,17.857143,24.285714,-45,452,698,-246,0,1,0,0.142857,54,7,7,0.759259,0,1,17,7,false,false,false,0.237,0.763
43,23,20,21.5,23,20,599,448,151,0,0,0,0,88,2,1,0.409091,0,0,11,18,false,false,true,0.681,0.319
88,125,-37,22,41.666667,-37,1632,2020,-388,0,0,0,0,69,4,3,0.449275,0,0,8,12,false,false,false,0.227,0.773
327,336,-9,17.210526,17.684211,-9,742,594,148,0,0,0,0,-23,19,19,-1.695652,0,0,3,2,false,false,true,0.504,0.496
34,18,16,17,18,16,402,448,-46,0,0,0,0,90,2,1,0.411111,0,0,11,12,false,false,false,0.254,0.746
68,97,-29,13.6,24.25,-29,342,263,79,0,0,0,0,67,5,4,0.507463,0,1,8,11,false,false,false,0.004,0.996
129,181,-52,12.9,18.1,-52,1075,1189,-114,0,0,0,0,33,10,10,1.212121,0,1,8,17,false,false,false,0.038,0.962
308,313,-5,23.692308,24.076923,-5,1563,1539,24,0,1,0,0.076923,-2,13,13,-17.5,0,0,10,11,false,false,false,0.13,0.87
45,37,8,11.25,12.333333,8,226,361,-135,0,0,0,0,73,4,3,0.60274,0,1,22,10,false,false,false,0.253,0.747
85,182,-97,10.625,22.75,-97,651,996,-345,0,1,0,0.125,44,8,8,1.022727,0,1,12,9,false,false,false,0.013,0.987
8,0,8,8,0,8,1656,1580,76,0,0,0,0,97,1,0,0.340206,0,0,7,0,false,false,true,0.678,0.322
54,142,-88,13.5,47.333333,-88,2143,2219,-76,0,0,0,0,73,4,3,0.424658,0,0,12,15,false,false,false,0.036,0.964
152,133,19,16.888889,14.777778,19,797,796,1,0,0,0,0,51,9,9,0.960784,1,1,6,16,false,false,false,0.131,0.869
144,246,-102,18,35.142857,-102,1576,1556,20,0,1,0,0.142857,40,8,7,0.75,0,0,20,7,false,false,false,0,1
52,53,-1,8.666667,10.6,-1,925,1000,-75,0,0,0,0,60,6,5,0.733333,0,1,7,9,false,false,false,0.249,0.751
93,137,-44,18.6,34.25,-44,1164,1149,15,0,0,0,0,72,5,4,0.652778,0,1,15,6,false,false,false,0.012,0.988
84,207,-123,16.8,41.4,-123,1539,1891,-352,0,1,0,0.2,57,5,5,0.438596,0,0,17,12,false,false,false,0,1
22,15,7,22,15,7,907,1070,-163,0,0,0,0,92,1,1,0.380435,0,0,12,17,false,false,false,0.251,0.749
186,213,-27,15.5,19.363636,-27,1312,1334,-22,0,0,0,0,17,12,11,2.294118,0,0,17,10,false,false,false,0.201,0.799
120,236,-116,15,33.714286,-116,1164,1149,15,0,1,0,0.142857,55,8,7,0.854545,0,0,12,18,false,false,false,0,1
14,32,-18,14,32,-18,1310,1477,-167,0,0,0,0,93,1,1,0.387097,0,0,7,7,false,false,false,0.271,0.729
113,203,-90,18.833333,33.833333,-90,1399,1210,189,0,1,0,0.166667,54,6,6,0.648148,0,0,17,23,false,false,false,0.032,0.968
142,169,-27,14.2,16.9,-27,848,976,-128,0,0,0,0,38,10,10,1.052632,0,0,25,12,false,false,false,0.093,0.907
53,33,20,26.5,16.5,20,991,1063,-72,0,0,0,0,88,2,2,0.431818,0,0,14,22,false,false,false,0.271,0.729
132,295,-163,8.25,18.4375,-163,651,567,84,0,0,0,0,12,16,16,4.583333,0,1,8,9,false,false,false,0,1
121,136,-15,20.166667,22.666667,-15,480,518,-38,0,0,0,0,54,6,6,0.740741,0,1,13,7,false,false,false,0.079,0.921
36,11,25,18,11,25,561,633,-72,0,0,0,0,88,2,1,0.397727,1,1,8,9,false,false,false,0.247,0.753
20,0,20,20,0,20,1070,814,256,0,0,0,0,95,1,0,0.347368,0,0,21,0,false,false,true,0.694,0.306
39,21,18,19.5,21,18,689,804,-115,0,0,0,0,88,2,1,0.397727,1,0,8,12,false,false,false,0.256,0.744
312,374,-62,18.352941,22,-62,561,633,-72,0,1,0,0.058824,-15,17,17,-2.333333,0,0,3,2,false,false,false,0,1
269,397,-128,15.823529,23.352941,-128,1408,1539,-131,0,1,0,0.058824,-21,17,17,-1.619048,0,0,2,2,true,false,false,0,1
165,328,-163,12.692308,27.333333,-163,940,947,-7,0,2,0,0.166667,14,13,12,2.5,1,0,18,16,false,false,false,0,1
35,73,-38,17.5,36.5,-38,620,698,-78,0,0,0,0,86,2,2,0.476744,0,0,19,13,false,false,false,0.058,0.942
26,20,6,13,10,6,797,796,1,0,0,0,0,91,2,2,0.538462,0,0,7,16,false,false,false,0.285,0.715
126,148,-22,11.454545,14.8,-22,391,542,-151,1,0,0.090909,0,34,11,10,1.352941,0,0,10,8,false,false,false,0.329,0.671
304,292,12,20.266667,20.857143,12,939,969,-30,0,0,0,0,-9,15,14,-3.666667,0,0,3,9,false,false,true,0.517,0.483
63,46,17,21,15.333333,17,1040,1091,-51,0,0,0,0,80,3,3,0.5875,0,0,8,19,false,false,false,0.412,0.588
189,287,-98,18.9,28.7,-98,874,868,6,0,0,0,0,23,10,10,1.434783,0,0,10,21,false,false,false,0,1
238,266,-28,17,20.461538,-28,595,733,-138,1,1,0.071429,0.076923,4,14,13,9.75,0,1,23,18,false,false,false,0,1
218,202,16,18.166667,18.363636,16,1417,1482,-65,0,0,0,0,33,12,11,1,0,1,16,8,false,false,false,0.182,0.818
234,324,-90,19.5,29.454545,-90,1334,1439,-105,1,1,0.083333,0.090909,30,12,11,1.2,0,0,16,9,false,false,false,0,1
162,130,32,18,16.25,32,771,668,103,0,0,0,0,33,9,8,1.151515,0,0,10,15,false,false,true,0.761,0.239
201,274,-73,12.5625,18.266667,-73,951,976,-25,0,0,0,0,6,16,15,7.333333,0,0,7,10,false,false,false,0,1
53,108,-55,13.25,27,-55,935,995,-60,0,0,0,0,75,4,4,0.52,2,0,17,9,false,false,false,0.223,0.777
304,423,-119,11.692308,16.92,-119,1037,1016,21,1,0,0.038462,0,-21,26,25,-2.761905,1,0,2,5,false,false,false,0,1
34,36,-2,17,18,-2,402,448,-46,0,0,0,0,86,2,2,0.430233,0,1,11,10,false,false,false,0.234,0.766
16,64,-48,8,32,-48,1038,917,121,0,0,0,0,87,2,2,0.402299,0,1,7,6,false,false,false,0.171,0.829
225,298,-73,22.5,29.8,-73,732,868,-136,0,1,0,0.1,21,10,10,1.52381,0,0,11,20,false,false,false,0,1
314,332,-18,14.952381,15.809524,-18,576,602,-26,0,0,0,0,-24,21,21,-1.75,0,0,1,1,true,false,false,0.007,0.993
116,110,6,16.571429,18.333333,6,651,700,-49,0,0,0,0,57,7,6,0.982456,1,0,11,20,false,false,true,0.616,0.384
82,100,-18,16.4,25,-18,710,758,-48,0,0,0,0,72,5,4,0.513889,0,1,14,6,false,false,false,0.08,0.92
221,311,-90,27.625,44.428571,-90,1885,1908,-23,1,3,0.125,0.428571,24,8,7,0.958333,0,0,7,9,false,false,false,0,1
37,103,-66,7.4,20.6,-66,907,1070,-163,0,0,0,0,66,5,5,0.530303,0,0,18,19,false,false,false,0.04,0.96
168,288,-120,33.6,57.6,-120,1398,1431,-33,0,0,0,0,43,5,5,0.651163,0,1,13,16,false,false,false,0,1
255,303,-48,13.421053,16.833333,-48,615,542,73,0,0,0,0,-10,19,18,-4.2,0,0,11,10,false,false,false,0,1
263,277,-14,20.230769,21.307692,-14,971,635,336,0,0,0,0,0,13,13,0,1,0,9,8,false,false,false,0.03,0.97
198,160,38,24.75,20,38,1070,814,256,1,1,0.125,0.125,36,8,8,0.916667,0,1,17,20,false,false,true,0.831,0.169
112,109,3,12.444444,12.111111,3,1045,948,97,0,0,0,0,39,9,9,0.871795,0,0,10,13,false,false,false,0.281,0.719
25,27,-2,12.5,27,-2,342,263,79,0,0,0,0,90,2,1,0.377778,0,0,10,19,false,false,true,0.546,0.454
114,163,-49,19,32.6,-49,1572,1777,-205,0,1,0,0.2,52,6,5,0.634615,0,1,8,6,false,false,false,0.049,0.951
310,368,-58,19.375,23,-58,561,633,-72,0,1,0,0.0625,-6,16,16,-5.833333,0,0,4,2,false,false,false,0,1
43,67,-24,14.333333,22.333333,-24,1123,1062,61,0,0,0,0,77,3,3,0.571429,0,0,7,17,false,false,false,0.223,0.777
41,70,-29,10.25,17.5,-29,1344,1314,30,0,1,0,0.25,73,4,4,0.465753,0,0,21,9,false,false,false,0.22,0.78
226,262,-36,13.294118,16.375,-36,526,502,24,0,0,0,0,3,17,16,16.666667,0,0,20,21,false,false,false,0,1
356,371,-15,23.733333,24.733333,-15,1305,1211,94,2,0,0.133333,0,-3,15,15,-11,0,1,10,4,false,false,false,0,1
76,119,-43,15.2,23.8,-43,714,892,-178,0,0,0,0,66,5,5,0.636364,1,1,10,14,false,false,false,0.018,0.982
167,169,-2,18.555556,21.125,-2,796,800,-4,1,0,0.111111,0,42,9,8,1.142857,0,0,8,8,false,false,false,0.316,0.684
344,368,-24,18.105263,19.368421,-24,1037,913,124,2,1,0.105263,0.052632,-17,19,19,-2.235294,0,0,4,6,true,false,false,0.012,0.988
134,227,-93,14.888889,25.222222,-93,915,971,-56,0,0,0,0,35,9,9,0.942857,0,1,10,21,false,false,false,0,1
199,280,-81,16.583333,23.333333,-81,711,746,-35,0,0,0,0,18,12,12,2.111111,0,0,11,16,false,false,false,0,1
172,265,-93,17.2,26.5,-93,1656,1649,7,0,0,0,0,28,10,10,1.142857,0,0,19,11,false,false,false,0,1
287,353,-66,15.105263,19.611111,-66,1422,1583,-161,0,1,0,0.055556,-10,19,18,-4.1,1,0,2,13,false,false,false,0,1
228,189,39,15.2,13.5,39,671,638,33,0,0,0,0,9,15,14,5.444444,0,1,15,24,false,false,true,0.607,0.393
174,218,-44,24.857143,36.333333,-44,1436,1489,-53,1,1,0.142857,0.166667,54,7,6,0.685185,0,0,12,10,false,false,false,0.192,0.808
8,0,8,8,0,8,1656,1649,7,0,0,0,0,96,1,0,0.333333,0,0,14,0,false,false,true,0.678,0.322
290,313,-23,19.333333,22.357143,-23,804,1080,-276,1,0,0.066667,0,2,15,14,17,0,0,7,9,false,false,false,0,1
120,403,-283,9.230769,31,-283,1164,1149,15,0,2,0,0.153846,34,13,13,1.382353,0,0,12,7,false,false,false,0,1
204,144,60,20.4,16,60,742,594,148,0,0,0,0,37,10,9,1.054054,0,1,20,10,false,false,true,0.963,0.037
303,265,38,17.823529,16.5625,38,1193,1220,-27,1,0,0.058824,0,-4,17,16,-10.75,0,0,21,15,false,false,true,0.994,0.006
236,237,-1,19.666667,21.545455,-1,1633,1739,-106,1,0,0.083333,0,23,12,11,1.478261,1,1,6,6,false,false,false,0.057,0.943
317,382,-65,19.8125,25.466667,-65,1127,995,132,0,1,0,0.066667,-10,16,15,-3.3,0,0,7,3,false,false,false,0,1
135,161,-26,16.875,20.125,-26,813,698,115,1,0,0.125,0,49,8,8,0.979592,0,1,7,19,false,false,false,0.004,0.996
187,294,-107,12.466667,21,-107,632,603,29,0,1,0,0.071429,-6,15,14,-6.333333,0,0,11,12,false,false,false,0,1
55,81,-26,27.5,40.5,-26,954,939,15,0,0,0,0,83,2,2,0.433735,0,0,10,9,false,false,true,0.644,0.356
336,342,-6,16.8,17.1,-6,1168,1062,106,0,0,0,0,-13,20,20,-3.307692,0,0,2,1,false,false,true,0.937,0.063
314,367,-53,19.625,22.9375,-53,742,868,-126,0,1,0,0.0625,-11,16,16,-3,0,0,2,5,false,false,false,0,1
153,159,-6,15.3,17.666667,-6,1580,1629,-49,0,0,0,0,36,10,9,1.027778,0,0,9,9,false,false,false,0.203,0.797
163,177,-14,10.866667,11.8,-14,542,390,152,0,0,0,0,30,15,15,1.666667,0,0,10,19,false,false,false,0.366,0.634
87,134,-47,14.5,22.333333,-47,1123,1062,61,0,0,0,0,57,6,6,0.77193,1,0,9,16,false,false,false,0.201,0.799
209,317,-108,12.294118,19.8125,-108,1305,1307,-2,0,1,0,0.0625,-7,17,16,-5.857143,0,1,10,15,false,false,false,0,1
158,204,-46,14.363636,18.545455,-46,306,361,-55,0,0,0,0,18,11,11,2,0,1,11,7,false,false,false,0.011,0.989
327,336,-9,16.35,17.684211,-9,742,594,148,0,0,0,0,-23,20,19,-1.695652,0,0,3,2,true,false,false,0.007,0.993
312,347,-35,18.352941,21.6875,-35,1063,1134,-71,1,0,0.058824,0,5,17,16,8.8,0,0,13,8,false,false,false,0,1
140,175,-35,17.5,21.875,-35,1417,1482,-65,0,0,0,0,52,8,8,0.634615,0,1,18,8,false,false,false,0.039,0.961
335,346,-11,15.952381,17.3,-11,775,786,-11,1,0,0.047619,0,-23,21,20,-1.869565,0,0,12,15,false,false,true,0.622,0.378
286,268,18,19.066667,19.142857,18,804,766,38,0,1,0,0.071429,15,15,14,2.733333,0,1,11,12,false,false,false,0.171,0.829
275,243,32,14.473684,12.789474,32,671,638,33,0,0,0,0,-14,19,19,-3.5,0,0,8,18,false,false,true,1,0
177,242,-65,13.615385,18.615385,-65,683,859,-176,0,0,0,0,24,13,13,1.875,0,0,11,13,false,false,false,0,1
259,371,-112,13.631579,19.526316,-112,907,878,29,0,0,0,0,-7,19,19,-6.142857,0,0,7,6,false,false,false,0,1
82,79,3,16.4,19.75,3,1131,1030,101,0,0,0,0,71,5,4,0.422535,1,0,11,8,false,false,true,0.663,0.337
73,36,37,18.25,12,37,1636,1702,-66,0,0,0,0,83,4,3,0.349398,0,1,16,11,false,false,false,0.47,0.53
242,314,-72,15.125,20.933333,-72,653,820,-167,0,0,0,0,-11,16,15,-3.454545,0,0,4,11,false,false,false,0,1
29,37,-8,14.5,18.5,-8,664,786,-122,0,0,0,0,90,2,2,0.366667,0,0,22,10,false,false,false,0.251,0.749
285,305,-20,23.75,27.727273,-20,1071,1065,6,0,0,0,0,12,12,11,2.583333,0,0,9,12,false,false,false,0.192,0.808
199,264,-65,15.307692,22,-65,952,826,126,0,1,0,0.083333,22,13,12,1.954545,0,0,8,10,false,false,false,0,1
283,276,7,15.722222,16.235294,7,1203,1270,-67,1,0,0.055556,0,-3,18,17,-14.666667,1,1,9,11,false,false,false,0.075,0.925
326,417,-91,18.111111,24.529412,-91,1232,1448,-216,0,2,0,0.117647,-20,18,17,-1.75,0,0,2,1,true,false,false,0,1
114,177,-63,11.4,17.7,-63,226,361,-135,0,0,0,0,32,10,10,1.375,0,0,7,10,false,false,false,0.047,0.953
195,215,-20,17.727273,19.545455,-20,1439,1428,11,0,0,0,0,33,11,11,1.212121,0,0,18,11,false,false,false,0.201,0.799
222,175,47,31.714286,29.166667,47,1167,1245,-78,1,0,0.142857,0,43,7,6,0.651163,1,0,7,15,false,false,true,0.661,0.339
47,41,6,11.75,10.25,6,1278,1101,177,0,0,0,0,74,4,4,0.5,1,0,15,13,false,false,true,0.647,0.353
195,243,-48,32.5,48.6,-48,2010,2219,-209,1,0,0.166667,0,51,6,5,0.509804,0,0,15,15,false,false,false,0.004,0.996
47,102,-55,15.666667,34,-55,1349,1203,146,0,1,0,0.333333,76,3,3,0.421053,0,0,11,11,false,false,false,0.168,0.832
192,238,-46,12.8,15.866667,-46,163,346,-183,0,0,0,0,-6,15,15,-6.5,0,0,26,8,false,false,false,0.002,0.998
22,0,22,22,0,22,1885,1908,-23,0,0,0,0,98,1,0,0.234694,0,0,12,0,false,false,true,0.678,0.322
201,218,-17,22.333333,24.222222,-17,1063,1134,-71,1,0,0.111111,0,46,9,9,0.956522,0,0,9,17,false,false,false,0.062,0.938
274,275,-1,27.4,27.5,-1,714,820,-106,1,0,0.1,0,27,10,10,1.148148,0,0,10,17,false,false,false,0.106,0.894
239,321,-82,18.384615,24.692308,-82,1417,1482,-65,0,1,0,0.076923,19,13,13,1.736842,0,1,15,8,false,false,false,0,1
85,119,-34,14.166667,23.8,-34,714,892,-178,0,0,0,0,63,6,5,0.666667,1,1,11,14,false,false,false,0.016,0.984
291,330,-39,18.1875,22,-39,727,820,-93,0,1,0,0.066667,-7,16,15,-5,0,1,9,5,false,false,false,0,1
175,344,-169,9.722222,19.111111,-169,651,996,-345,0,2,0,0.111111,-13,18,18,-3.461538,0,0,16,5,false,false,false,0,1
272,309,-37,17,19.3125,-37,907,1070,-163,0,0,0,0,5,16,16,7,0,2,7,7,false,false,false,0,1
112,74,38,22.4,18.5,38,664,786,-122,0,0,0,0,75,5,4,0.44,0,0,18,7,false,false,false,0.361,0.639
85,156,-71,21.25,39,-71,1537,1539,-2,0,1,0,0.25,64,4,4,0.53125,0,0,12,14,false,false,false,0.161,0.839
313,313,0,19.5625,20.866667,0,1227,1189,38,0,0,0,0,-10,16,15,-3.5,0,0,4,15,false,false,true,0.85,0.15
52,70,-18,26,70,-18,1182,1075,107,0,1,0,1,85,2,1,0.458824,0,0,15,10,false,false,false,0.202,0.798
177,175,2,19.666667,19.444444,2,1257,1176,81,1,0,0.111111,0,44,9,9,0.772727,1,0,16,20,false,false,true,0.788,0.212
303,333,-30,14.428571,16.65,-30,1045,1082,-37,0,0,0,0,-25,21,20,-1.8,0,0,2,2,false,false,false,0,1
193,225,-32,19.3,22.5,-32,785,892,-107,0,0,0,0,33,10,10,1.121212,0,0,11,8,false,false,false,0.05,0.95
52,7,45,26,3.5,45,742,594,148,0,0,0,0,86,2,2,0.453488,0,0,12,11,false,false,true,0.846,0.154
250,259,-9,17.857143,19.923077,-9,518,461,57,0,0,0,0,4,14,13,9,0,1,9,9,false,false,false,0.027,0.973
111,154,-43,15.857143,25.666667,-43,642,952,-310,0,0,0,0,54,7,6,0.814815,0,0,9,24,false,false,false,0.017,0.983
98,72,26,24.5,24,26,921,1045,-124,0,0,0,0,75,4,3,0.466667,0,0,11,10,false,false,false,0.259,0.741
223,321,-98,14.866667,22.928571,-98,503,668,-165,0,1,0,0.071429,3,15,14,12.333333,2,0,5,12,false,false,false,0,1
242,304,-62,18.615385,25.333333,-62,700,820,-120,0,1,0,0.083333,10,13,12,3.8,0,0,23,10,false,false,false,0,1
54,89,-35,10.8,22.25,-35,948,998,-50,0,0,0,0,67,5,4,0.552239,1,1,14,12,false,false,false,0.022,0.978
8,19,-11,8,19,-11,1210,1162,48,0,0,0,0,92,1,1,0.347826,0,0,7,14,false,false,true,0.557,0.443
95,56,39,23.75,14,39,742,594,148,0,0,0,0,70,4,4,0.557143,0,0,20,8,false,false,true,0.851,0.149
330,320,10,17.368421,16.842105,10,1065,948,117,0,1,0,0.052632,-12,19,19,-3.25,0,0,8,6,false,false,true,0.901,0.099
231,282,-51,17.769231,21.692308,-51,1432,1452,-20,0,1,0,0.076923,8,13,13,4.5,1,0,7,19,false,false,false,0.006,0.994
16,23,-7,16,23,-7,1003,1018,-15,0,0,0,0,90,1,1,0.411111,0,0,14,11,false,false,true,0.677,0.323
159,188,-29,15.9,20.888889,-29,721,757,-36,0,1,0,0.111111,39,10,9,0.974359,0,0,20,9,false,false,false,0.1,0.9
60,15,45,30,15,45,500,532,-32,0,0,0,0,87,2,1,0.471264,0,0,7,13,false,false,false,0.43,0.57
158,212,-54,17.555556,26.5,-54,1656,1580,76,0,1,0,0.125,41,9,8,0.804878,1,0,13,10,false,false,false,0.029,0.971
325,384,-59,18.055556,22.588235,-59,1021,897,124,0,2,0,0.117647,-22,18,17,-1.681818,0,0,10,1,false,false,false,0,1
217,246,-29,16.692308,18.923077,-29,1439,1428,11,0,0,0,0,21,13,13,1.904762,0,0,14,16,false,false,false,0.184,0.816
336,392,-56,24,28,-56,1606,1890,-284,0,1,0,0.071429,-6,14,14,-4.666667,1,0,10,9,true,false,false,0.098,0.902
69,46,23,17.25,15.333333,23,651,700,-49,0,0,0,0,78,4,3,0.717949,0,0,7,17,false,false,false,0.259,0.741
142,111,31,17.75,15.857143,31,897,996,-99,0,0,0,0,50,8,7,0.78,0,0,10,10,false,false,false,0.328,0.672
85,170,-85,17,34,-85,732,868,-136,0,1,0,0.2,63,5,5,0.507937,0,0,10,17,false,false,false,0.037,0.963
247,250,-3,20.583333,22.727273,-3,985,1062,-77,0,0,0,0,17,12,11,2.176471,1,0,12,13,false,false,false,0.284,0.716
162,208,-46,14.727273,20.8,-46,95,453,-358,0,0,0,0,31,11,10,1.258065,0,0,11,27,false,false,false,0.001,0.999
206,245,-39,12.117647,14.411765,-39,1220,1202,18,0,0,0,0,4,17,17,12.5,0,1,29,13,false,false,false,0.005,0.995
19,25,-6,9.5,25,-6,999,1283,-284,0,0,0,0,89,2,1,0.370787,1,1,19,16,false,false,false,0.031,0.969
55,59,-4,13.75,14.75,-4,1037,913,124,0,0,0,0,83,4,4,0.457831,1,0,8,17,false,false,false,0.354,0.646
112,76,36,22.4,19,36,999,1283,-284,0,0,0,0,67,5,4,0.492537,0,1,13,19,false,false,false,0.265,0.735
250,255,-5,13.888889,14.166667,-5,306,302,4,0,0,0,0,-18,18,18,-2.277778,0,0,9,5,false,false,true,0.686,0.314
242,323,-81,17.285714,24.846154,-81,1408,1539,-131,0,1,0,0.076923,-1,14,13,-34,0,1,7,24,false,false,false,0,1
45,70,-25,7.5,11.666667,-25,288,359,-71,0,0,0,0,71,6,6,0.380282,0,0,23,10,false,false,false,0.261,0.739
285,348,-63,20.357143,26.769231,-63,1126,1277,-151,0,0,0,0,-9,14,13,-3.888889,0,0,4,11,false,false,false,0,1
64,104,-40,9.142857,14.857143,-40,970,1030,-60,0,0,0,0,54,7,7,0.740741,0,0,27,10,false,false,false,0.227,0.773
241,316,-75,21.909091,28.727273,-75,732,868,-136,0,1,0,0.090909,14,11,11,2.285714,0,0,9,22,false,false,false,0,1
49,31,18,24.5,31,18,1093,1173,-80,0,0,0,0,89,2,1,0.483146,0,0,19,12,false,false,true,0.663,0.337
140,162,-22,11.666667,13.5,-22,542,390,152,0,0,0,0,42,12,12,1.190476,0,0,10,19,false,false,false,0.191,0.809
267,356,-89,12.714286,17.8,-89,714,892,-178,0,2,0,0.1,-25,21,20,-1.68,0,0,6,3,false,false,false,0,1
168,162,6,15.272727,16.2,6,889,855,34,0,0,0,0,36,11,10,1.111111,0,1,23,8,false,false,false,0.289,0.711
45,24,21,22.5,24,21,1539,1891,-352,0,0,0,0,89,2,1,0.280899,0,0,17,17,false,false,false,0.251,0.749
156,139,17,17.333333,17.375,17,1037,1009,28,0,0,0,0,49,9,8,0.897959,0,1,18,9,false,false,false,0.334,0.666
28,0,28,28,0,28,1428,1361,67,0,0,0,0,94,1,0,0.351064,0,0,12,0,false,false,true,0.685,0.315
240,316,-76,13.333333,18.588235,-76,306,361,-55,0,0,0,0,-26,18,17,-1.384615,0,0,1,3,false,false,false,0,1
259,333,-74,13.631579,17.526316,-74,95,453,-358,0,0,0,0,-15,19,19,-2.6,0,0,2,4,false,false,false,0,1
199,239,-40,22.111111,29.875,-40,1071,1065,6,0,0,0,0,30,9,8,1.033333,0,0,17,13,false,false,false,0.2,0.8
201,141,60,28.714286,23.5,60,691,695,-4,1,0,0.142857,0,53,7,6,0.603774,1,0,8,17,false,false,false,0.392,0.608
267,284,-17,14.833333,16.705882,-17,595,538,57,0,0,0,0,-12,18,17,-3.166667,0,0,1,3,false,false,false,0.243,0.757
132,113,19,22,22.6,19,621,786,-165,0,0,0,0,50,6,5,0.6,0,0,11,12,false,false,false,0.255,0.745
97,156,-59,16.166667,31.2,-59,561,633,-72,0,1,0,0.2,65,6,5,0.538462,1,0,9,17,false,false,false,0.045,0.955
296,390,-94,16.444444,22.941176,-94,563,523,40,0,0,0,0,-14,18,17,-2.642857,0,0,2,1,false,false,false,0,1
168,177,-9,33.6,35.4,-9,1793,1957,-164,0,0,0,0,55,5,5,0.527273,0,0,8,17,false,false,false,0.467,0.533
38,100,-62,9.5,25,-62,343,570,-227,0,0,0,0,65,4,4,0.553846,0,0,10,9,false,false,false,0.24,0.76
309,378,-69,19.3125,23.625,-69,771,668,103,2,0,0.125,0,-19,16,16,-2,0,0,3,8,false,false,false,0,1
150,164,-14,18.75,20.5,-14,527,954,-427,0,0,0,0,48,8,8,0.729167,0,2,23,12,false,false,false,0.214,0.786
65,91,-26,21.666667,30.333333,-26,954,939,15,0,0,0,0,77,3,3,0.467532,0,0,10,14,false,false,true,0.524,0.476
74,130,-56,14.8,26,-56,1633,1739,-106,0,0,0,0,72,5,5,0.472222,0,0,11,8,false,false,false,0.044,0.956
89,98,-9,17.8,19.6,-9,980,965,15,0,0,0,0,65,5,5,0.584615,0,1,19,8,false,false,true,0.652,0.348
268,303,-35,17.866667,20.2,-35,952,870,82,0,0,0,0,-4,15,15,-9.25,0,0,11,19,false,false,false,0,1
230,341,-111,17.692308,26.230769,-111,1315,1331,-16,0,0,0,0,4,13,13,8.25,0,0,10,7,false,false,false,0,1
30,44,-14,15,22,-14,1003,1018,-15,0,0,0,0,84,2,2,0.440476,0,0,11,8,false,false,true,0.676,0.324
185,238,-53,20.555556,26.444444,-53,1645,1636,9,0,1,0,0.111111,29,9,9,1.137931,0,0,13,8,false,false,false,0.023,0.977
235,312,-77,19.583333,28.363636,-77,1232,1281,-49,0,2,0,0.181818,11,12,11,2.818182,0,0,9,11,false,false,false,0,1
224,254,-30,14,16.933333,-30,1045,1082,-37,0,0,0,0,4,16,15,11.25,1,0,9,14,false,false,false,0.117,0.883
52,79,-27,8.666667,15.8,-27,970,1030,-60,0,0,0,0,64,6,5,0.625,0,1,25,7,false,false,false,0.194,0.806
60,157,-97,8.571429,26.166667,-97,1037,913,124,0,1,0,0.166667,68,7,6,0.558824,1,0,8,7,false,false,false,0.005,0.995
150,208,-58,15,23.111111,-58,1159,1131,28,0,2,0,0.222222,34,10,9,1.088235,0,0,18,18,false,false,false,0.057,0.943
84,139,-55,16.8,27.8,-55,944,1095,-151,0,1,0,0.2,68,5,5,0.573529,0,0,7,18,false,false,false,0.039,0.961
298,312,-14,18.625,20.8,-14,1488,1403,85,0,1,0,0.066667,-13,16,15,-2.615385,1,0,8,11,false,false,false,0.015,0.985
184,238,-54,23,29.75,-54,1266,1339,-73,0,1,0,0.125,47,8,8,0.744681,0,0,10,21,false,false,false,0.043,0.957
135,189,-54,19.285714,27,-54,1636,1796,-160,0,0,0,0,45,7,7,0.6,0,0,13,14,false,false,false,0.048,0.952
240,194,46,21.818182,17.636364,46,1043,1003,40,0,0,0,0,24,11,11,1.583333,0,1,9,13,false,false,true,0.862,0.138
263,338,-75,18.785714,24.142857,-75,721,757,-36,0,2,0,0.142857,5,14,14,7.6,0,0,10,12,false,false,false,0,1
276,327,-51,14.526316,17.210526,-51,613,525,88,0,0,0,0,-20,19,19,-2.1,0,0,10,4,false,false,false,0,1
200,326,-126,15.384615,25.076923,-126,342,263,79,0,0,0,0,2,13,13,17,1,0,10,8,false,false,false,0,1
223,278,-55,20.272727,25.272727,-55,503,527,-24,0,1,0,0.090909,13,11,11,2.538462,0,0,7,11,false,false,false,0.119,0.881
65,45,20,16.25,15,20,889,855,34,0,0,0,0,79,4,3,0.506329,0,0,18,11,false,false,true,0.685,0.315
166,220,-54,13.833333,20,-54,595,540,55,0,0,0,0,28,12,11,1.535714,0,0,10,12,false,false,false,0.026,0.974
115,118,-3,16.428571,19.666667,-3,402,448,-46,0,0,0,0,56,7,6,0.660714,0,1,10,9,false,false,false,0.058,0.942
88,104,-16,12.571429,17.333333,-16,1045,1082,-37,0,0,0,0,60,7,6,0.75,1,0,20,10,false,false,true,0.522,0.478
249,295,-46,20.75,24.583333,-46,1397,1309,88,2,0,0.166667,0,26,12,12,1.384615,0,0,11,10,false,false,false,0,1
56,63,-7,18.666667,21,-7,603,721,-118,0,0,0,0,83,3,3,0.518072,0,1,17,6,false,false,false,0.231,0.769
155,169,-14,14.090909,16.9,-14,848,976,-128,0,0,0,0,35,11,10,1.142857,0,0,19,12,false,false,false,0.056,0.944
77,160,-83,15.4,32,-83,1305,1194,111,0,0,0,0,65,5,5,0.507692,0,0,9,9,false,false,false,0.098,0.902
256,301,-45,16,20.066667,-45,995,965,30,0,1,0,0.066667,-2,16,15,-20,0,0,14,8,false,false,false,0,1
132,104,28,22,17.333333,28,615,542,73,0,0,0,0,63,6,6,0.666667,0,0,7,12,false,false,true,0.893,0.107
125,170,-45,17.857143,28.333333,-45,452,698,-246,0,1,0,0.166667,54,7,6,0.759259,0,1,17,6,false,false,false,0.2,0.8
10,0,10,10,0,10,595,540,55,0,0,0,0,97,1,0,0.443299,0,0,15,0,false,false,true,0.647,0.353
229,269,-40,17.615385,22.416667,-40,889,895,-6,0,1,0,0.083333,16,13,12,2.3125,0,1,14,31,false,false,false,0,1
67,42,25,22.333333,21,25,1205,1216,-11,0,0,0,0,84,3,2,0.392857,0,0,12,16,false,false,true,0.678,0.322
177,329,-152,14.75,29.909091,-152,1399,1210,189,0,1,0,0.090909,26,12,11,1.346154,0,0,18,9,false,false,false,0.014,0.986
333,354,-21,16.65,18.631579,-21,944,1095,-151,0,1,0,0.052632,-14,20,19,-2.785714,0,0,1,3,true,false,false,0,1
112,95,17,28,23.75,17,1331,1347,-16,1,0,0.25,0,64,4,4,0.5,0,0,7,21,false,false,true,0.679,0.321
338,377,-39,19.882353,23.5625,-39,700,820,-120,0,1,0,0.0625,-17,17,16,-2.235294,0,0,3,6,false,false,false,0,1
242,250,-8,26.888889,31.25,-8,1331,1432,-101,0,0,0,0,27,9,8,1,0,0,19,9,false,false,false,0.348,0.652
297,349,-52,15.631579,18.368421,-52,1037,1009,28,0,0,0,0,-9,19,19,-4.888889,0,0,2,2,false,false,false,0,1
79,47,32,19.75,15.666667,32,1652,1473,179,0,0,0,0,72,4,3,0.416667,0,0,20,10,false,false,true,0.708,0.292
151,157,-6,15.1,17.444444,-6,1000,960,40,0,0,0,0,36,10,9,1.25,0,0,11,16,false,false,false,0.201,0.799
168,191,-23,12.923077,14.692308,-23,163,346,-183,0,0,0,0,12,13,13,3.25,0,0,10,8,false,false,true,0.601,0.399
354,386,-32,19.666667,21.444444,-32,1691,1551,140,1,0,0.055556,0,-23,18,18,-1.608696,0,0,1,2,false,false,false,0.002,0.998
301,416,-115,16.722222,24.470588,-115,1038,917,121,1,2,0.055556,0.117647,-21,18,17,-1.666667,0,0,2,2,true,false,false,0,1
63,104,-41,21,52,-41,964,1003,-39,0,1,0,0.5,78,3,2,0.5,0,0,12,14,false,false,false,0.201,0.799
247,328,-81,12.35,16.4,-81,651,700,-49,0,0,0,0,-22,20,20,-2.545455,0,0,12,14,false,false,false,0,1
300,280,20,17.647059,17.5,20,824,830,-6,1,0,0.058824,0,2,17,16,22,0,0,9,18,false,false,true,0.976,0.024
379,380,-1,25.266667,27.142857,-1,1093,1100,-7,3,0,0.2,0,3,15,14,10.333333,0,0,6,9,false,false,false,0.204,0.796
221,419,-198,18.416667,38.090909,-198,1556,1656,-100,0,2,0,0.181818,5,12,11,6,1,0,17,13,false,false,false,0,1
244,321,-77,16.266667,21.4,-77,1159,1131,28,0,2,0,0.133333,0,15,15,0,0,1,10,16,false,false,false,0,1
331,337,-6,15.761905,16.85,-6,540,498,42,1,0,0.047619,0,-33,21,20,-1.393939,0,0,3,8,false,false,false,0.359,0.641
260,326,-66,18.571429,23.285714,-66,954,939,15,1,0,0.071429,0,-4,14,14,-9,0,1,7,11,false,false,false,0,1
154,187,-33,17.111111,20.777778,-33,1075,878,197,0,0,0,0,45,9,9,0.733333,0,0,10,8,false,false,false,0.196,0.804
266,277,-11,15.647059,16.294118,-11,1045,1082,-37,0,0,0,0,-7,17,17,-6.428571,0,0,9,14,false,false,false,0.108,0.892
231,357,-126,14.4375,23.8,-126,711,746,-35,0,0,0,0,1,16,15,38,0,0,11,7,false,false,false,0,1
195,145,50,21.666667,18.125,50,786,885,-99,1,0,0.111111,0,46,9,8,0.73913,0,1,14,6,false,false,false,0.26,0.74
176,165,11,25.142857,23.571429,11,1093,1173,-80,0,0,0,0,57,7,7,0.754386,0,0,17,16,false,false,false,0.239,0.761
159,193,-34,15.9,21.444444,-34,889,895,-6,0,1,0,0.111111,35,10,9,1.057143,0,1,17,13,false,false,false,0.103,0.897
225,278,-53,20.454545,25.272727,-53,980,965,15,0,0,0,0,23,11,11,1.652174,1,0,6,22,false,false,false,0.014,0.986
293,370,-77,20.928571,28.461538,-77,1576,1556,20,0,1,0,0.076923,-3,14,13,-10,0,0,3,16,false,false,false,0,1
309,344,-35,20.6,22.933333,-35,742,868,-126,0,1,0,0.066667,-4,15,15,-8.25,0,0,5,5,false,false,false,0.001,0.999
22,20,2,22,20,2,653,820,-167,0,0,0,0,90,1,1,0.422222,0,0,9,17,false,false,false,0.251,0.749
249,223,26,20.75,18.583333,26,742,868,-126,0,0,0,0,20,12,12,1.65,0,1,12,6,false,false,true,0.905,0.095
197,355,-158,13.133333,25.357143,-158,940,947,-7,0,2,0,0.142857,4,15,14,8.75,1,0,11,12,false,false,false,0,1
149,147,2,29.8,36.75,2,801,679,122,1,0,0.2,0,60,5,4,0.483333,0,0,9,9,false,false,false,0.117,0.883
248,264,-16,15.5,17.6,-16,306,468,-162,1,0,0.0625,0,0,16,15,0,0,0,17,14,false,false,false,0,1
46,17,29,23,17,29,1168,1062,106,0,0,0,0,89,2,1,0.483146,0,1,7,11,false,false,true,0.695,0.305
120,98,22,17.142857,16.333333,22,1452,1388,64,0,0,0,0,58,7,6,0.603448,0,0,18,18,false,false,false,0.238,0.762
221,333,-112,15.785714,23.785714,-112,711,746,-35,0,0,0,0,9,14,14,4.222222,0,0,9,12,false,false,false,0,1
332,378,-46,27.666667,34.363636,-46,1167,1245,-78,2,0,0.166667,0,-9,12,11,-2.555556,0,1,10,7,true,false,false,0,1
229,312,-83,15.266667,22.285714,-83,450,427,23,1,1,0.066667,0.071429,-7,15,14,-5.285714,0,0,13,13,false,false,false,0,1
165,283,-118,15,25.727273,-118,595,412,183,0,1,0,0.090909,27,11,11,1.925926,0,0,8,10,false,false,false,0,1
84,65,19,16.8,16.25,19,540,498,42,0,0,0,0,72,5,4,0.638889,0,1,9,11,false,false,false,0.3,0.7
167,207,-40,18.555556,25.875,-40,1232,1448,-216,0,1,0,0.125,37,9,8,0.945946,0,1,7,15,false,false,false,0.038,0.962
27,109,-82,9,36.333333,-82,1305,1194,111,0,0,0,0,78,3,3,0.423077,0,0,22,15,false,false,false,0.199,0.801
70,0,70,70,0,70,1689,1777,-88,1,0,1,0,93,1,0,0.322581,0,0,8,0,false,false,false,0.37,0.63
215,259,-44,26.875,32.375,-44,1164,1161,3,0,1,0,0.125,23,8,8,1,0,0,11,9,false,false,false,0.189,0.811
291,288,3,22.384615,24,3,1656,1580,76,1,1,0.076923,0.083333,11,13,12,3,0,0,16,26,false,false,false,0.425,0.575
108,163,-55,13.5,23.285714,-55,948,998,-50,0,0,0,0,45,8,7,0.822222,1,0,8,8,false,false,false,0.081,0.919
109,181,-72,18.166667,30.166667,-72,1110,1399,-289,0,1,0,0.166667,53,6,6,0.641509,0,0,20,10,false,false,false,0.05,0.95
95,296,-201,10.555556,32.888889,-201,1368,1452,-84,0,1,0,0.111111,43,9,9,0.744186,1,1,7,11,false,false,false,0,1
196,215,-19,19.6,21.5,-19,1432,1452,-20,0,1,0,0.1,29,10,10,1.241379,1,0,8,16,false,false,false,0.212,0.788
202,209,-7,14.428571,16.076923,-7,970,1030,-60,0,0,0,0,12,14,13,3.333333,0,0,17,8,false,false,false,0.088,0.912
300,305,-5,21.428571,21.785714,-5,1561,1495,66,1,0,0.071429,0,-8,14,14,-4.125,0,0,16,5,false,false,false,0.228,0.772
64,95,-31,16,23.75,-31,714,892,-178,0,0,0,0,70,4,4,0.6,1,1,9,17,false,false,false,0.02,0.98
74,142,-68,24.666667,47.333333,-68,1331,1432,-101,0,0,0,0,66,3,3,0.409091,0,0,10,23,false,false,false,0.03,0.97
41,54,-13,6.833333,10.8,-13,1037,1016,21,0,0,0,0,77,6,5,0.753247,0,1,7,6,false,false,false,0.05,0.95
27,64,-37,9,21.333333,-37,1210,1162,48,0,0,0,0,77,3,3,0.415584,0,0,9,14,false,false,false,0.207,0.793
259,302,-43,17.266667,21.571429,-43,758,791,-33,0,0,0,0,-3,15,14,-13,0,0,7,13,false,false,false,0,1
108,92,16,36,30.666667,16,2010,2219,-209,1,0,0.333333,0,76,3,3,0.342105,0,1,18,10,false,false,false,0.259,0.741
206,357,-151,18.727273,32.454545,-151,1368,1452,-84,1,1,0.090909,0.090909,26,11,11,1.230769,0,1,9,11,false,false,false,0,1
173,242,-69,19.222222,26.888889,-69,1315,1331,-16,0,0,0,0,34,9,9,0.970588,0,0,15,14,false,false,false,0.161,0.839
136,108,28,19.428571,15.428571,28,742,594,148,0,0,0,0,54,7,7,0.722222,0,1,29,9,false,false,true,0.862,0.138
44,70,-26,22,35,-26,965,1078,-113,0,0,0,0,85,2,2,0.435294,0,0,21,17,false,false,false,0.253,0.747
175,331,-156,9.722222,19.470588,-156,651,996,-345,0,2,0,0.117647,-10,18,17,-4.5,0,0,16,8,false,false,false,0,1
294,289,5,18.375,19.266667,5,985,1062,-77,0,0,0,0,-7,16,15,-5.285714,1,0,9,7,false,false,false,0.476,0.524
183,192,-9,15.25,17.454545,-9,1580,1629,-49,0,0,0,0,25,12,11,1.48,0,0,11,7,false,false,false,0.201,0.799
196,211,-15,14,16.230769,-15,361,413,-52,0,0,0,0,11,14,13,3.727273,1,0,14,7,false,false,false,0.427,0.573
215,214,1,19.545455,21.4,1,758,904,-146,1,0,0.090909,0,19,11,10,1.789474,0,1,9,6,false,false,false,0.025,0.975
124,104,20,24.8,26,20,1102,1245,-143,0,0,0,0,61,5,4,0.47541,0,0,13,12,false,false,false,0.375,0.625
335,345,-10,19.705882,20.294118,-10,786,885,-99,1,1,0.058824,0.058824,-6,17,17,-5.666667,0,0,2,1,true,false,false,0.012,0.988
141,183,-42,15.666667,20.333333,-42,306,361,-55,0,0,0,0,33,9,9,1.090909,0,1,8,6,false,false,false,0.013,0.987
297,428,-131,19.8,30.571429,-131,1636,1727,-91,0,2,0,0.142857,-12,15,14,-2.5,0,0,2,6,false,false,false,0,1
196,200,-4,28,28.571429,-4,1354,1210,144,0,1,0,0.142857,49,7,7,0.673469,0,0,13,9,false,false,false,0.221,0.779
161,200,-39,13.416667,16.666667,-39,1220,1202,18,0,0,0,0,24,12,12,2.083333,0,0,26,9,false,false,false,0.2,0.8
103,152,-49,17.166667,25.333333,-49,1193,1177,16,0,0,0,0,62,6,6,0.564516,0,0,9,8,false,false,false,0.197,0.803
128,118,10,21.333333,23.6,10,1110,1123,-13,0,1,0,0.2,52,6,5,0.634615,0,0,17,24,false,false,false,0.225,0.775
57,14,43,28.5,14,43,1556,1513,43,0,0,0,0,88,2,1,0.352273,0,0,16,7,false,false,true,0.71,0.29
16,24,-8,16,24,-8,897,996,-99,0,0,0,0,92,1,1,0.423913,0,0,12,8,false,false,false,0.289,0.711
174,221,-47,15.818182,20.090909,-47,360,371,-11,0,0,0,0,14,11,11,2.642857,1,0,9,11,false,false,false,0.35,0.65
244,289,-45,17.428571,22.230769,-45,691,704,-13,0,1,0,0.076923,9,14,13,4.222222,0,0,18,15,false,false,false,0,1
46,55,-9,11.5,13.75,-9,970,1030,-60,0,0,0,0,71,4,4,0.56338,0,1,25,11,false,false,false,0.269,0.731
191,186,5,14.692308,15.5,5,889,855,34,0,0,0,0,25,13,12,1.6,0,1,23,9,false,false,true,0.55,0.45
342,385,-43,24.428571,29.615385,-43,1086,926,160,0,2,0,0.153846,-12,14,13,-2.333333,0,0,5,1,false,false,false,0,1
120,236,-116,8.571429,16.857143,-116,1078,983,95,0,0,0,0,22,14,14,2.181818,1,1,7,14,false,false,false,0,1
180,211,-31,18,23.444444,-31,691,704,-13,0,1,0,0.111111,40,10,9,0.95,0,0,7,10,false,false,false,0.054,0.946
302,342,-40,15.894737,18,-40,480,518,-38,0,0,0,0,-19,19,19,-2.105263,0,0,2,1,false,false,false,0,1
83,75,8,13.833333,15,8,306,302,4,0,0,0,0,65,6,5,0.630769,0,0,13,10,false,false,false,0.287,0.713
224,232,-8,20.363636,23.2,-8,939,969,-30,0,0,0,0,20,11,10,1.65,0,0,17,7,false,false,false,0.268,0.732
86,38,48,43,19,48,595,733,-138,1,0,0.5,0,83,2,2,0.46988,0,1,19,9,false,false,false,0.046,0.954
199,233,-34,19.9,23.3,-34,804,1080,-276,0,0,0,0,30,10,10,1.133333,1,0,9,15,false,false,false,0.197,0.803
137,111,26,22.833333,18.5,26,1197,1156,41,0,0,0,0,59,6,6,0.59322,0,1,15,6,false,false,true,0.808,0.192
143,184,-41,14.3,20.444444,-41,500,509,-9,0,0,0,0,33,10,9,1.242424,0,0,26,10,false,false,false,0.052,0.948
77,92,-15,11,15.333333,-15,342,53,289,0,0,0,0,59,7,6,0.694915,0,0,9,20,false,false,false,0.205,0.795
271,324,-53,14.263158,17.052632,-53,1040,1091,-51,0,0,0,0,-18,19,19,-2.611111,0,0,11,6,false,false,false,0,1
106,104,2,11.777778,13,2,342,53,289,0,0,0,0,46,9,8,0.891304,1,0,15,16,false,false,true,0.663,0.337
44,65,-21,14.666667,21.666667,-21,563,523,40,0,0,0,0,80,3,3,0.4625,0,0,14,20,false,false,false,0.318,0.682
237,245,-8,16.928571,17.5,-8,840,1055,-215,0,0,0,0,5,14,14,7,0,0,10,7,false,false,false,0.245,0.755
41,53,-12,8.2,10.6,-12,925,1000,-75,0,0,0,0,64,5,5,0.6875,0,1,10,9,false,false,false,0.253,0.747
258,244,14,17.2,17.428571,14,1203,1270,-67,1,0,0.066667,0,17,15,14,2.588235,1,0,9,12,false,false,false,0.237,0.763
126,221,-95,14,24.555556,-95,1195,1397,-202,0,1,0,0.111111,42,9,9,0.952381,0,0,13,10,false,false,false,0.003,0.997
20,0,20,20,0,20,796,800,-4,0,0,0,0,97,1,0,0.494845,1,0,29,0,false,false,true,0.678,0.322
108,185,-77,18,30.833333,-77,1408,1539,-131,0,1,0,0.166667,53,6,6,0.641509,0,0,13,7,false,false,false,0.188,0.812
263,334,-71,18.785714,25.692308,-71,965,1078,-113,1,1,0.071429,0.076923,5,14,13,7.4,1,0,9,23,false,false,false,0,1
182,176,6,22.75,25.142857,6,1176,1133,43,1,0,0.125,0,54,8,7,0.62963,0,0,9,14,false,false,false,0.416,0.584
56,92,-36,11.2,23,-36,613,525,88,0,0,0,0,69,5,4,0.608696,0,1,18,7,false,false,false,0.146,0.854
288,282,6,16.941176,17.625,6,720,437,283,0,0,0,0,2,17,16,21,0,0,10,16,false,false,true,0.597,0.403
120,212,-92,10,19.272727,-92,651,996,-345,0,1,0,0.090909,20,12,11,2.25,0,2,26,5,false,false,false,0,1
18,13,5,9,13,5,917,856,61,0,0,0,0,89,2,1,0.370787,0,1,13,9,false,false,true,0.667,0.333
320,340,-20,13.913043,14.782609,-20,561,688,-127,0,0,0,0,-19,23,23,-2.421053,0,0,1,4,true,false,false,0.312,0.688
353,363,-10,23.533333,24.2,-10,1388,1366,22,0,1,0,0.066667,-8,15,15,-4,0,0,1,3,false,false,false,0.038,0.962
292,273,19,20.857143,19.5,19,1168,1216,-48,0,0,0,0,16,14,14,2.0625,1,1,6,8,false,false,false,0.238,0.762
238,269,-31,15.866667,17.933333,-31,970,1030,-60,0,0,0,0,3,15,15,13.333333,0,0,13,9,false,false,false,0.038,0.962
158,172,-14,17.555556,21.5,-14,1030,1014,16,0,0,0,0,45,9,8,0.733333,0,1,20,9,false,false,false,0.075,0.925
337,387,-50,18.722222,22.764706,-50,892,856,36,1,1,0.055556,0.058824,-26,18,17,-1.346154,0,0,3,1,true,false,false,0,1
351,387,-36,21.9375,24.1875,-36,1373,1334,39,1,2,0.0625,0.125,-9,16,16,-3.555556,1,0,3,4,true,false,false,0.008,0.992
278,336,-58,18.533333,24,-58,1047,1253,-206,1,1,0.066667,0.071429,5,15,14,7.4,1,0,7,17,false,false,false,0,1
330,346,-16,22,24.714286,-16,921,1045,-124,0,1,0,0.071429,2,15,14,17.5,0,1,4,21,false,false,false,0,1
42,29,13,14,14.5,13,977,1100,-123,0,0,0,0,80,3,2,0.5125,0,0,7,9,false,false,false,0.256,0.744
169,234,-65,24.142857,39,-65,1334,1486,-152,1,0,0.142857,0,58,7,6,0.5,0,0,11,15,false,false,false,0.002,0.998
74,156,-82,10.571429,26,-82,1699,1803,-104,0,0,0,0,70,7,6,0.5,0,0,7,12,false,false,false,0.035,0.965
92,104,-12,18.4,20.8,-12,694,658,36,0,0,0,0,65,5,5,0.569231,0,0,25,7,false,false,true,0.678,0.322
105,140,-35,17.5,28,-35,642,952,-310,0,0,0,0,61,6,5,0.721311,0,0,7,23,false,false,false,0.02,0.98
8,30,-22,4,15,-22,1269,1477,-208,0,0,0,0,90,2,2,0.388889,0,0,10,8,false,false,false,0.25,0.75
206,256,-50,20.6,28.444444,-50,1636,1796,-160,0,0,0,0,27,10,9,1,0,0,11,12,false,false,false,0.04,0.96
303,270,33,17.823529,15.882353,33,1193,1220,-27,1,0,0.058824,0,-7,17,17,-6.142857,0,0,21,13,false,false,true,0.999,0.001
80,0,80,80,0,80,1373,1334,39,1,0,1,0,93,1,0,0.344086,0,0,18,0,false,false,true,0.822,0.178
313,391,-78,18.411765,24.4375,-78,1269,1477,-208,1,0,0.058824,0,-11,17,16,-3.181818,0,0,4,1,false,false,false,0,1
388,465,-77,32.333333,38.75,-77,1777,1689,88,1,1,0.083333,0.083333,-5,12,12,-5.4,0,0,9,1,false,false,false,0,1
32,79,-47,10.666667,26.333333,-47,1101,1115,-14,0,0,0,0,83,3,3,0.361446,0,0,7,8,false,false,false,0.17,0.83
18,22,-4,9,11,-4,808,749,59,0,0,0,0,86,2,2,0.488372,0,1,12,17,false,false,false,0.477,0.523
94,210,-116,13.428571,30,-116,760,976,-216,0,1,0,0.142857,50,7,7,0.72,0,0,7,8,false,false,false,0,1
309,251,58,22.071429,19.307692,58,1331,1374,-43,0,0,0,0,1,14,13,33,0,0,14,12,false,false,true,1,0
290,302,-12,16.111111,16.777778,-12,970,1030,-60,0,1,0,0.055556,-19,18,18,-2.105263,1,0,3,7,false,false,false,0.465,0.535
275,354,-79,17.1875,23.6,-79,1633,1739,-106,1,0,0.0625,0,-9,16,15,-3.777778,0,0,2,16,false,false,false,0,1
32,51,-19,16,25.5,-19,1193,1177,16,0,0,0,0,85,2,2,0.411765,0,0,11,13,false,false,true,0.601,0.399
141,186,-45,23.5,31,-45,1554,1685,-131,0,1,0,0.166667,55,6,6,0.581818,0,0,18,7,false,false,false,0.207,0.793
325,334,-9,16.25,17.578947,-9,720,437,283,0,0,0,0,-14,20,19,-3,0,0,3,3,false,false,false,0,1
175,213,-38,17.5,21.3,-38,775,786,-11,0,0,0,0,29,10,10,1.482759,1,0,10,20,false,false,false,0.162,0.838
106,93,13,17.666667,18.6,13,889,895,-6,0,1,0,0.2,61,6,5,0.606557,0,0,9,15,false,false,true,0.522,0.478
16,0,16,16,0,16,797,796,1,0,0,0,0,97,1,0,0.505155,0,0,7,0,false,false,false,0.47,0.53
237,256,-19,15.8,18.285714,-19,561,688,-127,0,0,0,0,15,15,14,3.066667,0,0,14,13,false,false,false,0.087,0.913
184,158,26,26.285714,22.571429,26,540,498,42,1,0,0.142857,0,51,7,7,0.901961,0,0,9,21,false,false,false,0.483,0.517
86,133,-47,17.2,26.6,-47,518,461,57,0,0,0,0,66,5,5,0.545455,0,1,15,9,false,false,false,0.004,0.996
283,295,-12,28.3,29.5,-12,1047,1127,-80,0,1,0,0.1,14,10,10,1.928571,0,0,11,14,false,false,false,0.275,0.725
247,367,-120,19,30.583333,-120,1606,1890,-284,0,1,0,0.083333,5,13,12,5.6,1,0,10,13,false,false,false,0,1
298,371,-73,12.416667,16.130435,-73,595,412,183,0,1,0,0.043478,-19,24,23,-2.736842,0,0,10,11,false,false,false,0,1
71,81,-10,23.666667,40.5,-10,1439,1314,125,0,0,0,0,85,3,2,0.329412,0,0,12,8,false,false,false,0.218,0.782
230,254,-24,12.777778,14.941176,-24,808,749,59,0,0,0,0,-15,18,17,-2.8,0,0,6,8,false,false,false,0.08,0.92
235,342,-107,15.666667,24.428571,-107,342,263,79,0,0,0,0,-11,15,14,-3.090909,1,0,5,6,false,false,false,0,1
87,94,-7,17.4,18.8,-7,1691,1510,181,0,0,0,0,64,5,5,0.46875,0,0,16,16,false,false,false,0.312,0.688
216,164,52,18,14.909091,52,1344,1314,30,0,1,0,0.090909,25,12,11,1.36,0,1,10,24,false,false,false,0.401,0.599
180,329,-149,15,27.416667,-149,1484,1556,-72,0,2,0,0.166667,6,12,12,5.166667,1,0,26,16,false,false,false,0,1
149,113,36,21.285714,18.833333,36,1043,1003,40,0,0,0,0,54,7,6,0.703704,0,0,16,12,false,false,true,0.751,0.249
234,331,-97,15.6,22.066667,-97,341,416,-75,0,0,0,0,3,15,15,13,0,1,12,9,false,false,false,0,1
80,134,-54,13.333333,22.333333,-54,948,998,-50,0,0,0,0,55,6,6,0.672727,1,0,10,10,false,false,false,0.203,0.797
262,527,-265,17.466667,35.133333,-265,1632,2020,-388,0,3,0,0.2,-20,15,15,-1.55,0,0,4,2,false,false,false,0,1
108,151,-43,10.8,16.777778,-43,999,1165,-166,0,0,0,0,45,10,9,1.022222,0,0,22,10,false,false,false,0.04,0.96
146,109,37,20.857143,18.166667,37,1281,1268,13,0,0,0,0,56,7,6,0.75,0,0,12,13,false,false,true,0.719,0.281
237,501,-264,18.230769,41.75,-264,1632,2020,-388,0,2,0,0.166667,2,13,12,15.5,0,0,21,8,false,false,false,0,1
186,186,0,15.5,15.5,0,889,855,34,0,0,0,0,27,12,12,1.481481,0,1,23,9,false,false,true,0.71,0.29
241,262,-21,18.538462,21.833333,-21,1220,1185,35,0,1,0,0.083333,22,13,12,2.136364,0,0,17,20,false,false,false,0.187,0.813
256,292,-36,21.333333,24.333333,-36,1269,1477,-208,1,0,0.083333,0,19,12,12,1.842105,0,0,8,19,false,false,false,0.002,0.998
195,197,-2,16.25,17.909091,-2,430,542,-112,0,1,0,0.090909,24,12,11,2,0,0,27,11,false,false,true,0.654,0.346
30,44,-14,30,44,-14,1334,1486,-152,0,0,0,0,92,1,1,0.315217,0,1,13,11,false,false,false,0.03,0.97
230,247,-17,20.909091,24.7,-17,1645,1636,9,0,1,0,0.1,17,11,10,1.941176,0,0,17,11,false,false,false,0.153,0.847
261,329,-68,23.727273,32.9,-68,1586,1633,-47,1,0,0.090909,0,30,11,10,1.133333,0,1,13,8,false,false,false,0,1
190,186,4,21.111111,23.25,4,1168,1062,106,0,0,0,0,45,9,8,0.955556,0,0,12,11,false,false,false,0.203,0.797
218,332,-114,21.8,33.2,-114,1003,1004,-1,0,1,0,0.1,29,10,10,1.206897,0,1,7,9,false,false,false,0,1
66,100,-34,13.2,20,-34,952,826,126,0,0,0,0,74,5,5,0.581081,0,0,11,10,false,false,false,0.203,0.797
168,225,-57,21,28.125,-57,1126,1277,-151,0,0,0,0,36,8,8,0.972222,0,0,7,16,false,false,false,0.038,0.962
0,0,0,0,0,0,1127,995,132,0,0,0,0,100,1,0,0.33,0,0,11,0,false,false,true,0.677,0.323
29,36,-7,9.666667,18,-7,1636,1702,-66,0,0,0,0,85,3,2,0.341176,0,1,25,11,false,false,false,0.477,0.523
224,304,-80,18.666667,27.636364,-80,874,868,6,0,0,0,0,13,12,11,2.538462,0,0,13,18,false,false,false,0,1
33,103,-70,16.5,51.5,-70,1045,1100,-55,0,0,0,0,82,2,2,0.414634,0,1,13,10,false,false,false,0.005,0.995
210,278,-68,16.153846,23.166667,-68,1161,1176,-15,1,1,0.076923,0.083333,9,13,12,4.222222,0,0,9,19,false,false,false,0,1
286,285,1,19.066667,20.357143,1,540,498,42,1,0,0.066667,0,2,15,14,23,0,0,10,11,false,false,false,0.058,0.942
20,0,20,20,0,20,356,498,-142,0,0,0,0,96,1,0,0.364583,0,0,15,0,false,false,false,0.257,0.743
181,211,-30,25.857143,30.142857,-30,724,398,326,1,1,0.142857,0.142857,49,7,7,0.795918,0,0,8,9,false,false,false,0.255,0.745
236,265,-29,13.111111,14.722222,-29,163,346,-183,0,0,0,0,-25,18,18,-1.56,0,0,7,4,false,false,false,0.137,0.863
204,232,-28,20.4,23.2,-28,939,969,-30,0,0,0,0,22,10,10,1.5,0,0,13,7,false,false,false,0.238,0.762
239,450,-211,18.384615,34.615385,-211,842,926,-84,0,1,0,0.076923,-6,13,13,-5,0,0,12,5,false,false,false,0,1
42,64,-22,14,32,-22,1305,1211,94,0,0,0,0,86,3,2,0.383721,0,0,19,27,false,false,false,0.201,0.799
96,122,-26,12,15.25,-26,391,542,-151,1,0,0.125,0,45,8,8,1.022222,0,0,7,8,false,false,false,0.272,0.728
18,27,-9,18,27,-9,341,416,-75,0,0,0,0,92,1,1,0.423913,0,0,11,10,false,false,false,0.246,0.754
381,534,-153,31.75,48.545455,-153,1398,1431,-33,0,0,0,0,-11,12,11,-2.545455,0,0,2,18,false,false,false,0,1
329,339,-10,19.352941,21.1875,-10,1197,1156,41,0,1,0,0.0625,-12,17,16,-2.916667,0,0,1,1,false,false,false,0.007,0.993
92,73,19,18.4,18.25,19,1495,1597,-102,0,0,0,0,71,5,4,0.450704,0,0,12,16,false,false,false,0.491,0.509
235,274,-39,19.583333,22.833333,-39,971,800,171,0,1,0,0.083333,-1,12,12,-29,0,0,19,8,false,false,false,0.055,0.945
8,16,-8,8,16,-8,1037,1009,28,0,0,0,0,94,1,1,0.468085,0,0,11,8,false,false,true,0.677,0.323
233,300,-67,19.416667,27.272727,-67,835,786,49,0,0,0,0,7,12,11,4.857143,0,0,8,14,false,false,false,0,1
312,341,-29,18.352941,21.3125,-29,1075,878,197,0,1,0,0.0625,-10,17,16,-3.3,0,0,5,4,true,false,false,0,1
251,165,86,20.916667,15,86,742,594,148,0,0,0,0,25,12,11,1.56,1,1,10,14,false,false,true,0.996,0.004
195,251,-56,13.928571,17.928571,-56,1071,1000,71,0,0,0,0,13,14,14,3.615385,0,0,8,14,false,false,false,0.007,0.993
143,119,24,35.75,29.75,24,1436,1489,-53,1,0,0.25,0,71,4,4,0.521127,0,1,13,10,false,false,false,0.234,0.766
256,328,-72,16,20.5,-72,1432,1452,-20,0,1,0,0.0625,-11,16,16,-3.272727,1,0,2,17,false,false,false,0.002,0.998
16,0,16,16,0,16,1003,1018,-15,0,0,0,0,95,1,0,0.389474,0,0,14,0,false,false,true,0.659,0.341
136,131,5,17,18.714286,5,1037,1009,28,0,0,0,0,55,8,7,0.8,0,1,21,6,false,false,false,0.426,0.574
30,23,7,15,23,7,1003,1018,-15,0,0,0,0,87,2,1,0.425287,0,0,11,11,false,false,true,0.676,0.324
209,288,-79,16.076923,24,-79,1075,878,197,0,1,0,0.083333,21,13,12,1.571429,0,0,14,10,false,false,false,0,1
227,255,-28,16.214286,19.615385,-28,360,371,-11,0,0,0,0,-4,14,13,-9.25,0,0,7,9,false,false,false,0.122,0.878
352,428,-76,23.466667,28.533333,-76,1689,1777,-88,1,1,0.066667,0.066667,-15,15,15,-2,0,0,5,2,true,false,false,0,1
80,82,-2,20,20.5,-2,1071,1181,-110,0,0,0,0,75,4,4,0.453333,0,0,14,11,false,false,false,0.256,0.744
123,73,50,61.5,36.5,50,1436,1489,-53,1,0,0.5,0,82,2,2,0.45122,0,0,9,21,false,false,true,0.643,0.357
132,133,-1,22,22.166667,-1,621,786,-165,0,0,0,0,45,6,6,0.666667,0,0,11,10,false,false,false,0.254,0.746
276,366,-90,16.235294,22.875,-90,848,976,-128,0,1,0,0.0625,1,17,16,40,0,0,10,7,false,false,false,0,1
56,34,22,14,11.333333,22,1220,1185,35,0,0,0,0,75,4,3,0.626667,0,1,26,9,false,false,true,0.698,0.302
98,142,-44,8.166667,12.909091,-44,288,359,-71,0,0,0,0,40,12,11,0.675,0,0,15,12,false,false,false,0.039,0.961
14,21,-7,14,21,-7,689,804,-115,0,0,0,0,94,1,1,0.37234,0,0,10,12,false,false,false,0.251,0.749
395,539,-144,30.384615,41.461538,-144,1398,1431,-33,0,0,0,0,-18,13,13,-1.555556,0,0,1,10,false,false,false,0,1
229,296,-67,13.470588,17.411765,-67,1071,1000,71,0,0,0,0,-3,17,17,-15.666667,0,0,16,8,false,false,false,0,1
120,488,-368,7.058824,30.5,-368,1164,1149,15,0,3,0,0.1875,21,17,16,2.238095,0,1,12,9,false,false,false,0.001,0.999
50,114,-64,16.666667,38,-64,1315,1331,-16,0,0,0,0,77,3,3,0.428571,0,0,14,19,false,false,false,0.197,0.803
34,72,-38,17,72,-38,594,648,-54,0,1,0,1,87,2,1,0.45977,0,0,12,11,false,false,false,0.206,0.794
247,319,-72,16.466667,21.266667,-72,1037,1016,21,1,0,0.066667,0,16,15,15,3.625,1,0,16,8,false,false,false,0,1
63,72,-9,15.75,24,-9,1003,1004,-1,0,0,0,0,78,4,3,0.448718,0,0,24,13,false,false,true,0.628,0.372
180,148,32,18,16.444444,32,561,688,-127,0,0,0,0,43,10,9,1.069767,0,0,17,18,false,false,true,0.78,0.22
308,381,-73,23.692308,31.75,-73,1415,1361,54,0,1,0,0.083333,4,13,12,7.75,0,0,13,18,false,false,false,0,1
50,79,-29,10,15.8,-29,917,856,61,0,0,0,0,71,5,5,0.464789,0,1,17,6,false,false,false,0.344,0.656
67,70,-3,16.75,17.5,-3,603,721,-118,0,0,0,0,76,4,4,0.565789,0,1,16,15,false,false,false,0.242,0.758
98,102,-4,16.333333,17,-4,613,525,88,0,0,0,0,61,6,6,0.688525,0,1,10,6,false,false,true,0.676,0.324
294,335,-41,16.333333,18.611111,-41,1281,1268,13,0,0,0,0,-8,18,18,-5.25,0,0,4,4,false,false,false,0,1
119,146,-27,19.833333,29.2,-27,835,786,49,0,0,0,0,54,6,5,0.62963,0,1,17,10,false,false,false,0.041,0.959
263,155,108,18.785714,11.071429,108,1065,948,117,0,0,0,0,22,14,14,1.772727,0,0,8,15,false,false,true,1,0
247,316,-69,9.88,12.64,-69,1220,1202,18,0,0,0,0,-26,25,25,-1.923077,0,1,26,11,true,false,false,0,1
159,172,-13,19.875,24.571429,-13,1561,1495,66,1,0,0.125,0,38,8,7,0.868421,1,0,6,8,false,false,true,0.592,0.408
137,192,-55,19.571429,27.428571,-55,804,1080,-276,0,0,0,0,48,7,7,0.708333,0,0,10,19,false,false,false,0.043,0.957
218,266,-48,18.166667,22.166667,-48,1417,1482,-65,0,1,0,0.083333,26,12,12,1.269231,0,1,16,13,false,false,false,0.02,0.98
214,285,-71,11.263158,15.833333,-71,595,540,55,0,0,0,0,-8,19,18,-5.375,0,0,9,15,false,false,false,0,1
117,150,-33,14.625,21.428571,-33,1302,1351,-49,0,0,0,0,48,8,7,0.770833,0,0,13,12,false,false,false,0.164,0.836
160,157,3,17.777778,19.625,3,1407,1473,-66,0,1,0,0.125,41,9,8,0.756098,0,0,7,11,false,false,false,0.209,0.791
213,299,-86,16.384615,23,-86,1071,1181,-110,0,0,0,0,15,13,13,2.266667,0,0,23,13,false,false,false,0,1
109,200,-91,13.625,25,-91,563,523,40,0,0,0,0,47,8,8,0.787234,0,1,7,11,false,false,false,0.001,0.999
55,37,18,13.75,12.333333,18,1037,913,124,0,0,0,0,85,4,3,0.447059,1,0,8,26,false,false,false,0.295,0.705
12,0,12,12,0,12,668,363,305,0,0,0,0,96,1,0,0.489583,0,0,12,0,false,false,true,0.695,0.305
185,240,-55,18.5,26.666667,-55,1656,1580,76,0,1,0,0.111111,33,10,9,1,2,0,8,7,false,false,false,0.031,0.969
122,20,102,61,20,102,1373,1334,39,1,0,0.5,0,85,2,1,0.376471,0,0,12,10,false,false,true,0.848,0.152
229,391,-162,20.818182,35.545455,-162,1636,1727,-91,0,2,0,0.181818,12,11,11,2.5,1,0,11,23,false,false,false,0,1
62,44,18,20.666667,22,18,1556,1616,-60,0,0,0,0,85,3,2,0.341176,0,0,11,16,false,false,true,0.666,0.334
231,279,-48,13.588235,17.4375,-48,813,698,115,1,0,0.058824,0,6,17,16,8,0,0,8,11,false,false,false,0,1
286,349,-63,19.066667,24.928571,-63,1110,1399,-289,0,1,0,0.071429,10,15,14,3.4,1,0,6,11,false,false,false,0.008,0.992
109,163,-54,12.111111,20.375,-54,1071,1000,71,0,0,0,0,51,9,8,0.921569,1,1,6,8,false,false,false,0.007,0.993
67,73,-6,13.4,18.25,-6,726,818,-92,0,0,0,0,67,5,4,0.522388,0,0,11,15,false,false,false,0.247,0.753
278,442,-164,14.631579,24.555556,-164,1422,1510,-88,0,2,0,0.111111,-16,19,18,-2.4375,0,0,5,2,false,false,false,0,1
188,209,-21,14.461538,16.076923,-21,970,1030,-60,0,0,0,0,15,13,13,2.666667,0,0,17,8,false,false,false,0.099,0.901
111,109,2,18.5,21.8,2,1075,878,197,0,0,0,0,65,6,5,0.507692,0,0,9,9,false,false,false,0.21,0.79
212,238,-26,13.25,15.866667,-26,163,346,-183,0,0,0,0,-8,16,15,-4.875,0,0,21,8,false,false,false,0.136,0.864
274,444,-170,11.913043,20.181818,-170,1078,983,95,1,0,0.043478,0,-31,23,22,-1.548387,0,0,1,4,false,false,false,0,1
231,288,-57,11.55,15.157895,-57,391,542,-151,1,0,0.05,0,-24,20,19,-1.916667,0,0,7,16,false,false,false,0,1
187,152,35,15.583333,13.818182,35,671,638,33,0,0,0,0,22,12,11,2.227273,0,0,16,22,false,false,true,0.833,0.167
137,190,-53,13.7,19,-53,1182,1075,107,0,1,0,0.1,28,10,10,1.392857,0,1,24,6,false,false,false,0.046,0.954
193,224,-31,12.866667,16,-31,808,749,59,0,0,0,0,2,15,14,21,0,0,11,11,false,false,false,0.162,0.838
112,211,-99,18.666667,35.166667,-99,976,995,-19,0,1,0,0.166667,56,6,6,0.678571,0,0,16,16,false,false,false,0.015,0.985
209,177,32,17.416667,14.75,32,720,437,283,0,0,0,0,33,12,12,1.272727,1,0,13,18,false,false,true,0.791,0.209
343,444,-101,20.176471,26.117647,-101,1334,1439,-105,1,1,0.058824,0.058824,-8,17,17,-4.5,0,0,3,2,false,false,false,0,1
34,0,34,34,0,34,892,856,36,0,0,0,0,95,1,0,0.368421,0,0,12,0,false,false,true,0.72,0.28
10,26,-16,10,26,-16,1432,1452,-20,0,0,0,0,90,1,1,0.4,0,0,9,11,false,false,true,0.627,0.373
384,388,-4,22.588235,24.25,-4,1552,1803,-251,3,0,0.176471,0,-15,17,16,-2.2,0,0,7,2,true,false,false,0.39,0.61
266,440,-174,20.461538,33.846154,-174,1003,1004,-1,0,2,0,0.153846,6,13,13,5.833333,0,0,7,9,false,false,false,0,1
188,177,11,20.888889,22.125,11,921,1045,-124,0,0,0,0,38,9,8,0.921053,0,0,17,9,false,false,false,0.259,0.741
147,280,-133,14.7,28,-133,710,758,-48,0,1,0,0.1,36,10,10,1.027778,0,0,12,14,false,false,false,0,1
43,38,5,14.333333,12.666667,5,758,791,-33,0,0,0,0,79,3,3,0.493671,0,0,15,10,false,false,true,0.51,0.49
178,180,-2,29.666667,30,-2,1770,1751,19,0,1,0,0.166667,43,6,6,0.674419,0,0,11,23,false,false,false,0.201,0.799
92,170,-78,13.142857,24.285714,-78,342,263,79,0,0,0,0,47,7,7,0.723404,0,0,7,19,false,false,false,0.03,0.97
76,78,-2,15.2,15.6,-2,526,502,24,0,0,0,0,70,5,5,0.714286,0,0,19,14,false,false,false,0.416,0.584
184,348,-164,14.153846,29,-164,1399,1210,189,0,1,0,0.083333,18,13,12,1.944444,0,0,20,8,false,false,false,0.025,0.975
141,202,-61,15.666667,25.25,-61,822,845,-23,0,0,0,0,46,9,8,0.76087,1,0,21,8,false,false,false,0.013,0.987
237,328,-91,16.928571,25.230769,-91,1270,1424,-154,0,2,0,0.153846,9,14,13,3.888889,0,0,22,10,false,false,false,0,1
285,427,-142,16.764706,26.6875,-142,1315,1334,-19,0,2,0,0.125,-15,17,16,-2.4,0,0,1,4,false,false,false,0,1
66,108,-42,33,54,-42,2147,2219,-72,0,1,0,0.5,80,2,2,0.3,0,1,9,7,false,false,true,0.52,0.48
116,139,-23,16.571429,19.857143,-23,599,448,151,0,0,0,0,50,7,7,0.72,0,1,16,6,false,false,false,0.291,0.709
29,45,-16,9.666667,22.5,-16,907,1070,-163,0,0,0,0,83,3,2,0.421687,0,0,22,9,false,false,false,0.251,0.749
354,360,-6,23.6,24,-6,1407,1473,-66,1,2,0.066667,0.133333,-14,15,15,-2.214286,0,0,4,6,false,false,false,0.37,0.63
323,425,-102,26.916667,35.416667,-102,2143,2219,-76,1,0,0.083333,0,2,12,12,15.5,0,0,7,7,false,false,false,0,1
218,363,-145,16.769231,30.25,-145,1045,1100,-55,0,1,0,0.083333,14,13,12,2.428571,0,0,12,15,false,false,false,0,1
58,118,-60,14.5,29.5,-60,1633,1620,13,0,0,0,0,72,4,4,0.5,0,0,16,11,false,false,false,0.201,0.799
213,226,-13,16.384615,18.833333,-13,1176,1211,-35,0,0,0,0,6,13,12,5.5,1,0,13,26,false,false,false,0.423,0.577
277,320,-43,16.294118,18.823529,-43,561,688,-127,0,0,0,0,-1,17,17,-46,0,0,7,14,false,false,false,0,1
117,153,-36,13,19.125,-36,668,363,305,0,0,0,0,49,9,8,0.959184,0,0,8,9,false,false,false,0.14,0.86
160,233,-73,12.307692,17.923077,-73,226,361,-135,0,0,0,0,9,13,13,4.888889,0,0,9,11,false,false,false,0,1
312,345,-33,20.8,24.642857,-33,1417,1482,-65,0,1,0,0.071429,8,15,14,4.125,0,1,7,7,false,false,false,0,1
29,5,24,14.5,5,24,1003,1004,-1,0,0,0,0,89,2,1,0.393258,0,0,17,28,false,false,false,0.375,0.625
211,253,-42,19.181818,25.3,-42,971,800,171,0,1,0,0.1,9,11,10,3.222222,0,0,25,10,false,false,false,0.044,0.956
132,130,2,18.857143,18.571429,2,387,683,-296,0,0,0,0,46,7,7,0.73913,1,0,10,9,false,false,true,0.645,0.355
310,418,-108,20.666667,27.866667,-108,1334,1439,-105,1,1,0.066667,0.066667,6,15,15,6,0,0,8,10,false,false,false,0,1
212,220,-8,16.307692,16.923077,-8,480,518,-38,0,0,0,0,12,13,13,3.333333,0,0,19,19,false,false,false,0.231,0.769
146,139,7,14.6,15.444444,7,361,413,-52,0,0,0,0,39,10,9,1.051282,1,0,11,8,false,false,true,0.66,0.34
167,302,-135,13.916667,25.166667,-135,342,263,79,0,0,0,0,8,12,12,4.25,0,0,20,8,false,false,false,0,1
132,155,-23,10.153846,12.916667,-23,925,1000,-75,0,0,0,0,23,13,12,1.913043,0,0,16,17,false,false,false,0.039,0.961
111,135,-24,18.5,22.5,-24,1407,1473,-66,0,1,0,0.166667,57,6,6,0.54386,0,0,12,8,false,false,false,0.245,0.755
266,360,-94,16.625,24,-94,595,733,-138,1,1,0.0625,0.066667,-10,16,15,-3.9,0,1,23,10,false,false,false,0,1
291,392,-101,24.25,32.666667,-101,1388,1455,-67,0,0,0,0,1,12,12,28,1,0,16,9,false,false,false,0,1
139,226,-87,9.928571,16.142857,-87,818,826,-8,0,0,0,0,28,14,14,1.892857,1,0,6,14,false,false,false,0.016,0.984
222,379,-157,13.058824,22.294118,-157,760,976,-216,0,1,0,0.058824,-20,17,17,-1.8,0,0,1,15,false,false,false,0,1
169,240,-71,14.083333,20,-71,813,698,115,1,0,0.083333,0,31,12,12,1.548387,0,1,18,6,false,false,false,0,1
87,113,-26,17.4,22.6,-26,926,973,-47,0,0,0,0,62,5,5,0.564516,0,1,7,8,false,false,false,0.212,0.788
354,444,-90,19.666667,24.666667,-90,1334,1439,-105,1,1,0.055556,0.055556,-11,18,18,-3.272727,0,0,3,2,true,false,false,0,1
284,310,-26,25.818182,31,-26,1253,1324,-71,0,1,0,0.1,17,11,10,1.705882,0,0,18,10,false,false,false,0.19,0.81
101,182,-81,14.428571,26,-81,563,523,40,0,0,0,0,53,7,7,0.698113,0,0,7,14,false,false,false,0.027,0.973
214,212,2,21.4,23.555556,2,694,658,36,0,1,0,0.111111,33,10,9,1.121212,0,0,14,10,false,false,true,0.527,0.473
291,302,-11,13.857143,14.380952,-11,796,800,-4,1,0,0.047619,0,-12,21,21,-4,0,1,12,6,false,false,false,0,1
86,76,10,21.5,25.333333,10,450,503,-53,0,0,0,0,73,4,3,0.534247,0,0,13,13,false,false,false,0.255,0.745
55,49,6,13.75,16.333333,6,726,818,-92,0,0,0,0,76,4,3,0.460526,0,0,8,7,false,false,false,0.253,0.747
306,314,-8,25.5,28.545455,-8,1770,1745,25,2,0,0.166667,0,18,12,11,1.833333,0,0,14,7,false,false,false,0.188,0.812
46,84,-38,15.333333,28,-38,1055,1019,36,0,0,0,0,76,3,3,0.434211,1,0,6,16,false,false,false,0.256,0.744
166,263,-97,18.444444,29.222222,-97,1110,1399,-289,0,1,0,0.111111,38,9,9,0.894737,0,0,23,9,false,false,false,0,1
277,332,-55,27.7,36.888889,-55,1770,1751,19,0,1,0,0.111111,21,10,9,1.380952,0,0,8,10,false,false,false,0.004,0.996
266,392,-126,17.733333,28,-126,1572,1777,-205,0,2,0,0.142857,-11,15,14,-3,0,0,16,4,false,false,false,0,1
56,33,23,18.666667,16.5,23,1168,1062,106,0,0,0,0,82,3,2,0.52439,0,1,7,16,false,false,true,0.635,0.365
284,359,-75,14.947368,19.944444,-75,341,416,-75,0,0,0,0,-20,19,18,-1.95,0,0,1,1,false,false,false,0,1
199,337,-138,15.307692,25.923077,-138,1193,1177,16,0,1,0,0.076923,16,13,13,2.1875,0,0,14,9,false,false,false,0,1
110,177,-67,18.333333,29.5,-67,700,820,-120,0,1,0,0.166667,54,6,6,0.703704,0,0,14,7,false,false,false,0.045,0.955
237,249,-12,16.928571,19.153846,-12,615,542,73,0,0,0,0,16,14,13,2.625,0,0,7,9,false,false,false,0.257,0.743
259,376,-117,16.1875,23.5,-117,935,995,-60,1,1,0.0625,0.0625,-5,16,16,-7.8,0,0,16,7,false,false,false,0,1
27,38,-11,9,19,-11,1368,1452,-84,0,0,0,0,88,3,2,0.363636,1,0,7,13,false,false,false,0.278,0.722
216,179,37,27,25.571429,37,1770,1745,25,1,0,0.125,0,51,8,7,0.647059,0,0,10,12,false,false,true,0.703,0.297
175,84,91,35,21,91,1777,1689,88,1,0,0.2,0,56,5,4,0.482143,0,0,22,9,false,false,true,0.849,0.151
122,164,-42,13.555556,18.222222,-42,1040,1364,-324,0,0,0,0,34,9,9,1.058824,0,0,18,12,false,false,false,0.235,0.765
53,59,-6,13.25,19.666667,-6,683,859,-176,0,0,0,0,78,4,3,0.576923,1,1,12,17,false,false,false,0.021,0.979
10,33,-23,10,33,-23,965,1078,-113,0,0,0,0,92,1,1,0.402174,0,0,25,19,false,false,false,0.253,0.747
47,45,2,15.666667,15,2,889,855,34,0,0,0,0,82,3,3,0.487805,0,0,11,11,false,false,true,0.678,0.322
307,391,-84,18.058824,23,-84,835,786,49,0,0,0,0,-28,17,17,-1.214286,0,0,1,1,true,false,false,0,1
279,463,-184,18.6,30.866667,-184,1003,1004,-1,0,2,0,0.133333,-5,15,15,-7,0,0,7,3,false,false,false,0,1
186,198,-12,15.5,18,-12,797,796,1,0,0,0,0,34,12,11,1.441176,1,0,11,19,false,false,false,0.175,0.825
68,117,-49,13.6,23.4,-49,1580,1629,-49,0,0,0,0,67,5,5,0.552239,0,0,15,7,false,false,false,0.205,0.795
47,56,-9,11.75,14,-9,808,749,59,0,0,0,0,69,4,4,0.608696,0,1,11,16,false,false,true,0.56,0.44
8,69,-61,8,69,-61,518,414,104,0,1,0,1,90,1,1,0.422222,0,0,15,9,false,false,false,0.192,0.808
173,116,57,34.6,29,57,1167,1245,-78,1,0,0.2,0,59,5,4,0.474576,0,0,9,19,false,false,true,0.772,0.228
222,203,19,24.666667,25.375,19,1237,1265,-28,1,0,0.111111,0,32,9,8,1.125,0,0,9,7,false,false,true,0.691,0.309
303,321,-18,15.947368,16.894737,-18,1161,1030,131,0,1,0,0.052632,-24,19,19,-1.583333,0,0,2,1,true,false,false,0.01,0.99
154,97,57,19.25,13.857143,57,771,668,103,0,0,0,0,39,8,7,0.974359,0,0,7,11,false,false,true,0.889,0.111
84,70,14,21,17.5,14,387,683,-296,0,0,0,0,67,4,4,0.507463,1,0,13,10,false,false,true,0.65,0.35
86,144,-58,17.2,28.8,-58,452,698,-246,0,1,0,0.2,64,5,5,0.640625,0,0,22,9,false,false,false,0.244,0.756
109,182,-73,13.625,26,-73,563,523,40,0,0,0,0,50,8,7,0.74,0,0,7,14,false,false,false,0.019,0.981
213,278,-65,26.625,34.75,-65,1761,1770,-9,0,1,0,0.125,31,8,8,0.83871,1,0,6,16,false,false,false,0.032,0.968
184,223,-39,13.142857,15.928571,-39,163,346,-183,0,0,0,0,4,14,14,9.75,0,0,12,7,false,false,false,0.384,0.616
144,216,-72,14.4,21.6,-72,1064,1397,-333,0,2,0,0.2,48,10,10,0.895833,1,0,22,7,false,false,false,0.055,0.945
279,325,-46,12.130435,14.772727,-46,1071,1000,71,0,0,0,0,-29,23,22,-1.62069,0,0,1,1,false,false,false,0,1
238,248,-10,19.833333,20.666667,-10,758,904,-146,1,0,0.083333,0,7,12,12,4.857143,0,1,10,9,false,false,false,0.03,0.97
189,129,60,21,16.125,60,1197,1156,41,0,0,0,0,45,9,8,0.777778,0,1,15,6,false,false,true,0.864,0.136
95,70,25,23.75,23.333333,25,1691,1551,140,0,0,0,0,73,4,3,0.506849,0,0,10,21,false,false,false,0.214,0.786
284,299,-15,23.666667,24.916667,-15,1070,814,256,1,1,0.083333,0.083333,9,12,12,3.666667,0,0,9,14,false,false,false,0.063,0.937
125,135,-10,17.857143,19.285714,-10,758,791,-33,0,0,0,0,50,7,7,0.78,0,1,12,10,false,false,false,0.232,0.768
62,32,30,20.666667,16,30,388,542,-154,0,0,0,0,76,3,2,0.486842,0,0,16,17,false,false,false,0.278,0.722
115,173,-58,12.777778,21.625,-58,917,856,61,0,1,0,0.125,48,9,8,0.6875,0,1,21,9,false,false,false,0.177,0.823
158,65,93,31.6,16.25,93,1101,1237,-136,1,0,0.2,0,65,5,4,0.523077,0,1,8,7,false,false,false,0.471,0.529
220,319,-99,12.222222,17.722222,-99,388,542,-154,0,0,0,0,-17,18,18,-2.176471,0,1,4,2,false,false,false,0,1
258,299,-41,11.727273,14.238095,-41,683,859,-176,0,0,0,0,-2,22,21,-22.5,0,0,9,17,false,false,false,0,1
62,65,-3,15.5,21.666667,-3,1229,1220,9,0,0,0,0,73,4,3,0.506849,0,1,13,19,false,false,false,0.225,0.775
362,348,14,18.1,17.4,14,907,910,-3,0,1,0,0.05,-16,20,20,-2.6875,0,0,6,4,false,false,true,0.999,0.001
334,364,-30,14.521739,15.826087,-30,1220,1185,35,0,1,0,0.043478,-25,23,23,-1.88,0,0,8,4,false,false,false,0,1
336,372,-36,17.684211,19.578947,-36,1473,1500,-27,1,2,0.052632,0.105263,-31,19,19,-1.258065,0,0,1,1,false,false,false,0,1
56,175,-119,9.333333,29.166667,-119,1101,1130,-29,0,1,0,0.166667,60,6,6,0.75,0,0,7,13,false,false,false,0,1
153,159,-6,17,17.666667,-6,1580,1629,-49,0,0,0,0,36,9,9,1.027778,0,0,18,9,false,false,false,0.301,0.699
88,140,-52,17.6,28,-52,954,939,15,0,0,0,0,60,5,5,0.6,0,0,13,17,false,false,false,0.197,0.803
221,316,-95,22.1,35.111111,-95,1633,1680,-47,0,1,0,0.111111,17,10,9,1.647059,1,0,7,9,false,false,false,0.027,0.973
14,0,14,14,0,14,1305,1211,94,0,0,0,0,96,1,0,0.34375,0,0,12,0,false,false,true,0.679,0.321
264,292,-28,20.307692,24.333333,-28,689,804,-115,0,0,0,0,9,13,12,3.888889,0,1,7,7,false,false,false,0.003,0.997
180,238,-58,16.363636,21.636364,-58,822,845,-23,0,0,0,0,28,11,11,1.25,1,0,15,12,false,false,false,0.047,0.953
260,296,-36,26,32.888889,-36,1554,1685,-131,0,1,0,0.111111,29,10,9,1.103448,0,1,12,13,false,false,false,0.036,0.964
156,204,-48,26,40.8,-48,1388,1455,-67,0,0,0,0,50,6,5,0.56,1,0,14,10,false,false,false,0.154,0.846
211,272,-61,17.583333,24.727273,-61,700,820,-120,0,1,0,0.090909,19,12,11,2,0,0,14,10,false,false,false,0,1
303,467,-164,21.642857,33.357143,-164,1554,1685,-131,0,2,0,0.142857,-5,14,14,-6.4,0,0,6,3,false,false,false,0,1
122,79,43,24.4,19.75,43,691,704,-13,0,0,0,0,70,5,4,0.542857,0,0,7,9,false,false,true,0.74,0.26
255,347,-92,25.5,34.7,-92,1415,1361,54,0,1,0,0.1,22,10,10,1.409091,0,0,10,18,false,false,false,0,1
50,101,-51,12.5,25.25,-51,1101,1115,-14,0,0,0,0,75,4,4,0.4,0,0,17,14,false,false,false,0.126,0.874
124,136,-12,20.666667,22.666667,-12,796,800,-4,0,0,0,0,62,6,6,0.774194,0,0,10,13,false,false,false,0.229,0.771
176,192,-16,19.555556,21.333333,-16,1493,1413,80,0,0,0,0,40,9,9,0.9,0,1,16,13,false,false,false,0.201,0.799
133,143,-10,13.3,15.888889,-10,977,1100,-123,0,0,0,0,50,10,9,0.82,0,0,18,9,false,false,false,0.075,0.925
262,318,-56,13.1,16.736842,-56,1071,1000,71,0,0,0,0,-18,20,19,-2.611111,0,0,3,4,false,false,false,0,1
275,370,-95,17.1875,24.666667,-95,563,523,40,0,0,0,0,-4,16,15,-9.25,0,0,8,7,false,false,false,0,1
316,366,-50,21.066667,24.4,-50,1030,1014,16,0,1,0,0.066667,-3,15,15,-11,0,0,6,3,false,false,false,0,1
33,9,24,16.5,9,24,1484,1556,-72,0,0,0,0,86,2,1,0.360465,0,0,10,12,false,false,true,0.676,0.324
290,328,-38,20.714286,23.428571,-38,1237,1265,-28,1,0,0.071429,0,-7,14,14,-5.142857,0,0,7,13,false,false,false,0,1
291,289,2,15.315789,15.210526,2,796,800,-4,1,0,0.052632,0,-6,19,19,-8,0,1,12,8,false,false,false,0.002,0.998
25,70,-45,12.5,70,-45,1576,1556,20,0,1,0,1,88,2,1,0.340909,0,0,13,15,false,false,false,0.196,0.804
344,342,2,15.636364,16.285714,2,1193,1220,-27,1,0,0.045455,0,-29,22,21,-1.482759,0,0,2,1,true,false,true,0.809,0.191
174,272,-98,15.818182,24.727273,-98,700,820,-120,0,1,0,0.090909,24,11,11,1.583333,1,0,22,10,false,false,false,0.009,0.991
108,164,-56,15.428571,23.428571,-56,518,461,57,0,0,0,0,54,7,7,0.666667,0,1,16,15,false,false,false,0.003,0.997
83,96,-13,9.222222,10.666667,-13,925,1000,-75,0,0,0,0,45,9,9,0.977778,0,1,11,20,false,false,false,0.042,0.958
129,145,-16,16.125,20.714286,-16,840,1055,-215,0,0,0,0,51,8,7,0.686275,0,0,12,9,false,false,false,0.244,0.756
188,218,-30,12.533333,14.533333,-30,342,53,289,0,0,0,0,-4,15,15,-10.25,0,0,10,22,false,false,false,0.107,0.893
26,12,14,13,12,14,1161,1176,-15,0,0,0,0,88,2,1,0.431818,0,0,17,8,false,false,true,0.678,0.322
233,289,-56,15.533333,20.642857,-56,952,826,126,0,1,0,0.071429,13,15,14,3.307692,0,0,13,17,false,false,false,0,1
281,310,-29,11.708333,13.478261,-29,542,390,152,1,0,0.041667,0,-21,24,23,-2.380952,0,0,2,7,false,false,false,0,1
276,301,-25,21.230769,25.083333,-25,1093,1100,-7,2,0,0.153846,0,19,13,12,1.631579,0,0,11,7,false,false,false,0,1
197,226,-29,16.416667,18.833333,-29,1176,1211,-35,0,0,0,0,10,12,12,3.3,1,0,7,26,false,false,false,0.252,0.748
312,343,-31,17.333333,20.176471,-31,952,870,82,0,0,0,0,-22,18,17,-1.681818,0,0,4,3,false,false,false,0,1
101,138,-37,20.2,27.6,-37,965,1078,-113,0,0,0,0,63,5,5,0.587302,0,0,8,13,false,false,false,0.117,0.883
264,326,-62,22,27.166667,-62,1274,1394,-120,0,1,0,0.083333,6,12,12,5,0,0,15,17,false,false,false,0,1
242,301,-59,18.615385,25.083333,-59,1572,1777,-205,0,1,0,0.083333,3,13,12,11,0,1,21,6,false,false,false,0.001,0.999
230,262,-32,16.428571,18.714286,-32,1312,1334,-22,0,0,0,0,1,14,14,39,0,0,14,9,false,false,false,0.167,0.833
269,323,-54,20.692308,24.846154,-54,1269,1477,-208,1,0,0.076923,0,13,13,13,2.692308,0,0,7,10,false,false,false,0,1
24,0,24,24,0,24,1422,1798,-376,0,0,0,0,95,1,0,0.336842,0,0,10,0,false,false,false,0.251,0.749
12,9,3,12,9,3,1484,1556,-72,0,0,0,0,90,1,1,0.344444,0,0,8,12,false,false,true,0.671,0.329
127,148,-21,14.111111,18.5,-21,1000,960,40,0,0,0,0,46,9,8,0.978261,1,0,8,16,false,false,false,0.2,0.8
0,0,0,0,0,0,1576,1556,20,0,0,0,0,100,1,0,0.3,0,0,12,0,false,false,true,0.677,0.323
256,278,-22,23.272727,27.8,-22,1439,1314,125,0,0,0,0,18,11,10,1.555556,0,0,13,7,false,false,false,0.157,0.843
274,375,-101,19.571429,28.846154,-101,1334,1439,-105,1,1,0.071429,0.076923,14,14,13,2.571429,0,0,10,11,false,false,false,0,1
109,241,-132,15.571429,40.166667,-132,2143,2219,-76,0,0,0,0,52,7,6,0.596154,0,0,19,20,false,false,false,0,1
16,0,16,16,0,16,1552,1803,-251,0,0,0,0,97,1,0,0.340206,0,0,14,0,false,false,false,0.251,0.749
65,75,-10,13,15,-10,814,830,-16,0,0,0,0,66,5,5,0.621212,0,0,14,12,false,false,true,0.588,0.412
40,29,11,20,14.5,11,1399,1210,189,0,0,0,0,85,2,2,0.411765,0,1,11,11,false,false,true,0.656,0.344
125,73,52,31.25,24.333333,52,1237,1265,-28,1,0,0.25,0,66,4,3,0.545455,0,0,26,19,false,false,true,0.752,0.248
157,189,-32,19.625,27,-32,1636,1796,-160,0,0,0,0,42,8,7,0.642857,0,0,10,14,false,false,false,0.046,0.954
201,234,-33,15.461538,18,-33,402,448,-46,0,0,0,0,14,13,13,2.642857,0,1,17,14,false,false,false,0.017,0.983
54,88,-34,10.8,17.6,-34,1344,1314,30,0,1,0,0.2,66,5,5,0.515152,0,0,12,8,false,false,false,0.203,0.797
84,108,-24,16.8,27,-24,935,995,-60,0,0,0,0,72,5,4,0.541667,2,0,14,9,false,false,false,0.29,0.71
112,188,-76,18.666667,37.6,-76,1656,1649,7,0,0,0,0,55,6,5,0.581818,0,0,9,11,false,false,false,0.062,0.938
384,385,-1,24,25.666667,-1,1552,1803,-251,3,0,0.1875,0,-12,16,15,-2.75,0,0,7,2,false,false,false,0.319,0.681
211,222,-11,14.066667,15.857143,-11,526,502,24,0,0,0,0,14,15,14,3.571429,0,0,10,13,false,false,false,0.165,0.835
255,317,-62,13.421053,16.684211,-62,925,1000,-75,0,0,0,0,-19,19,19,-2.315789,0,0,13,3,false,false,false,0,1
291,256,35,22.384615,19.692308,35,1488,1428,60,1,0,0.076923,0,15,13,13,2.466667,0,1,16,7,false,false,true,0.936,0.064
0,12,-12,0,12,-12,1047,1253,-206,0,0,0,0,96,1,1,0.385417,1,0,12,12,false,false,false,0.251,0.749
98,102,-4,19.6,20.4,-4,796,800,-4,0,0,0,0,69,5,5,0.695652,0,0,10,10,false,false,true,0.513,0.487
305,340,-35,20.333333,22.666667,-35,1452,1388,64,0,1,0,0.066667,-3,15,15,-11.666667,0,0,13,7,false,false,false,0,1
145,133,12,29,26.6,12,1237,1265,-28,1,0,0.2,0,54,5,5,0.666667,0,0,27,11,false,false,true,0.684,0.316
199,239,-40,24.875,29.875,-40,1071,1065,6,0,0,0,0,30,8,8,1.033333,0,0,17,13,false,false,false,0.203,0.797
199,172,27,18.090909,17.2,27,561,688,-127,0,0,0,0,38,11,10,1.210526,0,0,14,9,false,false,true,0.778,0.222
318,339,-21,24.461538,28.25,-21,1173,1256,-83,2,0,0.153846,0,9,13,12,3.444444,0,1,8,8,false,false,false,0,1
202,282,-80,20.2,31.333333,-80,1606,1593,13,0,1,0,0.111111,26,10,9,1.115385,0,0,7,13,false,false,false,0,1
14,0,14,14,0,14,594,648,-54,0,0,0,0,96,1,0,0.416667,0,0,15,0,false,false,false,0.254,0.746
182,111,71,45.5,37,71,169,306,-137,2,1,0.5,0.333333,57,4,3,0.54386,0,0,14,20,false,false,false,0.278,0.722
246,204,42,16.4,14.571429,42,897,996,-99,0,0,0,0,10,15,14,3.9,0,1,14,15,false,false,true,0.656,0.344
212,285,-73,11.777778,15.833333,-73,595,540,55,0,0,0,0,-6,18,18,-7.166667,0,0,10,15,false,false,false,0,1
154,168,-14,15.4,16.8,-14,1312,1334,-22,0,0,0,0,27,10,10,1.444444,0,0,25,10,false,false,false,0.274,0.726
87,88,-1,14.5,17.6,-1,360,371,-11,0,0,0,0,60,6,5,0.616667,0,0,18,11,false,false,false,0.303,0.697
68,36,32,68,36,32,1488,1428,60,1,0,1,0,91,1,1,0.406593,0,0,14,8,false,false,true,0.915,0.085
115,25,90,38.333333,12.5,90,1341,1606,-265,1,0,0.333333,0,76,3,2,0.434211,0,0,16,11,false,false,false,0.477,0.523
265,319,-54,16.5625,21.266667,-54,795,786,9,1,0,0.0625,0,5,16,15,7.6,1,0,9,14,false,false,false,0,1
216,144,72,21.6,16,72,675,570,105,0,0,0,0,31,10,9,1.129032,0,0,11,21,false,false,true,0.969,0.031
0,0,0,0,0,0,1038,917,121,0,0,0,0,100,1,0,0.35,0,0,7,0,false,false,true,0.677,0.323
247,267,-20,20.583333,22.25,-20,985,1062,-77,0,0,0,0,14,12,12,2.642857,1,0,12,9,false,false,false,0.365,0.635
103,99,4,17.166667,19.8,4,595,538,57,0,0,0,0,59,6,5,0.644068,0,0,10,8,false,false,true,0.676,0.324
64,101,-37,12.8,20.2,-37,1071,1000,71,0,0,0,0,71,5,5,0.661972,1,0,6,14,false,false,false,0.205,0.795
288,330,-42,16.941176,19.411765,-42,599,448,151,0,0,0,0,-11,17,17,-3.272727,0,1,3,5,false,false,false,0,1
96,197,-101,24,49.25,-101,1556,1656,-100,0,1,0,0.25,62,4,4,0.483871,0,1,9,8,false,false,false,0.015,0.985
265,179,86,29.444444,19.888889,86,1156,1279,-123,2,0,0.222222,0,32,9,9,1.25,0,1,11,11,false,false,false,0.202,0.798
223,254,-31,20.272727,25.4,-31,503,527,-24,0,1,0,0.1,18,11,10,1.833333,0,0,7,17,false,false,false,0.205,0.795
271,305,-34,18.066667,21.785714,-34,1210,1162,48,0,0,0,0,3,15,14,10.666667,0,0,6,24,false,false,false,0,1
288,317,-29,19.2,21.133333,-29,1344,1314,30,0,2,0,0.133333,-3,15,15,-11.333333,0,0,9,11,false,false,false,0.007,0.993
334,355,-21,20.875,23.666667,-21,1101,1237,-136,1,0,0.0625,0,-2,16,15,-17,0,0,5,5,false,false,false,0,1
214,196,18,26.75,24.5,18,691,695,-4,1,0,0.125,0,43,8,8,0.744186,1,0,12,17,false,false,false,0.14,0.86
168,262,-94,33.6,52.4,-94,2147,2219,-72,0,2,0,0.4,49,5,5,0.489796,0,0,10,9,false,false,false,0.314,0.686
127,140,-13,15.875,20,-13,306,361,-55,0,0,0,0,45,8,7,0.8,0,2,10,8,false,false,false,0.082,0.918
169,193,-24,18.777778,24.125,-24,1205,1216,-11,0,0,0,0,41,9,8,0.804878,1,0,7,16,false,false,false,0.189,0.811
177,271,-94,12.642857,20.846154,-94,632,603,29,0,1,0,0.076923,1,14,13,38,0,0,11,9,false,false,false,0,1
32,6,26,16,6,26,526,502,24,0,0,0,0,89,2,1,0.561798,0,1,21,18,false,false,false,0.285,0.715
242,299,-57,16.133333,21.357143,-57,725,668,57,0,0,0,0,6,15,14,5.833333,1,0,8,11,false,false,false,0.009,0.991
51,153,-102,8.5,25.5,-102,595,662,-67,0,1,0,0.166667,55,6,6,0.8,0,0,22,7,false,false,false,0.027,0.973
253,328,-75,18.071429,23.428571,-75,1055,1019,36,0,0,0,0,-7,14,14,-4.714286,1,0,4,3,false,false,false,0.005,0.995
287,353,-66,14.35,17.65,-66,1422,1583,-161,0,1,0,0.05,-10,20,20,-4.1,1,0,2,13,false,false,false,0,1
48,79,-31,12,19.75,-31,1131,1030,101,0,0,0,0,74,4,4,0.405405,1,0,18,8,false,false,true,0.532,0.468
257,251,6,25.7,27.888889,6,1167,1245,-78,1,0,0.1,0,19,10,9,1.473684,1,0,6,11,false,false,true,0.602,0.398
107,173,-66,15.285714,28.833333,-66,1195,1397,-202,0,1,0,0.166667,54,7,6,0.740741,0,0,9,16,false,false,false,0.038,0.962
260,246,14,26,24.6,14,691,695,-4,1,0,0.1,0,25,10,10,1.28,0,0,10,21,false,false,false,0.229,0.771
42,47,-5,14,15.666667,-5,1484,1556,-72,0,0,0,0,74,3,3,0.418919,0,1,11,6,false,false,true,0.671,0.329
103,73,30,25.75,24.333333,30,892,856,36,0,0,0,0,75,4,3,0.466667,1,0,10,9,false,false,true,0.738,0.262
202,235,-33,16.833333,19.583333,-33,599,448,151,0,0,0,0,16,12,12,2.25,0,0,15,14,false,false,false,0.24,0.76
283,295,-12,15.722222,16.388889,-12,1045,1082,-37,0,0,0,0,-13,18,18,-3.461538,0,0,7,10,false,false,false,0.112,0.888
197,276,-79,19.7,27.6,-79,1315,1334,-19,0,1,0,0.1,28,10,10,1.285714,0,1,11,16,false,false,false,0,1
252,269,-17,18,20.692308,-17,451,448,3,0,0,0,0,7,14,13,5.285714,0,0,8,7,false,false,false,0.135,0.865
320,306,14,18.823529,19.125,14,1331,1374,-43,0,0,0,0,-15,17,16,-2.2,0,0,10,1,true,false,false,0.302,0.698
137,153,-16,17.125,19.125,-16,803,786,17,0,0,0,0,52,8,8,0.615385,0,0,13,15,false,false,false,0.062,0.938
132,163,-31,18.857143,27.166667,-31,954,939,15,0,0,0,0,50,7,6,0.72,0,1,8,19,false,false,false,0.006,0.994
256,330,-74,17.066667,23.571429,-74,1408,1539,-131,0,1,0,0.071429,-9,15,14,-3.777778,0,1,5,24,false,false,false,0,1
169,233,-64,14.083333,21.181818,-64,813,698,115,1,0,0.083333,0,34,12,11,1.411765,0,1,18,6,false,false,false,0,1
197,367,-170,13.133333,24.466667,-170,940,947,-7,0,2,0,0.133333,1,15,15,35,1,0,11,13,false,false,false,0,1
198,269,-71,16.5,22.416667,-71,889,895,-6,0,1,0,0.083333,18,12,12,2.055556,0,1,11,31,false,false,false,0,1
270,284,-14,18,18.933333,-14,704,523,181,0,0,0,0,-12,15,15,-2.916667,0,0,7,6,false,false,false,0.248,0.752
122,144,-22,17.428571,20.571429,-22,620,698,-78,1,0,0.142857,0,54,7,7,0.759259,0,0,28,16,false,false,false,0.434,0.566
294,319,-25,19.6,21.266667,-25,971,635,336,0,0,0,0,-15,15,15,-2.133333,0,0,2,3,false,false,false,0.015,0.985
166,227,-61,18.444444,28.375,-61,1305,1254,51,0,1,0,0.125,33,9,8,0.969697,0,0,18,15,false,false,false,0.039,0.961
215,211,4,35.833333,35.166667,4,820,718,102,0,2,0,0.333333,43,6,6,0.651163,0,0,15,10,false,false,true,0.814,0.186
149,172,-23,21.285714,24.571429,-23,356,498,-142,0,1,0,0.142857,51,7,7,0.686275,1,1,8,15,false,false,false,0.025,0.975
204,250,-46,12.75,15.625,-46,668,363,305,0,0,0,0,12,16,16,3.916667,1,1,9,7,false,false,false,0.005,0.995
203,252,-49,10.684211,13.263158,-49,542,390,152,0,0,0,0,5,19,19,10,1,0,6,13,false,false,false,0.033,0.967
245,419,-174,16.333333,27.933333,-174,1399,1210,189,0,1,0,0.066667,-2,15,15,-17.5,0,0,9,7,false,false,false,0.02,0.98
252,258,-6,14.823529,16.125,-6,797,796,1,0,0,0,0,10,17,16,4.9,1,0,8,16,false,false,false,0.251,0.749
213,254,-41,21.3,25.4,-41,980,965,15,0,0,0,0,33,10,10,1.151515,1,0,6,7,false,false,false,0.164,0.836
262,291,-29,16.375,19.4,-29,360,371,-11,0,0,0,0,-16,16,15,-2.3125,0,0,7,6,false,false,false,0.048,0.952
256,321,-65,18.285714,24.692308,-65,1417,1482,-65,0,1,0,0.076923,16,14,13,2.0625,0,1,14,8,false,false,false,0,1
212,209,3,21.2,23.222222,3,1269,1477,-208,1,0,0.1,0,37,10,9,0.945946,0,0,15,11,false,false,false,0.255,0.745
319,357,-38,22.785714,25.5,-38,1331,1347,-16,1,1,0.071429,0.071429,-16,14,14,-2,0,0,4,4,false,false,false,0,1
20,68,-48,20,68,-48,1645,1636,9,0,1,0,1,88,1,1,0.375,0,0,23,17,false,false,false,0.211,0.789
144,160,-16,18,22.857143,-16,1030,1014,16,0,0,0,0,52,8,7,0.634615,0,1,18,12,false,false,false,0.047,0.953
31,68,-37,10.333333,22.666667,-37,980,965,15,0,0,0,0,82,3,3,0.463415,0,1,15,8,false,false,false,0.149,0.851
160,120,40,20,15,40,742,594,148,0,0,0,0,48,8,8,0.8125,0,1,22,12,false,false,true,0.872,0.128
376,372,4,26.857143,26.571429,4,1552,1803,-251,3,0,0.214286,0,-6,14,14,-5.5,0,0,8,4,false,false,true,0.906,0.094
74,29,45,24.666667,14.5,45,1428,1361,67,0,0,0,0,79,3,2,0.417722,0,0,9,18,false,false,true,0.713,0.287
10,47,-37,2.5,15.666667,-37,907,878,29,0,0,0,0,87,4,3,0.494253,0,0,20,17,false,false,false,0.041,0.959
214,293,-79,16.461538,22.538462,-79,805,918,-113,0,0,0,0,6,13,13,6,0,1,10,16,false,false,false,0,1
299,431,-132,14.95,21.55,-132,913,1037,-124,0,3,0,0.15,-20,20,20,-2.05,0,0,9,6,false,false,false,0,1
148,233,-85,9.866667,15.533333,-85,925,1000,-75,0,0,0,0,10,15,15,4.4,0,1,17,6,false,false,false,0,1
251,246,5,27.888889,30.75,5,1770,1751,19,0,1,0,0.125,32,9,8,0.90625,0,0,9,10,false,false,false,0.196,0.804
30,77,-47,7.5,25.666667,-47,430,542,-112,0,0,0,0,79,4,3,0.607595,0,2,9,5,false,false,false,0.011,0.989
22,5,17,22,5,17,1422,1583,-161,0,0,0,0,93,1,1,0.44086,0,0,16,9,false,false,false,0.261,0.739
187,203,-16,20.777778,22.555556,-16,1227,1189,38,0,0,0,0,32,9,9,1.09375,0,0,11,19,false,false,false,0.201,0.799
116,215,-99,10.545455,21.5,-99,632,603,29,0,0,0,0,28,11,10,1.357143,0,0,17,13,false,false,false,0,1
393,402,-9,19.65,21.157895,-9,964,1003,-39,0,1,0,0.052632,-25,20,19,-1.56,0,0,3,2,true,false,false,0.349,0.651
14,0,14,14,0,14,689,804,-115,0,0,0,0,97,1,0,0.360825,0,0,10,0,false,false,false,0.252,0.748
268,330,-62,17.866667,22,-62,727,820,-93,0,1,0,0.066667,-4,15,15,-8.75,0,1,13,5,false,false,false,0,1
104,155,-51,13,22.142857,-51,714,892,-178,0,0,0,0,54,8,7,0.777778,1,1,15,6,false,false,false,0.01,0.99
145,219,-74,20.714286,31.285714,-74,1583,1403,180,0,0,0,0,45,7,7,0.711111,0,0,15,10,false,false,false,0.009,0.991
285,295,-10,21.923077,24.583333,-10,1341,1606,-265,1,0,0.076923,0,4,13,12,8.25,0,0,21,9,false,false,false,0.222,0.778
37,17,20,18.5,17,20,595,412,183,0,0,0,0,91,2,1,0.571429,0,0,10,10,false,false,true,0.69,0.31
271,333,-62,22.583333,30.272727,-62,1554,1685,-131,0,1,0,0.090909,17,12,11,1.882353,0,1,9,7,false,false,false,0,1
311,371,-60,19.4375,24.733333,-60,1349,1203,146,0,1,0,0.066667,-2,16,15,-16,0,0,3,8,false,false,false,0,1
131,133,-2,16.375,19,-2,603,721,-118,0,0,0,0,53,8,7,0.811321,0,0,10,21,false,false,false,0.104,0.896
17,110,-93,8.5,55,-93,760,976,-216,0,1,0,0.5,83,2,2,0.433735,0,0,16,17,false,false,false,0.008,0.992
298,341,-43,18.625,21.3125,-43,1488,1403,85,0,1,0,0.0625,-16,16,16,-2.125,1,0,8,3,false,false,false,0.006,0.994
172,143,29,17.2,15.888889,29,671,638,33,0,0,0,0,32,10,9,1.53125,0,0,16,16,false,false,true,0.92,0.08
149,196,-47,13.545455,17.818182,-47,613,525,88,0,0,0,0,34,11,11,1.235294,0,1,10,12,false,false,false,0.023,0.977
182,186,-4,15.166667,16.909091,-4,526,502,24,0,0,0,0,33,12,11,1.515152,0,0,13,11,false,false,false,0.115,0.885
44,64,-20,11,21.333333,-20,813,698,115,0,0,0,0,76,4,3,0.631579,1,0,11,12,false,false,false,0.408,0.592
64,75,-11,12.8,18.75,-11,480,739,-259,0,0,0,0,69,5,4,0.565217,0,0,14,10,false,false,false,0.251,0.749
136,230,-94,17,28.75,-94,1572,1777,-205,0,1,0,0.125,36,8,8,0.916667,0,1,10,6,false,false,false,0.002,0.998
270,341,-71,18,22.733333,-71,954,939,15,1,0,0.066667,0,-8,15,15,-4.5,0,1,9,8,false,false,false,0,1
70,74,-4,17.5,24.666667,-4,915,971,-56,0,0,0,0,75,4,3,0.44,0,0,9,25,false,false,false,0.068,0.932
287,400,-113,15.105263,22.222222,-113,530,683,-153,0,1,0,0.055556,-9,19,18,-4.444444,0,0,3,8,false,false,false,0,1
379,389,-10,21.055556,21.611111,-10,1436,1489,-53,1,1,0.055556,0.055556,-12,18,18,-3.083333,0,0,1,3,false,false,true,0.546,0.454
360,534,-174,32.727273,48.545455,-174,1398,1431,-33,0,0,0,0,-8,11,11,-3.5,0,0,8,18,false,false,false,0,1
58,55,3,11.6,13.75,3,771,668,103,0,0,0,0,66,5,4,0.575758,0,0,9,14,false,false,true,0.577,0.423
168,240,-72,18.666667,26.666667,-72,971,800,171,0,1,0,0.111111,18,9,9,1.611111,0,0,8,11,false,false,false,0.005,0.995
359,510,-151,23.933333,34,-151,1586,1633,-47,1,1,0.066667,0.066667,-7,15,15,-4.857143,0,0,4,3,false,false,false,0,1
200,256,-56,11.764706,15.058824,-56,391,542,-151,1,0,0.058824,0,-7,17,17,-6.571429,0,0,19,14,false,false,false,0,1
10,0,10,10,0,10,1021,897,124,0,0,0,0,96,1,0,0.385417,0,0,19,0,false,false,true,0.679,0.321
93,121,-28,13.285714,20.166667,-28,500,509,-9,0,0,0,0,57,7,6,0.719298,0,0,14,17,false,false,false,0.043,0.957
301,406,-105,16.722222,23.882353,-105,965,1078,-113,1,1,0.055556,0.058824,-20,18,17,-1.85,1,0,0,1,false,false,false,0,1
162,227,-65,20.25,28.375,-65,1305,1254,51,0,1,0,0.125,35,8,8,0.914286,0,0,13,15,false,false,false,0.024,0.976
68,38,30,22.666667,19,30,1094,1041,53,0,0,0,0,80,3,2,0.475,1,0,13,10,false,false,true,0.759,0.241
98,82,16,16.333333,13.666667,16,671,638,33,0,0,0,0,56,6,6,0.875,0,0,18,16,false,false,true,0.779,0.221
70,83,-13,17.5,27.666667,-13,1315,1334,-19,0,1,0,0.333333,73,4,3,0.493151,0,1,21,11,false,false,false,0.219,0.781
110,107,3,22,21.4,3,1205,1216,-11,0,0,0,0,67,5,5,0.492537,0,0,11,26,false,false,false,0.196,0.804
138,64,74,27.6,16,74,1341,1606,-265,1,0,0.2,0,59,5,4,0.559322,0,0,11,15,false,false,false,0.467,0.533
41,60,-19,13.666667,20,-19,1310,1477,-167,0,0,0,0,77,3,3,0.467532,1,0,16,11,false,false,false,0.273,0.727
114,109,5,14.25,13.625,5,1278,1101,177,0,0,0,0,52,8,8,0.711538,1,0,6,10,false,false,false,0.224,0.776
138,177,-39,13.8,17.7,-39,951,976,-25,0,0,0,0,41,10,10,1.073171,0,0,16,16,false,false,false,0.039,0.961
231,266,-35,12.833333,15.647059,-35,999,1165,-166,0,0,0,0,4,18,17,11.5,1,1,15,7,false,false,false,0.048,0.952
186,178,8,20.666667,22.25,8,1269,1477,-208,1,0,0.111111,0,44,9,8,0.795455,0,1,15,13,false,false,false,0.105,0.895
43,84,-41,8.6,21,-41,951,976,-25,0,0,0,0,72,5,4,0.611111,1,1,23,29,false,false,false,0.003,0.997
142,174,-32,11.833333,14.5,-32,163,346,-183,0,0,0,0,18,12,12,2.166667,0,0,13,7,false,false,false,0.362,0.638
279,325,-46,12.681818,14.772727,-46,1071,1000,71,0,0,0,0,-29,22,22,-1.62069,0,0,1,1,false,false,false,0,1
291,305,-14,20.785714,23.461538,-14,1652,1473,179,1,1,0.071429,0.076923,1,14,13,30,0,0,8,7,false,false,false,0.092,0.908
324,328,-4,21.6,23.428571,-4,1645,1636,9,0,1,0,0.071429,-12,15,14,-2.75,0,0,3,4,false,false,false,0.006,0.994
41,54,-13,8.2,10.8,-13,1037,1016,21,0,0,0,0,77,5,5,0.753247,0,1,7,6,false,false,false,0.168,0.832
84,99,-15,21,24.75,-15,620,698,-78,0,0,0,0,75,4,4,0.546667,0,0,21,10,false,false,false,0.251,0.749
155,170,-15,17.222222,21.25,-15,805,918,-113,0,0,0,0,34,9,8,1.058824,0,0,12,20,false,false,false,0.045,0.955
260,438,-178,12.380952,20.857143,-178,1078,983,95,1,0,0.047619,0,-23,21,21,-2.086957,0,0,8,6,false,false,false,0,1
179,115,64,22.375,16.428571,64,1652,1473,179,1,0,0.125,0,40,8,7,0.75,0,0,17,12,false,false,true,0.849,0.151
95,122,-27,15.833333,20.333333,-27,603,721,-118,0,0,0,0,63,6,6,0.68254,0,0,15,19,false,false,false,0.16,0.84
185,197,-12,16.818182,19.7,-12,430,542,-112,0,1,0,0.1,29,11,10,1.655172,0,0,21,11,false,false,false,0.391,0.609
297,355,-58,15.631579,19.722222,-58,736,791,-55,0,0,0,0,-25,19,18,-1.52,0,0,4,2,false,false,false,0,1
252,332,-80,18,23.714286,-80,700,820,-120,0,1,0,0.071429,-1,14,14,-38,0,0,20,13,false,false,false,0,1
225,258,-33,15,17.2,-33,797,796,1,0,0,0,0,15,15,15,3.266667,1,0,8,13,false,false,false,0.183,0.817
76,68,8,12.666667,13.6,8,226,361,-135,0,0,0,0,58,6,5,0.758621,0,0,23,14,false,false,false,0.357,0.643
106,117,-11,17.666667,23.4,-11,527,954,-427,0,0,0,0,62,6,5,0.564516,0,1,27,10,false,false,false,0.023,0.977
169,166,3,28.166667,27.666667,3,1237,1265,-28,1,0,0.166667,0,48,6,6,0.75,0,0,23,8,false,false,true,0.681,0.319
94,196,-102,13.428571,32.666667,-102,760,976,-216,0,1,0,0.166667,53,7,6,0.679245,0,0,7,11,false,false,false,0.001,0.999
150,163,-13,18.75,20.375,-13,939,969,-30,0,0,0,0,37,8,8,0.891892,0,1,13,15,false,false,false,0.135,0.865
46,75,-29,15.333333,25,-29,939,969,-30,0,0,0,0,76,3,3,0.434211,0,0,11,7,false,false,true,0.663,0.337
321,325,-4,17.833333,19.117647,-4,206,346,-140,1,0,0.055556,0,-19,18,17,-2.263158,0,1,17,7,false,false,false,0,1
143,216,-73,20.428571,30.857143,-73,980,965,15,0,0,0,0,48,7,7,0.791667,0,0,12,9,false,false,false,0.175,0.825
232,314,-82,15.466667,20.933333,-82,653,820,-167,0,0,0,0,-8,15,15,-4.75,0,0,6,11,false,false,false,0,1
185,246,-61,16.818182,24.6,-61,736,791,-55,0,0,0,0,20,11,10,1.9,0,0,12,12,false,false,false,0.013,0.987
167,117,50,33.4,29.25,50,824,830,-6,1,0,0.2,0,65,5,4,0.676923,0,0,12,16,false,false,true,0.771,0.229
190,248,-58,14.615385,19.076923,-58,813,698,115,1,0,0.076923,0,24,13,13,2,0,0,9,13,false,false,false,0,1
268,344,-76,11.652174,14.956522,-76,813,698,115,1,0,0.043478,0,-27,23,23,-1.777778,0,0,1,4,false,false,false,0,1
108,130,-22,13.5,16.25,-22,1040,1364,-324,0,0,0,0,41,8,8,0.878049,0,1,20,13,false,false,false,0.251,0.749
319,299,20,22.785714,23,20,1354,1210,144,0,1,0,0.076923,3,14,13,11,0,1,19,9,false,false,false,0.211,0.789
351,381,-30,18.473684,20.052632,-30,980,965,15,0,0,0,0,-19,19,19,-2,0,0,1,2,true,false,false,0.002,0.998
298,371,-73,12.956522,16.130435,-73,595,412,183,0,1,0,0.043478,-19,23,23,-2.736842,0,0,10,11,false,false,false,0,1
32,29,3,16,14.5,3,725,668,57,0,0,0,0,88,2,2,0.397727,0,0,14,27,false,false,true,0.552,0.448
201,371,-170,11.823529,23.1875,-170,1075,1189,-114,0,0,0,0,-6,17,16,-6.666667,0,0,6,10,false,false,false,0,1
241,315,-74,18.538462,24.230769,-74,1094,1159,-65,0,0,0,0,1,13,13,38,1,0,8,22,false,false,false,0,1
168,99,69,33.6,24.75,69,1793,1957,-164,0,0,0,0,63,5,4,0.460317,0,1,8,6,false,false,true,0.813,0.187
303,399,-96,21.642857,28.5,-96,724,398,326,1,1,0.071429,0.071429,12,14,14,3.25,0,0,13,10,false,false,false,0,1
177,210,-33,22.125,30,-33,1388,1366,22,0,1,0,0.142857,42,8,7,0.761905,0,0,11,19,false,false,false,0.179,0.821
114,167,-53,28.5,41.75,-53,1699,1580,119,1,0,0.25,0,67,4,4,0.447761,0,0,9,15,false,false,false,0.149,0.851
86,66,20,14.333333,11,20,450,427,23,0,0,0,0,59,6,6,0.627119,0,2,15,7,false,false,true,0.776,0.224
166,160,6,27.666667,26.666667,6,1331,1347,-16,1,0,0.166667,0,47,6,6,0.680851,0,0,9,18,false,false,true,0.679,0.321
298,331,-33,17.529412,19.470588,-33,689,804,-115,0,1,0,0.058824,-21,17,17,-1.666667,0,1,2,4,false,false,false,0,1
145,195,-50,13.181818,17.727273,-50,951,976,-25,0,0,0,0,35,11,11,1.257143,0,0,14,13,false,false,false,0.038,0.962
212,312,-100,19.272727,28.363636,-100,1232,1281,-49,0,2,0,0.181818,13,11,11,2.384615,1,0,8,11,false,false,false,0.004,0.996
216,356,-140,14.4,23.733333,-140,1003,1018,-15,0,0,0,0,-15,15,15,-2.466667,0,0,10,8,false,false,false,0,1
31,33,-2,10.333333,16.5,-2,651,996,-345,0,0,0,0,84,3,2,0.535714,0,0,9,14,false,false,false,0.251,0.749
292,377,-85,16.222222,22.176471,-85,848,976,-128,0,1,0,0.058824,-4,18,17,-10,0,0,4,6,false,false,false,0,1
329,364,-35,29.909091,36.4,-35,1761,1770,-9,1,1,0.090909,0.1,5,11,10,5.2,0,0,9,9,false,false,false,0.003,0.997
50,36,14,25,18,14,1030,998,32,0,0,0,0,82,2,2,0.45122,0,0,7,10,false,false,true,0.685,0.315
166,261,-95,18.444444,29,-95,874,868,6,0,0,0,0,31,9,9,1.064516,0,0,10,28,false,false,false,0,1
263,234,29,21.916667,21.272727,29,1197,1156,41,0,1,0,0.090909,22,12,11,1.590909,1,0,10,10,false,false,true,0.681,0.319
235,354,-119,15.666667,23.6,-119,342,263,79,0,0,0,0,-16,15,15,-2.125,1,0,5,2,false,false,false,0,1
86,165,-79,17.2,33,-79,1408,1539,-131,0,1,0,0.2,60,5,5,0.566667,0,0,17,9,false,false,false,0.194,0.806
12,13,-1,12,13,-1,1093,1100,-7,0,0,0,0,93,1,1,0.333333,0,0,10,20,false,false,true,0.614,0.386
0,0,0,0,0,0,1473,1500,-27,0,0,0,0,100,2,1,0.39,0,0,12,7,false,false,false,0.323,0.677
310,390,-80,20.666667,27.857143,-80,1334,1439,-105,1,1,0.066667,0.071429,8,15,14,4.5,0,0,8,12,false,false,false,0,1
12,0,12,12,0,12,1182,1075,107,0,0,0,0,97,1,0,0.402062,0,0,17,0,false,false,true,0.679,0.321
276,330,-54,15.333333,19.411765,-54,1037,1009,28,0,0,0,0,1,18,17,44,1,0,7,7,false,false,false,0,1
197,291,-94,21.888889,36.375,-94,1636,1727,-91,0,2,0,0.25,29,9,8,1.034483,1,0,12,20,false,false,false,0.024,0.976
149,196,-47,24.833333,39.2,-47,1331,1432,-101,0,0,0,0,45,6,5,0.6,0,0,11,7,false,false,false,0.22,0.78
314,333,-19,13.652174,15.136364,-19,1000,960,40,0,0,0,0,-27,23,22,-1.666667,0,0,1,1,true,false,false,0,1
162,155,7,16.2,17.222222,7,889,855,34,0,0,0,0,42,10,9,0.952381,0,1,18,6,false,false,false,0.217,0.783
248,303,-55,22.545455,27.545455,-55,1021,897,124,0,2,0,0.181818,14,11,11,2.642857,0,0,14,12,false,false,false,0.003,0.997
120,403,-283,8.571429,31,-283,1164,1149,15,0,2,0,0.153846,34,14,13,1.382353,0,0,12,7,false,false,false,0,1
54,188,-134,13.5,47,-134,2143,2219,-76,0,0,0,0,71,4,4,0.43662,0,0,12,8,false,false,false,0.001,0.999
0,0,0,0,0,0,1793,1869,-76,0,0,0,0,100,1,0,0.3,0,0,8,0,false,false,true,0.636,0.364
270,332,-62,15,19.529412,-62,1161,1176,-15,1,1,0.055556,0.058824,-24,18,17,-1.583333,0,0,1,9,false,false,false,0,1
35,52,-17,17.5,26,-17,642,952,-310,0,0,0,0,84,2,2,0.52381,0,0,13,7,false,false,false,0.251,0.749
43,26,17,14.333333,13,17,758,791,-33,0,0,0,0,82,3,2,0.47561,0,0,15,8,false,false,true,0.524,0.476
331,371,-40,20.6875,23.1875,-40,1691,1551,140,1,0,0.0625,0,-8,16,16,-4.625,0,0,6,4,false,false,false,0,1
283,309,-26,23.583333,25.75,-26,1167,1245,-78,1,0,0.083333,0,3,12,12,9.333333,1,0,7,9,false,false,false,0.426,0.574
235,280,-45,19.583333,23.333333,-45,976,995,-19,1,1,0.083333,0.083333,19,12,12,2,0,0,13,17,false,false,false,0.001,0.999
167,169,-2,16.7,16.9,-2,797,796,1,0,0,0,0,45,10,10,1.088889,1,1,6,10,false,false,false,0.013,0.987
196,209,-13,16.333333,17.416667,-13,796,800,-4,1,0,0.083333,0,29,12,12,1.655172,0,0,13,16,false,false,false,0.237,0.763
50,31,19,16.666667,15.5,19,848,976,-128,0,0,0,0,83,3,2,0.481928,0,0,10,15,false,false,false,0.252,0.748
176,242,-66,12.571429,18.615385,-66,595,662,-67,0,1,0,0.076923,17,14,13,2.588235,0,0,17,13,false,false,false,0,1
100,178,-78,16.666667,29.666667,-78,1633,1620,13,0,0,0,0,55,6,6,0.654545,1,0,9,9,false,false,false,0.288,0.712
322,370,-48,16.947368,19.473684,-48,824,830,-6,1,0,0.052632,0,-13,19,19,-3.384615,0,0,7,9,false,false,false,0,1
145,164,-19,18.125,23.428571,-19,518,461,57,0,0,0,0,49,8,7,0.734694,0,1,17,15,false,false,false,0.003,0.997
265,337,-72,14.722222,19.823529,-72,1432,1452,-20,0,1,0,0.058824,-17,18,17,-2.117647,1,0,1,9,false,false,false,0.001,0.999
238,227,11,23.8,25.222222,11,1439,1314,125,0,0,0,0,28,10,9,1,0,1,10,15,false,false,false,0.195,0.805
302,326,-24,15.1,17.157895,-24,1045,1082,-37,0,0,0,0,-20,20,19,-2.25,0,0,3,3,false,false,false,0,1
308,332,-24,15.4,17.473684,-24,576,602,-26,0,0,0,0,-20,20,19,-2.1,0,0,1,1,false,false,false,0,1
256,246,10,18.285714,18.923077,10,804,766,38,0,1,0,0.076923,23,14,13,1.782609,0,1,9,10,false,false,false,0.105,0.895
230,174,56,20.909091,17.4,56,675,570,105,0,0,0,0,24,11,10,1.458333,0,0,12,16,false,false,true,0.962,0.038
14,54,-40,3.5,18,-40,1793,1869,-76,0,0,0,0,83,4,3,0.361446,0,0,9,9,false,false,false,0.146,0.854
268,367,-99,15.764706,21.588235,-99,1580,1629,-49,0,1,0,0.058824,-15,17,17,-2.466667,0,0,4,1,false,false,false,0,1
90,113,-23,22.5,37.666667,-23,971,800,171,0,1,0,0.333333,64,4,3,0.453125,1,0,7,14,false,false,false,0.214,0.786
291,304,-13,12.125,12.666667,-13,797,796,1,0,0,0,0,-24,24,24,-2.041667,0,0,5,4,false,false,false,0.007,0.993
70,87,-17,14,21.75,-17,1000,960,40,0,0,0,0,69,5,4,0.652174,1,0,6,10,false,false,true,0.506,0.494
145,191,-46,20.714286,27.285714,-46,1645,1636,9,0,1,0,0.142857,41,7,7,0.804878,0,0,19,16,false,false,false,0.185,0.815
75,99,-24,15,24.75,-24,1123,1062,61,0,0,0,0,66,5,4,0.666667,1,0,6,16,false,false,false,0.209,0.791
47,34,13,15.666667,17,13,527,954,-427,0,0,0,0,83,3,2,0.421687,0,0,21,13,false,false,false,0.252,0.748
178,196,-18,19.777778,21.777778,-18,971,635,336,0,0,0,0,35,9,9,0.914286,0,0,19,19,false,false,false,0.215,0.785
216,313,-97,19.636364,28.454545,-97,1038,917,121,1,2,0.090909,0.181818,16,11,11,2.1875,0,0,10,10,false,false,false,0,1
256,318,-62,15.058824,19.875,-62,1101,1130,-29,1,1,0.058824,0.0625,3,17,16,15,0,1,11,11,false,false,false,0,1
29,15,14,14.5,15,14,907,1070,-163,0,0,0,0,89,2,1,0.393258,0,0,22,17,false,false,false,0.251,0.749
130,137,-7,18.571429,22.833333,-7,527,954,-427,0,0,0,0,56,7,6,0.625,0,1,26,10,false,false,false,0.03,0.97
57,62,-5,14.25,20.666667,-5,344,315,29,1,0,0.25,0,65,4,3,0.615385,0,0,7,10,false,false,false,0.498,0.502
12,0,12,12,0,12,642,952,-310,0,0,0,0,95,1,0,0.463158,0,0,12,0,false,false,false,0.251,0.749
75,192,-117,9.375,27.428571,-117,1305,1307,-2,0,1,0,0.142857,51,8,7,0.803922,0,0,11,13,false,false,false,0,1
120,297,-177,12,29.7,-177,1164,1149,15,0,1,0,0.1,47,10,10,1,0,0,12,8,false,false,false,0,1
228,301,-73,15.2,20.066667,-73,1161,1176,-15,1,1,0.066667,0.066667,-8,15,15,-4.75,0,0,11,23,false,false,false,0,1
206,299,-93,18.727273,27.181818,-93,1583,1403,180,0,0,0,0,22,11,11,1.454545,0,1,16,17,false,false,false,0,1
18,0,18,18,0,18,1101,1237,-136,0,0,0,0,95,1,0,0.357895,0,0,12,0,false,false,false,0.252,0.748
198,259,-61,22,28.777778,-61,1454,1479,-25,1,0,0.111111,0,31,9,9,1,0,0,14,23,false,false,false,0.008,0.992
280,342,-62,11.666667,14.869565,-62,1040,1091,-51,0,0,0,0,-34,24,23,-1.382353,0,0,6,1,true,false,false,0,1
36,70,-34,9,17.5,-34,1561,1495,66,0,0,0,0,71,4,4,0.464789,1,0,8,12,false,false,false,0.217,0.783
307,377,-70,20.466667,26.928571,-70,1176,1133,43,1,0,0.066667,0,9,15,14,3.777778,0,0,9,10,false,false,false,0,1
270,256,14,19.285714,19.692308,14,824,830,-6,1,0,0.071429,0,17,14,13,2.588235,0,0,7,20,false,false,false,0.202,0.798
270,275,-5,18,19.642857,-5,1055,840,215,0,1,0,0.071429,3,15,14,12,0,0,17,24,false,false,false,0.166,0.834
120,218,-98,8.571429,16.769231,-98,1078,983,95,0,0,0,0,25,14,13,1.92,1,1,7,14,false,false,false,0,1
24,0,24,24,0,24,621,786,-165,0,0,0,0,95,1,0,0.315789,0,0,21,0,false,false,false,0.258,0.742
35,93,-58,17.5,46.5,-58,1554,1685,-131,0,1,0,0.5,84,2,2,0.380952,0,0,11,9,false,false,false,0.201,0.799
242,330,-88,17.285714,23.571429,-88,1408,1539,-131,0,1,0,0.071429,-5,14,14,-6.8,0,1,7,24,false,false,false,0,1
323,329,-6,17.944444,18.277778,-6,742,594,148,0,0,0,0,-18,18,18,-2.166667,0,0,4,2,false,false,true,0.732,0.268
64,61,3,16,20.333333,3,1885,1842,43,0,0,0,0,74,4,3,0.364865,0,0,11,7,false,false,false,0.391,0.609
324,354,-30,21.6,25.285714,-30,1397,1405,-8,1,1,0.066667,0.071429,-12,15,14,-2.416667,0,1,2,7,true,false,false,0,1
302,360,-58,21.571429,25.714286,-58,801,679,122,1,0,0.071429,0,-14,14,14,-2.071429,0,0,5,1,false,false,false,0,1
0,48,-48,0,48,-48,1315,1331,-16,0,0,0,0,95,1,1,0.347368,0,0,15,13,false,false,false,0.177,0.823
191,171,20,21.222222,19,20,1341,1606,-265,1,0,0.111111,0,30,9,9,1.1,0,0,13,14,false,false,false,0.312,0.688
172,248,-76,13.230769,19.076923,-76,1248,1220,28,0,1,0,0.076923,27,13,13,1.925926,1,0,9,13,false,false,false,0.005,0.995
296,314,-18,18.5,19.625,-18,1245,1148,97,0,0,0,0,-15,16,16,-2.333333,0,0,11,2,false,false,false,0.083,0.917
278,281,-3,19.857143,21.615385,-3,540,498,42,1,0,0.071429,0,9,14,13,5.111111,0,0,13,8,false,false,false,0.05,0.95
67,86,-19,11.166667,17.2,-19,977,1100,-123,0,0,0,0,68,6,5,0.602941,1,0,13,8,false,false,false,0.248,0.752
301,330,-29,18.8125,22,-29,480,739,-259,1,0,0.0625,0,1,16,15,39,0,0,7,17,false,false,false,0,1
49,55,-6,16.333333,27.5,-6,1093,1173,-80,0,0,0,0,85,3,2,0.505882,0,0,23,15,false,false,false,0.31,0.69
241,273,-32,21.909091,24.818182,-32,1245,1148,97,0,0,0,0,20,11,11,1.75,0,0,17,7,false,false,false,0.199,0.801
37,28,9,12.333333,9.333333,9,889,895,-6,0,0,0,0,82,3,3,0.45122,0,1,15,6,false,false,false,0.381,0.619
86,120,-34,14.333333,20,-34,952,826,126,0,0,0,0,68,6,6,0.632353,0,0,9,7,false,false,false,0.203,0.797
180,165,15,22.5,20.625,15,1691,1510,181,0,1,0,0.125,41,8,8,0.731707,0,0,16,12,false,false,true,1,0
283,342,-59,17.6875,21.375,-59,387,683,-296,0,0,0,0,-17,16,16,-2,1,0,3,4,false,false,false,0.011,0.989
328,348,-20,21.866667,23.2,-20,1188,1334,-146,1,1,0.066667,0.066667,-11,15,15,-2.727273,1,0,4,5,true,false,true,0.866,0.134
185,120,65,26.428571,20,65,1274,1394,-120,0,0,0,0,48,7,6,0.625,0,0,10,9,false,false,true,0.834,0.166
242,323,-81,15.125,20.1875,-81,653,820,-167,0,0,0,0,-14,16,16,-2.714286,0,0,4,5,false,false,false,0,1
279,332,-53,18.6,22.133333,-53,1063,1134,-71,1,0,0.066667,0,16,15,15,2.75,0,0,10,10,false,false,false,0,1
52,24,28,17.333333,12,28,874,868,6,0,0,0,0,81,3,2,0.407407,0,0,19,9,false,false,true,0.696,0.304
270,253,17,19.285714,18.071429,17,356,498,-142,0,1,0,0.071429,6,14,14,5.833333,0,0,7,20,false,false,false,0.441,0.559
98,70,28,19.6,17.5,28,1561,1495,66,1,0,0.2,0,64,5,4,0.515625,1,0,9,12,false,false,true,0.682,0.318
80,72,8,13.333333,14.4,8,530,683,-153,0,0,0,0,70,6,5,0.571429,0,1,9,7,false,false,false,0.255,0.745
35,37,-2,11.666667,12.333333,-2,226,361,-135,0,0,0,0,77,3,3,0.571429,0,1,20,10,false,false,false,0.258,0.742
200,250,-50,15.384615,20.833333,-50,1037,913,124,1,1,0.076923,0.083333,25,13,12,1.52,1,0,11,10,false,false,false,0.077,0.923
13,9,4,6.5,4.5,4,1176,1133,43,0,0,0,0,91,2,2,0.373626,2,0,10,23,false,false,true,0.982,0.018
135,147,-12,19.285714,21,-12,480,518,-38,0,0,0,0,48,7,7,0.833333,0,1,16,7,false,false,false,0.153,0.847
12,0,12,12,0,12,491,651,-160,0,0,0,0,97,1,0,0.309278,0,0,13,0,false,false,false,0.252,0.748
35,74,-39,17.5,74,-39,1554,1685,-131,0,1,0,1,87,2,1,0.367816,0,0,11,9,false,false,false,0.201,0.799
312,352,-40,17.333333,19.555556,-40,1439,1428,11,0,0,0,0,-9,18,18,-4.444444,1,0,4,4,false,false,false,0.02,0.98
324,354,-30,23.142857,25.285714,-30,1397,1405,-8,1,1,0.071429,0.071429,-12,14,14,-2.416667,0,1,2,7,false,false,false,0.001,0.999
314,272,42,31.4,30.222222,42,820,718,102,0,2,0,0.222222,17,10,9,1.647059,0,0,13,11,false,false,true,0.853,0.147
39,50,-11,7.8,10,-11,288,359,-71,0,0,0,0,75,5,5,0.36,0,0,16,11,false,false,false,0.268,0.732
176,212,-36,17.6,23.555556,-36,1123,1062,61,0,0,0,0,35,10,9,1.257143,0,0,16,18,false,false,false,0.199,0.801
147,223,-76,13.363636,20.272727,-76,278,1,277,0,0,0,0,21,11,11,1.761905,0,1,25,8,false,false,false,0,1
124,294,-170,10.333333,24.5,-170,530,683,-153,0,1,0,0.083333,27,12,12,1.481481,0,0,18,12,false,false,false,0,1
331,362,-31,15.761905,18.1,-31,1220,1185,35,0,1,0,0.05,-20,21,20,-2.35,0,0,9,5,false,false,false,0,1
29,31,-2,14.5,15.5,-2,1003,1004,-1,0,0,0,0,87,2,2,0.402299,0,0,17,19,false,false,true,0.646,0.354
89,80,9,17.8,20,9,980,965,15,0,0,0,0,70,5,4,0.542857,0,1,19,8,false,false,true,0.639,0.361
256,319,-63,17.066667,21.266667,-63,889,895,-6,0,1,0,0.066667,0,15,15,0,0,1,11,21,false,false,false,0,1
8,22,-14,8,22,-14,430,542,-112,0,0,0,0,92,1,1,0.521739,0,2,8,9,false,false,false,0.02,0.98
239,226,13,21.727273,20.545455,13,1227,1189,38,0,0,0,0,19,11,11,1.842105,0,1,9,22,false,false,false,0.264,0.736
305,371,-66,19.0625,24.733333,-66,1232,1281,-49,0,2,0,0.133333,-16,16,15,-1.9375,0,0,2,5,true,false,false,0,1
55,87,-32,13.75,29,-32,1305,1211,94,0,0,0,0,80,4,3,0.4125,0,0,16,26,false,false,false,0.201,0.799
72,60,12,18,20,12,995,965,30,0,0,0,0,71,4,3,0.56338,0,0,21,8,false,false,true,0.679,0.321
279,309,-30,19.928571,22.071429,-30,1227,1189,38,0,0,0,0,-2,14,14,-17.5,0,0,9,17,false,false,false,0.031,0.969
30,47,-17,10,15.666667,-17,651,567,84,0,0,0,0,78,3,3,0.705128,0,0,10,22,false,false,false,0.303,0.697
160,223,-63,17.777778,27.875,-63,1408,1539,-131,0,1,0,0.125,34,9,8,1,0,0,10,9,false,false,false,0.143,0.857
293,292,1,24.416667,26.545455,1,1436,1489,-53,1,1,0.083333,0.090909,21,12,11,1.761905,0,0,8,7,false,false,false,0.281,0.719
120,615,-495,5,26.73913,-495,1164,1149,15,0,3,0,0.130435,-4,24,23,-11.75,0,1,12,13,true,false,false,0,1
184,330,-146,16.727273,30,-146,726,818,-92,0,1,0,0.090909,22,11,11,1.590909,0,0,11,11,false,false,false,0,1
108,140,-32,18,28,-32,1349,1203,146,0,1,0,0.2,58,6,5,0.551724,0,0,7,9,false,false,false,0.058,0.942
237,277,-40,21.545455,25.181818,-40,1397,1309,88,2,0,0.181818,0,32,11,11,1.125,0,0,13,10,false,false,false,0.005,0.995
83,75,8,16.6,18.75,8,1310,1477,-167,0,0,0,0,65,5,4,0.553846,0,0,8,8,false,false,false,0.276,0.724
195,175,20,17.727273,17.5,20,704,523,181,0,0,0,0,25,11,10,1.4,0,0,11,10,false,false,false,0.444,0.556
122,212,-90,10.166667,17.666667,-90,818,826,-8,0,0,0,0,38,12,12,1.394737,1,0,6,17,false,false,false,0.019,0.981
248,333,-85,14.588235,19.588235,-85,653,820,-167,0,0,0,0,-21,17,17,-1.809524,0,0,2,3,false,false,false,0,1
231,251,-20,14.4375,15.6875,-20,999,1165,-166,0,0,0,0,7,16,16,6.571429,1,1,15,6,false,false,false,0.273,0.727
195,228,-33,17.727273,20.727273,-33,668,771,-103,0,0,0,0,32,11,11,1.25,1,0,15,11,false,false,false,0.137,0.863
118,35,83,29.5,11.666667,83,1101,1237,-136,1,0,0.25,0,72,4,3,0.472222,0,1,19,10,false,false,false,0.47,0.53
331,350,-19,20.6875,23.333333,-19,804,1074,-270,0,0,0,0,-14,16,15,-2.285714,0,0,1,1,false,false,false,0.012,0.988
90,69,21,22.5,17.25,21,1070,814,256,1,1,0.25,0.25,68,4,4,0.485294,0,0,13,10,false,false,true,0.997,0.003
47,42,5,23.5,21,5,1205,1216,-11,0,0,0,0,88,2,2,0.375,0,0,13,16,false,false,true,0.676,0.324
75,113,-38,15,22.6,-38,1123,1062,61,0,0,0,0,63,5,5,0.698413,1,0,6,17,false,false,false,0.204,0.796
319,368,-49,21.266667,26.285714,-49,1071,1065,6,0,0,0,0,-13,15,14,-2.384615,0,0,1,1,false,false,false,0,1
10,0,10,10,0,10,1432,1452,-20,0,0,0,0,96,1,0,0.375,0,0,9,0,false,false,true,0.677,0.323
65,44,21,32.5,44,21,1334,1486,-152,0,0,0,0,87,2,1,0.333333,0,1,12,11,false,false,false,0.044,0.956
129,159,-30,16.125,19.875,-30,840,1055,-215,0,0,0,0,47,8,8,0.744681,0,0,12,7,false,false,false,0.246,0.754
101,81,20,14.428571,13.5,20,721,757,-36,0,0,0,0,60,7,6,0.633333,0,1,16,16,false,false,false,0.29,0.71
298,353,-55,16.555556,20.764706,-55,694,658,36,0,1,0,0.058824,-14,18,17,-2.642857,0,0,5,1,false,false,false,0,1
278,334,-56,17.375,20.875,-56,1633,1620,13,0,0,0,0,-17,16,16,-2.117647,0,0,4,4,false,false,false,0,1
93,89,4,15.5,17.8,4,848,976,-128,0,0,0,0,65,6,5,0.615385,0,0,10,12,false,false,false,0.25,0.75
299,335,-36,23,25.769231,-36,1388,1366,22,0,1,0,0.076923,5,13,13,6.4,0,0,23,9,false,false,false,0.029,0.971
203,235,-32,16.916667,19.583333,-32,1439,1428,11,0,0,0,0,26,12,12,1.538462,0,0,19,18,false,false,false,0.189,0.811
170,223,-53,14.166667,20.272727,-53,1248,1220,28,0,1,0,0.090909,35,12,11,1.485714,1,0,6,10,false,false,false,0.009,0.991
300,316,-16,17.647059,19.75,-16,451,448,3,0,0,0,0,-9,17,16,-4.111111,0,0,9,3,false,false,false,0.007,0.993
146,227,-81,14.6,25.222222,-81,915,971,-56,0,0,0,0,30,10,9,1.1,0,1,11,21,false,false,false,0,1
86,102,-16,12.285714,14.571429,-16,226,361,-135,0,0,0,0,47,7,7,0.93617,0,0,18,14,false,false,false,0.296,0.704
115,164,-49,11.5,18.222222,-49,830,787,43,0,0,0,0,38,10,9,1,1,0,16,16,false,false,false,0.182,0.818
197,100,97,32.833333,20,97,1373,1334,39,1,0,0.166667,0,61,6,5,0.52459,0,0,10,8,false,false,true,0.958,0.042
228,370,-142,17.538462,28.461538,-142,726,818,-92,0,1,0,0.076923,6,13,13,5.833333,0,0,23,11,false,false,false,0,1
66,120,-54,16.5,30,-54,594,648,-54,0,1,0,0.25,73,4,4,0.547945,0,1,13,10,false,false,false,0.041,0.959
37,19,18,18.5,19,18,1281,1268,13,0,0,0,0,88,2,1,0.477273,1,0,17,22,false,false,true,0.865,0.135
0,0,0,0,0,0,95,453,-358,0,0,0,0,100,1,0,0.39,0,0,0,0,false,false,false,0.251,0.749
201,288,-87,33.5,57.6,-87,1398,1431,-33,0,0,0,0,38,6,5,0.736842,0,1,13,16,false,false,false,0.006,0.994
44,26,18,22,26,18,1197,1156,41,0,0,0,0,85,2,1,0.411765,0,1,13,7,false,false,true,0.68,0.32
85,75,10,28.333333,25,10,1281,1268,13,0,0,0,0,75,3,3,0.56,0,0,11,7,false,false,true,0.68,0.32
206,255,-49,20.6,25.5,-49,1055,1019,36,0,0,0,0,19,10,10,1.736842,1,0,10,7,false,false,false,0.194,0.806
57,75,-18,28.5,75,-18,1556,1656,-100,0,1,0,1,85,2,1,0.352941,0,0,8,7,false,false,false,0.201,0.799
104,170,-66,17.333333,34,-66,732,868,-136,0,1,0,0.2,61,6,5,0.52459,1,0,6,17,false,false,false,0.037,0.963
186,151,35,18.6,16.777778,35,1281,1268,13,0,0,0,0,40,10,9,1.05,0,0,10,13,false,false,false,0.416,0.584
26,53,-27,8.666667,26.5,-27,1131,1030,101,0,0,0,0,81,3,2,0.37037,0,0,15,12,false,false,false,0.206,0.794
273,440,-167,19.5,33.846154,-167,1003,1004,-1,0,2,0,0.153846,3,14,13,11.666667,0,0,9,9,false,false,false,0,1
164,243,-79,32.8,48.6,-79,2010,2219,-209,1,0,0.2,0,54,5,5,0.481481,0,0,12,15,false,false,false,0.003,0.997
31,83,-52,7.75,20.75,-52,913,1037,-124,0,1,0,0.25,83,4,4,0.493976,0,0,28,8,false,false,false,0.071,0.929
263,274,-11,16.4375,18.266667,-11,561,688,-127,0,0,0,0,8,16,15,5.75,0,0,8,12,false,false,false,0.126,0.874
247,327,-80,15.4375,20.4375,-80,95,453,-358,0,0,0,0,-8,16,16,-4.875,0,0,4,4,false,false,false,0,1
210,308,-98,15,23.692308,-98,1003,1018,-15,0,0,0,0,-3,14,13,-12.333333,0,0,8,8,false,false,false,0,1
237,293,-56,13.166667,16.277778,-56,683,859,-176,0,0,0,0,5,18,18,9,0,0,9,17,false,false,false,0,1
223,384,-161,18.583333,32,-161,724,398,326,1,1,0.083333,0.083333,27,12,12,1.444444,1,0,6,9,false,false,false,0,1
27,29,-2,13.5,14.5,-2,771,668,103,0,0,0,0,86,2,2,0.44186,0,0,11,7,false,false,true,0.68,0.32
36,47,-11,9,15.666667,-11,632,603,29,0,0,0,0,76,4,3,0.5,1,1,6,17,false,false,false,0.059,0.941
287,265,22,17.9375,16.5625,22,1193,1220,-27,1,0,0.0625,0,-2,16,16,-21.5,0,0,23,15,false,false,true,0.905,0.095
97,153,-56,19.4,38.25,-56,971,800,171,0,1,0,0.25,54,5,4,0.537037,1,0,6,10,false,false,false,0.007,0.993
100,82,18,14.285714,13.666667,18,1278,1101,177,0,0,0,0,57,7,6,0.649123,1,0,6,14,false,false,false,0.241,0.759
332,319,13,30.181818,31.9,13,1167,1245,-78,2,0,0.181818,0,-1,11,10,-23,0,1,10,7,false,false,false,0.077,0.923
178,200,-22,16.181818,20,-22,727,820,-93,0,1,0,0.1,22,11,10,1.590909,0,0,8,20,false,false,false,0.048,0.952
174,218,-44,24.857143,36.333333,-44,1331,1432,-101,0,0,0,0,40,7,6,0.675,0,0,20,7,false,false,false,0.224,0.776
131,204,-73,16.375,25.5,-73,944,1095,-151,0,1,0,0.125,51,8,8,0.764706,0,1,7,12,false,false,false,0.037,0.963
255,328,-73,12.142857,15.619048,-73,651,700,-49,0,0,0,0,-25,21,21,-2.24,0,0,12,14,false,false,false,0,1
76,69,7,15.2,17.25,7,1040,1364,-324,0,0,0,0,67,5,4,0.537313,0,0,16,18,false,false,false,0.251,0.749
12,46,-34,12,46,-34,615,542,73,0,0,0,0,93,1,1,0.451613,0,0,11,20,false,false,false,0.015,0.985
279,292,-13,15.5,17.176471,-13,670,576,94,0,0,0,0,-13,18,17,-3.153846,0,0,2,6,false,false,false,0.262,0.738
80,148,-68,13.333333,24.666667,-68,430,542,-112,0,1,0,0.166667,58,6,6,0.827586,0,0,23,10,false,false,false,0.052,0.948
116,85,31,19.333333,17,31,704,523,181,0,0,0,0,59,6,5,0.59322,0,0,14,13,false,false,true,0.768,0.232
232,318,-86,14.5,19.875,-86,1101,1130,-29,1,1,0.0625,0.0625,7,16,16,6.428571,0,1,15,11,false,false,false,0,1
310,302,8,17.222222,17.764706,8,540,498,42,1,0,0.055556,0,-18,18,17,-2.555556,0,0,7,16,false,false,true,0.741,0.259
105,180,-75,17.5,30,-75,473,683,-210,0,0,0,0,56,6,6,0.678571,0,0,13,15,false,false,false,0.004,0.996
219,250,-31,18.25,22.727273,-31,595,733,-138,1,1,0.083333,0.090909,17,12,11,2.294118,0,1,22,15,false,false,false,0,1
302,319,-17,17.764706,19.9375,-17,758,904,-146,1,0,0.058824,0,-21,17,16,-1.619048,0,0,2,3,false,false,false,0.006,0.994
278,310,-32,23.166667,28.181818,-32,1188,1334,-146,1,1,0.083333,0.090909,10,12,11,3,1,0,10,10,false,false,false,0.235,0.765
181,178,3,30.166667,29.666667,3,714,820,-106,1,0,0.166667,0,54,6,6,0.574074,0,0,13,9,false,false,false,0.055,0.945
177,144,33,25.285714,20.571429,33,1156,1279,-123,1,0,0.142857,0,51,7,7,0.784314,1,0,7,10,false,false,true,0.697,0.303
110,11,99,36.666667,5.5,99,1237,1265,-28,1,0,0.333333,0,78,3,2,0.461538,0,1,22,7,false,false,true,0.843,0.157
276,291,-15,23,26.454545,-15,1793,1869,-76,0,1,0,0.090909,15,12,11,2,1,0,8,7,false,false,false,0.331,0.669
77,125,-48,19.25,31.25,-48,452,698,-246,0,1,0,0.25,72,4,4,0.569444,0,0,22,7,false,false,false,0.251,0.749
171,146,25,21.375,20.857143,25,758,904,-146,1,0,0.125,0,43,8,7,0.790698,0,0,10,10,false,false,true,0.52,0.48
100,59,41,20,11.8,41,675,570,105,0,0,0,0,63,5,5,0.555556,0,0,12,29,false,false,true,0.956,0.044
317,287,30,21.133333,19.133333,30,1331,1374,-43,0,0,0,0,-8,15,15,-4.125,0,0,11,1,false,false,true,0.921,0.079
51,39,12,17,19.5,12,952,870,82,0,0,0,0,80,3,2,0.4625,0,0,7,19,false,false,true,0.611,0.389
370,397,-27,19.473684,20.894737,-27,1093,1173,-80,1,1,0.052632,0.052632,-21,19,19,-2.047619,0,0,3,4,false,false,false,0.004,0.996
41,40,1,13.666667,20,1,480,739,-259,0,0,0,0,83,3,2,0.46988,0,0,9,10,false,false,false,0.251,0.749
206,263,-57,17.166667,21.916667,-57,758,791,-33,0,0,0,0,15,12,12,2.6,0,0,11,18,false,false,false,0.002,0.998
169,241,-72,15.363636,24.1,-72,952,826,126,0,1,0,0.1,39,11,10,1.102564,0,1,7,6,false,false,false,0.002,0.998
283,298,-15,15.722222,16.555556,-15,1203,1270,-67,1,0,0.055556,0,-6,18,18,-7.333333,1,1,9,9,false,false,false,0.052,0.948
53,63,-10,10.6,15.75,-10,1075,1189,-114,0,0,0,0,70,5,4,0.571429,0,0,7,15,false,false,false,0.193,0.807
284,322,-38,21.846154,26.833333,-38,1793,1869,-76,0,1,0,0.083333,7,13,12,4.285714,1,0,6,23,false,false,false,0.023,0.977
288,364,-76,16.941176,22.75,-76,691,704,-13,0,1,0,0.0625,-12,17,16,-3.166667,0,0,2,6,false,false,false,0,1
213,327,-114,15.214286,23.357143,-114,1195,1397,-202,0,2,0,0.142857,12,14,14,3.333333,0,1,11,13,false,false,false,0,1
136,73,63,45.333333,36.5,63,1436,1489,-53,1,0,0.333333,0,79,3,2,0.468354,0,0,11,21,false,false,true,0.682,0.318
244,261,-17,24.4,29,-17,1331,1347,-16,1,0,0.1,0,20,10,9,1.6,0,0,11,9,false,false,false,0.306,0.694
129,98,31,21.5,19.6,31,980,965,15,0,0,0,0,62,6,5,0.612903,0,1,13,8,false,false,true,0.735,0.265
136,248,-112,12.363636,22.545455,-112,948,998,-50,0,0,0,0,22,11,11,1.681818,1,0,14,10,false,false,false,0.005,0.995
176,141,35,22,20.142857,35,1452,1388,64,0,0,0,0,50,8,7,0.7,0,2,8,5,false,false,true,0.899,0.101
345,405,-60,21.5625,27,-60,1454,1479,-25,1,0,0.0625,0,-10,16,15,-3.1,0,0,9,6,true,false,false,0,1
12,13,-1,6,6.5,-1,1168,1216,-48,0,0,0,0,94,2,2,0.351064,0,0,21,24,false,false,false,0.217,0.783
173,242,-69,14.416667,22,-69,837,844,-7,0,0,0,0,35,12,11,1.171429,1,1,16,7,false,false,false,0.004,0.996
142,212,-70,17.75,26.5,-70,1656,1580,76,0,1,0,0.125,44,8,8,0.75,0,0,13,10,false,false,false,0.017,0.983
94,140,-46,13.428571,20,-46,450,427,23,0,1,0,0.142857,48,7,7,0.770833,0,0,16,7,false,false,false,0.276,0.724
123,132,-9,13.666667,16.5,-9,1064,1397,-333,0,1,0,0.125,61,9,8,0.704918,1,0,13,7,false,false,false,0.421,0.579
77,76,1,15.4,19,1,595,538,57,0,0,0,0,69,5,4,0.550725,0,0,12,8,false,false,true,0.675,0.325
277,295,-18,17.3125,18.4375,-18,704,523,181,0,0,0,0,-18,16,16,-1.944444,0,0,4,3,false,false,false,0.033,0.967
220,261,-41,20,23.727273,-41,967,856,111,0,0,0,0,26,11,11,1.269231,0,1,25,8,false,false,false,0.255,0.745
157,169,-12,22.428571,24.142857,-12,1093,1100,-7,1,0,0.142857,0,50,7,7,0.62,0,0,9,27,false,false,false,0.069,0.931
191,224,-33,17.363636,22.4,-33,1071,1181,-110,0,0,0,0,37,11,10,0.918919,0,1,7,9,false,false,false,0.024,0.976
121,127,-6,30.25,42.333333,-6,1431,1399,32,0,1,0,0.333333,68,4,3,0.367647,0,1,10,8,false,false,false,0.209,0.791
332,396,-64,20.75,24.75,-64,921,1045,-124,0,1,0,0.0625,-5,16,16,-7,0,1,3,5,false,false,false,0,1
32,38,-6,16,19,-6,1606,1593,13,0,0,0,0,84,2,2,0.345238,0,0,27,14,false,false,true,0.668,0.332
16,0,16,16,0,16,1315,1334,-19,0,0,0,0,94,1,0,0.382979,0,0,7,0,false,false,true,0.678,0.322
54,51,3,18,25.5,3,1193,1177,16,0,0,0,0,82,3,2,0.426829,0,0,8,13,false,false,true,0.636,0.364
79,117,-38,13.166667,23.4,-38,1580,1629,-49,0,0,0,0,64,6,5,0.578125,0,0,14,7,false,false,false,0.201,0.799
52,38,14,17.333333,19,14,1606,1593,13,0,0,0,0,81,3,2,0.358025,0,0,22,14,false,false,true,0.669,0.331
251,351,-100,20.916667,31.909091,-100,1003,1004,-1,0,1,0,0.090909,21,12,11,1.666667,0,1,7,7,false,false,false,0,1
307,339,-32,16.157895,17.842105,-32,995,965,30,0,1,0,0.052632,-20,19,19,-2,0,0,1,1,false,false,false,0,1
154,132,22,25.666667,26.4,22,1047,1127,-80,0,1,0,0.2,54,6,5,0.5,0,0,11,19,false,false,true,0.633,0.367
202,329,-127,15.538462,25.307692,-127,771,668,103,0,0,0,0,7,13,13,5.428571,0,0,7,19,false,false,false,0,1
97,86,11,13.857143,14.333333,11,999,1071,-72,0,0,0,0,54,7,6,0.740741,1,0,9,16,false,false,true,0.511,0.489
324,354,-30,23.142857,25.285714,-30,1656,1580,76,1,1,0.071429,0.071429,1,14,14,33,0,0,10,6,false,false,false,0.004,0.996
166,295,-129,13.833333,26.818182,-129,760,976,-216,0,1,0,0.090909,14,12,11,2.571429,0,1,15,20,false,false,false,0,1
285,312,-27,13.571429,14.857143,-27,999,1165,-166,0,0,0,0,-17,21,21,-2.705882,1,1,17,6,false,false,false,0.16,0.84
83,101,-18,11.857143,14.428571,-18,808,749,59,0,0,0,0,50,7,7,0.84,0,0,7,13,false,false,false,0.275,0.725
219,315,-96,15.642857,24.230769,-96,480,739,-259,0,0,0,0,13,14,13,3,1,0,6,19,false,false,false,0,1
54,128,-74,10.8,25.6,-74,343,570,-227,0,0,0,0,55,5,5,0.654545,0,0,19,10,false,false,false,0.228,0.772
32,22,10,16,11,10,163,346,-183,0,0,0,0,82,2,2,0.47561,0,1,9,8,false,false,false,0.276,0.724
111,77,34,22.2,15.4,34,995,965,30,0,0,0,0,61,5,5,0.655738,0,0,18,10,false,false,true,0.821,0.179
344,368,-24,18.105263,20.444444,-24,1037,913,124,2,1,0.105263,0.055556,-17,19,18,-2.235294,0,0,4,6,false,false,false,0,1
165,222,-57,20.625,27.75,-57,1315,1334,-19,0,1,0,0.125,42,8,8,0.857143,0,1,7,14,false,false,false,0.025,0.975
121,70,51,17.285714,11.666667,51,675,570,105,0,0,0,0,53,7,6,0.660377,0,0,14,31,false,false,true,0.945,0.055
80,77,3,26.666667,25.666667,3,965,1078,-113,0,0,0,0,78,3,3,0.474359,0,0,7,20,false,false,false,0.252,0.748
242,245,-3,16.133333,17.5,-3,840,1055,-215,0,0,0,0,2,15,14,17.5,0,0,19,7,false,false,false,0.239,0.761
249,345,-96,19.153846,26.538462,-96,1131,1030,101,0,0,0,0,1,13,13,30,0,0,5,4,false,false,false,0,1
236,289,-53,18.153846,22.230769,-53,795,786,9,1,0,0.076923,0,18,13,13,2.111111,0,0,8,14,false,false,false,0,1
164,162,2,16.4,18,2,907,1070,-163,0,0,0,0,39,10,9,0.897436,0,0,11,16,false,false,false,0.1,0.9
92,100,-8,23,33.333333,-8,1556,1616,-60,0,0,0,0,76,4,3,0.381579,0,0,11,16,false,false,false,0.239,0.761
296,349,-53,14.095238,17.45,-53,452,698,-246,0,1,0,0.05,-18,21,20,-2.277778,0,0,4,2,true,false,false,0,1
298,273,25,19.866667,19.5,25,1168,1216,-48,0,0,0,0,13,15,14,2.538462,1,1,6,8,false,false,false,0.128,0.872
284,308,-24,16.705882,18.117647,-24,1310,1477,-167,0,0,0,0,-24,17,17,-1.5,0,0,3,2,false,false,false,0.094,0.906
161,158,3,16.1,15.8,3,913,1037,-124,0,1,0,0.1,50,10,10,0.82,0,0,15,10,false,false,false,0.411,0.589
170,293,-123,12.142857,20.928571,-123,1305,1307,-2,0,1,0,0.071429,9,14,14,4.555556,0,1,8,10,false,false,false,0,1
233,349,-116,19.416667,29.083333,-116,999,1283,-284,0,2,0,0.166667,14,12,12,2.357143,0,0,16,10,false,false,false,0,1
33,29,4,16.5,14.5,4,1484,1556,-72,0,0,0,0,81,2,2,0.382716,0,0,10,7,false,false,true,0.678,0.322
126,175,-49,21,29.166667,-49,1428,1361,67,0,0,0,0,51,6,6,0.647059,0,0,16,8,false,false,false,0.201,0.799
97,91,6,19.4,22.75,6,500,532,-32,0,0,0,0,65,5,4,0.630769,0,0,10,10,false,false,false,0.332,0.668
233,258,-25,17.923077,21.5,-25,1488,1403,85,0,1,0,0.083333,5,13,12,6.8,0,0,24,22,false,false,false,0.019,0.981
298,321,-23,21.285714,22.928571,-23,1167,1245,-78,2,0,0.142857,0,-9,14,14,-3.111111,1,0,4,5,true,false,false,0.256,0.744
403,460,-57,31,38.333333,-57,1699,1580,119,3,2,0.230769,0.166667,0,13,12,0,0,0,4,12,false,false,false,0,1
309,314,-5,23.769231,24.153846,-5,1436,1489,-53,1,1,0.076923,0.076923,12,13,13,3.083333,0,1,10,19,false,false,false,0.06,0.94
286,305,-19,15.052632,16.052632,-19,1123,1062,61,0,0,0,0,-17,19,19,-2.588235,0,0,3,11,false,false,false,0.006,0.994
139,119,20,23.166667,19.833333,20,1257,1176,81,1,0,0.166667,0,65,6,6,0.523077,0,0,19,8,false,false,true,0.782,0.218
301,319,-18,15.05,16.789474,-18,1203,1270,-67,1,0,0.05,0,-17,20,19,-2.588235,1,0,4,5,false,false,false,0.43,0.57
167,93,74,27.833333,15.5,74,1101,1237,-136,1,0,0.166667,0,55,6,6,0.618182,0,1,11,7,false,false,false,0.473,0.527
91,241,-150,15.166667,40.166667,-150,2143,2219,-76,0,0,0,0,57,6,6,0.54386,0,0,17,20,false,false,false,0,1
280,331,-51,25.454545,33.1,-51,1086,926,160,0,2,0,0.2,11,11,10,2.545455,0,0,13,10,false,false,false,0.001,0.999
83,140,-57,13.833333,23.333333,-57,1094,1159,-65,0,0,0,0,55,6,6,0.690909,0,0,23,21,false,false,false,0.047,0.953
180,257,-77,12.857143,18.357143,-77,278,1,277,0,0,0,0,2,14,14,18.5,0,0,21,14,false,false,false,0,1
296,305,-9,16.444444,16.944444,-9,518,461,57,0,0,0,0,-20,18,18,-1.8,0,0,2,2,true,false,false,0.301,0.699
132,153,-21,16.5,21.857143,-21,1161,1030,131,0,1,0,0.142857,45,8,7,0.844444,0,0,12,10,false,false,false,0.183,0.817
189,244,-55,17.181818,24.4,-55,1055,840,215,0,1,0,0.1,26,11,10,1.384615,1,0,10,16,false,false,false,0.005,0.995
249,269,-20,15.5625,17.933333,-20,970,1030,-60,0,0,0,0,1,16,15,40,0,0,13,9,false,false,false,0.055,0.945
162,162,0,18,18,0,1633,1556,77,0,0,0,0,32,9,9,1.03125,0,0,22,19,false,false,false,0.204,0.796
125,120,5,17.857143,17.142857,5,526,502,24,0,0,0,0,57,7,7,0.877193,0,0,14,7,false,false,true,0.66,0.34
35,25,10,17.5,12.5,10,711,746,-35,0,0,0,0,89,2,2,0.426966,0,1,24,7,false,false,false,0.284,0.716
263,259,4,20.230769,21.583333,4,971,635,336,0,0,0,0,4,13,12,8,1,0,9,10,false,false,false,0.036,0.964
197,215,-18,21.888889,26.875,-18,1305,1211,94,1,0,0.111111,0,44,9,8,0.75,1,0,6,12,false,false,false,0.058,0.942
56,93,-37,11.2,23.25,-37,561,688,-127,0,0,0,0,71,5,4,0.647887,0,1,11,6,false,false,false,0.038,0.962
144,223,-79,18,31.857143,-79,594,648,-54,1,1,0.125,0.142857,45,8,7,0.888889,0,0,14,7,false,false,false,0,1
91,25,66,18.2,6.25,66,1193,1220,-27,0,0,0,0,69,5,4,0.623188,1,1,9,24,false,false,true,0.724,0.276
215,251,-36,16.538462,19.307692,-36,1123,1062,61,0,0,0,0,19,13,13,2.315789,0,1,13,7,false,false,false,0.179,0.821
285,418,-133,16.764706,24.588235,-133,1229,1220,9,0,1,0,0.058824,-9,17,17,-4.111111,0,0,3,2,false,false,false,0,1
62,88,-26,20.666667,29.333333,-26,1102,1245,-143,0,0,0,0,76,3,3,0.381579,0,0,7,9,false,false,false,0.255,0.745
214,193,21,21.4,19.3,21,664,786,-122,0,0,0,0,31,10,10,1.064516,1,0,11,9,false,false,true,0.678,0.322
129,111,18,18.428571,15.857143,18,1633,1556,77,0,0,0,0,47,7,7,0.702128,0,0,16,7,false,false,true,0.681,0.319
292,390,-98,16.222222,21.666667,-98,848,976,-128,0,1,0,0.055556,-10,18,18,-4,0,0,4,5,false,false,false,0,1
131,97,34,26.2,24.25,34,1078,1095,-17,1,0,0.2,0,64,5,4,0.578125,0,1,15,15,false,false,false,0.164,0.836
210,263,-53,17.5,21.916667,-53,1257,1176,81,1,0,0.083333,0,24,12,12,1.416667,1,0,9,13,false,false,false,0.143,0.857
37,54,-17,18.5,27,-17,1432,1452,-20,0,0,0,0,83,2,2,0.433735,0,0,16,11,false,false,true,0.664,0.336
244,199,45,22.181818,18.090909,45,540,498,42,1,0,0.090909,0,24,11,11,1.916667,0,1,7,15,false,false,false,0.087,0.913
112,156,-44,14,22.285714,-44,344,315,29,1,0,0.125,0,38,8,7,1.052632,1,0,27,11,false,false,false,0.344,0.656
184,218,-34,15.333333,19.818182,-34,568,570,-2,0,0,0,0,24,12,11,1.541667,0,0,18,14,false,false,false,0.038,0.962
269,261,8,24.454545,26.1,8,804,1074,-270,0,0,0,0,18,11,10,1.777778,0,1,12,12,false,false,false,0.109,0.891
12,8,4,12,8,4,808,749,59,0,0,0,0,93,1,1,0.451613,0,1,9,19,false,false,false,0.34,0.66
111,118,-7,15.857143,19.666667,-7,388,542,-154,0,0,0,0,47,7,6,0.787234,0,0,8,15,false,false,false,0.251,0.749
31,20,11,15.5,10,11,1495,1597,-102,0,0,0,0,87,2,2,0.367816,0,0,17,12,false,false,true,0.621,0.379
145,142,3,20.714286,23.666667,3,1645,1636,9,0,1,0,0.166667,46,7,6,0.717391,0,1,19,16,false,false,false,0.202,0.798
293,268,25,19.533333,19.142857,25,1168,1062,106,0,0,0,0,13,15,14,3.307692,1,0,6,8,false,false,true,0.75,0.25
180,240,-60,18,26.666667,-60,971,800,171,0,1,0,0.111111,15,10,9,1.933333,0,0,12,11,false,false,false,0.005,0.995
74,147,-73,18.5,36.75,-73,1408,1539,-131,0,1,0,0.25,68,4,4,0.5,0,0,12,12,false,false,false,0.192,0.808
246,267,-21,17.571429,19.071429,-21,803,786,17,1,0,0.071429,0,3,14,14,10.666667,0,0,11,18,false,false,false,0.196,0.804
228,357,-129,17.538462,29.75,-129,726,818,-92,0,1,0,0.083333,10,13,12,3.5,0,0,23,11,false,false,false,0,1
65,81,-16,16.25,27,-16,1193,1177,16,0,0,0,0,76,4,3,0.460526,0,0,8,11,false,false,false,0.275,0.725
148,291,-143,21.142857,48.5,-143,1556,1656,-100,0,2,0,0.333333,38,7,6,0.789474,0,0,12,16,false,false,false,0,1
283,314,-31,14.894737,16.526316,-31,518,414,104,0,1,0,0.052632,-15,19,19,-2.533333,0,0,12,4,true,false,false,0,1
86,226,-140,8.6,25.111111,-140,1101,1130,-29,0,1,0,0.111111,47,10,9,0.957447,0,1,8,7,false,false,false,0,1
209,501,-292,17.416667,41.75,-292,1632,2020,-388,0,2,0,0.166667,5,12,12,6.2,0,0,24,8,false,false,false,0,1
198,288,-90,18,26.181818,-90,1047,1253,-206,1,1,0.090909,0.090909,28,11,11,1.321429,0,0,17,7,false,false,false,0,1
205,237,-32,17.083333,21.545455,-32,356,498,-142,0,1,0,0.090909,17,12,11,2.058824,1,0,9,16,false,false,false,0.195,0.805
138,255,-117,17.25,31.875,-117,1232,1281,-49,0,2,0,0.25,34,8,8,0.911765,0,0,12,11,false,false,false,0,1
6,11,-5,6,11,-5,964,1003,-39,0,0,0,0,94,1,1,0.414894,0,1,18,9,false,false,false,0.255,0.745
235,290,-55,21.363636,26.363636,-55,1473,1500,-27,0,2,0,0.181818,23,11,11,1.695652,1,0,19,8,false,false,false,0.077,0.923
185,281,-96,18.5,31.222222,-96,1232,1281,-49,0,2,0,0.222222,24,10,9,1.291667,1,0,12,12,false,false,false,0.004,0.996
249,295,-46,17.785714,21.071429,-46,944,1095,-151,0,1,0,0.071429,19,14,14,2.052632,0,2,9,8,false,false,false,0.002,0.998
181,205,-24,22.625,29.285714,-24,1636,1727,-91,0,2,0,0.285714,41,8,7,0.731707,1,1,13,8,false,false,false,0.357,0.643
215,223,-8,16.538462,17.153846,-8,840,1055,-215,0,0,0,0,11,13,13,3.181818,0,0,11,9,false,false,false,0.235,0.765
133,126,7,19,21,7,1075,878,197,0,0,0,0,59,7,6,0.559322,0,1,10,16,false,false,false,0.204,0.796
125,159,-34,20.833333,26.5,-34,356,498,-142,0,1,0,0.166667,56,6,6,0.625,1,1,10,17,false,false,false,0.017,0.983
283,286,-3,17.6875,19.066667,-3,822,845,-23,0,0,0,0,-3,16,15,-11.666667,0,0,17,8,false,false,false,0.239,0.761
269,293,-24,22.416667,24.416667,-24,1237,1265,-28,1,0,0.083333,0,5,12,12,7.2,0,0,7,13,false,false,false,0.198,0.802
165,276,-111,12.692308,21.230769,-111,1305,1307,-2,0,1,0,0.076923,15,13,13,2.733333,0,1,10,10,false,false,false,0,1
278,301,-23,23.166667,27.363636,-23,1439,1314,125,0,0,0,0,12,12,11,2.333333,0,0,10,11,false,false,false,0.04,0.96
152,242,-90,21.714286,34.571429,-90,1633,1680,-47,0,1,0,0.142857,34,7,7,0.823529,0,0,12,11,false,false,false,0.006,0.994
114,159,-45,12.666667,17.666667,-45,907,878,29,0,0,0,0,55,9,9,0.781818,0,0,15,9,false,false,false,0.04,0.96
77,152,-75,11,21.714286,-75,343,570,-227,0,0,0,0,45,7,7,0.8,0,0,25,10,false,false,false,0.229,0.771
265,328,-63,18.928571,23.428571,-63,694,658,36,0,1,0,0.071429,8,14,14,4.625,0,0,12,9,false,false,false,0,1
10,0,10,10,0,10,568,570,-2,0,0,0,0,97,1,0,0.381443,0,0,11,0,false,false,false,0.27,0.73
150,181,-31,16.666667,20.111111,-31,1484,1556,-72,0,1,0,0.111111,31,9,9,1,1,0,10,14,false,false,false,0.187,0.813
223,317,-94,15.928571,24.384615,-94,1305,1254,51,0,1,0,0.076923,0,14,13,0,0,0,16,10,false,false,false,0,1
44,49,-5,14.666667,24.5,-5,1770,1751,19,0,0,0,0,76,3,2,0.381579,0,1,16,8,false,false,false,0.443,0.557
94,58,36,15.666667,11.6,36,1065,948,117,0,0,0,0,65,6,5,0.6,1,0,19,17,false,false,true,0.878,0.122
310,321,-11,20.666667,22.928571,-11,786,885,-99,1,1,0.066667,0.071429,6,15,14,5.666667,0,0,5,13,false,false,false,0.004,0.996
143,172,-29,20.428571,24.571429,-29,1561,1495,66,1,0,0.142857,0,42,7,7,0.785714,1,0,8,8,false,false,true,0.647,0.353
230,289,-59,20.909091,26.272727,-59,1454,1479,-25,1,0,0.090909,0,19,11,11,1.631579,0,0,18,23,false,false,false,0,1
217,365,-148,14.466667,26.071429,-148,473,683,-210,0,0,0,0,3,15,14,12.666667,0,0,7,9,false,false,false,0,1
48,77,-29,12,25.666667,-29,1176,1133,43,0,0,0,0,81,4,3,0.419753,2,0,8,17,false,false,false,0.476,0.524
404,452,-48,25.25,28.25,-48,1770,1745,25,2,1,0.125,0.0625,-11,16,16,-3,0,0,2,1,false,false,false,0.002,0.998
231,247,-16,16.5,17.642857,-16,306,468,-162,0,0,0,0,15,14,14,2.466667,0,0,11,7,false,false,false,0.458,0.542
215,210,5,17.916667,19.090909,5,1633,1556,77,0,0,0,0,16,12,11,2.0625,0,0,9,10,false,false,false,0.178,0.822
182,143,39,45.5,35.75,39,169,306,-137,2,1,0.5,0.25,54,4,4,0.574074,0,0,14,11,false,false,false,0.231,0.769
109,205,-96,9.083333,18.636364,-96,1078,983,95,0,0,0,0,38,12,11,1.263158,1,1,9,17,false,false,false,0,1
104,156,-52,14.857143,22.285714,-52,344,315,29,1,0,0.142857,0,42,7,7,0.952381,0,0,28,11,false,false,false,0.296,0.704
218,214,4,13.625,14.266667,4,999,1071,-72,0,0,0,0,2,16,15,20,0,0,17,17,false,false,false,0.144,0.856
252,275,-23,18,21.153846,-23,889,895,-6,0,1,0,0.076923,11,14,13,3.363636,0,1,11,28,false,false,false,0.002,0.998
323,324,-1,17.944444,19.058824,-1,1168,1062,106,0,0,0,0,-3,18,17,-14.333333,1,0,2,5,false,false,true,0.949,0.051
290,344,-54,17.058824,21.5,-54,1493,1453,40,0,0,0,0,-15,17,16,-2.333333,0,2,1,2,false,false,false,0,1
169,246,-77,15.363636,22.363636,-77,341,416,-75,0,0,0,0,31,11,11,1.258065,0,1,9,10,false,false,false,0,1
78,111,-33,13,22.2,-33,1210,1162,48,0,0,0,0,60,6,5,0.533333,0,0,16,16,false,false,false,0.201,0.799
254,320,-66,14.111111,18.823529,-66,1278,1101,177,0,1,0,0.058824,-9,18,17,-4.111111,0,0,10,1,false,false,false,0.026,0.974
307,250,57,23.615385,20.833333,57,1373,1334,39,1,1,0.076923,0.083333,15,13,12,2.133333,1,1,6,12,false,false,true,0.936,0.064
301,406,-105,14.333333,19.333333,-105,952,826,126,0,1,0,0.047619,-26,21,21,-1.653846,0,0,1,2,false,false,false,0,1
260,275,-15,18.571429,19.642857,-15,1021,1094,-73,1,0,0.071429,0,7,14,14,5.285714,1,0,15,10,false,false,false,0.327,0.673
72,0,72,72,0,72,1699,1580,119,1,0,1,0,93,1,0,0.322581,0,0,8,0,false,false,true,0.839,0.161
101,163,-62,14.428571,23.285714,-62,948,998,-50,0,0,0,0,48,7,7,0.770833,1,0,7,8,false,false,false,0.111,0.889
0,16,-16,0,16,-16,1269,1477,-208,0,0,0,0,97,1,1,0.360825,0,0,10,10,false,false,false,0.25,0.75
311,349,-38,16.368421,19.388889,-38,1220,1185,35,0,1,0,0.055556,-9,19,18,-5.222222,0,0,13,10,false,false,false,0,1
100,142,-42,20,35.5,-42,976,995,-19,0,1,0,0.25,68,5,4,0.558824,0,0,13,16,false,false,false,0.2,0.8
29,30,-1,9.666667,15,-1,1269,1477,-208,0,0,0,0,87,3,2,0.402299,0,0,9,8,false,false,false,0.251,0.749
267,319,-52,19.071429,24.538462,-52,566,742,-176,0,1,0,0.076923,1,14,13,32,0,0,4,12,false,false,false,0,1
78,63,15,15.6,15.75,15,1656,1580,76,0,0,0,0,70,5,4,0.471429,0,0,12,9,false,false,false,0.478,0.522
102,99,3,12.75,14.142857,3,917,856,61,0,0,0,0,58,8,7,0.568966,0,1,20,6,false,false,false,0.437,0.563
398,468,-70,30.615385,39,-70,2010,2219,-209,1,2,0.076923,0.166667,-9,13,12,-2.888889,0,0,7,1,false,false,false,0,1
171,174,-3,21.375,21.75,-3,758,904,-146,1,0,0.125,0,37,8,8,0.918919,0,0,10,7,false,false,false,0.298,0.702
334,364,-30,15.181818,16.545455,-30,1220,1185,35,0,1,0,0.045455,-25,22,22,-1.88,0,0,8,4,false,false,false,0,1
259,279,-20,19.923077,23.25,-20,1428,1361,67,0,0,0,0,8,13,12,4.125,1,0,9,10,false,false,false,0.066,0.934
251,263,-12,16.733333,18.785714,-12,1123,1062,61,0,0,0,0,10,15,14,4.4,0,0,9,8,false,false,false,0.199,0.801
295,342,-47,14.047619,17.1,-47,500,509,-9,0,0,0,0,-25,21,20,-1.64,0,0,2,1,true,false,false,0,1
252,279,-27,21,25.363636,-27,689,804,-115,0,0,0,0,15,12,11,2.333333,0,0,7,7,false,false,false,0.037,0.963
267,414,-147,19.071429,29.571429,-147,976,995,-19,1,2,0.071429,0.142857,3,14,14,12.666667,0,0,9,12,false,false,false,0,1
319,334,-15,16.789474,17.578947,-15,720,437,283,0,0,0,0,-11,19,19,-3.818182,0,0,5,3,false,false,false,0.001,0.999
64,92,-28,12.8,18.4,-28,1269,1477,-208,0,0,0,0,68,5,5,0.514706,1,0,6,12,false,false,false,0.246,0.754
259,344,-85,12.95,18.105263,-85,714,892,-178,0,2,0,0.105263,-19,20,19,-2.210526,0,0,6,6,false,false,false,0,1
264,369,-105,16.5,24.6,-105,1270,1424,-154,0,2,0,0.133333,-5,16,15,-7,0,0,14,6,false,false,false,0,1
272,291,-19,14.315789,15.315789,-19,797,796,1,0,0,0,0,-8,19,19,-6.125,0,0,10,7,false,false,false,0.008,0.992
355,457,-102,25.357143,32.642857,-102,2143,2219,-76,1,0,0.071429,0,-15,14,14,-2.066667,0,0,5,1,false,false,false,0,1
223,246,-23,15.928571,18.923077,-23,1439,1428,11,0,0,0,0,18,14,13,2.222222,1,0,12,16,false,false,false,0.196,0.804
6,0,6,6,0,6,913,1037,-124,0,0,0,0,97,1,1,0.42268,0,0,19,12,false,false,false,0.253,0.747
217,373,-156,13.5625,23.3125,-156,760,976,-216,0,1,0,0.0625,-13,16,16,-2.769231,0,0,4,18,false,false,false,0,1
106,164,-58,15.142857,27.333333,-58,944,1095,-151,0,1,0,0.166667,61,7,6,0.639344,0,1,9,17,false,false,false,0.038,0.962
12,0,12,12,0,12,939,969,-30,0,0,0,0,97,1,0,0.340206,0,0,8,0,false,false,false,0.348,0.652
25,33,-8,12.5,16.5,-8,651,996,-345,0,0,0,0,88,2,2,0.511364,0,0,9,14,false,false,false,0.251,0.749
119,195,-76,14.875,24.375,-76,1270,1424,-154,0,1,0,0.125,53,8,8,0.660377,0,0,12,8,false,false,false,0.038,0.962
239,278,-39,26.555556,30.888889,-39,1164,1161,3,0,1,0,0.111111,15,9,9,1.533333,0,1,16,9,false,false,false,0.16,0.84
151,160,-9,16.777778,20,-9,595,538,57,0,0,0,0,39,9,8,0.974359,0,1,16,10,false,false,false,0.151,0.849
48,102,-54,12,25.5,-54,341,416,-75,0,0,0,0,77,4,4,0.506494,0,0,16,12,false,false,false,0.11,0.89
50,66,-16,16.666667,33,-16,1315,1331,-16,0,0,0,0,82,3,2,0.402439,0,0,14,12,false,false,false,0.364,0.636
210,236,-26,17.5,21.454545,-26,1257,1176,81,1,0,0.083333,0,29,12,11,1.172414,1,0,9,10,false,false,false,0.305,0.695
12,12,0,12,12,0,1043,1003,40,0,0,0,0,91,1,1,0.417582,0,0,27,9,false,false,true,0.679,0.321
106,85,21,17.666667,14.166667,21,720,437,283,0,0,0,0,66,6,6,0.636364,0,1,12,13,false,false,false,0.484,0.516
165,273,-108,15,24.818182,-108,976,995,-19,0,1,0,0.090909,30,11,11,1.266667,0,0,8,9,false,false,false,0,1
12,0,12,12,0,12,775,786,-11,0,0,0,0,96,1,0,0.447917,0,0,8,0,false,false,false,0.367,0.633
0,22,-22,0,22,-22,944,1095,-151,0,0,0,0,95,1,1,0.410526,0,0,23,8,false,false,false,0.251,0.749
18,13,5,9,13,5,361,413,-52,0,0,0,0,88,2,1,0.465909,0,0,26,13,false,false,false,0.253,0.747
190,315,-125,15.833333,28.636364,-125,1193,1177,16,0,1,0,0.090909,24,12,11,1.458333,0,0,15,11,false,false,false,0,1
39,39,0,19.5,19.5,0,1349,1203,146,0,0,0,0,85,2,2,0.376471,0,1,8,6,false,false,true,0.66,0.34
316,267,49,24.307692,20.538462,49,1093,1173,-80,1,0,0.076923,0,16,13,13,2.6875,0,0,12,7,false,false,true,0.996,0.004
66,109,-43,16.5,27.25,-43,1253,1324,-71,0,0,0,0,71,4,4,0.408451,0,0,17,12,false,false,false,0.203,0.797
24,49,-25,24,49,-25,576,602,-26,0,0,0,0,94,1,1,0.446809,0,0,12,11,false,false,false,0.099,0.901
367,460,-93,30.583333,38.333333,-93,1699,1580,119,3,2,0.25,0.166667,5,12,12,6,0,0,17,12,false,false,false,0,1
221,217,4,20.090909,21.7,4,1633,1739,-106,1,0,0.090909,0,29,11,10,1.172414,1,0,8,10,false,false,false,0.388,0.612
244,272,-28,17.428571,20.923077,-28,568,570,-2,0,0,0,0,13,14,13,2.846154,0,1,9,10,false,false,false,0.005,0.995
10,0,10,10,0,10,1037,1016,21,0,0,0,0,98,1,0,0.591837,0,0,7,0,false,false,true,0.665,0.335
284,361,-77,20.285714,25.785714,-77,653,1004,-351,0,0,0,0,-6,14,14,-4.833333,0,0,16,4,false,false,false,0,1
158,103,55,15.8,11.444444,55,1040,1091,-51,0,0,0,0,40,10,9,1.175,0,1,10,24,false,false,false,0.318,0.682
294,325,-31,21,23.214286,-31,1691,1510,181,0,1,0,0.071429,-6,14,14,-5,1,0,2,7,false,false,false,0.014,0.986
152,176,-24,13.818182,16,-24,361,413,-52,0,0,0,0,27,11,11,1.518519,2,0,8,10,false,false,false,0.168,0.832
111,160,-49,22.2,32,-49,907,910,-3,0,1,0,0.2,65,5,5,0.661538,0,0,18,10,false,false,false,0.204,0.796
160,143,17,20,20.428571,17,985,1062,-77,0,0,0,0,43,8,7,0.860465,0,0,10,10,false,false,true,0.612,0.388
279,340,-61,18.6,24.285714,-61,771,668,103,2,0,0.133333,0,-9,15,14,-4.222222,1,0,16,20,false,false,false,0,1
164,210,-46,18.222222,23.333333,-46,620,698,-78,1,0,0.111111,0,41,9,9,1,0,0,22,7,false,false,false,0.079,0.921
186,161,25,16.909091,16.1,25,1000,960,40,0,0,0,0,29,11,10,1.551724,0,0,18,19,false,false,false,0.378,0.622
155,208,-53,19.375,26,-53,1315,1331,-16,0,0,0,0,42,8,8,0.785714,0,0,10,18,false,false,false,0.177,0.823
91,142,-51,15.166667,28.4,-51,1656,1580,76,0,1,0,0.2,61,6,5,0.540984,0,0,13,16,false,false,false,0.029,0.971
145,108,37,18.125,15.428571,37,1168,1216,-48,0,0,0,0,61,8,7,0.540984,0,0,18,14,false,false,false,0.405,0.595
113,76,37,22.6,15.2,37,1652,1473,179,1,0,0.2,0,59,5,5,0.508475,0,0,15,10,false,false,true,0.823,0.177
255,247,8,23.181818,22.454545,8,824,830,-6,1,0,0.090909,0,27,11,11,1.62963,0,0,7,18,false,false,false,0.3,0.7
248,349,-101,19.076923,29.083333,-101,999,1283,-284,0,2,0,0.166667,12,13,12,2.75,0,0,18,10,false,false,false,0,1
63,39,24,21,13,24,1110,1123,-13,0,0,0,0,72,3,3,0.458333,0,0,16,7,false,false,true,0.724,0.276
168,226,-58,33.6,56.5,-58,2147,2219,-72,0,2,0,0.5,55,5,4,0.436364,0,0,10,10,false,false,false,0.186,0.814
183,186,-3,18.3,18.6,-3,480,518,-38,0,0,0,0,29,10,10,1.37931,0,1,8,8,false,false,false,0.207,0.793
14,0,14,14,0,14,342,263,79,0,0,0,0,97,1,0,0.350515,0,0,7,0,false,false,true,0.576,0.424
149,192,-43,18.625,24,-43,1344,1208,136,0,1,0,0.125,46,8,8,0.652174,0,0,10,13,false,false,false,0.042,0.958
20,14,6,20,14,6,1397,1405,-8,0,0,0,0,89,1,1,0.325843,0,0,7,19,false,false,true,0.677,0.323
266,399,-133,17.733333,28.5,-133,1484,1556,-72,0,2,0,0.142857,-10,15,14,-3.1,0,0,4,3,false,false,false,0,1
343,434,-91,24.5,33.384615,-91,1770,1751,19,0,1,0,0.076923,-10,14,13,-2.9,0,0,1,2,false,false,false,0,1
304,305,-1,17.882353,19.0625,-1,985,1062,-77,0,0,0,0,-12,17,16,-3.083333,1,0,4,5,false,false,false,0.392,0.608
195,198,-3,15,15.230769,-3,1040,1091,-51,0,0,0,0,21,13,13,2.238095,0,1,10,15,false,false,false,0.11,0.89
279,341,-62,17.4375,22.733333,-62,954,939,15,1,0,0.0625,0,-11,16,15,-3.272727,0,1,4,8,false,false,false,0,1
196,202,-6,19.6,22.444444,-6,1210,1162,48,0,0,0,0,35,10,9,0.914286,1,0,6,18,false,false,false,0.237,0.763
279,325,-46,11.625,14.130435,-46,1071,1000,71,0,0,0,0,-29,24,23,-1.62069,0,0,1,1,true,false,false,0,1
230,265,-35,19.166667,24.090909,-35,1205,1216,-11,0,0,0,0,21,12,11,1.571429,0,0,16,12,false,false,false,0.142,0.858
101,85,16,14.428571,12.142857,16,721,757,-36,0,0,0,0,57,7,7,0.666667,0,1,16,15,false,false,false,0.403,0.597
84,126,-42,16.8,31.5,-42,944,1095,-151,0,1,0,0.25,71,5,4,0.549296,0,0,7,17,false,false,false,0.039,0.961
27,91,-64,9,30.333333,-64,518,414,104,0,1,0,0.333333,77,3,3,0.493506,0,0,23,7,false,false,false,0.209,0.791
379,414,-35,27.071429,29.571429,-35,820,718,102,0,2,0,0.142857,-15,14,14,-1.866667,0,0,6,3,true,false,false,0,1
294,433,-139,24.5,36.083333,-139,1586,1633,-47,1,1,0.083333,0.083333,14,12,12,2.428571,0,0,12,15,false,false,false,0,1
165,229,-64,13.75,19.083333,-64,1071,1000,71,0,0,0,0,30,12,12,1.566667,0,1,9,13,false,false,false,0.002,0.998
226,379,-153,12.555556,22.294118,-153,760,976,-216,0,1,0,0.058824,-23,18,17,-1.565217,0,0,1,15,false,false,false,0,1
125,293,-168,17.857143,48.833333,-168,1219,1216,3,0,3,0,0.5,39,7,6,0.692308,0,0,8,16,false,false,false,0,1
14,0,14,14,0,14,804,766,38,0,0,0,0,96,1,0,0.427083,0,0,17,0,false,false,true,0.676,0.324
323,311,12,19,18.294118,12,1488,1428,60,1,0,0.058824,0,-8,17,17,-4.625,0,1,29,4,false,false,true,0.834,0.166
111,163,-52,13.875,20.375,-52,388,542,-154,0,0,0,0,39,8,8,0.948718,0,0,11,24,false,false,false,0.038,0.962
266,403,-137,17.733333,26.866667,-137,1572,1777,-205,0,2,0,0.133333,-14,15,15,-2.357143,0,0,16,2,false,false,false,0,1
126,170,-44,18,24.285714,-44,1349,1203,146,0,1,0,0.142857,48,7,7,0.666667,0,0,12,8,false,false,false,0.095,0.905
115,186,-71,12.777778,20.666667,-71,917,856,61,0,1,0,0.111111,43,9,9,0.767442,0,1,21,15,false,false,false,0.114,0.886
125,96,29,17.857143,16,29,526,502,24,0,0,0,0,60,7,6,0.833333,0,0,14,11,false,false,true,0.779,0.221
38,26,12,38,26,12,1431,1399,32,0,0,0,0,93,1,1,0.268817,0,1,13,8,false,false,true,0.688,0.312
291,352,-61,14.55,17.6,-61,620,698,-78,1,0,0.05,0,-25,20,20,-1.64,1,0,3,1,false,false,false,0,1
16,26,-10,8,26,-10,1131,1030,101,0,0,0,0,89,2,1,0.337079,0,0,10,16,false,false,false,0.214,0.786
255,275,-20,13.421053,14.473684,-20,999,1071,-72,0,0,0,0,-18,19,19,-2.222222,0,0,2,3,false,false,false,0.052,0.948
46,57,-11,23,28.5,-11,804,1080,-276,0,0,0,0,83,2,2,0.409639,1,0,7,12,false,false,false,0.206,0.794
248,328,-80,16.533333,21.866667,-80,1071,1181,-110,0,0,0,0,4,15,15,8.5,0,1,10,9,false,false,false,0,1
199,272,-73,16.583333,22.666667,-73,1071,1181,-110,0,0,0,0,24,12,12,1.416667,0,0,12,16,false,false,false,0,1
208,217,-9,20.8,21.7,-9,1633,1739,-106,1,0,0.1,0,32,10,10,1.0625,0,0,7,10,false,false,false,0.169,0.831
314,397,-83,19.625,24.8125,-83,527,954,-427,0,1,0,0.0625,-7,16,16,-5,0,0,8,4,false,false,false,0,1
167,216,-49,27.833333,43.2,-49,1164,1261,-97,0,1,0,0.2,59,6,5,0.711864,0,0,21,13,false,false,false,0.154,0.846
294,342,-48,16.333333,19,-48,480,518,-38,0,0,0,0,-17,18,18,-2.352941,0,0,4,1,false,false,false,0,1
318,368,-50,21.2,24.533333,-50,1021,897,124,0,2,0,0.133333,-14,15,15,-2.642857,0,0,11,3,false,false,false,0,1
320,340,-20,13.913043,15.454545,-20,561,688,-127,0,0,0,0,-19,23,22,-2.421053,0,0,1,4,false,false,false,0.001,0.999
231,406,-175,21,36.909091,-175,786,848,-62,0,2,0,0.181818,19,11,11,1.631579,0,0,20,10,false,false,false,0,1
51,192,-141,10.2,38.4,-141,940,947,-7,0,2,0,0.4,60,5,5,0.583333,0,0,11,16,false,false,false,0,1
96,190,-94,9.6,21.111111,-94,1078,983,95,0,0,0,0,49,10,9,0.979592,1,1,7,14,false,false,false,0,1
148,102,46,24.666667,20.4,46,1093,1100,-7,1,0,0.166667,0,63,6,5,0.492063,0,1,7,21,false,false,false,0.232,0.768
201,146,55,22.333333,18.25,55,1691,1551,140,0,0,0,0,43,9,8,0.860465,0,1,7,28,false,false,false,0.371,0.629
68,60,8,22.666667,20,8,1094,1041,53,0,0,0,0,76,3,3,0.5,1,0,13,8,false,false,true,0.776,0.224
223,200,23,27.875,28.571429,23,824,830,-6,1,0,0.125,0,48,8,7,0.916667,0,0,7,14,false,false,false,0.13,0.87
295,325,-30,22.692308,25,-30,1070,814,256,1,1,0.076923,0.076923,2,13,13,16.5,0,0,12,9,false,false,false,0.013,0.987
202,193,9,18.363636,17.545455,9,1281,1268,13,0,0,0,0,31,11,11,1.354839,0,0,8,11,false,false,false,0.247,0.753
133,104,29,19,17.333333,29,897,996,-99,0,0,0,0,59,7,6,0.661017,0,0,10,7,false,false,false,0.292,0.708
296,353,-57,17.411765,20.764706,-57,694,658,36,0,1,0,0.058824,-12,17,17,-3.083333,0,0,6,1,false,false,false,0,1
250,227,23,22.727273,20.636364,23,1093,1173,-80,0,0,0,0,28,11,11,1.535714,0,0,10,14,false,false,false,0.372,0.628
274,373,-99,18.266667,24.866667,-99,1094,1159,-65,0,0,0,0,-9,15,15,-4.222222,1,0,5,7,false,false,false,0,1
232,230,2,17.846154,19.166667,2,1021,1094,-73,1,0,0.076923,0,18,13,12,2.055556,1,0,13,10,false,false,true,0.586,0.414
290,268,22,19.333333,19.142857,22,742,594,148,0,0,0,0,5,15,14,7.8,1,0,6,7,false,false,true,0.714,0.286
34,58,-24,17,29,-24,952,826,126,0,0,0,0,89,2,2,0.483146,1,0,7,10,false,false,true,0.62,0.38
330,340,-10,15.714286,16.190476,-10,720,437,283,0,0,0,0,-20,21,21,-2.1,0,0,3,2,true,false,false,0.081,0.919
297,273,24,22.846154,22.75,24,1397,1405,-8,1,0,0.076923,0,2,13,12,14.5,0,1,10,9,false,false,true,0.578,0.422
342,395,-53,16.285714,18.809524,-53,824,830,-6,1,0,0.047619,0,-24,21,21,-1.833333,0,0,2,2,false,false,false,0,1
71,56,15,11.833333,11.2,15,1045,948,97,0,0,0,0,61,6,5,0.557377,0,0,13,23,false,false,false,0.239,0.761
216,198,18,16.615385,15.230769,18,1030,998,32,0,0,0,0,15,13,13,2.466667,0,1,21,10,false,false,true,0.897,0.103
110,54,56,36.666667,18,56,1777,1689,88,1,0,0.333333,0,71,3,3,0.380282,0,0,18,9,false,false,true,0.817,0.183
325,433,-108,20.3125,27.0625,-108,1334,1439,-105,1,1,0.0625,0.0625,-1,16,16,-36,0,0,8,4,false,false,false,0,1
252,358,-106,14.823529,22.375,-106,503,668,-165,0,1,0,0.0625,-7,17,16,-5.285714,1,0,7,6,false,false,false,0,1
282,311,-29,21.692308,23.923077,-29,1691,1510,181,0,1,0,0.076923,4,13,13,7.5,1,0,6,13,false,false,false,0.031,0.969
114,101,13,16.285714,16.833333,13,1310,1477,-167,0,0,0,0,51,7,6,0.705882,1,0,9,14,false,false,false,0.295,0.705
176,344,-168,22,49.142857,-168,1632,2020,-388,0,2,0,0.285714,35,8,7,0.885714,0,1,10,8,false,false,false,0,1
281,275,6,18.733333,19.642857,6,1021,1094,-73,1,0,0.066667,0,5,15,14,7.4,1,0,6,10,false,false,false,0.153,0.847
12,0,12,12,0,12,1253,1324,-71,0,0,0,0,95,1,0,0.305263,0,0,11,0,false,false,true,0.52,0.48
130,145,-15,18.571429,24.166667,-15,653,820,-167,0,0,0,0,48,7,6,0.791667,0,0,14,21,false,false,false,0.187,0.813
217,300,-83,31,50,-83,2010,2219,-209,1,0,0.142857,0,41,7,6,0.634146,0,0,8,9,false,false,false,0,1
16,17,-1,8,17,-1,1606,1890,-284,0,0,0,0,89,2,1,0.314607,1,0,9,9,false,false,false,0.251,0.749
220,297,-77,15.714286,22.846154,-77,804,1080,-276,0,0,0,0,12,14,13,2.833333,1,0,9,9,false,false,false,0.001,0.999
256,344,-88,19.692308,28.666667,-88,1576,1556,20,0,1,0,0.083333,4,13,12,7.5,1,0,8,7,false,false,false,0.007,0.993
308,325,-17,20.533333,23.214286,-17,1691,1510,181,0,1,0,0.071429,-9,15,14,-3.333333,1,0,2,7,false,false,false,0.011,0.989
97,234,-137,16.166667,39,-137,1334,1486,-152,0,0,0,0,65,6,6,0.446154,1,0,6,15,false,false,false,0.001,0.999
210,150,60,30,25,60,1397,1405,-8,1,0,0.142857,0,46,7,6,0.630435,0,0,13,13,false,false,true,0.862,0.138
115,253,-138,10.454545,25.3,-138,530,683,-153,0,1,0,0.1,39,11,10,1.025641,0,0,19,13,false,false,false,0,1
276,316,-40,14.526316,17.555556,-40,613,525,88,0,0,0,0,-17,19,18,-2.470588,0,0,10,7,false,false,false,0,1
216,328,-112,14.4,23.428571,-112,1064,1397,-333,0,2,0,0.142857,15,15,14,2.866667,1,0,17,10,false,false,false,0,1
286,387,-101,35.75,55.285714,-101,1398,1431,-33,0,0,0,0,21,8,7,1.333333,0,1,14,12,false,false,false,0,1
67,79,-12,13.4,19.75,-12,1257,1176,81,0,0,0,0,78,5,4,0.435897,0,0,8,7,false,false,false,0.218,0.782
274,367,-93,18.266667,26.214286,-93,1094,1159,-65,0,0,0,0,-7,15,14,-5.428571,1,0,5,8,false,false,false,0,1
17,37,-20,8.5,18.5,-20,1656,1580,76,0,0,0,0,86,2,2,0.383721,0,0,14,9,false,false,false,0.272,0.728
323,334,-11,23.071429,25.692308,-11,804,1074,-270,0,0,0,0,-2,14,13,-16,0,0,3,11,false,false,false,0.058,0.942
68,68,0,8.5,9.714286,0,1037,1016,21,0,0,0,0,66,8,7,0.878788,0,1,13,9,false,false,false,0.05,0.95
320,340,-20,22.857143,26.153846,-20,1102,1245,-143,0,1,0,0.076923,-8,14,13,-3.625,0,0,5,3,false,false,false,0.16,0.84
234,202,32,29.25,28.857143,32,714,820,-106,1,0,0.125,0,44,8,7,0.704545,0,0,12,12,false,false,false,0.141,0.859
28,0,28,28,0,28,306,468,-162,0,0,0,0,95,1,1,0.389474,0,0,12,20,false,false,false,0.409,0.591
176,155,21,25.142857,25.833333,21,1093,1173,-80,0,0,0,0,59,7,6,0.728814,0,0,17,14,false,false,false,0.253,0.747
274,253,21,21.076923,19.461538,21,1168,1216,-48,0,0,0,0,22,13,13,1.5,0,1,7,9,false,false,true,0.508,0.492
14,39,-25,14,39,-25,1167,1245,-78,0,0,0,0,91,1,1,0.252747,0,0,11,15,false,false,true,0.576,0.424
161,210,-49,13.416667,17.5,-49,840,1055,-215,0,0,0,0,20,12,12,1.75,0,0,23,7,false,false,false,0.067,0.933
278,434,-156,23.166667,36.166667,-156,1606,1593,13,1,1,0.083333,0.083333,4,12,12,7.25,0,0,11,3,false,false,false,0,1
231,253,-22,16.5,19.461538,-22,907,1070,-163,0,0,0,0,18,14,13,1.944444,0,1,13,20,false,false,false,0.026,0.974
254,228,26,23.090909,22.8,26,1397,1405,-8,1,0,0.090909,0,19,11,10,1.526316,1,1,10,10,false,false,false,0.273,0.727
89,55,34,29.666667,18.333333,34,804,1074,-270,0,0,0,0,79,3,3,0.405063,0,0,7,20,false,false,false,0.288,0.712
31,23,8,10.333333,7.666667,8,1037,1016,21,0,0,0,0,87,3,3,0.666667,0,1,7,8,false,false,false,0.345,0.655
183,164,19,16.636364,14.909091,19,1344,1314,30,0,1,0,0.090909,30,11,11,1.133333,0,1,9,24,false,false,false,0.39,0.61
166,186,-20,12.769231,14.307692,-20,342,53,289,0,0,0,0,12,13,13,3.416667,0,0,10,19,false,false,true,0.555,0.445
152,113,39,25.333333,22.6,39,1770,1745,25,1,0,0.166667,0,65,6,5,0.507692,0,0,7,19,false,false,true,0.696,0.304
378,510,-132,23.625,34,-132,1586,1633,-47,1,1,0.0625,0.066667,-9,16,15,-3.777778,0,0,2,3,false,false,false,0,1
82,196,-114,13.666667,32.666667,-114,760,976,-216,0,1,0,0.166667,56,6,6,0.642857,0,0,7,11,false,false,false,0.001,0.999
116,125,-9,23.2,25,-9,689,804,-115,0,0,0,0,59,5,5,0.59322,0,0,12,19,false,false,false,0.249,0.751
358,442,-84,21.058824,26,-84,724,398,326,1,1,0.058824,0.058824,-9,17,17,-4.333333,0,0,9,8,false,false,false,0,1
73,135,-62,10.428571,22.5,-62,1368,1452,-84,0,0,0,0,62,7,6,0.516129,1,0,7,19,false,false,false,0.038,0.962
60,28,32,15,9.333333,32,797,796,1,0,0,0,0,83,4,3,0.590361,0,0,13,21,false,false,false,0.305,0.695
206,231,-25,20.6,25.666667,-25,1055,1019,36,0,0,0,0,23,10,9,1.434783,1,0,10,11,false,false,false,0.206,0.794
240,227,13,26.666667,25.222222,13,1354,1210,144,0,1,0,0.111111,35,9,9,0.942857,0,0,19,8,false,false,false,0.386,0.614
216,313,-97,12.705882,18.411765,-97,388,542,-154,0,0,0,0,-11,17,17,-3.363636,0,1,6,2,false,false,false,0,1
135,261,-126,16.875,32.625,-126,653,1004,-351,0,0,0,0,38,8,8,0.763158,0,0,9,9,false,false,false,0,1
97,41,56,32.333333,20.5,56,1488,1428,60,1,0,0.333333,0,80,3,2,0.4625,0,0,9,11,false,false,true,0.733,0.267
12,23,-11,12,23,-11,206,346,-140,0,0,0,0,93,1,1,0.462366,0,0,13,17,false,false,false,0.236,0.764
175,330,-155,17.5,33,-155,1368,1452,-84,1,1,0.1,0.1,33,10,10,0.969697,0,1,9,11,false,false,false,0,1
144,178,-34,16,19.777778,-34,1047,1253,-206,1,0,0.111111,0,46,9,9,0.804348,0,0,7,10,false,false,false,0.242,0.758
201,209,-8,18.272727,20.9,-8,1021,1094,-73,1,0,0.090909,0,32,11,10,1.15625,1,0,6,11,false,false,false,0.346,0.654
261,299,-38,21.75,24.916667,-38,1473,1500,-27,0,2,0,0.166667,18,12,12,2.166667,1,0,11,8,false,false,false,0.029,0.971
295,256,39,21.071429,19.692308,39,1488,1428,60,1,0,0.071429,0,13,14,13,2.846154,0,1,19,7,false,false,true,0.91,0.09
105,123,-18,17.5,24.6,-18,971,635,336,0,0,0,0,59,6,5,0.542373,0,0,21,12,false,false,false,0.209,0.791
28,44,-16,14,22,-16,668,771,-103,0,0,0,0,82,2,2,0.487805,0,0,17,11,false,false,false,0.254,0.746
142,141,1,23.666667,23.5,1,1055,1019,36,0,0,0,0,52,6,6,0.634615,0,0,11,11,false,false,true,0.652,0.348
158,187,-29,17.555556,23.375,-29,1493,1453,40,0,0,0,0,41,9,8,0.853659,0,0,12,11,false,false,false,0.199,0.801
66,112,-46,16.5,37.333333,-46,1021,897,124,0,1,0,0.333333,74,4,3,0.5,0,0,13,13,false,false,false,0.198,0.802
196,247,-51,16.333333,22.454545,-51,620,698,-78,1,0,0.083333,0,28,12,11,1.464286,0,0,21,14,false,false,false,0,1
180,224,-44,12.857143,16,-44,668,363,305,0,0,0,0,21,14,14,2.238095,1,1,18,9,false,false,false,0.016,0.984
91,171,-80,18.2,42.75,-80,1576,1556,20,0,1,0,0.25,61,5,4,0.491803,0,0,19,16,false,false,false,0.055,0.945
85,35,50,28.333333,17.5,50,691,704,-13,0,0,0,0,83,3,2,0.457831,0,0,13,9,false,false,true,0.801,0.199
266,317,-51,16.625,19.8125,-51,758,791,-33,0,0,0,0,-11,16,16,-3.545455,0,0,10,7,false,false,false,0,1
72,67,5,18,16.75,5,995,965,30,0,0,0,0,67,4,4,0.597015,0,0,21,7,false,false,true,0.685,0.315
106,94,12,26.5,23.5,12,1305,1254,51,0,0,0,0,68,4,4,0.470588,0,0,9,10,false,false,true,0.68,0.32
298,261,37,33.111111,32.625,37,820,718,102,0,2,0,0.25,25,9,8,1.12,0,0,10,9,false,false,true,0.864,0.136
26,3,23,26,3,23,1193,1220,-27,0,0,0,0,92,1,1,0.467391,1,1,10,25,false,false,true,0.544,0.456
261,372,-111,18.642857,28.615385,-111,1101,1115,-14,0,1,0,0.076923,-1,14,13,-30,1,0,8,7,false,false,false,0,1
129,144,-15,16.125,18,-15,500,532,-32,0,0,0,0,45,8,8,0.911111,0,0,14,10,false,false,false,0.264,0.736
120,102,18,24,20.4,18,1070,814,256,1,1,0.2,0.2,59,5,5,0.559322,0,0,10,19,false,false,true,0.946,0.054
146,241,-95,20.857143,40.166667,-95,786,848,-62,0,1,0,0.166667,57,7,6,0.54386,1,0,14,11,false,false,false,0.003,0.997
257,250,7,25.7,27.777778,7,1188,1334,-146,1,1,0.1,0.111111,20,10,9,1.5,1,0,7,13,false,false,true,0.909,0.091
54,88,-34,27,44,-34,1645,1636,9,0,1,0,0.5,80,2,2,0.4125,0,0,18,17,false,false,false,0.202,0.798
175,236,-61,19.444444,26.222222,-61,1428,1361,67,0,0,0,0,31,9,9,1.064516,0,0,16,9,false,false,false,0.169,0.831
255,281,-26,18.214286,21.615385,-26,343,570,-227,0,0,0,0,-1,14,13,-36,0,0,10,9,false,false,false,0.01,0.99
154,115,39,22,19.166667,39,1270,1261,9,1,0,0.142857,0,59,7,6,0.627119,0,0,7,17,false,false,true,0.766,0.234
64,25,39,21.333333,12.5,39,387,683,-296,0,0,0,0,79,3,2,0.43038,1,0,9,8,false,false,true,0.644,0.356
195,286,-91,15,23.833333,-91,595,412,183,0,1,0,0.083333,19,13,12,2.736842,0,0,14,12,false,false,false,0,1
143,138,5,15.888889,15.333333,5,1344,1314,30,0,1,0,0.111111,41,9,9,0.829268,0,0,11,22,false,false,false,0.285,0.715
291,352,-61,13.857143,17.6,-61,620,698,-78,1,0,0.047619,0,-25,21,20,-1.64,1,0,3,1,true,false,false,0,1
166,174,-8,20.75,24.857143,-8,1586,1633,-47,1,0,0.125,0,57,8,7,0.596491,0,0,21,12,false,false,false,0.154,0.846
135,159,-24,13.5,17.666667,-24,907,878,29,0,0,0,0,52,10,9,0.826923,1,0,11,9,false,false,false,0.05,0.95
270,278,-8,16.875,18.533333,-8,1045,948,97,0,0,0,0,-21,16,15,-1.619048,0,0,6,8,false,false,false,0.018,0.982
170,206,-36,21.25,25.75,-36,595,733,-138,1,1,0.125,0.125,34,8,8,1.147059,0,1,17,16,false,false,false,0.102,0.898
50,39,11,16.666667,13,11,848,976,-128,0,0,0,0,79,3,3,0.506329,0,0,10,18,false,false,false,0.255,0.745
276,270,6,21.230769,20.769231,6,939,969,-30,0,0,0,0,-1,13,13,-33,0,0,11,12,false,false,false,0.463,0.537
36,27,9,12,13.5,9,830,787,43,0,0,0,0,79,3,2,0.481013,0,0,22,21,false,false,true,0.672,0.328
222,249,-27,20.181818,22.636364,-27,1633,1620,13,0,0,0,0,18,11,11,2,0,1,9,15,false,false,false,0.048,0.952
108,103,5,36,34.333333,5,714,820,-106,1,0,0.333333,0,76,3,3,0.407895,0,0,15,18,false,false,false,0.021,0.979
120,546,-426,6,27.3,-426,1164,1149,15,0,3,0,0.15,6,20,20,7.833333,0,1,12,20,false,false,false,0.005,0.995
156,180,-24,17.333333,22.5,-24,775,786,-11,0,0,0,0,41,9,8,1.04878,1,0,10,17,false,false,false,0.065,0.935
135,186,-51,13.5,20.666667,-51,917,856,61,0,1,0,0.111111,38,10,9,0.868421,0,1,19,15,false,false,false,0.143,0.857
180,213,-33,16.363636,21.3,-33,775,786,-11,0,0,0,0,27,11,10,1.592593,1,0,12,20,false,false,false,0.086,0.914
227,307,-80,17.461538,25.583333,-80,1270,1424,-154,0,2,0,0.166667,18,13,12,1.944444,0,0,22,12,false,false,false,0,1
264,289,-25,22,24.083333,-25,1354,1210,144,0,1,0,0.083333,11,12,12,3,0,1,20,6,false,false,false,0.012,0.988
276,308,-32,18.4,20.533333,-32,758,904,-146,1,0,0.066667,0,-11,15,15,-3.090909,0,1,11,7,false,false,false,0,1
323,251,72,26.916667,20.916667,72,1156,1279,-123,2,0,0.166667,0,14,12,12,2.857143,0,1,7,17,false,false,true,1,0
14,21,-7,14,21,-7,2010,2219,-209,0,0,0,0,93,1,1,0.27957,1,1,11,18,false,false,true,0.672,0.328
28,37,-9,9.333333,18.5,-9,1656,1580,76,0,0,0,0,83,3,2,0.39759,0,0,18,9,false,false,false,0.271,0.729
137,261,-124,17.125,32.625,-124,473,683,-210,0,0,0,0,40,8,8,0.95,0,0,8,7,false,false,false,0,1
203,309,-106,20.3,34.333333,-106,1636,1702,-66,0,1,0,0.111111,30,10,9,0.966667,0,0,14,10,false,false,false,0,1
257,218,39,28.555556,24.222222,39,1373,1334,39,1,1,0.111111,0.111111,35,9,9,0.914286,0,0,10,19,false,false,true,0.959,0.041
10,22,-12,3.333333,11,-12,907,878,29,0,0,0,0,92,3,2,0.467391,0,0,20,10,false,false,false,0.38,0.62
98,153,-55,8.166667,12.75,-55,288,359,-71,0,0,0,0,38,12,12,0.710526,0,0,15,9,false,false,false,0.039,0.961
65,55,10,16.25,18.333333,10,1168,1062,106,0,0,0,0,77,4,3,0.558442,0,1,10,14,false,false,false,0.343,0.657
225,175,50,22.5,19.444444,50,1691,1510,181,0,1,0,0.111111,32,10,9,0.9375,1,0,9,14,false,false,true,0.927,0.073
38,10,28,19,10,28,388,542,-154,0,0,0,0,83,2,1,0.445783,1,0,24,17,false,false,true,0.653,0.347
148,171,-23,21.142857,28.5,-23,1315,1334,-19,0,1,0,0.166667,53,7,6,0.679245,0,0,7,10,false,false,false,0.201,0.799
316,232,84,24.307692,19.333333,84,1093,1173,-80,1,0,0.076923,0,18,13,12,2.388889,0,0,12,14,false,false,true,1,0
36,51,-15,12,25.5,-15,595,540,55,0,0,0,0,81,3,2,0.530864,0,0,12,8,false,false,true,0.667,0.333
12,39,-27,12,39,-27,835,786,49,0,0,0,0,95,1,1,0.357895,0,0,15,9,false,false,true,0.588,0.412
235,324,-89,19.583333,27,-89,1232,1281,-49,0,2,0,0.166667,7,12,12,4.428571,0,0,9,18,false,false,false,0,1
26,28,-2,13,14,-2,1161,1176,-15,0,0,0,0,84,2,2,0.452381,0,0,17,10,false,false,true,0.678,0.322
137,104,33,19.571429,14.857143,33,691,704,-13,0,0,0,0,59,7,7,0.644068,0,0,7,9,false,false,true,0.757,0.243
420,503,-83,35,41.916667,-83,2147,2219,-72,1,2,0.083333,0.166667,-9,12,12,-2.666667,0,0,7,1,true,false,false,0,1
48,29,19,24,14.5,19,1428,1361,67,0,0,0,0,82,2,2,0.402439,0,0,12,18,false,false,true,0.684,0.316
33,44,-11,16.5,22,-11,653,1004,-351,0,0,0,0,84,2,2,0.345238,0,0,7,10,false,false,false,0.251,0.749
167,224,-57,18.555556,24.888889,-57,1232,1448,-216,0,1,0,0.111111,34,9,9,1.029412,0,2,7,12,false,false,false,0.033,0.967
17,20,-3,8.5,20,-3,760,976,-216,0,0,0,0,90,2,1,0.4,0,1,16,9,false,false,false,0.249,0.751
311,328,-17,20.733333,23.428571,-17,1237,1265,-28,1,0,0.066667,0,-11,15,14,-3.272727,0,0,9,13,false,false,false,0.004,0.996
59,81,-22,14.75,20.25,-22,952,870,82,0,0,0,0,70,4,4,0.528571,0,0,11,25,false,false,false,0.203,0.797
156,229,-73,17.333333,28.625,-73,954,939,15,0,0,0,0,37,9,8,0.972973,1,1,21,8,false,false,false,0.011,0.989
139,249,-110,17.375,31.125,-110,976,995,-19,0,1,0,0.125,45,8,8,0.844444,0,0,8,11,false,false,false,0,1
228,296,-68,15.2,21.142857,-68,1161,1176,-15,1,1,0.066667,0.071429,-4,15,14,-9.5,0,0,11,23,false,false,false,0,1
109,113,-4,21.8,22.6,-4,621,786,-165,0,0,0,0,56,5,5,0.535714,0,0,10,12,false,false,false,0.251,0.749
153,287,-134,10.928571,20.5,-134,388,542,-154,0,0,0,0,8,14,14,4.625,0,1,11,6,false,false,false,0,1
85,93,-8,17,18.6,-8,889,895,-6,0,1,0,0.2,65,5,5,0.569231,0,0,10,15,false,false,false,0.433,0.567
258,299,-41,11.217391,13.590909,-41,683,859,-176,0,0,0,0,-2,23,22,-22.5,0,0,9,17,true,false,false,0,1
124,102,22,20.666667,20.4,22,796,800,-4,0,0,0,0,65,6,5,0.738462,0,0,10,10,false,false,true,0.605,0.395
149,122,27,16.555556,15.25,27,897,996,-99,0,0,0,0,43,9,8,0.906977,0,0,17,9,false,false,false,0.374,0.626
79,130,-51,26.333333,43.333333,-51,1925,1885,40,1,0,0.333333,0,69,3,3,0.362319,0,0,17,12,false,false,true,0.662,0.338
289,377,-88,20.642857,26.928571,-88,1176,1133,43,1,0,0.071429,0,11,14,14,3.090909,0,0,9,10,false,false,false,0,1
255,265,-10,17,18.928571,-10,907,1070,-163,0,0,0,0,12,15,14,2.916667,0,1,9,19,false,false,false,0.057,0.943
142,170,-28,17.75,21.25,-28,1021,1094,-73,1,0,0.125,0,44,8,8,0.840909,1,0,6,13,false,false,false,0.284,0.716
10,0,10,10,0,10,1770,1745,25,0,0,0,0,98,1,0,0.336735,0,0,8,0,false,false,true,0.678,0.322
250,306,-56,20.833333,25.5,-56,1110,1399,-289,0,1,0,0.083333,26,12,12,1.307692,0,0,10,13,false,false,false,0,1
187,265,-78,12.466667,18.928571,-78,951,976,-25,0,0,0,0,14,15,14,3.142857,0,0,9,12,false,false,false,0,1
12,15,-3,12,15,-3,668,363,305,0,0,0,0,92,1,1,0.51087,0,0,12,8,false,false,true,0.667,0.333
117,178,-61,16.714286,29.666667,-61,1656,1580,76,0,1,0,0.166667,53,7,6,0.622642,0,0,13,9,false,false,false,0.012,0.988
209,310,-101,16.076923,23.846154,-101,1075,878,197,0,1,0,0.076923,17,13,13,1.941176,0,0,14,9,false,false,false,0,1
118,117,1,13.111111,14.625,1,808,749,59,0,0,0,0,36,9,8,1.166667,0,0,21,9,false,false,true,0.621,0.379
268,401,-133,14.888889,23.588235,-133,1422,1510,-88,0,2,0,0.117647,-6,18,17,-6.5,0,0,9,10,false,false,false,0,1
273,399,-126,10.5,15.96,-126,1248,1220,28,0,1,0,0.04,-26,26,25,-2,0,0,2,4,false,false,false,0,1
279,372,-93,17.4375,24.8,-93,965,1078,-113,1,1,0.0625,0.066667,-5,16,15,-7.4,1,0,5,17,false,false,false,0,1
333,346,-13,17.526316,18.210526,-13,775,786,-11,1,0,0.052632,0,-21,19,19,-2.047619,0,0,13,15,false,false,false,0.27,0.73
309,364,-55,30.9,36.4,-55,1761,1770,-9,1,1,0.1,0.1,9,10,10,2.888889,0,0,13,9,false,false,false,0,1
161,187,-26,16.1,20.777778,-26,1075,878,197,0,0,0,0,42,10,9,0.785714,0,0,13,8,false,false,false,0.197,0.803
44,23,21,22,23,21,1633,1739,-106,0,0,0,0,91,2,1,0.373626,0,0,8,13,false,false,true,0.665,0.335
81,40,41,40.5,20,41,691,695,-4,1,0,0.5,0,80,2,2,0.4,0,0,21,16,false,false,true,0.793,0.207
171,165,6,21.375,20.625,6,566,742,-176,0,1,0,0.125,37,8,8,0.864865,0,0,7,15,false,false,true,0.67,0.33
185,224,-39,18.5,24.888889,-39,1232,1448,-216,0,1,0,0.111111,32,10,9,1.09375,0,2,10,12,false,false,false,0.038,0.962
29,45,-16,14.5,22.5,-16,907,1070,-163,0,0,0,0,83,2,2,0.421687,0,0,22,9,false,false,false,0.251,0.749
120,262,-142,13.333333,32.75,-142,1164,1149,15,0,1,0,0.125,51,9,8,0.921569,0,0,12,11,false,false,false,0,1
144,111,33,24,18.5,33,1341,1606,-265,1,0,0.166667,0,49,6,6,0.673469,0,0,12,10,false,false,false,0.324,0.676
157,135,22,19.625,19.285714,22,1043,1003,40,0,0,0,0,47,8,7,0.808511,0,0,18,15,false,false,true,0.549,0.451
71,62,9,11.833333,10.333333,9,1045,948,97,0,0,0,0,57,6,6,0.596491,0,0,13,24,false,false,false,0.267,0.733
25,45,-20,12.5,22.5,-20,1572,1777,-205,0,0,0,0,83,2,2,0.39759,0,1,11,7,false,false,false,0.25,0.75
218,260,-42,19.818182,23.636364,-42,964,1003,-39,0,1,0,0.090909,25,11,11,1.56,1,0,12,19,false,false,false,0.444,0.556
111,251,-140,12.333333,27.888889,-140,760,976,-216,0,1,0,0.111111,35,9,9,1.028571,0,0,10,9,false,false,false,0,1
217,383,-166,14.466667,27.357143,-166,1422,1510,-88,0,2,0,0.142857,12,15,14,3.25,0,0,14,7,false,false,false,0,1
116,127,-11,16.571429,18.142857,-11,1691,1510,181,0,0,0,0,52,7,7,0.576923,1,0,21,18,false,false,true,0.606,0.394
20,0,20,20,0,20,995,965,30,0,0,0,0,95,1,0,0.421053,0,0,16,0,false,false,true,0.682,0.318
193,241,-48,13.785714,18.538462,-48,1045,948,97,0,0,0,0,-2,14,13,-17,1,0,13,12,false,false,false,0.017,0.983
269,345,-76,14.944444,19.166667,-76,620,698,-78,1,0,0.055556,0,-17,18,18,-2.411765,1,0,14,3,false,false,false,0,1
194,160,34,27.714286,26.666667,34,1331,1347,-16,1,0,0.142857,0,44,7,6,0.727273,0,0,10,18,false,false,true,0.698,0.302
219,144,75,19.909091,14.4,75,742,594,148,0,0,0,0,32,11,10,1.21875,1,1,19,15,false,false,true,0.992,0.008
167,268,-101,12.846154,22.333333,-101,948,998,-50,0,0,0,0,12,13,12,3.083333,0,0,23,12,false,false,false,0,1
14,0,14,14,0,14,970,1030,-60,0,0,0,0,97,1,0,0.412371,0,0,23,0,false,false,false,0.317,0.683
271,370,-99,15.055556,21.764706,-99,805,918,-113,0,0,0,0,-22,18,17,-1.636364,0,0,1,4,false,false,false,0,1
271,318,-47,18.066667,21.2,-47,1210,1162,48,0,0,0,0,0,15,15,0,0,0,6,13,false,false,false,0,1
271,282,-11,19.357143,20.142857,-11,664,786,-122,0,0,0,0,3,14,14,11,0,0,10,10,false,false,false,0.211,0.789
143,102,41,35.75,34,41,1885,1908,-23,0,2,0,0.666667,64,4,3,0.359375,0,0,10,19,false,false,true,0.989,0.011
105,105,0,15,15,0,1030,998,32,0,0,0,0,48,7,7,0.770833,0,0,7,15,false,false,false,0.437,0.563
226,245,-19,18.833333,20.416667,-19,576,602,-26,0,0,0,0,23,12,12,1.826087,1,0,6,11,false,false,false,0.079,0.921
258,307,-49,17.2,21.928571,-49,1078,1095,-17,1,1,0.066667,0.071429,2,15,14,18.5,0,0,9,19,false,false,false,0,1
93,110,-17,23.25,36.666667,-17,1399,1210,189,0,1,0,0.333333,70,4,3,0.5,0,1,8,11,false,false,false,0.069,0.931
55,83,-28,27.5,41.5,-28,1093,1100,-7,0,0,0,0,78,2,2,0.448718,0,1,11,8,false,false,false,0.123,0.877
321,364,-43,16.894737,19.157895,-43,1439,1428,11,0,0,0,0,-14,19,19,-2.857143,1,0,2,1,false,false,false,0.013,0.987
163,221,-58,16.3,24.555556,-58,700,820,-120,0,1,0,0.111111,32,10,9,1.1875,1,0,22,10,false,false,false,0.069,0.931
288,286,2,20.571429,22,2,971,800,171,0,1,0,0.076923,-11,14,13,-2.636364,0,0,4,6,false,false,false,0.009,0.991
27,62,-35,9,20.666667,-35,1368,1452,-84,0,0,0,0,85,3,3,0.376471,1,0,7,12,false,false,false,0.149,0.851
219,258,-39,18.25,21.5,-39,1488,1403,85,0,1,0,0.083333,9,12,12,3.777778,0,0,10,22,false,false,false,0.006,0.994
85,125,-40,17,25,-40,653,820,-167,0,0,0,0,61,5,5,0.622951,0,0,14,20,false,false,false,0.178,0.822
323,395,-72,16.15,20.789474,-72,480,739,-259,1,0,0.05,0,-18,20,19,-2.166667,0,0,1,1,true,false,false,0,1
37,49,-12,12.333333,16.333333,-12,278,1,277,0,0,0,0,72,3,3,0.513889,0,0,14,9,false,false,true,0.673,0.327
117,130,-13,23.4,26,-13,1556,1513,43,0,0,0,0,58,5,5,0.534483,2,0,9,14,false,false,true,0.899,0.101
205,304,-99,20.5,33.777778,-99,1334,1486,-152,2,1,0.2,0.111111,31,10,9,0.935484,0,0,8,14,false,false,false,0,1
352,390,-38,18.526316,21.666667,-38,700,820,-120,0,1,0,0.055556,-26,19,18,-1.461538,0,0,2,3,false,false,false,0,1
83,104,-21,16.6,20.8,-21,402,448,-46,0,0,0,0,66,5,5,0.560606,0,1,16,8,false,false,false,0.074,0.926
96,173,-77,24,57.666667,-77,1556,1656,-100,0,1,0,0.333333,66,4,3,0.454545,0,0,9,11,false,false,false,0.182,0.818
146,167,-21,14.6,16.7,-21,361,413,-52,0,0,0,0,35,10,10,1.171429,1,0,11,11,false,false,true,0.609,0.391
91,268,-177,11.375,33.5,-177,940,947,-7,0,2,0,0.25,39,8,8,0.897436,0,0,8,25,false,false,false,0,1
66,17,49,33,17,49,1495,1531,-36,0,0,0,0,90,2,1,0.411111,0,0,11,14,false,false,true,0.712,0.288
186,151,35,20.666667,16.777778,35,1281,1268,13,0,0,0,0,40,9,9,1.05,0,0,7,13,false,false,true,0.771,0.229
93,116,-23,13.285714,16.571429,-23,163,346,-183,0,0,0,0,49,7,7,0.795918,0,1,7,15,false,false,false,0.029,0.971
167,170,-3,27.833333,28.333333,-3,1071,1065,6,0,0,0,0,46,6,6,0.673913,0,0,22,20,false,false,true,0.545,0.455
216,364,-148,9.818182,16.545455,-148,651,996,-345,0,2,0,0.090909,-36,22,22,-1.25,0,0,4,2,false,false,false,0,1
197,294,-97,24.625,36.75,-97,1415,1361,54,0,1,0,0.125,35,8,8,0.885714,0,0,15,20,false,false,false,0,1
180,209,-29,18,20.9,-29,1021,1094,-73,1,0,0.1,0,34,10,10,1.088235,1,0,9,11,false,false,false,0.42,0.58
96,139,-43,16,23.166667,-43,518,461,57,0,0,0,0,59,6,6,0.610169,1,1,15,11,false,false,false,0.006,0.994
216,311,-95,14.4,20.733333,-95,913,1037,-124,0,2,0,0.133333,14,15,15,2.928571,0,1,20,11,false,false,false,0,1
138,148,-10,17.25,18.5,-10,561,688,-127,0,0,0,0,50,8,8,0.92,0,0,13,7,false,false,false,0.263,0.737
195,300,-105,32.5,50,-105,2010,2219,-209,1,0,0.166667,0,46,6,6,0.565217,0,0,15,9,false,false,false,0,1
338,387,-49,16.9,19.35,-49,1164,1261,-97,0,1,0,0.05,-19,20,20,-2.210526,0,0,6,4,false,false,false,0,1
179,201,-22,17.9,22.333333,-22,451,448,3,0,0,0,0,37,10,9,1,0,0,7,12,false,false,false,0.038,0.962
184,290,-106,12.266667,19.333333,-106,977,1100,-123,0,1,0,0.066667,14,15,15,2.928571,0,1,9,18,false,false,false,0,1
133,117,16,22.166667,23.4,16,1003,1004,-1,0,0,0,0,66,6,5,0.530303,0,0,18,8,false,false,true,0.673,0.327
52,48,4,17.333333,24,4,1408,1539,-131,0,0,0,0,80,3,2,0.425,0,1,13,6,false,false,false,0.28,0.72
265,283,-18,29.444444,31.444444,-18,1047,1127,-80,0,1,0,0.111111,20,9,9,1.35,0,0,14,14,false,false,false,0.225,0.775
149,218,-69,24.833333,36.333333,-69,1331,1432,-101,0,0,0,0,42,6,6,0.642857,0,0,11,7,false,false,false,0.203,0.797
146,141,5,16.222222,17.625,5,1312,1334,-22,0,0,0,0,39,9,8,1,0,0,24,7,false,false,true,0.605,0.395
75,181,-106,12.5,30.166667,-106,1454,1479,-25,0,0,0,0,57,6,6,0.54386,1,0,8,9,false,false,false,0.019,0.981
182,196,-14,18.2,19.6,-14,599,448,151,0,0,0,0,31,10,10,1.16129,0,0,10,9,false,false,false,0.234,0.766
269,250,19,22.416667,22.727273,19,1305,1194,111,1,0,0.083333,0,16,12,11,2.0625,0,0,18,7,false,false,true,0.593,0.407
33,44,-11,11,14.666667,-11,771,668,103,0,0,0,0,77,3,3,0.493506,1,0,10,10,false,false,true,0.678,0.322
276,329,-53,14.526316,18.277778,-53,814,830,-16,0,0,0,0,-22,19,18,-1.863636,0,0,6,5,false,false,false,0,1
314,342,-28,19.625,21.375,-28,1043,1003,40,0,1,0,0.0625,-5,16,16,-7.6,0,0,11,12,false,false,false,0,1
18,34,-16,18,34,-16,1102,1245,-143,0,0,0,0,91,1,1,0.318681,0,0,12,23,false,false,false,0.241,0.759
62,59,3,20.666667,19.666667,3,653,820,-167,0,0,0,0,74,3,3,0.513514,0,0,7,19,false,false,false,0.251,0.749
189,291,-102,11.8125,18.1875,-102,595,662,-67,0,1,0,0.0625,-1,16,16,-44,0,0,16,11,false,false,false,0,1
388,306,82,32.333333,27.818182,82,1777,1689,88,1,1,0.083333,0.090909,3,12,11,9,0,1,9,9,false,false,true,1,0
75,121,-46,18.75,30.25,-46,1167,1245,-78,0,0,0,0,64,4,4,0.359375,0,0,10,12,false,false,false,0.286,0.714
194,291,-97,11.411765,18.1875,-97,595,662,-67,0,1,0,0.0625,-3,17,16,-14.666667,0,0,16,11,false,false,false,0,1
78,110,-32,13,22,-32,818,826,-8,0,0,0,0,72,6,5,0.736111,1,1,6,16,false,false,false,0.002,0.998
307,359,-52,18.058824,21.117647,-52,668,771,-103,0,0,0,0,-8,17,17,-5,0,1,1,2,false,false,false,0,1
221,442,-221,18.416667,36.833333,-221,1556,1656,-100,0,2,0,0.166667,1,12,12,30,1,0,17,8,false,false,false,0,1
235,316,-81,18.076923,24.307692,-81,721,757,-36,0,2,0,0.153846,9,13,13,4.222222,0,0,10,19,false,false,false,0,1
167,160,7,20.875,20,7,785,892,-107,0,0,0,0,45,8,8,0.822222,0,0,14,11,false,false,false,0.286,0.714
46,58,-12,15.333333,29,-12,952,826,126,0,0,0,0,86,3,2,0.5,0,0,7,10,false,false,false,0.256,0.744
203,219,-16,25.375,27.375,-16,801,679,122,1,0,0.125,0,31,8,8,0.935484,0,0,15,12,false,false,true,0.646,0.354
286,371,-85,13,17.666667,-85,595,412,183,0,1,0,0.047619,-16,22,21,-3.25,0,0,10,11,false,false,false,0,1
129,174,-45,12.9,17.4,-45,970,1030,-60,0,0,0,0,31,10,10,1.290323,0,0,24,8,false,false,false,0.135,0.865
182,218,-36,18.2,21.8,-36,771,668,103,0,0,0,0,24,10,10,1.583333,0,0,7,24,false,false,false,0.195,0.805
151,141,10,18.875,20.142857,10,742,868,-126,0,0,0,0,49,8,7,0.673469,0,0,13,11,false,false,false,0.255,0.745
261,314,-53,13.05,16.526316,-53,951,976,-25,0,0,0,0,-17,20,19,-2.588235,0,0,3,5,false,false,false,0,1
263,267,-4,14.611111,15.705882,-4,797,796,1,0,0,0,0,2,18,17,24.5,1,0,8,17,false,false,false,0.216,0.784
28,16,12,28,16,12,804,1074,-270,0,0,0,0,92,1,1,0.347826,0,0,14,18,false,false,false,0.252,0.748
114,151,-37,14.25,18.875,-37,907,878,29,0,0,0,0,58,8,8,0.741379,0,0,15,9,false,false,false,0.052,0.948
156,167,-11,13,15.181818,-11,306,302,4,0,0,0,0,25,12,11,1.64,0,0,7,22,false,false,false,0.139,0.861
171,221,-50,21.375,31.571429,-50,835,786,49,0,0,0,0,34,8,7,1,0,0,20,16,false,false,false,0.175,0.825
265,325,-60,24.090909,32.5,-60,1554,1685,-131,0,1,0,0.1,23,11,10,1.391304,0,1,10,7,false,false,false,0,1
197,198,-1,17.909091,19.8,-1,1302,1351,-49,0,0,0,0,32,11,10,1.15625,0,0,12,12,false,false,false,0.135,0.865
317,326,-9,17.611111,18.111111,-9,785,892,-107,0,0,0,0,-18,18,18,-2.055556,0,0,1,2,false,false,false,0.222,0.778
333,347,-14,13.875,15.086957,-14,430,542,-112,0,1,0,0.043478,-33,24,23,-1.454545,0,0,1,1,false,false,false,0,1
53,54,-1,17.666667,27,-1,999,1283,-284,0,0,0,0,81,3,2,0.407407,0,1,21,16,false,false,false,0.2,0.8
203,254,-51,11.941176,14.941176,-51,808,749,59,0,0,0,0,-10,17,17,-4.2,0,0,15,8,false,false,false,0.001,0.999
78,61,17,11.142857,10.166667,17,670,576,94,0,0,0,0,55,7,6,0.745455,0,0,22,10,false,false,true,0.74,0.26
280,347,-67,16.470588,21.6875,-67,503,527,-24,0,1,0,0.0625,-24,17,16,-1.375,0,0,1,3,true,false,false,0,1
152,129,23,25.333333,21.5,23,1770,1745,25,1,0,0.166667,0,62,6,6,0.532258,0,0,7,20,false,false,true,0.685,0.315
213,191,22,26.625,27.285714,22,1167,1245,-78,1,0,0.125,0,27,8,7,0.851852,0,0,10,13,false,false,true,0.684,0.316
287,413,-126,17.9375,25.8125,-126,1038,917,121,1,2,0.0625,0.125,-14,16,16,-2.5,0,0,6,2,false,false,false,0,1
265,337,-72,14.722222,18.722222,-72,1432,1452,-20,0,1,0,0.055556,-17,18,18,-2.117647,1,0,1,9,true,false,false,0,1
218,235,-17,15.571429,16.785714,-17,999,1165,-166,0,0,0,0,18,14,14,2.555556,1,1,15,9,false,false,false,0.197,0.803
206,270,-64,17.166667,22.5,-64,653,820,-167,0,0,0,0,9,12,12,4.222222,0,0,7,17,false,false,false,0,1
26,0,26,26,0,26,820,718,102,0,0,0,0,94,1,0,0.297872,0,0,20,0,false,false,true,0.703,0.297
206,258,-52,10.3,12.9,-52,542,390,152,0,0,0,0,-1,20,20,-50,1,0,6,17,false,false,false,0.003,0.997
122,93,29,24.4,23.25,29,1417,1482,-65,0,0,0,0,69,5,4,0.478261,0,0,23,10,false,false,true,0.683,0.317
289,311,-22,20.642857,22.214286,-22,1341,1606,-265,1,0,0.071429,0,-4,14,14,-8.25,0,0,22,5,false,false,false,0.029,0.971
32,25,7,16,25,7,840,1055,-215,0,0,0,0,88,2,1,0.397727,0,0,8,14,false,false,false,0.251,0.749
183,192,-9,12.2,13.714286,-9,391,542,-151,1,0,0.066667,0,10,15,14,4.6,0,0,7,20,false,false,false,0.283,0.717
166,190,-24,20.75,23.75,-24,1110,1123,-13,0,1,0,0.125,38,8,8,0.868421,0,0,9,19,false,false,false,0.201,0.799
155,90,65,31,18,65,1563,1539,24,0,0,0,0,59,5,5,0.59322,0,1,17,8,false,false,true,0.848,0.152
317,329,-12,13.208333,14.304348,-12,526,502,24,0,0,0,0,-36,24,23,-1.388889,0,0,13,13,false,false,false,0.269,0.731
60,37,23,20,18.5,23,664,786,-122,0,0,0,0,87,3,2,0.37931,0,0,19,10,false,false,false,0.257,0.743
229,337,-108,16.357143,25.923077,-108,1193,1177,16,0,1,0,0.076923,12,14,13,2.916667,1,0,6,9,false,false,false,0,1
281,218,63,25.545455,21.8,63,1373,1334,39,1,1,0.090909,0.1,28,11,10,1.142857,0,1,8,15,false,false,true,0.757,0.243
30,81,-51,15,40.5,-51,1439,1314,125,0,0,0,0,88,2,2,0.318182,0,0,19,8,false,false,false,0.201,0.799
14,71,-57,14,71,-57,1925,1885,40,0,0,0,0,88,1,1,0.284091,0,0,13,20,false,false,false,0.018,0.982
15,115,-100,3.75,28.75,-100,1422,1510,-88,0,1,0,0.25,81,4,4,0.481481,0,0,10,29,false,false,false,0.004,0.996
276,257,19,21.230769,21.416667,19,1305,1194,111,1,0,0.076923,0,12,13,12,2.75,0,0,16,7,false,false,true,0.576,0.424
201,283,-82,22.333333,31.444444,-82,1021,897,124,0,2,0,0.222222,27,9,9,1.37037,0,0,21,13,false,false,false,0,1
227,309,-82,18.916667,28.090909,-82,1101,1115,-14,0,0,0,0,16,12,11,1.875,0,1,9,14,false,false,false,0,1
50,48,2,16.666667,24,2,1229,1220,9,0,0,0,0,81,3,2,0.45679,0,1,10,13,false,false,true,0.586,0.414
45,80,-35,11.25,20,-35,653,1004,-351,0,0,0,0,72,4,4,0.402778,0,0,8,13,false,false,false,0.251,0.749
337,324,13,16.85,17.052632,13,1193,1220,-27,1,0,0.05,0,-19,20,19,-2.263158,0,0,7,6,false,false,true,0.998,0.002
214,254,-40,21.4,25.4,-40,1101,1237,-136,1,0,0.1,0,26,10,10,1.307692,1,0,6,13,false,false,false,0.032,0.968
255,301,-46,13.421053,16.722222,-46,925,1000,-75,0,0,0,0,-14,19,18,-3.142857,0,1,13,5,false,false,false,0,1
138,183,-45,15.333333,20.333333,-45,1302,1351,-49,0,0,0,0,39,9,9,0.948718,0,0,16,15,false,false,false,0.129,0.871
73,109,-36,10.428571,18.166667,-36,1064,1397,-333,0,1,0,0.166667,78,7,6,0.551282,1,0,16,11,false,false,false,0.16,0.84
343,442,-99,24.5,31.571429,-99,1770,1751,19,0,1,0,0.071429,-15,14,14,-1.933333,0,0,1,2,false,false,false,0,1
107,128,-21,15.285714,21.333333,-21,840,1055,-215,0,0,0,0,58,7,6,0.603448,0,1,10,8,false,false,false,0.211,0.789
181,305,-124,9.05,15.25,-124,818,826,-8,0,0,0,0,-10,20,20,-5.3,0,0,9,14,false,false,false,0,1
231,252,-21,15.4,18,-21,402,448,-46,0,0,0,0,3,15,14,12.333333,0,1,20,12,false,false,false,0.019,0.981
233,293,-60,19.416667,24.416667,-60,1047,1253,-206,1,1,0.083333,0.083333,20,12,12,1.85,1,0,9,12,false,false,false,0.172,0.828
28,8,20,14,8,20,970,1030,-60,0,0,0,0,89,2,1,0.449438,0,1,29,10,false,false,false,0.262,0.738
60,54,6,15,13.5,6,814,830,-16,0,0,0,0,72,4,4,0.569444,0,0,10,11,false,false,true,0.65,0.35
85,152,-67,17,38,-67,732,868,-136,0,1,0,0.25,67,5,4,0.477612,0,0,10,17,false,false,false,0.038,0.962
83,71,12,9.222222,8.875,12,925,1000,-75,0,0,0,0,47,9,8,0.93617,0,1,11,20,false,false,false,0.081,0.919
281,294,-13,20.071429,22.615385,-13,1245,1148,97,0,0,0,0,-2,14,13,-17.5,0,0,15,7,false,false,false,0.188,0.812
336,411,-75,19.764706,24.176471,-75,991,1063,-72,0,1,0,0.058824,-14,17,17,-2.714286,0,0,3,7,false,false,false,0,1
173,144,29,19.222222,16,29,742,594,148,0,0,0,0,40,9,9,0.975,0,1,24,10,false,false,true,0.898,0.102
231,253,-22,14.4375,15.8125,-22,925,1000,-75,0,0,0,0,2,16,16,22,0,1,15,8,false,false,false,0.461,0.539
148,163,-15,16.444444,18.111111,-15,1203,1270,-67,0,0,0,0,48,9,9,0.916667,1,0,11,11,false,false,false,0.077,0.923
368,394,-26,20.444444,21.888889,-26,1093,1173,-80,1,1,0.055556,0.055556,-16,18,18,-2.6875,0,0,4,5,false,false,false,0.001,0.999
218,330,-112,18.166667,27.5,-112,1315,1334,-19,0,2,0,0.166667,13,12,12,2.769231,0,0,11,19,false,false,false,0,1
121,240,-119,15.125,30,-119,726,818,-92,0,1,0,0.125,42,8,8,0.833333,0,0,14,9,false,false,false,0,1
0,0,0,0,0,0,795,786,9,0,0,0,0,100,1,0,0.38,0,0,10,0,false,false,false,0.289,0.711
51,67,-16,12.75,16.75,-16,1269,1477,-208,0,0,0,0,77,4,4,0.454545,0,0,7,14,false,false,false,0.246,0.754
35,148,-113,8.75,37,-113,760,976,-216,0,1,0,0.25,69,4,4,0.521739,0,0,15,19,false,false,false,0,1
70,61,9,11.666667,10.166667,9,670,576,94,0,0,0,0,58,6,6,0.706897,0,0,19,10,false,false,true,0.768,0.232
349,288,61,31.727273,28.8,61,1777,1689,88,1,1,0.090909,0.1,10,11,10,2.7,0,1,18,11,false,false,true,1,0
55,107,-52,9.166667,21.4,-52,1368,1452,-84,0,0,0,0,69,6,5,0.463768,1,0,14,26,false,false,false,0.039,0.961
158,153,5,14.363636,13.909091,5,808,749,59,0,0,0,0,19,11,11,2.210526,0,0,16,10,false,false,true,0.673,0.327
12,25,-13,12,25,-13,999,1283,-284,0,0,0,0,93,1,1,0.354839,1,1,19,16,false,false,false,0.041,0.959
87,96,-9,14.5,19.2,-9,1176,1211,-35,0,0,0,0,55,6,5,0.6,1,0,9,14,false,false,true,0.618,0.382
120,204,-84,20,40.8,-84,1576,1556,20,0,1,0,0.2,54,6,5,0.555556,0,0,18,13,false,false,false,0.018,0.982
343,411,-68,19.055556,24.176471,-68,991,1063,-72,0,1,0,0.058824,-16,18,17,-2.375,0,0,1,7,false,false,false,0,1
18,19,-1,18,19,-1,1777,1500,277,0,0,0,0,90,1,1,0.311111,1,0,8,20,false,false,true,0.608,0.392
237,332,-95,18.230769,25.538462,-95,1349,1203,146,0,1,0,0.076923,15,13,13,2.133333,0,1,13,15,false,false,false,0,1
194,87,107,27.714286,14.5,107,1188,1334,-146,1,0,0.142857,0,47,7,6,0.638298,0,1,10,12,false,false,false,0.498,0.502
106,94,12,26.5,23.5,12,1495,1531,-36,0,0,0,0,73,4,4,0.506849,0,0,12,8,false,false,true,0.68,0.32
52,128,-76,13,32,-76,1195,1397,-202,0,1,0,0.25,72,4,4,0.555556,0,0,7,13,false,false,false,0.039,0.961
181,291,-110,22.625,36.375,-110,1636,1727,-91,0,2,0,0.25,33,8,8,0.909091,1,0,13,20,false,false,false,0.022,0.978
146,238,-92,9.733333,15.866667,-92,818,826,-8,0,0,0,0,24,15,15,2.208333,1,0,6,24,false,false,false,0,1
41,39,2,8.2,9.75,2,1037,1016,21,0,0,0,0,80,5,4,0.725,0,1,7,8,false,false,false,0.173,0.827
157,233,-76,15.7,23.3,-76,452,698,-246,0,1,0,0.1,31,10,10,1.322581,0,0,19,11,false,false,false,0,1
181,200,-19,25.857143,33.333333,-19,724,398,326,1,1,0.142857,0.166667,52,7,6,0.75,0,0,8,9,false,false,false,0.237,0.763
255,270,-15,18.214286,20.769231,-15,1488,1403,85,0,1,0,0.076923,0,14,13,0,1,0,23,21,false,false,false,0.099,0.901
219,340,-121,19.909091,30.909091,-121,1334,1486,-152,2,1,0.181818,0.090909,22,11,11,1.318182,0,0,8,14,false,false,false,0,1
131,200,-69,26.2,50,-69,1925,1885,40,1,1,0.2,0.25,55,5,4,0.454545,0,0,8,14,false,false,false,0.006,0.994
275,356,-81,19.642857,27.384615,-81,1583,1403,180,0,0,0,0,0,14,13,0,0,0,4,8,false,false,false,0,1
191,224,-33,12.733333,16,-33,668,363,305,0,0,0,0,19,15,14,2.473684,1,1,9,9,false,false,false,0.002,0.998
262,353,-91,16.375,22.0625,-91,889,895,-6,0,1,0,0.0625,-5,16,16,-7.4,0,1,11,13,false,false,false,0,1
79,72,7,26.333333,24,7,921,1045,-124,0,0,0,0,78,3,3,0.448718,0,0,11,10,false,false,false,0.258,0.742
73,39,34,24.333333,19.5,34,1691,1510,181,0,0,0,0,81,3,2,0.37037,0,0,17,12,false,false,true,0.692,0.308
69,121,-52,11.5,20.166667,-52,913,1037,-124,0,1,0,0.166667,71,6,6,0.577465,0,0,29,9,false,false,false,0.048,0.952
226,272,-46,13.294118,16,-46,526,502,24,0,0,0,0,0,17,17,0,0,0,20,19,false,false,false,0,1
168,174,-6,12.923077,14.5,-6,163,346,-183,0,0,0,0,15,13,12,2.6,0,0,10,7,false,false,true,0.6,0.4
242,395,-153,17.285714,30.384615,-153,1045,1100,-55,0,1,0,0.076923,5,14,13,6.8,1,0,14,12,false,false,false,0,1
154,140,14,22,20,14,1257,1176,81,1,0,0.142857,0,57,7,7,0.596491,1,1,15,9,false,false,false,0.468,0.532
54,41,13,18,20.5,13,785,892,-107,0,0,0,0,81,3,2,0.45679,1,0,12,10,false,false,false,0.266,0.734
254,298,-44,18.142857,22.923077,-44,1078,1095,-17,1,1,0.071429,0.076923,10,14,13,3.7,0,0,7,10,false,false,false,0,1
301,306,-5,20.066667,21.857143,-5,1043,1003,40,0,1,0,0.071429,3,15,14,12.666667,0,0,11,9,false,false,true,0.561,0.439
121,97,24,30.25,24.25,24,1078,1095,-17,1,0,0.25,0,68,4,4,0.544118,0,1,16,15,false,false,false,0.173,0.827
245,288,-43,11.666667,13.714286,-43,668,363,305,0,0,0,0,-20,21,21,-2.35,0,0,11,2,false,false,false,0,1
32,9,23,10.666667,4.5,23,1176,1133,43,0,0,0,0,88,3,2,0.386364,2,0,9,23,false,false,true,0.985,0.015
95,97,-2,19,19.4,-2,1331,1374,-43,0,0,0,0,59,5,5,0.559322,0,0,14,16,false,false,true,0.647,0.353
39,41,-2,13,13.666667,-2,306,361,-55,0,0,0,0,76,3,3,0.473684,0,1,16,16,false,false,false,0.252,0.748
263,291,-28,14.611111,17.117647,-28,1040,1091,-51,0,0,0,0,-10,18,17,-4.7,0,0,13,12,false,false,false,0,1
170,151,19,24.285714,25.166667,19,1102,1245,-143,0,0,0,0,44,7,6,0.659091,0,0,15,8,false,false,true,0.587,0.413
257,267,-10,19.769231,22.25,-10,985,1062,-77,0,0,0,0,12,13,12,3.083333,1,0,13,9,false,false,false,0.256,0.744
44,74,-30,14.666667,24.666667,-30,668,771,-103,0,0,0,0,75,3,3,0.533333,0,0,14,20,false,false,false,0.233,0.767
362,359,3,16.454545,17.095238,3,907,910,-3,0,1,0,0.047619,-20,22,21,-2.15,0,0,6,4,true,false,true,0.54,0.46
332,423,-91,22.133333,30.214286,-91,1537,1539,-2,0,1,0,0.071429,-9,15,14,-3.777778,0,1,5,9,false,false,false,0,1
54,100,-46,10.8,25,-46,343,570,-227,0,0,0,0,60,5,4,0.6,0,0,19,9,false,false,false,0.241,0.759
89,155,-66,17.8,31,-66,1315,1331,-16,0,0,0,0,62,5,5,0.532258,2,0,13,15,false,false,false,0.175,0.825
158,145,13,14.363636,14.5,13,808,749,59,0,0,0,0,23,11,10,1.826087,0,0,16,7,false,false,true,0.672,0.328
324,475,-151,24.923077,36.538462,-151,1586,1633,-47,1,1,0.076923,0.076923,6,13,13,5.666667,0,0,11,10,false,false,false,0,1
68,160,-92,13.6,40,-92,595,412,183,0,1,0,0.25,69,5,4,0.753623,0,1,15,10,false,false,false,0.002,0.998
117,102,15,19.5,20.4,15,1495,1597,-102,0,0,0,0,63,6,5,0.507937,0,1,10,18,false,false,false,0.089,0.911
268,442,-174,14.888889,24.555556,-174,1422,1510,-88,0,2,0,0.111111,-12,18,18,-3.25,0,0,9,2,false,false,false,0,1
241,274,-33,17.214286,19.571429,-33,785,892,-107,0,0,0,0,12,14,14,3.083333,0,1,14,9,false,false,false,0.072,0.928
155,117,38,38.75,29.25,38,824,830,-6,1,0,0.25,0,67,4,4,0.656716,0,0,9,16,false,false,true,0.75,0.25
145,190,-45,20.714286,27.142857,-45,964,1003,-39,0,1,0,0.142857,51,7,7,0.764706,0,0,10,9,false,false,false,0.194,0.806
41,18,23,20.5,18,23,971,800,171,0,0,0,0,85,2,1,0.341176,0,1,13,7,false,false,true,0.696,0.304
249,296,-47,22.636364,29.6,-47,1274,1394,-120,0,1,0,0.1,14,11,10,2.142857,0,0,17,23,false,false,false,0.003,0.997
317,329,-12,12.68,13.16,-12,526,502,24,0,0,0,0,-36,25,25,-1.388889,0,0,13,13,true,false,true,0.959,0.041
82,117,-35,13.666667,23.4,-35,342,263,79,0,0,0,0,59,6,5,0.576271,0,1,8,10,false,false,false,0.004,0.996
188,240,-52,15.666667,21.818182,-52,95,453,-358,0,0,0,0,24,12,11,1.625,0,0,10,22,false,false,false,0,1
126,90,36,31.5,22.5,36,1397,1405,-8,1,0,0.25,0,63,4,4,0.460317,0,0,14,19,false,false,true,0.721,0.279
105,127,-22,21,25.4,-22,921,1045,-124,0,0,0,0,64,5,5,0.546875,0,0,11,13,false,false,false,0.241,0.759
148,225,-77,13.454545,20.454545,-77,977,1100,-123,0,1,0,0.090909,36,11,11,1.138889,0,0,16,10,false,false,false,0.003,0.997
185,227,-42,13.214286,17.461538,-42,1278,1101,177,0,1,0,0.076923,21,14,13,1.761905,0,0,22,9,false,false,true,0.991,0.009
156,211,-55,17.333333,23.444444,-55,691,704,-13,0,1,0,0.111111,44,9,9,0.863636,0,0,11,10,false,false,false,0.048,0.952
191,244,-53,15.916667,22.181818,-53,450,427,23,0,1,0,0.090909,20,12,11,1.85,0,0,13,9,false,false,false,0.072,0.928
248,343,-95,20.666667,31.181818,-95,1636,1796,-160,0,0,0,0,4,12,11,6.75,0,1,7,6,false,false,false,0,1
51,63,-12,17,31.5,-12,1167,1245,-78,0,0,0,0,79,3,2,0.291139,0,0,8,21,false,false,false,0.15,0.85
78,151,-73,11.142857,21.571429,-73,651,567,84,0,0,0,0,52,7,7,1.057692,0,0,9,9,false,false,false,0.194,0.806
301,416,-115,17.705882,24.470588,-115,1038,917,121,1,2,0.058824,0.117647,-21,17,17,-1.666667,0,0,2,2,false,false,false,0,1
146,78,68,36.5,19.5,68,1373,1334,39,1,0,0.25,0,71,4,4,0.450704,0,0,14,10,false,false,true,0.862,0.138
110,161,-51,27.5,53.666667,-51,1164,1261,-97,0,1,0,0.333333,72,4,3,0.583333,0,0,25,12,false,false,false,0.201,0.799
73,142,-69,18.25,35.5,-69,976,995,-19,0,1,0,0.25,71,4,4,0.535211,0,0,11,16,false,false,false,0.199,0.801
26,0,26,26,0,26,1193,1220,-27,0,0,0,0,95,1,0,0.452632,1,0,10,0,false,false,true,0.701,0.299
147,84,63,18.375,12,63,675,570,105,0,0,0,0,47,8,7,0.744681,0,0,13,27,false,false,true,0.967,0.033
155,203,-48,17.222222,22.555556,-48,1161,1030,131,0,1,0,0.111111,34,9,9,1.117647,0,0,14,11,false,false,false,0.047,0.953
270,275,-5,15.882353,17.1875,-5,670,576,94,0,0,0,0,-7,17,16,-5.857143,0,0,4,7,false,false,true,0.511,0.489
86,217,-131,10.75,27.125,-131,1101,1130,-29,0,1,0,0.125,49,8,8,0.918367,0,1,8,7,false,false,false,0,1
32,35,-3,10.666667,17.5,-3,948,998,-50,0,0,0,0,79,3,2,0.468354,1,1,10,8,false,false,false,0.325,0.675
136,77,59,22.666667,15.4,59,995,965,30,0,0,0,0,58,6,5,0.689655,0,0,16,10,false,false,true,0.847,0.153
199,222,-23,28.428571,31.714286,-23,1164,1161,3,0,1,0,0.142857,32,7,7,0.71875,0,0,10,10,false,false,false,0.221,0.779
34,37,-3,17,37,-3,473,683,-210,0,0,0,0,89,2,1,0.426966,0,0,14,22,false,false,false,0.02,0.98
251,325,-74,17.928571,25,-74,1633,1556,77,0,0,0,0,-2,14,13,-16.5,0,1,9,6,false,false,false,0,1
89,137,-48,22.25,34.25,-48,1164,1161,3,0,1,0,0.25,64,4,4,0.359375,1,0,8,21,false,false,false,0.24,0.76
43,48,-5,21.5,24,-5,1408,1539,-131,0,0,0,0,84,2,2,0.404762,0,1,10,6,false,false,false,0.277,0.723
387,398,-11,25.8,28.428571,-11,1793,1957,-164,1,2,0.066667,0.142857,-12,15,14,-2.416667,0,0,3,3,true,false,false,0.141,0.859
294,335,-41,16.333333,19.705882,-41,344,315,29,1,1,0.055556,0.058824,-28,18,17,-1.428571,0,0,2,5,false,false,false,0,1
255,397,-142,15,24.8125,-142,915,971,-56,0,0,0,0,-14,17,16,-2.357143,0,0,1,5,true,false,false,0,1
14,0,14,14,0,14,1168,1062,106,0,0,0,0,96,1,0,0.447917,0,0,11,0,false,false,true,0.679,0.321
165,103,62,12.692308,8.583333,62,491,651,-160,0,0,0,0,29,13,12,1.034483,1,1,11,6,false,false,true,0.927,0.073
229,269,-40,19.083333,24.454545,-40,621,786,-165,0,0,0,0,6,12,11,5,0,0,14,10,false,false,false,0.033,0.967
235,338,-103,13.055556,18.777778,-103,907,878,29,0,0,0,0,1,18,18,43,0,0,10,11,false,false,false,0,1
287,265,22,17.9375,17.666667,22,1193,1220,-27,1,0,0.0625,0,-2,16,15,-21.5,0,0,23,15,false,false,true,0.687,0.313
45,49,-4,15,16.333333,-4,726,818,-92,0,0,0,0,78,3,3,0.448718,0,0,7,7,false,false,false,0.255,0.745
65,44,21,16.25,14.666667,21,1043,1003,40,0,0,0,0,73,4,3,0.520548,1,0,18,11,false,false,true,0.684,0.316
86,14,72,43,14,72,801,679,122,1,0,0.5,0,85,2,1,0.341176,0,0,11,18,false,false,true,0.92,0.08
194,357,-163,16.166667,29.75,-163,726,818,-92,0,1,0,0.083333,16,12,12,2.1875,0,0,8,11,false,false,false,0,1
61,103,-42,10.166667,20.6,-42,907,1070,-163,0,0,0,0,61,6,5,0.57377,0,0,19,19,false,false,false,0.047,0.953
43,172,-129,8.6,43,-129,1305,1307,-2,0,1,0,0.25,64,5,4,0.640625,0,0,13,14,false,false,false,0,1
53,72,-19,10.6,18,-19,651,567,84,0,0,0,0,68,5,4,0.808824,0,0,9,28,false,false,false,0.173,0.827
90,104,-14,12.857143,14.857143,-14,814,830,-16,0,0,0,0,54,7,7,0.759259,0,0,11,20,false,false,false,0.069,0.931
136,149,-13,17,21.285714,-13,727,820,-93,0,1,0,0.142857,45,8,7,0.777778,0,0,12,9,false,false,false,0.332,0.668
369,374,-5,20.5,20.777778,-5,1156,1279,-123,2,0,0.111111,0,-17,18,18,-2.352941,0,0,2,1,false,false,true,0.711,0.289
167,196,-29,16.7,21.777778,-29,1071,1181,-110,0,0,0,0,42,10,9,0.809524,0,1,10,12,false,false,false,0.033,0.967
171,146,25,34.2,29.2,25,714,820,-106,1,0,0.2,0,63,5,5,0.492063,0,0,11,14,false,false,false,0.132,0.868
263,247,16,18.785714,19,16,500,509,-9,0,0,0,0,12,14,13,3.416667,0,0,7,16,false,false,false,0.267,0.733
249,295,-46,17.785714,22.692308,-46,944,1095,-151,0,1,0,0.076923,19,14,13,2.052632,0,2,9,14,false,false,false,0,1
276,277,-1,19.714286,21.307692,-1,971,635,336,0,0,0,0,-2,14,13,-16,1,0,9,8,false,false,false,0.037,0.963
164,323,-159,7.809524,15.380952,-159,651,567,84,0,0,0,0,-9,21,21,-6.111111,0,0,7,11,false,false,false,0,1
210,309,-99,23.333333,34.333333,-99,1003,1004,-1,0,1,0,0.111111,35,9,9,1,0,1,7,9,false,false,false,0,1
131,117,14,21.833333,23.4,14,450,624,-174,0,0,0,0,59,6,5,0.559322,0,0,9,12,false,false,false,0.263,0.737
140,134,6,17.5,19.142857,6,711,746,-35,0,0,0,0,51,8,7,0.745098,0,0,10,19,false,false,false,0.079,0.921
338,367,-29,19.882353,22.9375,-29,980,965,15,0,0,0,0,-9,17,16,-4.222222,0,0,3,5,false,false,false,0,1
69,74,-5,17.25,24.666667,-5,402,448,-46,0,0,0,0,75,4,3,0.493333,0,1,7,6,false,false,false,0.025,0.975
122,99,23,20.333333,16.5,23,691,704,-13,0,0,0,0,65,6,6,0.584615,0,0,7,9,false,false,true,0.512,0.488
202,149,53,25.25,21.285714,53,804,1074,-270,0,0,0,0,47,8,7,0.680851,0,1,12,8,false,false,true,0.569,0.431
256,323,-67,14.222222,19,-67,642,952,-310,0,0,0,0,-10,18,17,-4.4,0,0,2,5,false,false,false,0,1
150,206,-56,18.75,25.75,-56,874,868,6,0,0,0,0,38,8,8,0.868421,0,0,12,15,false,false,false,0.175,0.825
182,225,-43,16.545455,20.454545,-43,343,570,-227,0,0,0,0,18,11,11,2,1,0,18,10,false,false,false,0.216,0.784
26,37,-11,26,37,-11,473,683,-210,0,0,0,0,92,1,1,0.413043,0,0,13,22,false,false,false,0.021,0.979
95,91,4,23.75,22.75,4,1691,1551,140,0,0,0,0,70,4,4,0.528571,0,0,10,20,false,false,false,0.205,0.795
132,75,57,26.4,18.75,57,1552,1803,-251,1,0,0.2,0,69,5,4,0.478261,1,0,9,11,false,false,false,0.363,0.637
230,278,-48,13.529412,17.375,-48,683,859,-176,0,0,0,0,10,17,16,4.5,0,0,10,17,false,false,false,0,1
228,309,-81,15.2,20.6,-81,620,698,-78,1,0,0.066667,0,2,15,15,20.5,0,0,18,10,false,false,false,0,1
143,265,-122,14.3,26.5,-122,595,412,183,0,1,0,0.1,33,10,10,1.575758,0,0,10,9,false,false,false,0,1
70,18,52,70,18,52,169,306,-137,1,1,1,1,86,1,1,0.360465,0,0,19,13,false,false,true,0.663,0.337
299,444,-145,21.357143,34.153846,-145,1633,1680,-47,0,2,0,0.153846,-14,14,13,-2,1,0,5,10,false,false,false,0,1
100,116,-16,20,23.2,-16,1266,1339,-73,0,0,0,0,69,5,5,0.507246,0,1,17,8,false,false,false,0.224,0.776
222,285,-63,10.571429,13.571429,-63,595,540,55,0,0,0,0,-10,21,21,-4.3,0,0,7,15,false,false,false,0,1
77,166,-89,25.666667,55.333333,-89,1093,1100,-7,0,1,0,0.333333,69,3,3,0.507246,0,0,7,12,false,false,false,0.186,0.814
231,333,-102,15.4,23.785714,-102,711,746,-35,0,0,0,0,5,15,14,7.6,0,0,11,12,false,false,false,0,1
208,260,-52,18.909091,23.636364,-52,1210,1162,48,0,0,0,0,26,11,11,1.230769,1,1,9,11,false,false,false,0.007,0.993
109,109,0,18.166667,21.8,0,500,532,-32,0,0,0,0,59,6,5,0.694915,0,0,8,10,false,false,false,0.278,0.722
212,249,-37,21.2,27.666667,-37,1173,1256,-83,1,0,0.1,0,33,10,9,0.939394,1,1,13,13,false,false,false,0.003,0.997
35,32,3,17.5,16,3,1777,1689,88,0,0,0,0,84,2,2,0.321429,1,0,7,9,false,false,true,0.926,0.074
24,39,-15,12,19.5,-15,952,870,82,0,0,0,0,84,2,2,0.440476,0,0,8,19,false,false,false,0.346,0.654
269,319,-50,19.214286,24.538462,-50,1205,1216,-11,0,0,0,0,5,14,13,6.6,1,0,8,12,false,false,false,0.025,0.975
19,29,-10,9.5,14.5,-10,566,742,-176,0,0,0,0,87,2,2,0.367816,0,1,8,15,false,false,false,0.25,0.75
133,209,-76,16.625,29.857143,-76,1397,1309,88,1,0,0.125,0,58,8,7,0.62069,0,1,9,9,false,false,false,0,1
152,212,-60,15.2,21.2,-60,1248,1220,28,0,1,0,0.1,43,10,10,1.209302,1,0,15,10,false,false,false,0.166,0.834
152,198,-46,19,24.75,-46,907,910,-3,0,1,0,0.125,50,8,8,0.86,1,1,6,20,false,false,false,0.029,0.971
160,226,-66,17.777778,28.25,-66,1045,1100,-55,0,0,0,0,42,9,8,0.809524,0,1,19,10,false,false,false,0.002,0.998
42,51,-9,14,25.5,-9,344,315,29,1,0,0.333333,0,74,3,2,0.540541,0,0,8,10,false,false,false,0.071,0.929
153,211,-58,15.3,23.444444,-58,480,739,-259,0,0,0,0,39,10,9,1,1,0,15,16,false,false,false,0.007,0.993
77,83,-6,25.666667,41.5,-6,1093,1100,-7,0,0,0,0,76,3,2,0.460526,0,1,7,8,false,false,false,0.109,0.891
30,22,8,15,22,8,944,1095,-151,0,0,0,0,92,2,1,0.423913,0,0,16,8,false,false,false,0.251,0.749
358,433,-75,21.058824,27.0625,-75,724,398,326,1,1,0.058824,0.0625,-6,17,16,-6.5,0,0,9,11,false,false,false,0,1
283,231,52,35.375,28.875,52,1777,1689,88,1,1,0.125,0.125,28,8,8,0.964286,0,1,12,15,false,false,true,0.886,0.114
105,97,8,21,24.25,8,480,518,-38,0,0,0,0,66,5,4,0.606061,0,1,13,9,false,false,false,0.033,0.967
291,418,-127,16.166667,24.588235,-127,1229,1220,9,0,1,0,0.058824,-11,18,17,-3.363636,0,0,1,2,false,false,false,0,1
50,79,-29,12.5,26.333333,-29,1101,1115,-14,0,0,0,0,79,4,3,0.379747,0,0,17,8,false,false,false,0.333,0.667
258,299,-41,12.285714,14.95,-41,683,859,-176,0,0,0,0,-2,21,20,-22.5,0,0,9,17,false,false,false,0,1
185,261,-76,11.5625,16.3125,-76,226,361,-135,0,0,0,0,-10,16,16,-4.4,1,0,10,12,false,false,false,0.023,0.977
80,57,23,16,14.25,23,671,638,33,0,0,0,0,66,5,4,0.742424,0,0,18,19,false,false,true,0.696,0.304
281,428,-147,21.615385,35.666667,-147,1633,1680,-47,0,2,0,0.166667,-6,13,12,-4.666667,1,0,5,12,false,false,false,0,1
168,232,-64,18.666667,25.777778,-64,594,648,-54,1,1,0.111111,0.111111,40,9,9,1,0,0,7,18,false,false,false,0.004,0.996
218,276,-58,19.818182,27.6,-58,1576,1556,20,0,1,0,0.1,17,11,10,1.764706,1,0,8,17,false,false,false,0.01,0.99
320,387,-67,17.777778,22.764706,-67,771,668,103,2,0,0.111111,0,-26,18,17,-1.461538,0,0,1,4,false,false,false,0,1
179,224,-45,16.272727,20.363636,-45,804,766,38,0,1,0,0.090909,41,11,11,1,0,1,17,10,false,false,false,0.037,0.963
130,109,21,21.666667,21.8,21,1432,1452,-20,0,0,0,0,60,6,5,0.6,1,0,6,7,false,false,true,0.783,0.217
295,270,25,21.071429,19.285714,25,1488,1428,60,1,0,0.071429,0,10,14,14,3.7,0,1,19,6,false,false,true,0.907,0.093
59,80,-21,11.8,20,-21,430,542,-112,0,0,0,0,71,5,4,0.676056,0,2,27,8,false,false,false,0.074,0.926
320,340,-20,15.238095,16.190476,-20,561,688,-127,0,0,0,0,-19,21,21,-2.421053,0,0,1,4,false,false,false,0.002,0.998
314,318,-4,17.444444,17.666667,-4,1021,1094,-73,1,0,0.055556,0,-17,18,18,-2.176471,1,1,1,3,false,false,false,0.114,0.886
365,376,-11,28.076923,31.333333,-11,1793,1957,-164,1,2,0.076923,0.166667,2,13,12,14.5,0,0,7,12,false,false,false,0.177,0.823
232,173,59,25.777778,21.625,59,1188,1334,-146,1,0,0.111111,0,30,9,8,1,1,0,16,7,false,false,true,0.952,0.048
35,49,-14,17.5,24.5,-14,842,926,-84,0,0,0,0,82,2,2,0.365854,0,0,16,10,false,false,false,0.405,0.595
77,77,0,19.25,25.666667,0,842,926,-84,0,0,0,0,72,4,3,0.416667,0,0,16,7,false,false,false,0.43,0.57
171,122,49,17.1,13.555556,49,897,996,-99,0,0,0,0,41,10,9,0.95122,0,0,15,10,false,false,true,0.731,0.269
216,160,56,24,20,56,1070,814,256,1,1,0.111111,0.125,32,9,8,1.03125,0,1,14,20,false,false,true,0.723,0.277
214,312,-98,15.285714,22.285714,-98,450,427,23,1,1,0.071429,0.071429,-3,14,14,-12.333333,0,0,13,13,false,false,false,0,1
365,378,-13,21.470588,23.625,-13,1305,1211,94,2,0,0.117647,0,-11,17,16,-3,0,1,5,4,true,false,false,0.001,0.999
72,77,-5,14.4,19.25,-5,1229,1220,9,0,0,0,0,66,5,4,0.560606,0,1,19,19,false,false,false,0.219,0.781
144,203,-59,20.571429,29,-59,1045,1100,-55,0,0,0,0,52,7,7,0.653846,0,1,9,13,false,false,false,0.003,0.997
88,152,-64,11,21.714286,-64,343,570,-227,0,0,0,0,42,8,7,0.857143,0,0,28,10,false,false,false,0.22,0.78
393,402,-9,20.684211,21.157895,-9,964,1003,-39,0,1,0,0.052632,-25,19,19,-1.56,0,0,3,2,false,false,true,0.811,0.189
270,339,-69,15.882353,21.1875,-69,725,668,57,0,0,0,0,-10,17,16,-3.5,0,0,1,3,false,false,false,0,1
296,305,-9,16.444444,17.941176,-9,518,461,57,0,0,0,0,-20,18,17,-1.8,0,0,2,2,false,false,false,0.5,0.5
163,126,37,14.818182,12.6,37,670,576,94,0,0,0,0,31,11,10,1.322581,1,0,13,10,false,false,true,0.958,0.042
68,147,-79,11.333333,24.5,-79,1270,1424,-154,0,1,0,0.166667,64,6,6,0.546875,0,0,12,8,false,false,false,0.039,0.961
316,409,-93,15.8,21.526316,-93,935,995,-60,1,1,0.05,0.052632,-25,20,19,-1.56,0,0,6,1,true,false,false,0,1
114,88,26,22.8,17.6,26,1038,917,121,1,0,0.2,0,69,5,5,0.507246,0,1,10,8,false,false,true,0.828,0.172
92,104,-12,11.5,13,-12,342,53,289,0,0,0,0,50,8,8,0.82,1,0,11,16,false,false,true,0.631,0.369
201,187,14,20.1,20.777778,14,566,742,-176,0,1,0,0.111111,27,10,9,1.185185,0,0,15,11,false,false,true,0.714,0.286
304,321,-17,17.882353,18.882353,-17,785,892,-107,0,0,0,0,-9,17,17,-4.111111,0,0,2,2,false,false,false,0.084,0.916
318,380,-62,17.666667,22.352941,-62,480,739,-259,1,0,0.055556,0,-9,18,17,-4.333333,0,0,3,5,false,false,false,0,1
112,152,-40,14,21.714286,-40,1182,1075,107,0,1,0,0.142857,46,8,7,0.847826,0,1,25,8,false,false,false,0.186,0.814
159,194,-35,17.666667,24.25,-35,451,448,3,0,0,0,0,43,9,8,0.860465,0,0,7,14,false,false,false,0.02,0.98
273,292,-19,24.818182,29.2,-19,1436,1489,-53,1,1,0.090909,0.1,25,11,10,1.48,0,0,9,7,false,false,false,0.195,0.805
90,153,-63,22.5,38.25,-63,971,800,171,0,1,0,0.25,58,4,4,0.5,1,0,7,10,false,false,false,0.032,0.968
65,69,-4,16.25,17.25,-4,1161,1176,-15,0,0,0,0,73,4,4,0.520548,0,0,10,7,false,false,true,0.677,0.323
300,386,-86,15.789474,20.315789,-86,691,704,-13,0,1,0,0.052632,-24,19,19,-1.583333,0,0,1,1,true,false,false,0,1
211,231,-20,16.230769,19.25,-20,360,371,-11,0,0,0,0,4,13,12,9.25,1,0,6,11,false,false,false,0.374,0.626
298,371,-73,12.956522,16.863636,-73,595,412,183,0,1,0,0.045455,-19,23,22,-2.736842,0,0,10,11,false,false,false,0,1
119,194,-75,23.8,38.8,-75,1397,1309,88,1,0,0.2,0,66,5,5,0.545455,0,1,7,10,false,false,false,0.009,0.991
59,33,26,19.666667,16.5,26,1388,1366,22,0,0,0,0,82,3,2,0.390244,0,0,9,14,false,false,true,0.679,0.321
286,289,-3,19.066667,19.266667,-3,804,766,38,0,1,0,0.066667,11,15,15,3.727273,0,0,11,13,false,false,true,0.743,0.257
299,315,-16,17.588235,19.6875,-16,1302,1351,-49,0,0,0,0,-9,17,16,-4.111111,0,0,3,2,false,false,false,0.111,0.889
41,45,-4,8.2,11.25,-4,925,1000,-75,0,0,0,0,67,5,4,0.656716,0,1,10,9,false,false,false,0.25,0.75
321,271,50,17.833333,15.941176,50,897,996,-99,0,0,0,0,-7,18,17,-5.571429,0,0,5,15,false,false,true,1,0
55,14,41,27.5,14,41,921,1045,-124,0,0,0,0,89,2,1,0.393258,0,0,10,18,false,false,false,0.269,0.731
140,151,-11,20,21.571429,-11,1071,1181,-110,0,0,0,0,58,7,7,0.586207,0,0,7,7,false,false,false,0.227,0.773
296,392,-96,16.444444,21.777778,-96,563,523,40,0,0,0,0,-16,18,18,-2.3125,0,0,2,1,false,false,false,0,1
301,387,-86,18.8125,25.8,-86,835,786,49,0,0,0,0,-24,16,15,-1.416667,0,0,1,2,false,false,false,0,1
37,105,-68,7.4,21,-68,907,878,29,0,0,0,0,77,5,5,0.558442,0,0,16,14,false,false,false,0.04,0.96
165,219,-54,15,19.909091,-54,518,414,104,0,1,0,0.090909,28,11,11,1.357143,0,1,9,9,false,false,false,0.057,0.943
149,180,-31,21.285714,25.714286,-31,1439,1314,125,0,0,0,0,50,7,7,0.56,0,0,14,8,false,false,false,0.201,0.799
201,221,-20,15.461538,17,-20,430,542,-112,0,1,0,0.076923,18,13,13,2.666667,0,0,36,16,false,false,false,0.278,0.722
255,288,-33,11.590909,13.714286,-33,668,363,305,0,0,0,0,-23,22,21,-2.043478,0,0,10,2,false,false,false,0,1
264,240,24,26.4,24,24,1563,1539,24,0,1,0,0.1,19,10,10,1.842105,0,0,10,15,false,false,false,0.35,0.65
125,110,15,15.625,15.714286,15,1344,1314,30,0,1,0,0.142857,50,8,7,0.68,0,0,10,15,false,false,false,0.237,0.763
194,192,2,19.4,21.333333,2,1495,1531,-36,0,0,0,0,41,10,9,0.902439,1,0,6,7,false,false,false,0.24,0.76
16,22,-6,8,22,-6,430,542,-112,0,0,0,0,89,2,1,0.539326,0,2,7,9,false,false,false,0.02,0.98
259,364,-105,16.1875,24.266667,-105,935,995,-60,1,1,0.0625,0.066667,-1,16,15,-39,0,0,16,9,false,false,false,0,1
223,263,-40,15.928571,18.785714,-40,1123,1062,61,0,0,0,0,13,14,14,3.384615,0,0,13,8,false,false,false,0.161,0.839
258,293,-35,17.2,20.928571,-35,343,570,-227,0,0,0,0,-7,15,14,-5.142857,0,1,8,6,false,false,false,0,1
77,114,-37,11,16.285714,-37,1075,1189,-114,0,0,0,0,54,7,7,0.740741,0,0,10,19,false,false,false,0.04,0.96
170,242,-72,14.166667,20.166667,-72,1248,1220,28,0,1,0,0.083333,32,12,12,1.625,1,0,6,9,false,false,false,0.006,0.994
298,301,-3,19.866667,20.066667,-3,1168,1216,-48,0,0,0,0,8,15,15,4.125,1,0,6,7,false,false,false,0.273,0.727
148,155,-7,24.666667,25.833333,-7,1093,1173,-80,0,0,0,0,61,6,6,0.704918,0,0,16,14,false,false,false,0.223,0.777
281,323,-42,20.071429,24.846154,-42,1269,1477,-208,1,0,0.071429,0,10,14,13,3.5,0,0,10,10,false,false,false,0,1
58,80,-22,9.666667,16,-22,999,1165,-166,0,0,0,0,66,6,5,0.69697,0,0,18,12,false,false,false,0.229,0.771
33,27,6,16.5,27,6,1633,1620,13,0,0,0,0,87,2,1,0.413793,0,0,10,27,false,false,false,0.207,0.793
106,79,27,26.5,19.75,27,691,704,-13,0,0,0,0,73,4,4,0.520548,0,0,10,9,false,false,true,0.745,0.255
25,25,0,12.5,12.5,0,306,361,-55,0,0,0,0,83,2,2,0.433735,0,1,16,7,false,false,false,0.261,0.739
180,253,-73,15,23,-73,1484,1556,-72,0,1,0,0.090909,13,12,11,2.384615,1,0,26,9,false,false,false,0.054,0.946
196,205,-9,17.818182,20.5,-9,796,800,-4,1,0,0.090909,0,32,11,10,1.5,0,0,11,8,false,false,false,0.234,0.766
109,160,-51,15.571429,22.857143,-51,1030,1014,16,0,0,0,0,57,7,7,0.578947,1,1,10,12,false,false,false,0.004,0.996
279,408,-129,17.4375,25.5,-129,874,868,6,0,0,0,0,-20,16,16,-1.65,0,0,2,1,false,false,false,0,1
42,17,25,14,8.5,25,542,390,152,0,0,0,0,90,3,2,0.555556,0,0,11,21,false,false,true,0.704,0.296
150,201,-51,21.428571,33.5,-51,1266,1339,-73,0,1,0,0.166667,54,7,6,0.648148,0,0,10,14,false,false,false,0.161,0.839
85,65,20,21.25,16.25,20,356,498,-142,0,0,0,0,72,4,4,0.486111,1,0,11,9,false,false,true,0.663,0.337
54,70,-16,10.8,17.5,-16,822,845,-23,0,0,0,0,76,5,4,0.460526,1,0,24,21,false,false,false,0.156,0.844
237,288,-51,12.473684,16,-51,278,1,277,0,0,0,0,-14,19,18,-2.642857,0,0,9,1,true,false,false,0,1
131,182,-51,18.714286,30.333333,-51,1315,1331,-16,0,0,0,0,51,7,6,0.647059,0,0,12,13,false,false,false,0.197,0.803
249,216,33,14.647059,12.705882,33,671,638,33,0,0,0,0,-2,17,17,-24.5,0,0,12,21,false,false,true,0.932,0.068
196,355,-159,15.076923,29.583333,-159,1422,1510,-88,0,2,0,0.166667,25,13,12,1.56,0,0,7,7,false,false,false,0,1
248,318,-70,13.052632,16.736842,-70,1071,1000,71,0,0,0,0,-15,19,19,-3.133333,0,0,4,4,false,false,false,0,1
167,207,-40,11.928571,15.923077,-40,1220,1202,18,0,0,0,0,17,14,13,2.941176,0,1,31,8,false,false,true,0.528,0.472
62,41,21,20.666667,20.5,21,1197,1156,41,0,0,0,0,79,3,2,0.443038,0,1,13,6,false,false,true,0.684,0.316
295,321,-26,16.388889,17.833333,-26,1161,1030,131,0,1,0,0.055556,-22,18,18,-1.727273,0,0,2,1,false,false,false,0.012,0.988
30,11,19,15,11,19,1094,1041,53,0,0,0,0,88,2,1,0.431818,1,0,10,12,false,false,true,0.679,0.321
259,370,-111,16.1875,23.125,-111,1195,1397,-202,0,2,0,0.125,0,16,16,0,0,1,9,9,false,false,false,0,1
209,285,-76,17.416667,25.909091,-76,1270,1424,-154,0,2,0,0.181818,25,12,11,1.4,0,0,24,19,false,false,false,0,1
266,360,-94,26.6,40,-94,1537,1539,-2,0,1,0,0.111111,20,10,9,1.7,0,1,8,19,false,false,false,0,1
173,109,64,12.357143,7.785714,64,491,651,-160,0,0,0,0,22,14,14,1.363636,0,1,24,6,false,false,true,0.923,0.077
203,268,-65,16.916667,22.333333,-65,795,786,9,1,0,0.083333,0,25,12,12,1.52,0,0,18,11,false,false,false,0,1
221,301,-80,14.733333,20.066667,-80,995,965,30,0,1,0,0.066667,3,15,15,13.333333,0,0,13,8,false,false,false,0,1
127,121,6,21.166667,20.166667,6,711,746,-35,0,0,0,0,61,6,6,0.622951,0,0,7,22,false,false,false,0.203,0.797
323,395,-72,17,20.789474,-72,480,739,-259,1,0,0.052632,0,-18,19,19,-2.166667,0,0,1,1,false,false,false,0,1
151,220,-69,18.875,27.5,-69,1473,1500,-27,0,2,0,0.25,43,8,8,0.906977,0,0,15,22,false,false,false,0.009,0.991
39,35,4,19.5,17.5,4,1188,1334,-146,0,0,0,0,82,2,2,0.365854,0,0,12,7,false,false,false,0.353,0.647
190,242,-52,19,24.2,-52,1131,1030,101,0,0,0,0,28,10,10,1.071429,1,1,9,9,false,false,false,0.005,0.995
263,292,-29,16.4375,18.25,-29,561,688,-127,0,0,0,0,5,16,16,9.2,0,0,8,15,false,false,false,0.001,0.999
197,186,11,17.909091,18.6,11,480,518,-38,0,0,0,0,26,11,10,1.538462,0,1,16,8,false,false,false,0.33,0.67
256,257,-1,17.066667,18.357143,-1,796,800,-4,1,0,0.066667,0,13,15,14,3.692308,0,1,10,8,false,false,false,0.03,0.97
236,249,-13,13.111111,14.647059,-13,163,346,-183,0,0,0,0,-21,18,17,-1.857143,0,0,7,5,false,false,false,0.408,0.592
175,278,-103,9.210526,14.631579,-103,818,826,-8,0,0,0,0,-5,19,19,-10.6,0,0,7,19,false,false,false,0,1
159,188,-29,14.454545,17.090909,-29,714,892,-178,0,0,0,0,36,11,11,1.166667,0,1,9,7,false,false,false,0.059,0.941
69,42,27,17.25,14,27,725,668,57,0,0,0,0,78,4,3,0.448718,0,0,11,25,false,false,true,0.634,0.366
145,179,-34,20.714286,29.833333,-34,503,527,-24,0,1,0,0.166667,46,7,6,0.717391,0,0,7,7,false,false,false,0.245,0.755
293,344,-51,16.277778,20.235294,-51,1633,1620,13,0,0,0,0,-25,18,17,-1.44,0,0,1,1,false,false,false,0,1
65,39,26,21.666667,19.5,26,500,532,-32,0,0,0,0,80,3,2,0.5125,0,0,9,12,false,false,false,0.338,0.662
238,339,-101,18.307692,28.25,-101,1038,917,121,1,2,0.076923,0.166667,6,13,12,5.833333,0,0,11,13,false,false,false,0,1
74,79,-5,12.333333,15.8,-5,1699,1803,-104,0,0,0,0,78,6,5,0.448718,0,2,7,7,false,false,false,0.042,0.958
18,0,18,18,0,18,1302,1351,-49,0,0,0,0,96,1,0,0.385417,1,0,6,0,false,false,true,0.671,0.329
162,240,-78,14.727273,21.818182,-78,95,453,-358,0,0,0,0,28,11,11,1.392857,0,0,11,22,false,false,false,0,1
165,167,-2,20.625,23.857143,-2,1227,1189,38,0,0,0,0,42,8,7,0.833333,0,0,11,25,false,false,false,0.201,0.799
206,263,-57,15.846154,21.916667,-57,758,791,-33,0,0,0,0,15,13,12,2.6,1,0,7,18,false,false,false,0.007,0.993
107,215,-108,10.7,21.5,-108,632,603,29,0,0,0,0,31,10,10,1.225806,0,0,18,13,false,false,false,0,1
227,299,-72,15.133333,21.357143,-72,1580,1629,-49,0,1,0,0.071429,2,15,14,18.5,0,1,16,20,false,false,false,0,1
192,189,3,14.769231,14.538462,3,671,638,33,0,0,0,0,14,13,13,3.5,0,0,14,21,false,false,true,0.711,0.289
16,38,-22,8,38,-22,1038,917,121,0,0,0,0,90,2,1,0.388889,0,1,7,16,false,false,false,0.017,0.983
273,232,41,21,19.333333,41,1227,1189,38,0,0,0,0,6,13,12,5.833333,0,1,9,29,false,false,true,0.957,0.043
20,18,2,20,18,2,1344,1314,30,0,1,0,1,88,1,1,0.386364,0,0,7,7,false,false,true,0.603,0.397
153,138,15,19.125,17.25,15,1633,1556,77,0,0,0,0,38,8,8,0.868421,0,0,19,18,false,false,false,0.23,0.77
196,209,-13,17.818182,19,-13,796,800,-4,1,0,0.090909,0,29,11,11,1.655172,0,0,11,16,false,false,false,0.253,0.747
122,221,-99,9.384615,17,-99,818,826,-8,0,0,0,0,36,13,13,1.472222,1,0,9,16,false,false,false,0.008,0.992
26,56,-30,8.666667,28,-30,803,786,17,0,0,0,0,83,3,2,0.385542,0,0,21,9,false,false,true,0.532,0.468
72,53,19,18,13.25,19,1040,1091,-51,0,0,0,0,72,4,4,0.652778,0,0,11,19,false,false,true,0.563,0.437
52,44,8,17.333333,14.666667,8,874,868,6,0,0,0,0,78,3,3,0.423077,0,0,19,8,false,false,true,0.688,0.312
230,339,-109,19.166667,28.25,-109,1038,917,121,1,2,0.083333,0.166667,9,12,12,3.888889,0,0,13,13,false,false,false,0,1
309,328,-19,22.071429,23.428571,-19,1645,1636,9,0,1,0,0.071429,-10,14,14,-3.3,0,0,4,4,false,false,false,0.006,0.994
214,231,-17,19.454545,23.1,-17,921,1045,-124,0,0,0,0,26,11,10,1.346154,0,0,18,12,false,false,false,0.043,0.957
269,258,11,22.416667,23.454545,11,1237,1265,-28,1,0,0.083333,0,8,12,11,4.5,0,0,7,19,false,false,false,0.366,0.634
47,80,-33,9.4,16,-33,595,662,-67,0,0,0,0,65,5,5,0.676923,0,1,18,6,false,false,false,0.249,0.751
329,461,-132,29.909091,41.909091,-132,1885,1908,-23,1,3,0.090909,0.272727,-15,11,11,-1.533333,0,0,2,6,false,false,false,0,1
181,189,-8,36.2,37.8,-8,1699,1580,119,2,0,0.4,0,55,5,5,0.545455,0,0,10,9,false,false,false,0.449,0.551
78,135,-57,15.6,33.75,-57,1572,1777,-205,0,1,0,0.25,63,5,4,0.52381,0,0,11,9,false,false,false,0.128,0.872
337,420,-83,24.071429,32.307692,-83,1689,1777,-88,1,1,0.071429,0.076923,-10,14,13,-3,0,0,5,6,false,false,false,0,1
248,394,-146,19.076923,30.307692,-146,999,1283,-284,0,2,0,0.153846,7,13,13,4.714286,0,0,18,7,false,false,false,0,1
267,296,-29,14.833333,16.444444,-29,595,538,57,0,0,0,0,-15,18,18,-2.533333,0,0,1,1,false,false,false,0.134,0.866
97,71,26,24.25,17.75,26,1493,1413,80,0,0,0,0,75,4,4,0.48,0,0,23,10,false,false,true,0.734,0.266
129,101,28,18.428571,16.833333,28,1334,1439,-105,1,0,0.142857,0,71,7,6,0.507042,0,0,16,15,false,false,false,0.296,0.704
103,152,-49,14.714286,21.714286,-49,1182,1075,107,0,1,0,0.142857,49,7,7,0.795918,0,1,22,8,false,false,false,0.174,0.826
160,182,-22,14.545455,18.2,-22,603,721,-118,0,0,0,0,34,11,10,1.264706,0,0,18,22,false,false,false,0.048,0.952
53,73,-20,17.666667,24.333333,-20,1493,1453,40,0,0,0,0,81,3,3,0.432099,0,0,9,19,false,false,false,0.204,0.796
56,72,-16,18.666667,36,-16,1636,1796,-160,0,0,0,0,82,3,2,0.329268,0,0,16,10,false,false,true,0.522,0.478
266,419,-153,16.625,27.933333,-153,1399,1210,189,0,1,0,0.066667,-5,16,15,-7,0,0,4,7,false,false,false,0.015,0.985
157,217,-60,15.7,24.111111,-60,452,698,-246,0,1,0,0.111111,37,10,9,1.108108,0,0,19,8,false,false,false,0.024,0.976
219,238,-19,18.25,21.636364,-19,822,845,-23,0,0,0,0,24,12,11,1.458333,0,0,7,12,false,false,false,0.04,0.96
8,0,8,8,0,8,563,523,40,0,0,0,0,96,1,0,0.385417,0,0,12,0,false,false,true,0.555,0.445
248,219,29,27.555556,27.375,29,1167,1245,-78,1,0,0.111111,0,27,9,8,1.037037,1,0,8,17,false,false,true,0.666,0.334
304,285,19,21.714286,21.923077,19,964,1003,-39,0,1,0,0.076923,7,14,13,5.571429,0,0,13,17,false,false,true,0.766,0.234
277,310,-33,17.3125,19.375,-33,450,624,-174,0,0,0,0,-17,16,16,-1.941176,1,0,3,6,false,false,false,0.197,0.803
227,206,21,18.916667,18.727273,21,387,683,-296,0,0,0,0,9,12,11,3.777778,1,0,14,22,false,false,false,0.321,0.679
285,309,-24,25.909091,30.9,-24,1164,1161,3,1,1,0.090909,0.1,1,11,10,23,0,1,19,12,false,false,false,0.101,0.899
201,288,-87,12.5625,18,-87,951,976,-25,0,0,0,0,3,16,16,14.666667,0,0,7,9,false,false,false,0,1
12,0,12,12,0,12,1770,1751,19,0,0,0,0,94,1,0,0.308511,0,0,13,0,false,false,true,0.678,0.322
216,240,-24,24,30,-24,732,868,-136,0,1,0,0.125,33,9,8,0.969697,0,0,14,9,false,false,false,0.061,0.939
179,191,-12,16.272727,19.1,-12,1310,1477,-167,0,0,0,0,23,11,10,1.565217,1,0,12,10,false,false,false,0.148,0.852
150,201,-51,12.5,18.272727,-51,1182,1075,107,0,1,0,0.090909,19,12,11,2.052632,0,1,21,9,false,false,false,0.006,0.994
10,23,-13,10,23,-13,1257,1176,81,0,0,0,0,94,1,1,0.361702,0,0,17,18,false,false,false,0.305,0.695
147,114,33,18.375,14.25,33,675,570,105,0,0,0,0,44,8,8,0.795455,0,0,13,21,false,false,true,0.955,0.045
216,294,-78,19.636364,29.4,-78,842,926,-84,0,0,0,0,14,11,10,2.142857,0,0,7,7,false,false,false,0,1
139,95,44,13.9,9.5,44,491,651,-160,0,0,0,0,43,10,10,0.697674,0,1,7,6,false,false,true,0.532,0.468
228,299,-71,12,16.611111,-71,1248,1220,28,0,1,0,0.055556,4,19,18,13,1,0,8,13,false,false,false,0,1
136,203,-67,17,29,-67,1572,1777,-205,0,1,0,0.142857,39,8,7,0.846154,0,1,10,9,false,false,false,0.02,0.98
141,138,3,14.1,15.333333,3,814,830,-16,0,0,0,0,37,10,9,1.108108,0,0,19,30,false,false,false,0.057,0.943
313,357,-44,15.65,17.85,-44,1037,1009,28,0,0,0,0,-18,20,20,-2.444444,0,0,1,1,false,false,false,0,1
122,114,8,20.333333,22.8,8,1305,1254,51,0,0,0,0,58,6,5,0.551724,0,0,12,11,false,false,false,0.452,0.548
103,61,42,20.6,15.25,42,1043,1003,40,0,0,0,0,66,5,4,0.575758,0,0,22,12,false,false,true,0.781,0.219
323,236,87,26.916667,21.454545,87,1156,1279,-123,2,0,0.166667,0,17,12,11,2.352941,0,1,7,8,false,false,true,0.999,0.001
330,342,-12,20.625,22.8,-12,1645,1636,9,0,1,0,0.066667,-19,16,15,-1.736842,0,0,1,3,false,false,false,0.006,0.994
64,94,-30,21.333333,47,-30,976,995,-19,0,1,0,0.5,82,3,2,0.463415,0,0,8,12,false,false,false,0.201,0.799
101,130,-29,25.25,43.333333,-29,1925,1885,40,1,0,0.25,0,66,4,3,0.378788,0,0,11,12,false,false,true,0.513,0.487
108,194,-86,10.8,19.4,-86,818,826,-8,0,0,0,0,48,10,10,1.104167,1,0,8,20,false,false,false,0.016,0.984
91,92,-1,22.75,23,-1,1606,1593,13,0,0,0,0,71,4,4,0.408451,0,0,18,18,false,false,false,0.398,0.602
83,109,-26,13.833333,21.8,-26,1270,1261,9,0,0,0,0,69,6,5,0.536232,1,0,6,15,false,false,false,0.184,0.816
243,213,30,15.1875,14.2,30,671,638,33,0,0,0,0,3,16,15,16.333333,0,0,12,21,false,false,true,0.757,0.243
295,319,-24,21.071429,24.538462,-24,1452,1388,64,0,1,0,0.076923,6,14,13,5.833333,0,0,14,12,false,false,false,0.007,0.993
77,88,-11,19.25,22,-11,842,926,-84,0,0,0,0,69,4,4,0.434783,0,0,16,10,false,false,false,0.325,0.675
199,280,-81,16.583333,25.454545,-81,892,856,36,0,1,0,0.090909,18,12,11,1.944444,1,0,10,11,false,false,false,0.005,0.995
44,45,-1,14.666667,22.5,-1,563,523,40,0,0,0,0,83,3,2,0.445783,0,0,14,19,false,false,true,0.536,0.464
84,59,25,16.8,14.75,25,721,757,-36,0,0,0,0,70,5,4,0.542857,0,0,7,19,false,false,false,0.273,0.727
51,35,16,17,17.5,16,694,658,36,0,0,0,0,82,3,2,0.45122,0,0,13,11,false,false,true,0.679,0.321
146,75,71,29.2,18.75,71,1156,1279,-123,1,0,0.2,0,63,5,4,0.634921,1,0,7,10,false,false,true,0.914,0.086
370,367,3,21.764706,22.9375,3,1436,1489,-53,1,1,0.058824,0.0625,-5,17,16,-7.4,0,0,2,5,false,false,true,0.956,0.044
23,20,3,11.5,20,3,700,820,-120,0,0,0,0,90,2,1,0.422222,0,0,17,9,false,false,false,0.251,0.749
189,247,-58,17.181818,22.454545,-58,620,698,-78,1,0,0.090909,0,32,11,11,1.28125,0,0,21,14,false,false,false,0,1
227,236,-9,14.1875,15.733333,-9,361,413,-52,0,0,0,0,-6,16,15,-6.833333,0,0,13,7,false,false,false,0.2,0.8
86,82,4,12.285714,13.666667,4,226,361,-135,0,0,0,0,52,7,6,0.846154,0,0,18,13,false,false,false,0.32,0.68
255,383,-128,15.9375,25.533333,-128,915,971,-56,0,0,0,0,-11,16,15,-3,0,0,1,5,false,false,false,0,1
121,101,20,20.166667,20.2,20,1043,1003,40,0,0,0,0,61,6,5,0.622951,0,0,22,13,false,false,true,0.679,0.321
182,179,3,18.2,17.9,3,387,683,-296,0,0,0,0,22,10,10,1.545455,1,0,11,21,false,false,true,0.552,0.448
14,20,-6,14,20,-6,700,820,-120,0,0,0,0,93,1,1,0.408602,0,0,20,9,false,false,false,0.251,0.749
291,309,-18,22.384615,25.75,-18,1167,1245,-78,1,0,0.076923,0,1,13,12,28,1,0,4,9,false,false,false,0.098,0.902
249,277,-28,20.75,25.181818,-28,1397,1309,88,2,0,0.166667,0,29,12,11,1.241379,0,0,11,10,false,false,false,0.005,0.995
335,345,-10,19.705882,21.5625,-10,786,885,-99,1,1,0.058824,0.0625,-6,17,16,-5.666667,0,0,2,1,false,false,false,0.001,0.999
68,88,-20,22.666667,44,-20,1645,1636,9,0,1,0,0.5,76,3,2,0.434211,0,0,17,17,false,false,false,0.201,0.799
290,290,0,17.058824,17.058824,0,1065,948,117,0,1,0,0.058824,2,17,17,19.5,0,0,11,12,false,false,true,0.661,0.339
196,224,-28,14,16,-28,361,413,-52,0,0,0,0,8,14,14,5.125,1,0,14,8,false,false,false,0.318,0.682
295,342,-47,14.75,17.1,-47,500,509,-9,0,0,0,0,-25,20,20,-1.64,0,0,2,1,false,false,false,0,1
225,288,-63,18.75,24,-63,1656,1580,76,0,1,0,0.083333,18,12,12,1.833333,2,0,8,26,false,false,false,0.1,0.9
61,80,-19,12.2,20,-19,595,540,55,0,0,0,0,68,5,4,0.632353,0,0,13,10,false,false,true,0.569,0.431
258,328,-70,13.578947,17.263158,-70,813,698,115,1,0,0.052632,0,-12,19,19,-4,0,0,6,12,false,false,false,0,1
87,119,-32,14.5,23.8,-32,563,523,40,0,0,0,0,64,6,5,0.578125,0,0,8,12,false,false,false,0.066,0.934
186,141,45,31,23.5,45,691,695,-4,1,0,0.166667,0,55,6,6,0.581818,0,0,10,17,false,false,true,0.906,0.094
256,372,-116,14.222222,20.666667,-116,503,668,-165,0,1,0,0.055556,-18,18,18,-2.055556,1,0,6,2,false,false,false,0,1
159,161,-2,13.25,14.636364,-2,1045,1082,-37,0,0,0,0,27,12,11,1.666667,1,0,18,20,false,false,false,0.363,0.637
56,123,-67,14,30.75,-67,1484,1556,-72,0,1,0,0.25,64,4,4,0.484375,0,0,16,7,false,false,false,0.2,0.8
190,245,-55,14.615385,20.416667,-55,642,952,-310,0,0,0,0,21,13,12,2.095238,0,0,14,12,false,false,false,0,1
177,204,-27,14.75,17,-27,450,503,-53,0,0,0,0,21,12,12,1.857143,1,0,20,10,false,false,false,0.496,0.504
149,170,-21,18.625,24.285714,-21,1349,1203,146,0,1,0,0.142857,45,8,7,0.711111,0,0,10,8,false,false,false,0.126,0.874
296,335,-39,18.5,20.9375,-39,1055,840,215,0,1,0,0.0625,-8,16,16,-4.5,0,0,8,9,false,false,false,0,1
180,178,2,22.5,25.428571,2,1102,1245,-143,0,0,0,0,37,8,7,0.783784,0,0,15,19,false,false,false,0.165,0.835
267,291,-24,15.705882,18.1875,-24,450,503,-53,0,0,0,0,-7,17,16,-5.571429,0,0,14,7,false,false,false,0.001,0.999
202,235,-33,22.444444,26.111111,-33,1452,1388,64,0,1,0,0.111111,34,9,9,1.029412,0,0,16,13,false,false,false,0.186,0.814
82,175,-93,13.666667,35,-93,760,976,-216,0,1,0,0.2,59,6,5,0.610169,0,0,7,10,false,false,false,0.028,0.972
80,25,55,40,25,55,824,830,-6,1,0,0.5,0,87,2,1,0.505747,0,0,15,21,false,false,false,0.438,0.562
107,160,-53,11.888889,20,-53,503,668,-165,0,0,0,0,46,9,8,0.804348,0,0,12,9,false,false,false,0.051,0.949
286,394,-108,20.428571,28.142857,-108,1232,1448,-216,0,2,0,0.142857,0,14,14,0,0,0,7,7,false,false,false,0,1
26,6,20,26,6,20,726,818,-92,0,0,0,0,90,1,1,0.388889,0,1,7,6,false,false,false,0.298,0.702
70,80,-10,14,16,-10,568,570,-2,0,0,0,0,67,5,5,0.552239,0,0,7,26,false,false,false,0.065,0.935
250,275,-25,13.888889,16.176471,-25,500,532,-32,0,0,0,0,-14,18,17,-2.928571,0,2,25,5,false,false,false,0,1
137,209,-72,17.125,26.125,-72,1003,1018,-15,0,0,0,0,40,8,8,0.925,0,0,11,9,false,false,false,0.151,0.849
335,384,-49,18.611111,21.333333,-49,1164,1261,-97,0,1,0,0.055556,-14,18,18,-3,0,0,7,5,false,false,false,0,1
73,94,-21,12.166667,15.666667,-21,206,346,-140,0,0,0,0,62,6,6,0.693548,0,0,7,16,false,false,false,0.264,0.736
122,99,23,24.4,19.8,23,967,856,111,0,0,0,0,61,5,5,0.540984,0,0,10,24,false,false,true,0.586,0.414
214,166,48,26.75,23.714286,48,691,695,-4,1,0,0.125,0,46,8,7,0.695652,1,0,12,21,false,false,false,0.191,0.809
135,92,43,22.5,18.4,43,1269,1477,-208,1,0,0.166667,0,61,6,5,0.57377,0,0,16,12,false,false,false,0.322,0.678
105,154,-49,15,25.666667,-49,837,844,-7,0,0,0,0,63,7,6,0.650794,0,1,10,12,false,false,false,0.003,0.997
67,107,-40,13.4,21.4,-40,840,1055,-215,0,0,0,0,66,5,5,0.530303,0,1,15,9,false,false,false,0.239,0.761
255,303,-48,14.166667,16.833333,-48,615,542,73,0,0,0,0,-10,18,18,-4.2,0,0,11,10,false,false,false,0,1
221,331,-110,22.1,33.1,-110,1633,1680,-47,0,1,0,0.1,14,10,10,2,1,0,7,9,false,false,false,0.02,0.98
226,254,-28,22.6,28.222222,-28,1126,1277,-151,0,0,0,0,22,10,9,1.590909,1,0,6,16,false,false,false,0.025,0.975
225,273,-48,22.5,30.333333,-48,732,868,-136,0,1,0,0.111111,26,10,9,1.230769,0,0,11,10,false,false,false,0.031,0.969
59,39,20,19.666667,19.5,20,926,973,-47,0,0,0,0,81,3,2,0.432099,0,0,10,9,false,false,true,0.641,0.359
149,127,22,24.833333,21.166667,22,1070,814,256,1,1,0.166667,0.166667,51,6,6,0.647059,0,0,14,16,false,false,true,0.972,0.028
63,128,-65,10.5,25.6,-65,343,570,-227,0,0,0,0,51,6,5,0.705882,0,0,19,10,false,false,false,0.211,0.789
277,323,-46,13.190476,16.15,-46,1071,1000,71,0,0,0,0,-25,21,20,-1.88,0,0,2,2,false,false,false,0,1
147,256,-109,14.7,28.444444,-109,710,758,-48,0,1,0,0.111111,39,10,9,0.948718,0,0,12,15,false,false,false,0,1
15,39,-24,7.5,19.5,-24,540,498,42,0,0,0,0,88,2,2,0.522727,0,1,18,6,false,false,false,0.298,0.702
156,284,-128,14.181818,25.818182,-128,342,263,79,0,0,0,0,16,11,11,2.125,0,0,18,11,false,false,false,0,1
85,70,15,17,17.5,15,1633,1556,77,0,0,0,0,66,5,4,0.5,0,0,24,7,false,false,true,0.663,0.337
304,307,-3,21.714286,21.928571,-3,964,1003,-39,0,1,0,0.071429,5,14,14,7.8,0,0,13,15,false,false,true,0.717,0.283
329,324,5,17.315789,18,5,1193,1220,-27,1,0,0.052632,0,-17,19,18,-2.529412,0,0,10,6,false,false,false,0.445,0.555
14,36,-22,14,36,-22,1305,1211,94,0,0,0,0,94,1,1,0.351064,0,0,12,28,false,false,false,0.201,0.799
238,302,-64,18.307692,25.166667,-64,1229,1220,9,0,1,0,0.083333,15,13,12,2.466667,0,0,7,25,false,false,false,0,1
55,85,-30,18.333333,28.333333,-30,1407,1473,-66,0,1,0,0.333333,76,3,3,0.407895,0,0,11,11,false,false,false,0.232,0.768
214,186,28,26.75,23.25,28,1397,1405,-8,1,0,0.125,0,36,8,8,0.805556,0,0,13,19,false,false,true,0.808,0.192
189,231,-42,17.181818,23.1,-42,653,820,-167,0,0,0,0,19,11,10,2,0,1,8,14,false,false,false,0.003,0.997
44,41,3,22,20.5,3,1197,1156,41,0,0,0,0,82,2,2,0.426829,0,1,13,6,false,false,true,0.681,0.319
133,106,27,26.6,21.2,27,786,885,-99,1,0,0.2,0,67,5,5,0.507463,0,1,9,11,false,false,false,0.048,0.952
28,31,-3,28,31,-3,1093,1173,-80,0,0,0,0,91,1,1,0.472527,0,0,22,12,false,false,true,0.672,0.328
140,158,-18,23.333333,26.333333,-18,1126,1277,-151,0,0,0,0,51,6,6,0.686275,0,0,8,12,false,false,false,0.243,0.757
61,88,-27,15.25,22,-27,736,791,-55,0,0,0,0,73,4,4,0.520548,1,0,14,16,false,false,false,0.253,0.747
27,10,17,13.5,10,17,306,302,4,0,0,0,0,91,2,1,0.450549,1,0,13,17,false,false,true,0.648,0.352
129,86,43,18.428571,12.285714,43,1040,1091,-51,0,0,0,0,55,7,7,0.854545,0,1,8,17,false,false,false,0.488,0.512
344,338,6,16.380952,16.9,6,1193,1220,-27,1,0,0.047619,0,-25,21,20,-1.72,0,0,2,1,false,false,true,0.984,0.016
166,208,-42,18.444444,26,-42,964,1003,-39,0,1,0,0.125,39,9,8,1,0,0,13,9,false,false,false,0.194,0.806
198,212,-14,19.8,21.2,-14,1331,1374,-43,0,0,0,0,28,10,10,1.178571,0,0,17,7,false,false,false,0.242,0.758
193,237,-44,12.866667,15.8,-44,808,749,59,0,0,0,0,-1,15,15,-42,0,0,11,9,false,false,false,0.038,0.962
221,324,-103,27.625,40.5,-103,1537,1539,-2,0,1,0,0.125,29,8,8,1.172414,0,1,16,19,false,false,false,0,1
278,327,-49,14.631579,17.210526,-49,1312,1334,-22,0,0,0,0,-25,19,19,-1.56,0,0,2,2,false,false,false,0,1
288,359,-71,18,22.4375,-71,1633,1556,77,1,0,0.0625,0,-22,16,16,-1.5,0,1,1,2,false,false,false,0,1
191,219,-28,19.1,21.9,-28,985,1062,-77,0,0,0,0,27,10,10,1.37037,0,0,7,22,false,false,false,0.039,0.961
64,21,43,21.333333,7,43,1193,1220,-27,0,0,0,0,80,3,3,0.5375,1,1,7,23,false,false,true,0.501,0.499
229,302,-73,19.083333,25.166667,-73,621,786,-165,0,0,0,0,2,12,12,15,0,0,14,7,false,false,false,0,1
26,0,26,26,0,26,653,1004,-351,0,0,0,0,95,1,0,0.305263,0,0,7,0,false,false,false,0.253,0.747
246,302,-56,12.947368,16.777778,-56,951,976,-25,0,0,0,0,-11,19,18,-4,0,0,6,7,false,false,false,0,1
134,130,4,13.4,14.444444,4,808,749,59,0,0,0,0,29,10,9,1.448276,0,0,25,10,false,false,true,0.604,0.396
206,258,-52,9.809524,12.9,-52,542,390,152,0,0,0,0,-1,21,20,-50,1,0,6,17,false,false,false,0,1
10,0,10,10,0,10,848,976,-128,0,0,0,0,97,1,0,0.412371,0,0,9,0,false,false,false,0.251,0.749
145,127,18,24.166667,21.166667,18,1495,1531,-36,0,0,0,0,63,6,6,0.587302,0,0,7,16,false,false,true,0.522,0.478
278,285,-7,21.384615,21.923077,-7,964,1003,-39,0,1,0,0.076923,13,13,13,3,0,0,10,17,false,false,true,0.543,0.457
223,249,-26,13.117647,14.647059,-26,163,346,-183,0,0,0,0,-17,17,17,-2.294118,0,0,11,5,false,false,false,0.44,0.56
273,307,-34,18.2,20.466667,-34,206,346,-140,1,0,0.066667,0,-3,15,15,-14.333333,0,0,31,10,false,false,false,0,1
316,403,-87,16.631579,22.388889,-87,935,995,-60,1,1,0.052632,0.055556,-22,19,18,-1.772727,0,0,6,1,false,false,false,0,1
23,8,15,11.5,8,15,651,567,84,0,0,0,0,90,2,1,0.611111,0,0,11,17,false,false,true,0.672,0.328
294,301,-7,19.6,21.5,-7,971,635,336,0,0,0,0,-13,15,14,-2.461538,0,0,2,8,false,false,false,0.008,0.992
228,281,-53,15.2,20.071429,-53,620,698,-78,1,0,0.066667,0,6,15,14,6.833333,0,0,18,17,false,false,false,0,1
193,309,-116,14.846154,23.769231,-116,503,668,-165,0,1,0,0.076923,13,13,13,2.846154,2,0,5,15,false,false,false,0.001,0.999
94,109,-15,15.666667,18.166667,-15,1094,1041,53,0,0,0,0,54,6,6,0.703704,1,0,16,16,false,false,false,0.493,0.507
112,80,32,22.4,16,32,664,786,-122,0,0,0,0,71,5,5,0.464789,0,0,18,16,false,false,true,0.642,0.358
42,38,4,10.5,12.666667,4,595,662,-67,0,0,0,0,74,4,3,0.594595,0,0,20,18,false,false,false,0.252,0.748
308,327,-19,18.117647,20.4375,-19,1037,913,124,2,1,0.117647,0.0625,-4,17,16,-9.5,0,0,11,9,false,false,false,0,1
133,234,-101,14.777778,29.25,-101,595,412,183,0,1,0,0.125,43,9,8,1.209302,0,0,8,9,false,false,false,0,1
8,0,8,8,0,8,1131,1030,101,0,0,0,0,96,1,0,0.3125,0,0,7,0,false,false,true,0.678,0.322
156,273,-117,15.6,27.3,-117,976,995,-19,0,1,0,0.1,34,10,10,1.117647,0,0,11,9,false,false,false,0,1
131,194,-63,16.375,27.714286,-63,944,1095,-151,0,1,0,0.142857,55,8,7,0.709091,0,1,7,10,false,false,false,0.038,0.962
287,268,19,20.5,19.142857,19,1168,1062,106,0,0,0,0,16,14,14,2.6875,1,0,9,8,false,false,true,0.731,0.269
308,349,-41,18.117647,20.529412,-41,1037,913,124,2,1,0.117647,0.058824,-7,17,17,-5.428571,0,0,11,11,false,false,false,0,1
200,238,-38,16.666667,19.833333,-38,1040,1364,-324,0,0,0,0,14,12,12,2.571429,0,1,14,10,false,false,false,0.098,0.902
298,270,28,21.285714,20.769231,28,939,969,-30,0,0,0,0,-4,14,13,-8.25,0,0,4,12,false,false,true,0.855,0.145
131,98,33,21.833333,19.6,33,1047,1253,-206,1,0,0.166667,0,64,6,5,0.578125,0,0,7,11,false,false,false,0.281,0.719
304,265,39,30.4,29.444444,39,169,306,-137,2,1,0.2,0.111111,12,10,9,2.583333,0,0,11,12,false,false,false,0.258,0.742
188,151,37,23.5,18.875,37,1341,1606,-265,1,0,0.125,0,35,8,8,0.942857,0,0,8,16,false,false,false,0.423,0.577
134,127,7,22.333333,21.166667,7,1417,1482,-65,0,0,0,0,61,6,6,0.540984,0,0,20,7,false,false,true,0.678,0.322
168,206,-38,33.6,51.5,-38,1398,1431,-33,0,0,0,0,51,5,4,0.54902,0,0,13,15,false,false,false,0.018,0.982
289,329,-40,18.0625,20.5625,-40,952,870,82,0,0,0,0,-9,16,16,-4.111111,0,0,7,8,false,false,false,0,1
182,223,-41,16.545455,22.3,-41,1161,1176,-15,1,1,0.090909,0.1,23,11,10,1.652174,0,0,9,17,false,false,false,0.149,0.851
93,205,-112,13.285714,29.285714,-112,1454,1479,-25,0,0,0,0,51,7,7,0.607843,1,0,6,7,false,false,false,0.006,0.994
207,222,-15,18.818182,20.181818,-15,527,954,-427,0,0,0,0,31,11,11,1.129032,0,2,26,8,false,false,false,0.217,0.783
42,83,-41,8.4,20.75,-41,95,453,-358,0,0,0,0,80,5,4,0.4875,0,0,16,9,false,false,false,0.048,0.952
190,287,-97,11.176471,17.9375,-97,1078,983,95,1,0,0.058824,0,10,17,16,4.8,0,1,12,7,false,false,false,0,1
141,250,-109,11.75,20.833333,-109,388,542,-154,0,0,0,0,17,12,12,2.176471,0,1,8,9,false,false,false,0,1
178,238,-60,14.833333,19.833333,-60,518,414,104,0,1,0,0.083333,21,12,12,1.809524,0,0,7,10,false,false,false,0.037,0.963
67,104,-37,16.75,26,-37,1248,1220,28,0,1,0,0.25,74,4,4,0.702703,0,0,10,16,false,false,false,0.201,0.799
210,338,-128,15,24.142857,-128,1003,1018,-15,0,0,0,0,-9,14,14,-4.111111,0,0,8,9,false,false,false,0,1
318,332,-14,22.714286,25.538462,-14,1188,1334,-146,1,1,0.071429,0.076923,-2,14,13,-15,1,0,4,12,false,false,false,0.237,0.763
332,361,-29,19.529412,21.235294,-29,721,757,-36,0,2,0,0.117647,-10,17,17,-3.8,0,0,2,5,false,false,false,0,1
211,310,-99,17.583333,25.833333,-99,1349,1203,146,0,1,0,0.083333,21,12,12,1.52381,0,1,11,9,false,false,false,0,1
146,163,-17,18.25,23.285714,-17,1075,878,197,0,0,0,0,54,8,7,0.611111,0,0,10,8,false,false,false,0.201,0.799
150,165,-15,16.666667,20.625,-15,1484,1556,-72,0,1,0,0.125,34,9,8,0.911765,1,0,10,11,false,false,false,0.206,0.794
299,351,-52,14.95,18.473684,-52,603,721,-118,0,0,0,0,-20,20,19,-2.15,1,0,2,3,false,false,false,0,1
297,396,-99,15.631579,20.842105,-99,848,976,-128,0,1,0,0.052632,-15,19,19,-2.666667,0,0,2,4,false,false,false,0,1
165,187,-22,16.5,18.7,-22,402,448,-46,0,0,0,0,36,10,10,1.027778,0,2,9,13,false,false,false,0.034,0.966
275,332,-57,18.333333,23.714286,-57,700,820,-120,0,1,0,0.071429,-4,15,14,-9.5,0,0,20,13,false,false,false,0,1
256,230,26,21.333333,19.166667,26,1803,1658,145,1,0,0.083333,0,10,12,12,3.3,0,0,7,16,false,false,true,0.504,0.496
281,361,-80,20.071429,25.785714,-80,1269,1477,-208,1,0,0.071429,0,6,14,14,5.833333,0,0,10,10,false,false,false,0,1
283,297,-14,15.722222,17.470588,-14,1123,1062,61,0,0,0,0,-9,18,17,-4.888889,0,0,4,14,false,false,false,0.012,0.988
28,31,-3,14,15.5,-3,1093,1100,-7,0,0,0,0,87,2,2,0.356322,0,0,10,16,false,false,true,0.657,0.343
197,283,-86,24.625,40.428571,-86,1415,1361,54,0,1,0,0.142857,38,8,7,0.815789,0,0,15,17,false,false,false,0,1
248,222,26,24.8,24.666667,26,824,830,-6,1,0,0.1,0,35,10,9,1.257143,0,0,7,17,false,false,false,0.335,0.665
57,83,-26,28.5,83,-26,907,910,-3,0,1,0,1,88,2,1,0.488636,0,0,9,12,false,false,false,0.201,0.799
209,245,-36,19,24.5,-36,1656,1580,76,0,1,0,0.1,28,11,10,1.178571,2,0,5,10,false,false,false,0.036,0.964
92,53,39,30.666667,26.5,39,1770,1745,25,1,0,0.333333,0,81,3,2,0.407407,0,0,12,17,false,false,true,0.679,0.321
0,0,0,0,0,0,1101,1115,-14,0,0,0,0,100,1,0,0.3,0,0,10,0,false,false,false,0.402,0.598
168,236,-68,16.8,23.6,-68,594,648,-54,1,1,0.1,0.1,38,10,10,1.052632,0,0,9,17,false,false,false,0,1
103,117,-14,17.166667,19.5,-14,595,538,57,0,0,0,0,55,6,6,0.690909,0,0,10,13,false,false,true,0.595,0.405
110,164,-54,10,16.4,-54,999,1165,-166,0,0,0,0,39,11,10,1.179487,0,0,22,10,false,false,false,0.038,0.962
253,326,-73,19.461538,25.076923,-73,976,995,-19,1,1,0.076923,0.076923,13,13,13,2.923077,0,1,12,9,false,false,false,0,1
278,345,-67,16.352941,21.5625,-67,795,786,9,1,0,0.058824,0,-2,17,16,-19,1,0,9,7,false,false,false,0,1
104,114,-10,13,16.285714,-10,1075,1189,-114,0,0,0,0,51,8,7,0.784314,0,0,8,19,false,false,false,0.043,0.957
115,43,72,38.333333,14.333333,72,1341,1606,-265,1,0,0.333333,0,70,3,3,0.471429,0,0,16,7,false,false,false,0.464,0.536
109,83,26,21.8,20.75,26,621,786,-165,0,0,0,0,62,5,4,0.483871,0,0,10,14,false,false,false,0.258,0.742
401,539,-138,28.642857,38.5,-138,1398,1431,-33,0,0,0,0,-21,14,14,-1.333333,0,0,1,10,true,false,false,0,1
214,195,19,26.75,27.857143,19,1885,1842,43,0,2,0,0.285714,33,8,7,0.818182,0,0,8,23,false,false,true,0.998,0.002
57,70,-13,14.25,17.5,-13,344,315,29,1,0,0.25,0,62,4,4,0.645161,0,0,7,10,false,false,true,0.543,0.457
36,52,-16,9,17.333333,-16,1561,1495,66,0,0,0,0,76,4,3,0.434211,1,0,8,14,false,false,false,0.224,0.776
307,449,-142,20.466667,32.071429,-142,1606,1593,13,1,1,0.066667,0.071429,-9,15,14,-3.222222,0,0,2,1,true,false,false,0,1
12,17,-5,12,17,-5,822,845,-23,0,0,0,0,94,1,1,0.37234,0,0,23,9,false,false,true,0.606,0.394
46,88,-42,11.5,22,-42,952,826,126,0,0,0,0,80,4,4,0.5375,0,0,12,10,false,false,false,0.202,0.798
83,225,-142,11.857143,37.5,-142,940,947,-7,0,2,0,0.333333,50,7,6,0.7,0,0,9,20,false,false,false,0,1
206,229,-23,22.888889,25.444444,-23,1422,1798,-376,0,1,0,0.111111,36,9,9,0.888889,0,1,14,9,false,false,false,0.166,0.834
302,338,-36,15.894737,17.789474,-36,1281,1268,13,0,0,0,0,-14,19,19,-3,0,0,2,3,false,false,false,0,1
310,341,-31,18.235294,20.058824,-31,1488,1403,85,0,1,0,0.058824,-19,17,17,-1.789474,1,0,8,3,true,false,false,0.006,0.994
112,130,-18,14,18.571429,-18,360,371,-11,0,0,0,0,44,8,7,0.840909,0,0,19,10,false,false,false,0.327,0.673
206,294,-88,13.733333,19.6,-88,907,878,29,0,0,0,0,19,15,15,2.263158,2,0,5,16,false,false,false,0.002,0.998
58,89,-31,19.333333,44.5,-31,1021,897,124,0,1,0,0.5,81,3,2,0.45679,0,0,7,16,false,false,false,0.2,0.8
400,454,-54,28.571429,32.428571,-54,1777,1500,277,2,2,0.142857,0.142857,-11,14,14,-2.545455,0,0,1,4,true,false,false,0.443,0.557
44,0,44,22,0,44,1070,814,256,0,0,0,0,92,2,1,0.358696,0,0,17,0,false,false,true,0.828,0.172
72,35,37,72,35,37,1699,1580,119,1,0,1,0,90,1,1,0.333333,0,1,8,9,false,false,true,0.807,0.193
112,166,-54,14,20.75,-54,1182,1075,107,0,1,0,0.125,43,8,8,0.906977,0,1,25,6,false,false,false,0.164,0.836
198,203,-5,24.75,25.375,-5,1237,1265,-28,1,0,0.125,0,36,8,8,1,0,0,16,7,false,false,true,0.68,0.32
24,34,-10,12,17,-10,527,954,-427,0,0,0,0,85,2,2,0.411765,0,0,20,13,false,false,false,0.251,0.749
90,93,-3,22.5,23.25,-3,1205,1216,-11,0,0,0,0,73,4,4,0.452055,0,0,13,26,false,false,false,0.235,0.765
14,21,-7,14,21,-7,736,791,-55,0,0,0,0,93,1,1,0.408602,1,0,9,23,false,false,false,0.258,0.742
211,315,-104,13.1875,21,-104,632,603,29,0,1,0,0.066667,-12,16,15,-3.166667,0,0,10,12,false,false,false,0,1
155,203,-48,19.375,29,-48,842,926,-84,0,0,0,0,38,8,7,0.789474,0,0,10,10,false,false,false,0.042,0.958
112,29,83,37.333333,14.5,83,1156,1279,-123,1,0,0.333333,0,77,3,2,0.519481,0,0,14,13,false,false,true,0.587,0.413
117,109,8,13,13.625,8,1278,1101,177,0,0,0,0,49,9,8,0.755102,1,0,9,10,false,false,false,0.206,0.794
53,75,-22,10.6,15,-22,1075,1189,-114,0,0,0,0,67,5,5,0.597015,0,0,7,14,false,false,false,0.195,0.805
136,151,-15,17,21.571429,-15,1123,1062,61,0,0,0,0,49,8,7,0.897959,0,0,12,15,false,false,false,0.201,0.799
28,13,15,14,13,15,1093,1100,-7,0,0,0,0,90,2,1,0.344444,0,0,10,20,false,false,true,0.61,0.39
334,372,-38,16.7,18.6,-38,1063,1134,-71,1,0,0.05,0,-12,20,20,-3.666667,0,0,2,2,false,false,false,0,1
140,156,-16,11.666667,14.181818,-16,542,390,152,0,0,0,0,45,12,11,1.111111,0,0,10,22,false,false,false,0.096,0.904
353,377,-24,20.764706,23.5625,-24,1110,1399,-289,0,1,0,0.0625,-9,17,16,-3.777778,0,0,1,4,false,false,false,0,1
152,197,-45,16.888889,24.625,-45,926,973,-47,0,0,0,0,35,9,8,1,0,1,14,19,false,false,false,0.007,0.993
238,444,-206,19.833333,37,-206,1219,1216,3,1,4,0.083333,0.333333,-8,12,12,-3.375,0,0,8,5,false,false,false,0.052,0.948
280,349,-69,14.736842,19.388889,-69,402,448,-46,0,0,0,0,-22,19,18,-1.681818,0,0,2,1,true,false,false,0,1
273,399,-126,10.92,15.96,-126,1248,1220,28,0,1,0,0.04,-26,25,25,-2,0,0,2,4,false,false,false,0,1
132,75,57,33,18.75,57,1156,1279,-123,1,0,0.25,0,66,4,4,0.606061,1,0,9,10,false,false,true,0.909,0.091
304,371,-67,20.266667,24.733333,-67,1349,1203,146,0,1,0,0.066667,2,15,15,16,0,0,3,8,false,false,false,0,1
243,272,-29,12.15,14.315789,-29,163,346,-183,0,0,0,0,-33,20,19,-1.181818,0,0,1,4,true,false,false,0.001,0.999
137,122,15,19.571429,20.333333,15,1047,1253,-206,1,0,0.142857,0,59,7,6,0.627119,0,0,7,10,false,false,false,0.255,0.745
28,26,2,14,26,2,1253,1324,-71,0,0,0,0,87,2,1,0.333333,0,0,9,23,false,false,false,0.4,0.6
12,19,-7,12,19,-7,1281,1268,13,0,0,0,0,91,1,1,0.461538,0,0,22,22,false,false,true,0.618,0.382
12,14,-2,12,14,-2,1075,1189,-114,0,0,0,0,91,1,1,0.43956,0,0,7,12,false,false,false,0.257,0.743
238,320,-82,18.307692,24.615385,-82,1229,1220,9,0,1,0,0.076923,13,13,13,2.846154,0,0,7,25,false,false,false,0,1
104,110,-6,11.555556,13.75,-6,542,390,152,0,0,0,0,59,9,8,0.847458,0,0,13,16,false,false,false,0.195,0.805
335,346,-11,16.75,17.3,-11,775,786,-11,1,0,0.05,0,-23,20,20,-1.869565,0,0,12,15,false,false,true,0.816,0.184
199,283,-84,14.214286,21.769231,-84,952,826,126,0,1,0,0.076923,20,14,13,2.15,0,0,22,16,false,false,false,0,1
19,60,-41,6.333333,20,-41,1078,983,95,0,0,0,0,83,3,3,0.578313,1,0,10,9,false,false,false,0.245,0.755
145,204,-59,16.111111,22.666667,-59,736,791,-55,0,0,0,0,35,9,9,1.085714,0,0,7,9,false,false,false,0.039,0.961
145,187,-42,16.111111,20.777778,-42,813,698,115,1,0,0.111111,0,41,9,9,1.170732,0,1,7,12,false,false,false,0.006,0.994
256,298,-42,18.285714,21.285714,-42,387,683,-296,0,0,0,0,-6,14,14,-5.666667,1,1,6,16,false,false,false,0.042,0.958
289,312,-23,11.56,12.48,-23,542,390,152,1,0,0.04,0,-25,25,25,-2,0,0,2,6,true,false,true,0.705,0.295
212,297,-85,19.272727,29.7,-85,1232,1281,-49,0,2,0,0.2,16,11,10,1.9375,1,0,8,19,false,false,false,0.004,0.996
20,0,20,20,0,20,1065,948,117,0,0,0,0,96,1,0,0.40625,1,0,8,0,false,false,true,0.684,0.316
214,257,-43,17.833333,23.363636,-43,452,698,-246,0,1,0,0.090909,21,12,11,1.952381,0,0,21,10,false,false,false,0.013,0.987
286,335,-49,16.823529,19.705882,-49,1071,1181,-110,0,0,0,0,-5,17,17,-6.8,0,1,5,5,true,false,false,0,1
130,160,-30,18.571429,22.857143,-30,527,954,-427,0,0,0,0,53,7,7,0.660377,0,1,26,13,false,false,false,0.029,0.971
307,381,-74,21.928571,29.307692,-74,1422,1798,-376,0,2,0,0.153846,2,14,13,16,0,0,7,10,false,false,false,0,1
255,456,-201,19.615385,35.076923,-201,1219,1216,3,1,4,0.076923,0.307692,-16,13,13,-1.6875,0,0,1,5,false,false,false,0.053,0.947
335,377,-42,18.611111,22.176471,-42,1164,1261,-97,0,1,0,0.058824,-11,18,17,-3.818182,0,0,7,7,false,false,false,0,1
95,140,-45,13.571429,20,-45,668,363,305,0,0,0,0,56,7,7,0.839286,0,0,8,10,false,false,false,0.17,0.83
293,386,-93,19.533333,25.733333,-93,1269,1477,-208,1,0,0.066667,0,0,15,15,0,0,0,7,5,false,false,false,0,1
283,253,30,18.866667,18.071429,30,356,498,-142,0,1,0,0.071429,3,15,14,11.666667,0,0,7,20,false,false,false,0.44,0.56
237,316,-79,13.941176,18.588235,-79,306,361,-55,0,0,0,0,-24,17,17,-1.5,0,0,1,3,false,false,false,0,1
221,296,-75,15.785714,21.142857,-75,1161,1176,-15,1,1,0.071429,0.071429,0,14,14,0,0,0,10,23,false,false,false,0,1
110,190,-80,27.5,47.5,-80,1164,1261,-97,0,1,0,0.25,68,4,4,0.617647,0,0,25,10,false,false,false,0.198,0.802
34,74,-40,11.333333,24.666667,-40,915,971,-56,0,0,0,0,79,3,3,0.417722,0,0,9,25,false,false,false,0.039,0.961
119,109,10,17,18.166667,10,1094,1041,53,0,0,0,0,52,7,6,0.730769,1,0,16,16,false,false,true,0.618,0.382
252,294,-42,21,24.5,-42,561,633,-72,0,1,0,0.083333,15,12,12,2.333333,0,0,12,14,false,false,false,0.027,0.973
217,249,-32,12.055556,13.833333,-32,1220,1202,18,0,0,0,0,-2,18,18,-25,0,1,27,13,false,false,false,0,1
108,33,75,36,16.5,75,724,398,326,1,0,0.333333,0,81,3,2,0.481481,0,0,16,13,false,false,true,0.968,0.032
45,63,-18,15,31.5,-18,1176,1211,-35,0,0,0,0,78,3,2,0.423077,1,0,8,17,false,false,false,0.491,0.509
364,365,-1,21.411765,22.8125,-1,1093,1173,-80,1,1,0.058824,0.0625,-8,17,16,-5.375,0,0,5,15,false,false,false,0.327,0.673
127,190,-63,15.875,27.142857,-63,480,739,-259,0,0,0,0,50,8,7,0.78,0,0,8,16,false,false,false,0.003,0.997
344,342,2,16.380952,16.285714,2,1193,1220,-27,1,0,0.047619,0,-29,21,21,-1.482759,0,0,2,1,false,false,true,0.996,0.004
73,37,36,24.333333,18.5,36,1885,1908,-23,0,1,0,0.5,79,3,2,0.291139,1,1,7,9,false,false,true,0.927,0.073
86,89,-3,17.2,17.8,-3,1334,1439,-105,1,0,0.2,0,82,5,5,0.439024,0,0,13,14,false,false,false,0.252,0.748
378,380,-2,23.625,23.75,-2,1110,1123,-13,1,2,0.0625,0.125,-19,16,16,-1.736842,0,0,3,3,false,false,true,0.858,0.142
237,223,14,16.928571,17.153846,14,840,1055,-215,0,0,0,0,7,14,13,5,0,0,10,9,false,false,false,0.409,0.591
276,309,-33,15.333333,17.166667,-33,430,542,-112,0,1,0,0.055556,-8,18,18,-6,0,0,18,12,false,false,false,0,1
134,136,-2,16.75,19.428571,-2,341,416,-75,0,0,0,0,54,8,7,0.722222,0,0,11,9,false,false,false,0.296,0.704
261,310,-49,15.352941,18.235294,-49,1312,1334,-22,0,0,0,0,-14,17,17,-2.785714,0,0,5,4,false,false,false,0,1
259,332,-73,19.923077,27.666667,-73,1583,1403,180,0,0,0,0,8,13,12,4,0,0,10,18,false,false,false,0,1
168,209,-41,14,17.416667,-41,848,976,-128,0,0,0,0,27,12,12,1.481481,0,1,19,10,false,false,false,0.072,0.928
233,296,-63,15.533333,21.142857,-63,848,976,-128,0,1,0,0.071429,10,15,14,4,0,0,13,14,false,false,false,0,1
236,268,-32,18.153846,22.333333,-32,795,786,9,1,0,0.076923,0,22,13,12,1.727273,0,0,8,11,false,false,false,0.001,0.999
128,109,19,18.285714,15.571429,19,720,437,283,0,0,0,0,58,7,7,0.724138,0,0,9,9,false,false,true,0.566,0.434
192,170,22,19.2,18.888889,22,742,868,-126,0,0,0,0,36,10,9,0.916667,0,1,12,13,false,false,false,0.316,0.684
290,327,-37,19.333333,23.357143,-37,1205,1216,-11,0,0,0,0,0,15,14,0,0,0,5,12,false,false,false,0,1
297,228,69,24.75,20.727273,69,1373,1334,39,1,1,0.083333,0.090909,20,12,11,1.6,0,1,7,19,false,false,true,0.901,0.099
310,335,-25,20.666667,23.928571,-25,892,856,36,1,1,0.066667,0.071429,-7,15,14,-5,0,0,15,13,false,false,false,0,1
262,527,-265,16.375,35.133333,-265,1632,2020,-388,0,3,0,0.2,-20,16,15,-1.55,0,0,4,2,true,false,false,0,1
80,73,7,20,18.25,7,704,523,181,0,0,0,0,70,4,4,0.5,1,0,12,10,false,false,true,0.775,0.225
140,127,13,20,21.166667,13,1417,1482,-65,0,0,0,0,58,7,6,0.568966,0,0,19,7,false,false,true,0.664,0.336
279,309,-30,14.684211,16.263158,-30,670,576,94,0,0,0,0,-17,19,19,-2.411765,0,0,2,1,false,false,false,0.004,0.996
209,307,-98,17.416667,25.583333,-98,1270,1424,-154,0,2,0,0.166667,21,12,12,1.666667,0,0,24,12,false,false,false,0,1
154,244,-90,12.833333,22.181818,-90,1075,1189,-114,0,0,0,0,23,12,11,1.73913,0,0,7,16,false,false,false,0,1
284,358,-74,25.818182,35.8,-74,1770,1751,19,0,1,0,0.1,14,11,10,2.071429,0,0,15,14,false,false,false,0,1
156,272,-116,13,24.727273,-116,1305,1307,-2,0,1,0,0.090909,20,12,11,2.05,0,0,10,23,false,false,false,0,1
233,245,-12,17.923077,20.416667,-12,576,602,-26,0,0,0,0,19,13,12,2.210526,1,0,6,11,false,false,false,0.05,0.95
27,13,14,13.5,13,14,771,668,103,0,0,0,0,90,2,1,0.422222,0,0,11,8,false,false,true,0.681,0.319
91,49,42,30.333333,16.333333,42,1563,1539,24,0,0,0,0,76,3,3,0.460526,0,0,11,10,false,false,true,0.788,0.212
185,221,-36,18.5,22.1,-36,518,461,57,0,0,0,0,30,10,10,1.2,0,1,16,6,false,false,false,0.008,0.992
148,193,-45,18.5,24.125,-45,1205,1216,-11,0,0,0,0,45,8,8,0.733333,0,0,9,16,false,false,false,0.146,0.854
223,203,20,22.3,22.555556,20,1227,1189,38,0,0,0,0,27,10,9,1.296296,0,0,8,19,false,false,false,0.207,0.793
246,263,-17,24.6,29.222222,-17,1793,1869,-76,0,1,0,0.111111,27,10,9,1.111111,0,0,20,8,false,false,false,0.201,0.799
354,333,21,27.230769,27.75,21,1885,1842,43,0,2,0,0.166667,-3,13,12,-9,0,1,7,5,false,false,false,0.03,0.97
247,259,-12,17.642857,19.923077,-12,1161,1030,131,0,1,0,0.076923,2,14,13,19,0,0,17,7,false,false,false,0.035,0.965
56,47,9,14,15.666667,9,1484,1556,-72,0,0,0,0,71,4,3,0.43662,0,1,16,6,false,false,true,0.672,0.328
323,390,-67,17,21.666667,-67,480,739,-259,1,0,0.052632,0,-15,19,18,-2.6,0,0,1,1,false,false,false,0,1
243,412,-169,17.357143,31.692308,-169,1093,1100,-7,0,2,0,0.153846,10,14,13,3.5,0,0,26,13,false,false,false,0,1
296,349,-53,15.578947,19.388889,-53,452,698,-246,0,1,0,0.055556,-18,19,18,-2.277778,0,0,4,2,false,false,false,0,1
332,359,-27,20.75,23.933333,-27,892,856,36,1,1,0.0625,0.066667,-14,16,15,-2.5,0,0,5,8,false,false,false,0,1
48,85,-37,16,28.333333,-37,341,416,-75,0,0,0,0,80,3,3,0.4875,0,0,16,10,false,false,false,0.156,0.844
162,186,-24,16.2,20.666667,-24,430,542,-112,0,1,0,0.111111,36,10,9,1.333333,0,0,19,13,false,false,false,0.127,0.873
293,335,-42,17.235294,19.705882,-42,1220,1185,35,0,1,0,0.058824,0,17,17,0,0,0,17,14,false,false,false,0,1
263,338,-75,10.115385,13.52,-75,818,826,-8,0,0,0,0,-43,26,25,-1.232558,0,0,2,4,false,false,false,0,1
311,345,-34,19.4375,21.5625,-34,1344,1314,30,0,2,0,0.125,-9,16,16,-3.777778,0,0,7,4,false,false,false,0.005,0.995
242,265,-23,26.888889,29.444444,-23,1331,1432,-101,0,0,0,0,22,9,9,1.227273,0,1,19,15,false,false,false,0.072,0.928
120,83,37,30,27.666667,37,1770,1745,25,1,0,0.25,0,77,4,3,0.428571,0,0,9,13,false,false,true,0.682,0.318
272,361,-89,15.111111,21.235294,-89,595,412,183,0,1,0,0.058824,-7,18,17,-7.428571,0,0,10,12,false,false,false,0,1
234,308,-74,21.272727,30.8,-74,1606,1890,-284,0,1,0,0.1,16,11,10,1.75,1,0,10,19,false,false,false,0.024,0.976
221,281,-60,12.277778,15.611111,-60,391,542,-151,1,0,0.055556,0,-13,18,18,-3.538462,0,0,11,18,false,false,false,0,1
66,23,43,33,23,43,1793,1957,-164,0,0,0,0,87,2,1,0.333333,0,0,11,16,false,false,true,0.671,0.329
142,151,-9,11.833333,13.727273,-9,163,346,-183,0,0,0,0,21,12,11,1.857143,0,0,13,10,false,false,true,0.503,0.497
159,212,-53,14.454545,21.2,-53,1248,1220,28,0,1,0,0.1,40,11,10,1.3,1,0,15,10,false,false,false,0.137,0.863
53,89,-36,10.6,22.25,-36,1064,1397,-333,0,1,0,0.25,84,5,4,0.511905,1,0,10,20,false,false,false,0.055,0.945
286,282,4,15.052632,15.666667,4,361,413,-52,0,0,0,0,-24,19,18,-1.708333,0,0,3,4,false,false,false,0.349,0.651
286,417,-131,22,34.75,-131,1554,1685,-131,0,2,0,0.166667,6,13,12,5.333333,0,0,12,16,false,false,false,0,1
37,87,-50,7.4,21.75,-50,907,1070,-163,0,0,0,0,71,5,4,0.492958,0,0,18,16,false,false,false,0.046,0.954
194,178,16,27.714286,25.428571,16,1331,1347,-16,1,0,0.142857,0,40,7,7,0.8,0,0,10,14,false,false,true,0.694,0.306
0,0,0,0,0,0,720,437,283,0,0,0,0,100,1,0,0.42,0,0,15,0,false,false,true,0.702,0.298
96,118,-22,16,19.666667,-22,388,542,-154,0,0,0,0,51,6,6,0.72549,0,0,16,15,false,false,false,0.252,0.748
301,395,-94,18.8125,26.333333,-94,726,818,-92,0,1,0,0.066667,-7,16,15,-5,0,0,9,6,false,false,false,0,1
293,357,-64,18.3125,22.3125,-64,668,771,-103,0,0,0,0,-3,16,16,-13.333333,0,1,4,3,false,false,false,0,1
85,102,-17,14.166667,20.4,-17,1040,1364,-324,0,0,0,0,60,6,5,0.6,0,1,16,14,false,false,false,0.249,0.751
285,312,-27,23.75,26,-27,1071,1065,6,0,0,0,0,8,12,12,3.875,0,1,9,10,false,false,false,0.07,0.93
237,344,-107,14.8125,21.5,-107,736,791,-55,0,0,0,0,-12,16,16,-3.166667,0,0,12,4,false,false,false,0,1
93,189,-96,18.6,37.8,-96,1399,1210,189,0,1,0,0.2,63,5,5,0.555556,0,0,20,23,false,false,false,0.02,0.98
34,57,-23,11.333333,19,-23,951,976,-25,0,0,0,0,79,3,3,0.556962,1,1,16,29,false,false,false,0.012,0.988
146,109,37,24.333333,18.166667,37,1281,1268,13,0,0,0,0,56,6,6,0.75,0,0,8,13,false,false,true,0.802,0.198
14,0,14,14,0,14,1803,1658,145,0,0,0,0,97,1,0,0.340206,1,0,10,0,false,false,true,0.927,0.073
38,84,-46,9.5,21,-46,951,976,-25,0,0,0,0,75,4,4,0.586667,1,1,18,29,false,false,false,0.003,0.997
329,324,5,17.315789,17.052632,5,1193,1220,-27,1,0,0.052632,0,-17,19,19,-2.529412,0,0,10,6,false,false,true,0.987,0.013
32,0,32,32,0,32,518,461,57,0,0,0,0,96,1,0,0.375,0,0,12,0,false,false,true,0.738,0.262
244,298,-54,18.769231,22.923077,-54,1078,1095,-17,1,1,0.076923,0.076923,13,13,13,2.846154,0,0,7,10,false,false,false,0,1
60,46,14,20,23,14,1539,1891,-352,0,0,0,0,81,3,2,0.308642,0,0,17,14,false,false,false,0.251,0.749
56,107,-51,11.2,21.4,-51,561,688,-127,0,0,0,0,69,5,5,0.666667,0,1,11,13,false,false,false,0.011,0.989
190,181,9,21.111111,22.625,9,621,786,-165,0,0,0,0,26,9,8,1.153846,0,0,8,16,false,false,false,0.268,0.732
284,302,-18,16.705882,18.875,-18,1045,948,97,0,0,0,0,-31,17,16,-1.096774,0,0,6,2,false,false,false,0.006,0.994
58,77,-19,14.5,25.666667,-19,1633,1620,13,0,0,0,0,75,4,3,0.48,0,0,16,20,false,false,false,0.201,0.799
102,127,-25,14.571429,21.166667,-25,951,976,-25,0,0,0,0,59,7,6,0.745763,1,1,15,22,false,false,false,0.003,0.997
285,207,78,17.8125,13.8,78,1030,998,32,0,0,0,0,4,16,15,9.25,0,1,18,9,false,false,true,0.979,0.021
237,259,-22,16.928571,18.5,-22,615,542,73,0,0,0,0,12,14,14,3.5,0,0,7,7,false,false,false,0.396,0.604
70,104,-34,11.666667,20.8,-34,1000,960,40,0,0,0,0,66,6,5,0.681818,1,0,13,8,false,false,false,0.253,0.747
143,100,43,35.75,33.333333,43,1436,1489,-53,1,0,0.25,0,75,4,3,0.493333,0,1,13,11,false,false,false,0.075,0.925
44,64,-20,14.666667,21.333333,-20,1770,1751,19,0,0,0,0,73,3,3,0.39726,0,1,16,7,false,false,false,0.43,0.57
253,303,-50,31.625,37.875,-50,1431,1399,32,0,2,0,0.25,22,8,8,1.136364,0,0,11,9,false,false,false,0.007,0.993
257,307,-50,15.117647,19.1875,-50,889,855,34,0,1,0,0.0625,-6,17,16,-6.666667,0,1,10,7,false,false,false,0,1
116,170,-54,23.2,34,-54,1071,1065,6,0,0,0,0,52,5,5,0.596154,0,0,24,7,false,false,false,0.345,0.655
16,11,5,16,11,5,561,633,-72,0,0,0,0,91,1,1,0.384615,1,1,7,9,false,false,false,0.249,0.751
251,291,-40,14.764706,17.117647,-40,1040,1091,-51,0,0,0,0,-7,17,17,-6.714286,0,0,13,12,false,false,false,0,1
14,18,-4,14,18,-4,402,448,-46,0,0,0,0,93,1,1,0.397849,0,0,10,12,false,false,false,0.252,0.748
192,196,-4,19.2,21.777778,-4,971,635,336,0,0,0,0,31,10,9,1.032258,0,0,17,19,false,false,false,0.195,0.805
53,74,-21,13.25,24.666667,-21,935,995,-60,0,0,0,0,78,4,3,0.5,2,0,17,16,false,false,false,0.442,0.558
166,329,-163,15.090909,29.909091,-163,1399,1210,189,0,1,0,0.090909,29,11,11,1.206897,0,0,16,9,false,false,false,0.02,0.98
100,94,6,33.333333,47,6,1761,1770,-9,0,1,0,0.5,77,3,2,0.337662,0,0,8,18,false,false,false,0.202,0.798
275,382,-107,17.1875,23.875,-107,563,523,40,0,0,0,0,-6,16,16,-6.166667,0,0,8,5,false,false,false,0,1
88,183,-95,11,22.875,-95,343,570,-227,0,0,0,0,37,8,8,0.972973,0,0,28,7,false,false,false,0.004,0.996
278,328,-50,23.166667,27.333333,-50,1439,1314,125,0,0,0,0,6,12,12,4.666667,0,1,10,8,false,false,false,0.003,0.997
334,372,-38,20.875,23.25,-38,1101,1237,-136,1,0,0.0625,0,-5,16,16,-6.8,0,0,5,2,false,false,false,0,1
242,273,-31,16.133333,19.5,-31,1176,1211,-35,0,0,0,0,-5,15,14,-6.6,0,0,8,12,false,false,false,0.126,0.874
134,206,-72,14.888889,25.75,-72,915,971,-56,0,0,0,0,39,9,8,0.846154,0,0,10,22,false,false,false,0.016,0.984
294,342,-48,14.7,18,-48,758,791,-33,0,0,0,0,-26,20,19,-1.5,0,0,2,1,true,false,false,0,1
152,212,-60,16.888889,23.555556,-60,1123,1062,61,0,0,0,0,37,9,9,1.189189,0,0,18,18,false,false,false,0.192,0.808
158,118,40,19.75,16.857143,40,206,346,-140,1,0,0.125,0,46,8,7,0.934783,0,1,15,13,false,false,false,0.051,0.949
234,437,-203,21.272727,39.727273,-203,1539,1891,-352,0,2,0,0.181818,3,11,11,8.333333,1,1,7,8,false,false,false,0,1
40,99,-59,13.333333,49.5,-59,1270,1424,-154,0,1,0,0.5,81,3,2,0.432099,0,0,12,8,false,false,false,0.2,0.8
30,28,2,10,14,2,651,567,84,0,0,0,0,82,3,2,0.670732,0,0,10,14,false,false,true,0.667,0.333
70,139,-69,10,19.857143,-69,813,698,115,0,0,0,0,58,7,7,0.827586,1,1,7,12,false,false,false,0.006,0.994
14,6,8,14,6,8,874,868,6,0,0,0,0,93,1,1,0.354839,1,0,21,12,false,false,true,0.681,0.319
125,146,-21,12.5,14.6,-21,542,390,152,0,0,0,0,51,10,10,0.980392,0,0,8,20,false,false,false,0.137,0.863
249,258,-9,14.647059,16.125,-9,1182,1075,107,0,1,0,0.0625,-12,17,16,-3.25,0,1,15,15,false,false,false,0.01,0.99
287,373,-86,17.9375,24.866667,-86,1094,1159,-65,0,0,0,0,-11,16,15,-3.454545,1,0,3,7,false,false,false,0,1
228,388,-160,19,32.333333,-160,842,926,-84,0,1,0,0.083333,-1,12,12,-30,0,0,16,16,false,false,false,0,1
298,285,13,19.866667,20.357143,13,1803,1658,145,1,0,0.066667,0,-6,15,14,-5.5,0,0,5,12,false,false,false,0.393,0.607
166,218,-52,18.444444,24.222222,-52,964,1003,-39,0,1,0,0.111111,35,9,9,1.114286,0,0,13,8,false,false,false,0.198,0.802
325,377,-52,20.3125,23.5625,-52,1021,897,124,0,2,0,0.125,-18,16,16,-2.055556,0,0,10,2,false,false,false,0,1
125,124,1,17.857143,20.666667,1,500,532,-32,0,0,0,0,53,7,6,0.773585,0,0,7,10,false,false,false,0.265,0.735
354,362,-8,16.857143,18.1,-8,804,766,38,0,1,0,0.05,-17,21,20,-2.411765,0,0,2,1,true,false,false,0.002,0.998
30,38,-8,15,19,-8,1094,1041,53,0,0,0,0,84,2,2,0.452381,1,0,10,10,false,false,true,0.683,0.317
179,181,-2,22.375,22.625,-2,621,786,-165,0,0,0,0,29,8,8,1.034483,0,0,9,16,false,false,false,0.268,0.732
218,214,4,14.533333,15.285714,4,1040,1091,-51,0,0,0,0,16,15,14,2.9375,0,1,9,15,false,false,false,0.325,0.675
302,267,35,13.727273,12.714286,35,671,638,33,0,0,0,0,-30,22,21,-1.633333,0,0,2,13,false,false,true,1,0
287,352,-65,15.944444,20.705882,-65,594,648,-54,1,1,0.055556,0.058824,-7,18,17,-5.714286,0,0,2,5,false,false,false,0,1
252,334,-82,14.823529,19.647059,-82,1037,1016,21,1,0,0.058824,0,7,17,17,8.285714,1,0,15,9,false,false,false,0,1
158,135,23,15.8,13.5,23,1040,1091,-51,0,0,0,0,37,10,10,1.27027,0,1,10,18,false,false,false,0.17,0.83
124,116,8,20.666667,23.2,8,1266,1339,-73,0,0,0,0,66,6,5,0.530303,0,1,11,8,false,false,false,0.227,0.773
232,237,-5,17.846154,19.75,-5,356,498,-142,0,1,0,0.083333,14,13,12,2.5,1,0,15,14,false,false,false,0.44,0.56
270,247,23,20.769231,20.583333,23,824,830,-6,1,0,0.076923,0,21,13,12,2.095238,0,0,7,20,false,false,false,0.24,0.76
171,151,20,17.1,15.1,20,897,996,-99,0,0,0,0,39,10,10,1,0,0,15,10,false,false,true,0.548,0.452
63,152,-89,10.5,25.333333,-89,343,570,-227,0,0,0,0,48,6,6,0.75,0,0,19,7,false,false,false,0.202,0.798
188,256,-68,15.666667,21.333333,-68,95,453,-358,0,0,0,0,21,12,12,1.857143,0,0,10,23,false,false,false,0,1
202,277,-75,18.363636,27.7,-75,1305,1254,51,0,1,0,0.1,20,11,10,1.6,0,0,8,13,false,false,false,0,1
254,382,-128,18.142857,27.285714,-128,726,818,-92,0,1,0,0.071429,0,14,14,0,0,0,25,8,false,false,false,0,1
305,324,-19,16.944444,18,-19,1030,998,32,0,0,0,0,-15,18,18,-2.466667,0,1,13,9,false,false,false,0.003,0.997
40,35,5,20,35,5,480,518,-38,0,0,0,0,88,2,1,0.454545,0,1,14,15,false,false,false,0.02,0.98
186,208,-22,11.625,13,-22,542,390,152,0,0,0,0,23,16,16,2.173913,1,0,6,10,false,false,false,0.372,0.628
120,195,-75,15,27.857143,-75,1195,1397,-202,0,1,0,0.142857,48,8,7,0.833333,0,0,10,9,false,false,false,0.037,0.963
48,90,-42,12,22.5,-42,566,742,-176,0,0,0,0,72,4,4,0.444444,0,1,13,15,false,false,false,0.034,0.966
239,235,4,18.384615,18.076923,4,1281,1268,13,0,0,0,0,20,13,13,2.1,0,0,8,12,false,false,false,0.247,0.753
116,137,-21,14.5,19.571429,-21,913,1037,-124,0,1,0,0.142857,62,8,7,0.66129,0,0,23,7,false,false,false,0.074,0.926
309,339,-30,15.45,17.842105,-30,995,965,30,0,1,0,0.052632,-22,20,19,-1.818182,0,0,1,1,false,false,false,0,1
135,130,5,12.272727,13,5,1278,1101,177,0,0,0,0,38,11,10,0.973684,1,1,18,12,false,false,false,0.227,0.773
14,0,14,14,0,14,1399,1210,189,0,0,0,0,95,1,0,0.368421,0,0,13,0,false,false,true,0.684,0.316
108,118,-10,13.5,16.857143,-10,1040,1364,-324,0,0,0,0,45,8,7,0.8,0,1,20,13,false,false,false,0.251,0.749
36,37,-1,12,18.5,-1,818,826,-8,0,0,0,0,88,3,2,0.602273,1,0,9,19,false,false,false,0.268,0.732
83,92,-9,13.833333,15.333333,-9,163,346,-183,0,0,0,0,55,6,6,0.709091,0,1,9,11,false,false,false,0.137,0.863
122,212,-90,9.384615,17.666667,-90,818,826,-8,0,0,0,0,38,13,12,1.394737,1,0,9,17,false,false,false,0.008,0.992
63,103,-40,21,51.5,-40,1045,1100,-55,0,0,0,0,79,3,2,0.43038,0,1,12,10,false,false,false,0.007,0.993
101,162,-61,25.25,54,-61,1633,1680,-47,0,1,0,0.333333,60,4,3,0.466667,0,0,8,21,false,false,false,0.102,0.898
287,362,-75,15.944444,20.111111,-75,594,648,-54,1,1,0.055556,0.055556,-12,18,18,-3.333333,0,0,2,4,false,false,false,0,1
28,4,24,14,4,24,670,576,94,0,0,0,0,86,2,1,0.476744,0,0,9,10,false,false,true,0.692,0.308
100,142,-42,25,47.333333,-42,1331,1432,-101,0,0,0,0,61,4,3,0.442623,0,0,10,23,false,false,false,0.03,0.97
205,269,-64,14.642857,20.692308,-64,714,892,-178,0,2,0,0.153846,10,14,13,4.2,0,0,12,7,false,false,false,0,1
80,61,19,20,20.333333,19,1071,1181,-110,0,0,0,0,78,4,3,0.435897,0,0,14,12,false,false,false,0.259,0.741
210,255,-45,15,18.214286,-45,813,698,115,1,0,0.071429,0,17,14,14,2.823529,0,0,10,10,false,false,false,0.003,0.997
339,448,-109,30.818182,40.727273,-109,2010,2219,-209,1,2,0.090909,0.181818,1,11,11,26,0,0,19,4,false,false,false,0,1
102,173,-71,12.75,21.625,-71,917,856,61,0,1,0,0.125,51,8,8,0.647059,0,1,20,9,false,false,false,0.171,0.829
236,296,-60,15.733333,21.142857,-60,95,453,-358,0,0,0,0,2,15,14,19.5,0,0,12,12,false,false,false,0,1
266,215,51,20.461538,17.916667,51,675,570,105,0,0,0,0,10,13,12,3.5,1,0,10,12,false,false,true,0.969,0.031
14,0,14,14,0,14,1388,1366,22,0,0,0,0,96,1,0,0.333333,0,0,11,0,false,false,true,0.678,0.322
230,330,-100,15.333333,22,-100,736,791,-55,0,0,0,0,-5,15,15,-7.6,0,0,13,16,false,false,false,0,1
88,209,-121,14.666667,34.833333,-121,710,758,-48,0,1,0,0.166667,58,6,6,0.637931,0,0,11,14,false,false,false,0,1
303,341,-38,14.428571,16.238095,-38,1045,1082,-37,0,0,0,0,-30,21,21,-1.5,0,0,2,1,false,false,false,0,1
239,398,-159,12.578947,20.947368,-159,473,683,-210,0,0,0,0,-23,19,19,-1.652174,0,0,1,1,true,false,false,0,1
126,111,15,15.75,15.857143,15,889,855,34,0,0,0,0,54,8,7,0.740741,0,0,25,10,false,false,true,0.689,0.311
16,0,16,16,0,16,830,787,43,0,0,0,0,97,1,0,0.391753,0,0,14,0,false,false,true,0.677,0.323
68,0,68,68,0,68,1167,1245,-78,1,0,1,0,93,1,0,0.301075,0,0,16,0,false,false,false,0.253,0.747
276,226,50,18.4,16.142857,50,1193,1220,-27,1,0,0.066667,0,5,15,14,8.6,0,0,24,14,false,false,true,0.973,0.027
291,265,26,19.4,18.928571,26,675,570,105,0,0,0,0,-9,15,14,-3.888889,0,0,20,9,false,false,true,0.793,0.207
187,341,-154,12.466667,22.733333,-154,1075,1189,-114,0,0,0,0,4,15,15,10,0,1,8,15,false,false,false,0,1
207,264,-57,14.785714,20.307692,-57,837,844,-7,0,0,0,0,23,14,13,1.782609,1,1,10,6,false,false,false,0.013,0.987
37,79,-42,7.4,19.75,-42,907,878,29,0,0,0,0,80,5,4,0.5375,0,0,16,21,false,false,false,0.039,0.961
32,19,13,16,19,13,1021,897,124,0,0,0,0,90,2,1,0.411111,0,0,16,8,false,false,true,0.679,0.321
24,20,4,12,20,4,1439,1428,11,0,0,0,0,91,2,1,0.43956,0,0,8,15,false,false,true,0.522,0.478
20,28,-8,20,28,-8,1176,1211,-35,0,0,0,0,89,1,1,0.370787,0,0,7,18,false,false,true,0.671,0.329
268,325,-57,22.333333,27.083333,-57,1266,1339,-73,0,1,0,0.083333,18,12,12,1.944444,0,0,7,9,false,false,false,0.001,0.999
204,324,-120,18.545455,29.454545,-120,1334,1439,-105,1,1,0.090909,0.090909,35,11,11,1.028571,0,0,18,9,false,false,false,0,1
75,90,-15,9.375,11.25,-15,288,359,-71,0,0,0,0,58,8,8,0.465517,0,0,14,13,false,false,false,0.333,0.667
106,143,-37,17.666667,23.833333,-37,889,895,-6,0,1,0,0.166667,59,6,6,0.627119,0,0,9,8,false,false,false,0.213,0.787
296,432,-136,26.909091,43.2,-136,1925,1885,40,1,2,0.090909,0.2,-5,11,10,-5,0,0,2,6,false,false,false,0,1
224,222,2,18.666667,20.181818,2,527,954,-427,0,0,0,0,28,12,11,1.25,0,2,24,8,false,false,false,0.22,0.78
43,44,-1,21.5,22,-1,599,448,151,0,0,0,0,85,2,2,0.423529,0,0,11,10,false,false,true,0.681,0.319
53,81,-28,17.666667,27,-28,1094,1159,-65,0,0,0,0,75,3,3,0.506667,0,0,16,17,false,false,false,0.485,0.515
20,0,20,20,0,20,1176,1211,-35,0,0,0,0,95,1,0,0.347368,0,0,7,0,false,false,true,0.66,0.34
200,210,-10,28.571429,30,-10,1770,1751,19,0,1,0,0.142857,38,7,7,0.763158,0,0,8,19,false,false,false,0.188,0.812
71,132,-61,10.142857,22,-61,795,786,9,0,0,0,0,67,7,6,0.567164,0,0,10,17,false,false,false,0.038,0.962
125,158,-33,15.625,19.75,-33,1803,1658,145,0,0,0,0,41,8,8,0.804878,2,0,8,17,false,false,false,0.036,0.964
206,229,-23,22.888889,28.625,-23,1422,1798,-376,0,1,0,0.125,36,9,8,0.888889,0,1,14,12,false,false,false,0.056,0.944
129,135,-6,16.125,19.285714,-6,500,532,-32,0,0,0,0,47,8,7,0.87234,0,0,14,10,false,false,false,0.258,0.742
110,113,-3,13.75,14.125,-3,306,302,4,0,0,0,0,45,8,8,0.911111,0,1,7,6,false,false,false,0.328,0.672
162,190,-28,20.25,27.142857,-28,964,1003,-39,0,1,0,0.142857,48,8,7,0.8125,0,0,10,9,false,false,false,0.192,0.808
173,254,-81,14.416667,21.166667,-81,837,844,-7,0,0,0,0,33,12,12,1.242424,1,1,16,6,false,false,false,0.005,0.995
227,328,-101,17.461538,25.230769,-101,1270,1424,-154,0,2,0,0.153846,15,13,13,2.333333,0,0,22,10,false,false,false,0,1
294,238,56,17.294118,14,56,1030,998,32,0,0,0,0,-5,17,17,-7.4,0,1,16,9,false,false,true,0.945,0.055
208,205,3,17.333333,18.636364,3,306,468,-162,0,0,0,0,31,12,11,1.193548,1,0,7,12,false,false,false,0.113,0.887
70,125,-55,17.5,31.25,-55,473,683,-210,0,0,0,0,73,4,4,0.520548,0,0,10,22,false,false,false,0.006,0.994
217,263,-46,11.421053,13.842105,-46,1220,1202,18,0,0,0,0,-5,19,19,-10,0,1,27,13,false,false,false,0,1
319,423,-104,11.392857,15.107143,-104,1037,1016,21,1,0,0.035714,0,-29,28,28,-2,1,0,0,5,false,false,false,0,1
136,193,-57,17,27.571429,-57,700,820,-120,0,1,0,0.142857,43,8,7,0.883721,0,0,10,7,false,false,false,0.04,0.96
167,226,-59,12.846154,18.833333,-59,613,525,88,0,0,0,0,26,13,12,1.615385,0,1,10,9,false,false,false,0.001,0.999
141,146,-5,20.142857,20.857143,-5,758,904,-146,1,0,0.142857,0,48,7,7,0.708333,0,0,16,10,false,false,false,0.293,0.707
121,178,-57,20.166667,29.666667,-57,1388,1366,22,0,1,0,0.166667,53,6,6,0.603774,0,0,12,9,false,false,false,0.184,0.816
97,206,-109,19.4,41.2,-109,1334,1486,-152,0,0,0,0,68,5,5,0.426471,0,0,7,17,false,false,false,0.001,0.999
328,301,27,17.263158,16.722222,27,897,996,-99,0,0,0,0,-15,19,18,-2.6,0,0,2,7,false,false,true,1,0
21,12,9,10.5,12,9,742,868,-126,0,0,0,0,88,2,1,0.375,0,0,16,14,false,false,false,0.251,0.749
37,62,-25,9.25,20.666667,-25,1368,1452,-84,0,0,0,0,82,4,3,0.390244,1,0,11,12,false,false,false,0.129,0.871
270,305,-35,18,20.333333,-35,1055,840,215,0,1,0,0.066667,-1,15,15,-36,0,0,17,24,false,false,false,0,1
77,118,-41,38.5,59,-41,1699,1580,119,1,0,0.5,0,79,2,2,0.379747,0,0,9,19,false,false,false,0.144,0.856
202,218,-16,22.444444,24.222222,-16,1176,1133,43,1,0,0.111111,0,45,9,9,0.755556,0,0,7,26,false,false,false,0.042,0.958
309,333,-24,15.45,16.65,-24,1000,960,40,0,0,0,0,-25,20,20,-1.8,0,0,5,1,false,false,false,0.001,0.999
44,30,14,11,10,14,1045,948,97,0,0,0,0,74,4,3,0.459459,0,0,11,14,false,false,true,0.658,0.342
180,267,-87,20,29.666667,-87,1127,995,132,0,1,0,0.111111,36,9,9,0.916667,0,0,9,12,false,false,false,0,1
6,0,6,6,0,6,913,1037,-124,0,0,0,0,97,1,0,0.42268,0,0,19,0,false,false,false,0.251,0.749
312,374,-62,17.333333,22,-62,561,633,-72,0,1,0,0.058824,-15,18,17,-2.333333,0,0,3,2,true,false,false,0,1
237,394,-157,13.166667,23.176471,-157,473,683,-210,0,0,0,0,-18,18,17,-2.111111,0,0,1,2,false,false,false,0,1
237,278,-41,13.941176,17.375,-41,278,1,277,0,0,0,0,-10,17,16,-3.7,0,0,9,3,false,false,false,0,1
116,136,-20,16.571429,19.428571,-20,341,416,-75,0,0,0,0,59,7,7,0.661017,0,0,12,9,false,false,false,0.266,0.734
218,360,-142,15.571429,27.692308,-142,1484,1556,-72,0,2,0,0.153846,-1,14,13,-31,1,0,15,9,false,false,false,0,1
45,44,1,15,22,1,653,1004,-351,0,0,0,0,80,3,2,0.3625,0,0,7,10,false,false,false,0.251,0.749
193,234,-41,19.3,23.4,-41,725,668,57,0,0,0,0,33,10,10,1.060606,0,0,16,9,false,false,false,0.183,0.817
98,135,-37,16.333333,22.5,-37,1161,1030,131,0,1,0,0.166667,59,6,6,0.644068,0,0,7,13,false,false,false,0.16,0.84
231,233,-2,14.4375,15.533333,-2,925,1000,-75,0,0,0,0,5,16,15,8.8,0,1,15,6,false,false,false,0.459,0.541
80,182,-102,10,22.75,-102,530,683,-153,0,1,0,0.125,56,8,8,0.714286,0,0,11,19,false,false,false,0,1
151,165,-14,15.1,18.333333,-14,526,502,24,0,0,0,0,44,10,9,1.136364,0,0,16,7,false,false,false,0.062,0.938
213,233,-20,26.625,29.125,-20,1167,1245,-78,1,0,0.125,0,23,8,8,1,0,0,10,11,false,false,true,0.674,0.326
251,309,-58,11.952381,15.45,-58,391,542,-151,1,0,0.047619,0,-28,21,20,-1.642857,0,0,2,9,false,false,false,0,1
78,142,-64,15.6,28.4,-64,1656,1580,76,0,1,0,0.2,63,5,5,0.52381,0,0,12,16,false,false,false,0.021,0.979
107,107,0,17.833333,21.4,0,1127,995,132,0,1,0,0.2,61,6,5,0.540984,0,0,18,15,false,false,false,0.207,0.793
85,141,-56,14.166667,23.5,-56,714,892,-178,0,0,0,0,59,6,6,0.711864,1,1,11,8,false,false,false,0.017,0.983
220,294,-74,13.75,19.6,-74,907,878,29,0,0,0,0,16,16,15,2.6875,2,0,8,16,false,false,false,0.004,0.996
273,253,20,24.818182,25.3,20,1305,1211,94,2,0,0.181818,0,27,11,10,1.222222,0,0,12,7,false,false,true,0.941,0.059
4,0,4,4,0,4,1110,1399,-289,0,0,0,0,98,1,0,0.346939,0,0,12,0,false,false,false,0.251,0.749
128,279,-151,9.142857,19.928571,-151,651,567,84,0,0,0,0,18,14,14,3.055556,0,0,7,11,false,false,false,0,1
234,270,-36,18,20.769231,-36,822,845,-23,0,0,0,0,16,13,13,2.1875,0,0,8,9,false,false,false,0.036,0.964
58,36,22,19.333333,18,22,651,700,-49,0,0,0,0,83,3,2,0.674699,0,0,8,14,false,false,false,0.263,0.737
176,204,-28,19.555556,22.666667,-28,518,461,57,0,0,0,0,40,9,9,0.9,0,1,17,8,false,false,false,0.004,0.996
120,297,-177,10.909091,29.7,-177,1164,1149,15,0,1,0,0.1,47,11,10,1,0,0,12,8,false,false,false,0,1
106,157,-51,21.2,39.25,-51,1632,2020,-388,0,0,0,0,63,5,4,0.492063,0,0,7,9,false,false,false,0.131,0.869
160,192,-32,17.777778,24,-32,804,766,38,0,1,0,0.125,52,9,8,0.788462,0,1,7,9,false,false,false,0.041,0.959
275,369,-94,17.1875,23.0625,-94,1633,1739,-106,1,0,0.0625,0,-13,16,16,-2.615385,0,0,2,6,false,false,false,0,1
132,173,-41,16.5,21.625,-41,1161,1030,131,0,1,0,0.125,41,8,8,0.926829,0,0,12,12,false,false,false,0.097,0.903
95,158,-63,10.555556,17.555556,-63,970,1030,-60,0,0,0,0,40,9,9,1,0,0,23,7,false,false,false,0.056,0.944
197,206,-9,17.909091,18.727273,-9,480,518,-38,0,0,0,0,23,11,11,1.73913,0,0,16,7,false,false,true,0.58,0.42
80,226,-146,8.888889,25.111111,-146,530,683,-153,0,1,0,0.111111,54,9,9,0.740741,0,0,11,10,false,false,false,0,1
346,407,-61,19.222222,23.941176,-61,921,1045,-124,0,1,0,0.058824,-11,18,17,-3.181818,0,1,1,5,true,false,false,0,1
48,61,-13,16,20.333333,-13,1885,1842,43,0,0,0,0,79,3,3,0.341772,0,0,7,7,false,false,false,0.321,0.679
90,82,8,22.5,27.333333,8,689,804,-115,0,0,0,0,71,4,3,0.492958,1,0,12,22,false,false,false,0.083,0.917
302,333,-31,20.133333,23.785714,-31,980,965,15,0,0,0,0,1,15,14,38,0,0,10,13,false,false,false,0.003,0.997
280,312,-32,17.5,19.5,-32,944,1095,-151,0,1,0,0.0625,3,16,16,13,0,2,9,15,false,false,false,0,1
317,270,47,17.611111,15.882353,47,1193,1220,-27,1,0,0.055556,0,-10,18,17,-4.3,0,0,21,13,false,false,true,1,0
26,56,-30,8.666667,28,-30,2143,2219,-76,0,0,0,0,85,3,2,0.364706,0,1,7,9,false,false,false,0.193,0.807
196,222,-26,17.818182,22.2,-26,356,498,-142,0,1,0,0.1,24,11,10,1.458333,1,0,9,19,false,false,false,0.199,0.801
338,314,24,24.142857,22.428571,24,1156,1279,-123,2,0,0.142857,0,4,14,14,10,0,0,10,16,false,false,true,1,0
137,132,5,19.571429,18.857143,5,1432,1452,-20,0,0,0,0,51,7,7,0.705882,1,0,6,7,false,false,true,0.686,0.314
173,219,-46,13.307692,16.846154,-46,999,1165,-166,0,0,0,0,23,13,13,2,1,1,15,11,false,false,false,0.111,0.889
42,68,-26,10.5,17,-26,391,542,-151,0,0,0,0,76,4,4,0.605263,1,1,9,11,false,false,false,0.02,0.98
37,29,8,12.333333,14.5,8,1219,1216,3,0,1,0,0.5,83,3,2,0.325301,0,0,18,10,false,false,true,0.61,0.39
339,436,-97,21.1875,27.25,-97,1537,1539,-2,0,1,0,0.0625,-19,16,16,-1.789474,0,1,1,1,false,false,false,0,1
223,372,-149,13.9375,24.8,-149,473,683,-210,0,0,0,0,-4,16,15,-9.5,0,0,5,9,false,false,false,0,1
74,86,-12,12.333333,17.2,-12,391,542,-151,1,0,0.166667,0,62,6,5,0.741935,0,0,7,10,false,false,false,0.239,0.761
19,26,-7,9.5,13,-7,940,947,-7,0,0,0,0,86,2,2,0.406977,0,0,9,7,false,false,true,0.667,0.333
86,84,2,17.2,16.8,2,889,855,34,0,0,0,0,69,5,5,0.57971,0,0,16,11,false,false,true,0.681,0.319
211,275,-64,14.066667,19.642857,-64,306,361,-55,0,0,0,0,-5,15,14,-7.2,0,0,12,8,false,false,false,0,1
40,22,18,20,22,18,1000,960,40,0,0,0,0,89,2,1,0.505618,0,0,7,19,false,false,true,0.674,0.326
341,374,-33,15.5,17,-33,1063,1134,-71,1,0,0.045455,0,-19,22,22,-2.315789,0,0,1,1,true,false,false,0.42,0.58
56,51,5,14,17,5,540,498,42,0,0,0,0,78,4,3,0.589744,0,1,12,11,false,false,false,0.263,0.737
212,247,-35,15.142857,17.642857,-35,500,532,-32,0,0,0,0,3,14,14,13.666667,0,2,30,8,false,false,false,0.017,0.983
215,210,5,16.538462,17.5,5,840,1055,-215,0,0,0,0,15,13,12,2.333333,0,0,11,7,false,false,false,0.254,0.746
231,357,-126,14.4375,22.3125,-126,711,746,-35,0,0,0,0,1,16,16,38,0,0,11,7,false,false,false,0,1
132,286,-154,16.5,35.75,-154,1399,1210,189,0,1,0,0.125,43,8,8,0.813953,0,0,16,13,false,false,false,0,1
318,306,12,18.705882,19.125,12,1168,1062,106,0,0,0,0,1,17,16,43,1,0,4,13,false,false,true,1,0
70,16,54,35,16,54,804,1074,-270,0,0,0,0,88,2,1,0.363636,0,0,7,18,false,false,false,0.309,0.691
259,299,-40,12.333333,14.238095,-40,226,361,-135,0,0,0,0,-31,21,21,-1.419355,0,0,1,3,false,false,false,0,1
98,95,3,14,13.571429,3,306,302,4,0,0,0,0,53,7,7,0.773585,0,1,9,6,false,false,false,0.363,0.637
239,234,5,21.727273,21.272727,5,1197,1156,41,0,1,0,0.090909,26,11,11,1.346154,1,0,9,10,false,false,true,0.62,0.38
22,0,22,22,0,22,907,1070,-163,0,0,0,0,95,1,0,0.368421,0,0,12,0,false,false,false,0.253,0.747
261,361,-100,18.642857,25.785714,-100,1349,1203,146,0,1,0,0.071429,10,14,14,3.2,0,0,13,14,false,false,false,0,1
248,237,11,24.8,23.7,11,824,830,-6,1,0,0.1,0,32,10,10,1.375,0,0,7,19,false,false,false,0.339,0.661
317,389,-72,19.8125,24.3125,-72,1127,995,132,0,1,0,0.0625,-14,16,16,-2.357143,0,0,7,3,false,false,false,0,1
214,285,-71,19.454545,25.909091,-71,1101,1237,-136,1,0,0.090909,0,24,11,11,1.416667,1,0,15,10,false,false,false,0.003,0.997
182,247,-65,16.545455,22.454545,-65,594,648,-54,1,1,0.090909,0.090909,31,11,11,1.290323,0,0,10,17,false,false,false,0,1
178,219,-41,14.833333,19.909091,-41,518,414,104,0,1,0,0.090909,24,12,11,1.583333,0,1,7,9,false,false,false,0.029,0.971
199,238,-39,22.111111,29.75,-39,1266,1339,-73,0,1,0,0.125,44,9,8,0.795455,0,0,13,21,false,false,false,0.043,0.957
214,307,-93,16.461538,23.615385,-93,892,856,36,0,1,0,0.076923,8,13,13,4.375,1,0,7,17,false,false,false,0,1
265,310,-45,24.090909,28.181818,-45,1188,1334,-146,1,1,0.090909,0.090909,14,11,11,2.142857,1,0,7,10,false,false,false,0.225,0.775
39,9,30,19.5,9,30,1220,1185,35,0,0,0,0,88,2,1,0.534091,0,1,25,11,false,false,true,0.702,0.298
195,165,30,21.666667,20.625,30,1691,1510,181,0,1,0,0.125,38,9,8,0.789474,0,0,17,12,false,false,true,1,0
95,43,52,31.666667,21.5,52,1078,1095,-17,1,0,0.333333,0,79,3,2,0.468354,0,0,10,19,false,false,true,0.673,0.327
141,99,42,15.666667,12.375,42,670,576,94,0,0,0,0,44,9,8,0.931818,1,0,9,9,false,false,true,0.956,0.044
155,191,-36,11.923077,14.692308,-36,391,542,-151,1,0,0.076923,0,15,13,13,3.066667,0,0,7,20,false,false,false,0.181,0.819
253,320,-67,18.071429,24.615385,-67,1229,1220,9,0,1,0,0.076923,10,14,13,3.7,0,0,7,25,false,false,false,0,1
289,312,-23,19.266667,20.8,-23,1488,1403,85,0,1,0,0.066667,-11,15,15,-3.090909,1,0,16,11,false,false,false,0.025,0.975
230,225,5,19.166667,18.75,5,1000,960,40,0,0,0,0,22,12,12,2.045455,0,0,11,8,false,false,false,0.328,0.672
104,161,-57,13,20.125,-57,714,892,-178,0,0,0,0,51,8,8,0.823529,1,1,15,6,false,false,false,0.014,0.986
90,43,47,22.5,14.333333,47,1070,814,256,1,0,0.25,0,75,4,3,0.44,0,0,13,10,false,false,true,0.825,0.175
336,342,-6,16,17.1,-6,1168,1062,106,0,0,0,0,-13,21,20,-3.307692,0,0,2,1,false,false,false,0.024,0.976
190,287,-97,11.875,17.9375,-97,1078,983,95,1,0,0.0625,0,10,16,16,4.8,0,1,10,7,false,false,false,0,1
178,191,-13,19.777778,21.222222,-13,206,346,-140,1,0,0.111111,0,36,9,9,1.194444,0,0,12,8,false,false,false,0.127,0.873
314,325,-11,19.625,21.666667,-11,1043,1003,40,0,1,0,0.066667,-3,16,15,-12.666667,0,0,11,14,false,false,false,0.039,0.961
333,369,-36,18.5,21.705882,-36,1397,1309,88,2,0,0.111111,0,-12,18,17,-3,0,0,3,5,false,false,false,0,1
230,269,-39,20.909091,26.9,-39,1454,1479,-25,1,0,0.090909,0,23,11,10,1.347826,0,0,18,21,false,false,false,0.007,0.993
266,232,34,24.181818,23.2,34,1102,1245,-143,0,0,0,0,17,11,10,1.705882,0,0,9,8,false,false,true,0.563,0.437
82,117,-35,16.4,23.4,-35,842,926,-84,0,0,0,0,59,5,5,0.508475,0,0,15,15,false,false,false,0.202,0.798
175,280,-105,14.583333,25.454545,-105,915,971,-56,0,0,0,0,15,12,11,2.2,0,0,11,25,false,false,false,0,1
45,29,16,15,14.5,16,1075,1189,-114,0,0,0,0,80,3,2,0.5,0,0,7,19,false,false,false,0.253,0.747
312,290,22,18.352941,18.125,22,675,570,105,0,0,0,0,-21,17,16,-1.666667,0,0,14,2,false,false,true,0.824,0.176
148,208,-60,18.5,26,-60,1488,1403,85,0,1,0,0.125,41,8,8,0.829268,0,0,7,11,false,false,false,0.006,0.994
21,23,-2,10.5,11.5,-2,742,868,-126,0,0,0,0,85,2,2,0.388235,0,0,16,15,false,false,false,0.251,0.749
300,337,-37,20,24.071429,-37,1495,1531,-36,0,1,0,0.071429,5,15,14,7.4,0,0,7,15,false,false,false,0,1
12,0,12,12,0,12,808,749,59,0,0,0,0,95,1,0,0.442105,0,0,9,0,false,false,true,0.678,0.322
142,147,-5,17.75,21,-5,1021,1094,-73,1,0,0.125,0,47,8,7,0.787234,1,0,6,10,false,false,false,0.344,0.656
34,64,-30,17,32,-30,473,683,-210,0,0,0,0,86,2,2,0.44186,0,0,14,22,false,false,false,0.028,0.972
250,267,-17,19.230769,22.25,-17,1063,1134,-71,1,0,0.076923,0,25,13,12,1.76,0,0,10,22,false,false,false,0.008,0.992
68,188,-120,9.714286,31.333333,-120,1305,1307,-2,0,1,0,0.166667,56,7,6,0.732143,0,0,11,13,false,false,false,0,1
30,24,6,10,8,6,1168,1216,-48,0,0,0,0,88,3,3,0.375,0,0,19,30,false,false,false,0.118,0.882
65,75,-10,32.5,37.5,-10,1334,1486,-152,0,0,0,0,85,2,2,0.341176,0,1,12,18,false,false,false,0.049,0.951
100,167,-67,20,33.4,-67,976,995,-19,0,1,0,0.2,64,5,5,0.59375,0,0,13,18,false,false,false,0.193,0.807
135,299,-164,19.285714,42.714286,-164,1777,1500,277,0,2,0,0.285714,41,7,7,0.682927,1,0,8,21,false,false,false,0.245,0.755
8,0,8,8,0,8,342,53,289,0,0,0,0,96,1,0,0.427083,0,0,7,0,false,false,true,0.696,0.304
101,181,-80,11.222222,22.625,-80,795,786,9,0,0,0,0,53,9,8,0.716981,0,0,9,13,false,false,false,0.025,0.975
186,221,-35,20.666667,24.555556,-35,1110,1123,-13,0,1,0,0.111111,32,9,9,1.03125,0,0,8,22,false,false,false,0.195,0.805
333,251,82,25.615385,20.916667,82,1156,1279,-123,2,0,0.153846,0,12,13,12,3.333333,0,1,7,17,false,false,true,1,0
246,281,-35,24.6,28.1,-35,1793,1869,-76,0,1,0,0.1,24,10,10,1.25,0,0,20,7,false,false,false,0.199,0.801
277,292,-15,16.294118,18.25,-15,561,688,-127,0,0,0,0,1,17,16,46,0,0,7,15,false,false,false,0.024,0.976
167,242,-75,27.833333,40.333333,-75,1164,1261,-97,0,1,0,0.166667,57,6,6,0.736842,0,0,21,10,false,false,false,0.07,0.93
211,236,-25,14.066667,15.733333,-25,361,413,-52,0,0,0,0,-2,15,15,-20.5,1,0,9,7,false,false,false,0.284,0.716
223,272,-49,18.583333,22.666667,-49,917,856,61,0,1,0,0.083333,20,12,12,1.65,0,0,7,13,false,false,false,0.036,0.964
186,177,9,18.6,17.7,9,527,954,-427,0,0,0,0,37,10,10,0.945946,0,2,26,12,false,false,false,0.303,0.697
187,447,-260,18.7,49.666667,-260,1632,2020,-388,0,2,0,0.222222,20,10,9,1.55,0,0,18,15,false,false,false,0,1
187,291,-104,18.7,29.1,-104,653,1004,-351,0,0,0,0,23,10,10,1.26087,0,0,7,8,false,false,false,0,1
0,0,0,0,0,0,944,1095,-151,0,0,0,0,100,1,0,0.39,0,0,23,0,false,false,false,0.251,0.749
170,221,-51,13.076923,18.416667,-51,951,976,-25,0,0,0,0,28,13,12,1.571429,0,0,10,7,false,false,false,0.033,0.967
160,251,-91,17.777778,31.375,-91,1576,1556,20,0,1,0,0.125,32,9,8,0.9375,0,0,20,12,false,false,false,0,1
260,319,-59,20,24.538462,-59,566,742,-176,0,1,0,0.076923,5,13,13,6.4,0,0,7,12,false,false,false,0,1
99,135,-36,16.5,27,-36,775,786,-11,0,0,0,0,61,6,5,0.704918,0,0,10,7,false,false,false,0.128,0.872
155,133,22,22.142857,22.166667,22,621,786,-165,0,0,0,0,40,7,6,0.75,0,0,18,10,false,false,false,0.277,0.723
144,80,64,24,16,64,1341,1606,-265,1,0,0.166667,0,52,6,5,0.634615,0,0,12,16,false,false,false,0.446,0.554
176,197,-21,17.6,21.888889,-21,758,791,-33,0,0,0,0,34,10,9,1.147059,0,0,8,12,false,false,false,0.042,0.958
150,146,4,16.666667,18.25,4,1310,1477,-167,0,0,0,0,36,9,8,1,1,0,7,10,false,false,false,0.351,0.649
176,219,-43,17.6,24.333333,-43,653,820,-167,0,0,0,0,25,10,9,1.52,1,0,6,16,false,false,false,0.005,0.995
74,214,-140,7.4,23.777778,-140,1037,913,124,0,1,0,0.111111,49,10,9,0.77551,1,0,10,8,false,false,false,0,1
206,262,-56,13.733333,18.714286,-56,1045,948,97,0,0,0,0,-11,15,14,-3.090909,1,0,7,11,false,false,false,0.005,0.995
268,344,-76,11.652174,15.636364,-76,813,698,115,1,0,0.043478,0,-27,23,22,-1.777778,0,0,1,4,false,false,false,0,1
205,347,-142,13.666667,24.785714,-142,760,976,-216,0,1,0,0.071429,-3,15,14,-12,0,1,12,21,false,false,false,0,1
289,298,-9,19.266667,21.285714,-9,1488,1403,85,0,1,0,0.071429,-8,15,14,-4.25,1,0,16,14,false,false,false,0.033,0.967
127,107,20,21.166667,21.4,20,711,746,-35,0,0,0,0,64,6,5,0.59375,0,0,7,11,false,false,false,0.289,0.711
276,297,-21,18.4,19.8,-21,907,910,-3,0,1,0,0.066667,13,15,15,3.307692,0,0,16,7,false,false,false,0.289,0.711
323,310,13,17.944444,18.235294,13,742,594,148,0,0,0,0,-14,18,17,-2.785714,0,0,4,6,false,false,true,0.971,0.029
153,78,75,25.5,15.6,75,1274,1394,-120,0,0,0,0,57,6,5,0.526316,0,0,15,14,false,false,true,0.846,0.154
286,359,-73,20.428571,27.615385,-73,991,1063,-72,0,1,0,0.076923,5,14,13,7.6,0,0,11,9,false,false,false,0,1
53,54,-1,17.666667,18,-1,736,791,-55,0,0,0,0,80,3,3,0.475,1,0,14,20,false,false,false,0.356,0.644
12,0,12,6,0,12,1168,1216,-48,0,0,0,0,97,2,1,0.340206,0,0,21,28,false,false,false,0.211,0.789
179,170,9,25.571429,28.333333,9,1071,1065,6,0,0,0,0,42,7,6,0.738095,0,0,20,20,false,false,false,0.382,0.618
330,395,-65,18.333333,23.235294,-65,1495,1531,-36,0,1,0,0.058824,-10,18,17,-3.7,0,0,1,2,false,false,false,0,1
79,106,-27,15.8,21.2,-27,727,820,-93,0,1,0,0.2,60,5,5,0.583333,0,0,19,13,false,false,true,0.591,0.409
112,130,-18,16,21.666667,-18,1203,1270,-67,0,0,0,0,60,7,6,0.733333,1,0,10,18,false,false,false,0.044,0.956
290,309,-19,19.333333,22.071429,-19,1227,1189,38,0,0,0,0,-4,15,14,-8.75,0,0,10,17,false,false,false,0.041,0.959
290,237,53,26.363636,21.545455,53,1552,1803,-251,2,0,0.181818,0,19,11,11,1.736842,0,1,8,7,false,false,true,0.505,0.495
315,340,-25,19.6875,22.666667,-25,1452,1388,64,0,1,0,0.066667,-6,16,15,-5.833333,0,0,8,7,false,false,false,0.001,0.999
223,228,-5,18.583333,20.727273,-5,1302,1351,-49,0,0,0,0,25,12,11,1.48,0,0,10,18,false,false,false,0.054,0.946
279,329,-50,16.411765,20.5625,-50,344,315,29,1,1,0.058824,0.0625,-21,17,16,-1.904762,0,0,8,6,false,false,false,0,1
269,257,12,15.823529,16.0625,12,796,800,-4,1,0,0.058824,0,8,17,16,6,0,1,12,6,false,false,false,0.098,0.902
256,263,-7,21.333333,23.909091,-7,1269,1477,-208,1,0,0.083333,0,22,12,11,1.590909,0,0,8,9,false,false,false,0.17,0.83
0,28,-28,0,28,-28,915,971,-56,0,0,0,0,95,1,1,0.347368,0,0,11,30,false,false,false,0.039,0.961
92,105,-13,15.333333,21,-13,726,818,-92,0,0,0,0,62,6,5,0.564516,0,0,9,13,false,false,false,0.222,0.778
154,154,0,22,22,0,1270,1261,9,1,0,0.142857,0,55,7,7,0.672727,0,0,7,26,false,false,false,0.103,0.897
147,252,-105,24.5,42,-105,1537,1539,-2,0,1,0,0.166667,43,6,6,0.790698,0,0,25,10,false,false,false,0.004,0.996
288,301,-13,18,20.066667,-13,576,602,-26,0,0,0,0,-2,16,15,-21,0,0,11,7,false,false,false,0.016,0.984
191,174,17,31.833333,34.8,17,1354,1210,144,0,1,0,0.2,57,6,5,0.578947,0,0,13,12,false,false,false,0.209,0.791
161,159,2,17.888889,17.666667,2,1043,1003,40,0,0,0,0,37,9,9,1.027027,0,0,19,13,false,false,false,0.354,0.646
347,366,-19,21.6875,22.875,-19,964,1003,-39,0,1,0,0.0625,-8,16,16,-4.875,0,0,14,10,false,false,false,0.001,0.999
258,350,-92,11.727273,15.909091,-92,642,952,-310,0,0,0,0,-23,22,22,-1.913043,0,0,1,2,true,false,false,0,1
84,84,0,21,28,0,1539,1891,-352,0,1,0,0.333333,70,4,3,0.357143,0,0,16,9,false,false,false,0.251,0.749
72,85,-13,14.4,21.25,-13,500,509,-9,0,0,0,0,69,5,4,0.594203,0,0,13,25,false,false,false,0.053,0.947
234,298,-64,16.714286,22.923077,-64,594,648,-54,1,1,0.071429,0.076923,17,14,13,2.352941,0,0,15,8,false,false,false,0,1
216,362,-146,19.636364,32.909091,-146,842,926,-84,0,1,0,0.090909,7,11,11,4.285714,0,0,7,25,false,false,false,0,1
141,147,-6,11.75,12.25,-6,1278,1101,177,0,0,0,0,32,12,12,1.15625,1,1,18,9,false,false,false,0.344,0.656
28,0,28,28,0,28,1331,1432,-101,0,0,0,0,95,1,0,0.284211,0,0,11,0,false,false,true,0.514,0.486
197,211,-14,24.625,30.142857,-14,724,398,326,1,1,0.125,0.142857,46,8,7,0.847826,0,0,7,9,false,false,false,0.333,0.667
251,338,-87,13.944444,18.777778,-87,653,820,-167,0,0,0,0,-26,18,18,-1.461538,0,0,1,1,false,false,false,0,1
130,198,-68,18.571429,33,-68,594,648,-54,1,1,0.142857,0.166667,51,7,6,0.784314,0,0,7,11,false,false,false,0.029,0.971
312,380,-68,28.363636,34.545455,-68,1431,1399,32,0,2,0,0.181818,-3,11,11,-8.333333,0,0,21,3,false,false,false,0,1
196,148,48,21.777778,18.5,48,664,786,-122,0,0,0,0,44,9,8,0.75,1,0,14,8,false,false,true,0.73,0.27
244,323,-79,12.2,16.15,-79,595,662,-67,0,1,0,0.05,-23,20,20,-1.913043,0,0,4,9,false,false,false,0,1
16,0,16,16,0,16,391,542,-151,0,0,0,0,95,1,0,0.484211,0,0,7,0,false,false,false,0.253,0.747
278,341,-63,18.533333,22.733333,-63,1047,1253,-206,1,1,0.066667,0.066667,1,15,15,37,1,0,7,16,false,false,false,0.002,0.998
170,194,-24,17,19.4,-24,1633,1556,77,0,0,0,0,26,10,10,1.269231,0,0,19,12,false,false,false,0.198,0.802
237,218,19,18.230769,18.166667,19,1037,1009,28,0,0,0,0,26,13,12,1.692308,1,1,10,8,false,false,false,0.359,0.641
221,394,-173,15.785714,28.142857,-173,1399,1210,189,0,1,0,0.071429,4,14,14,8.75,0,0,9,7,false,false,false,0.034,0.966
137,119,18,15.222222,14.875,18,1220,1185,35,0,0,0,0,52,9,8,0.903846,0,1,29,10,false,false,true,0.519,0.481
99,104,-5,14.142857,17.333333,-5,480,739,-259,0,0,0,0,60,7,6,0.65,0,1,11,10,false,false,false,0.126,0.874
78,77,1,19.5,25.666667,1,1232,1281,-49,0,1,0,0.333333,66,4,3,0.469697,0,0,12,15,false,false,false,0.457,0.543
191,261,-70,17.363636,26.1,-70,926,973,-47,0,0,0,0,21,11,10,1.666667,0,0,12,17,false,false,false,0,1
87,136,-49,21.75,34,-49,907,910,-3,0,1,0,0.25,76,4,4,0.565789,0,0,11,13,false,false,false,0.199,0.801
41,52,-11,13.666667,26,-11,1302,1351,-49,0,0,0,0,82,3,2,0.45122,1,0,10,9,false,false,true,0.689,0.311
20,0,20,20,0,20,387,683,-296,0,0,0,0,96,1,0,0.354167,0,0,19,0,false,false,false,0.254,0.746
62,68,-6,15.5,22.666667,-6,1000,960,40,0,0,0,0,76,4,3,0.592105,1,0,7,12,false,false,true,0.649,0.351
216,221,-5,18,20.090909,-5,500,509,-9,0,0,0,0,22,12,11,1.863636,0,0,9,11,false,false,false,0.12,0.88
52,59,-7,13,19.666667,-7,758,904,-146,0,0,0,0,73,4,3,0.465753,1,0,7,23,false,false,false,0.25,0.75
202,312,-110,20.2,31.2,-110,1606,1593,13,0,1,0,0.1,22,10,10,1.318182,0,0,7,10,false,false,false,0,1
76,82,-6,12.666667,13.666667,-6,226,361,-135,0,0,0,0,55,6,6,0.8,0,0,23,13,false,false,false,0.373,0.627
150,169,-19,15,18.777778,-19,840,1055,-215,0,0,0,0,36,10,9,0.972222,0,0,16,7,false,false,false,0.236,0.764
299,451,-152,23,34.692308,-152,1556,1656,-100,0,2,0,0.153846,-7,13,13,-4.285714,0,0,5,4,false,false,false,0,1
236,306,-70,13.111111,17,-70,651,700,-49,0,0,0,0,-12,18,18,-4.666667,0,1,12,10,false,false,false,0,1
308,354,-46,23.692308,27.230769,-46,691,695,-4,1,0,0.076923,0,0,13,13,0,0,0,5,5,false,false,false,0,1
57,44,13,19,14.666667,13,1043,1003,40,0,0,0,0,75,3,3,0.506667,1,0,18,11,false,false,true,0.694,0.306
303,465,-162,17.823529,29.0625,-162,1003,1004,-1,0,2,0,0.125,-12,17,16,-2.916667,0,0,1,2,false,false,false,0,1
224,233,-9,24.888889,29.125,-9,1793,1869,-76,0,1,0,0.125,33,9,8,0.909091,0,0,24,10,false,false,false,0.202,0.798
200,303,-103,15.384615,25.25,-103,480,739,-259,0,0,0,0,20,13,12,1.95,1,0,9,12,false,false,false,0,1
300,380,-80,15.789474,20,-80,795,786,9,1,0,0.052632,0,-16,19,19,-2.375,0,0,5,2,true,false,false,0,1
82,40,42,20.5,13.333333,42,711,746,-35,0,0,0,0,78,4,3,0.487179,1,1,13,14,false,false,false,0.263,0.737
307,446,-139,21.928571,34.307692,-139,1606,1593,13,1,1,0.071429,0.076923,-7,14,13,-4.142857,0,0,2,1,false,false,false,0,1
272,361,-89,15.111111,20.055556,-89,595,412,183,0,1,0,0.055556,-7,18,18,-7.428571,0,0,10,12,false,false,false,0,1
134,156,-22,19.142857,26,-22,1606,1890,-284,0,0,0,0,52,7,6,0.538462,1,0,16,13,false,false,false,0.338,0.662
20,0,20,20,0,20,907,910,-3,0,0,0,0,97,1,0,0.443299,0,0,14,0,false,false,true,0.637,0.363
270,349,-79,15.882353,20.529412,-79,341,416,-75,0,0,0,0,-11,17,17,-3.545455,0,1,7,5,false,false,false,0,1
136,205,-69,17,25.625,-69,700,820,-120,0,1,0,0.125,41,8,8,0.926829,0,0,10,7,false,false,false,0.039,0.961
15,58,-43,7.5,29,-43,935,995,-60,0,0,0,0,88,2,2,0.443182,2,0,11,18,false,false,false,0.101,0.899
69,78,-9,11.5,15.6,-9,503,668,-165,0,0,0,0,64,6,5,0.578125,0,0,7,13,false,false,false,0.25,0.75
169,238,-69,15.363636,23.8,-69,642,952,-310,0,0,0,0,30,11,10,1.466667,0,0,10,12,false,false,false,0,1
244,312,-68,12.842105,16.421053,-68,830,787,43,0,0,0,0,-23,19,19,-1.652174,0,0,2,1,true,false,false,0,1
244,268,-24,24.4,29.777778,-24,1071,1065,6,0,0,0,0,22,10,9,1.409091,0,0,10,16,false,false,false,0.198,0.802
19,32,-13,9.5,16,-13,822,845,-23,0,0,0,0,88,2,2,0.397727,0,0,22,21,false,false,false,0.263,0.737
151,199,-48,16.777778,22.111111,-48,518,414,104,0,1,0,0.111111,41,9,9,0.926829,0,1,9,9,false,false,false,0.177,0.823
112,156,-44,14,19.5,-44,344,315,29,1,0,0.125,0,38,8,8,1.052632,1,0,27,13,false,false,false,0.308,0.692
241,349,-108,26.777778,38.777778,-108,1689,1777,-88,1,1,0.111111,0.111111,21,9,9,1.428571,0,0,23,7,false,false,false,0,1
233,242,-9,16.642857,18.615385,-9,595,538,57,0,0,0,0,11,14,13,3.454545,0,1,14,9,false,false,false,0.151,0.849
187,165,22,23.375,23.571429,22,1093,1173,-80,0,0,0,0,51,8,7,0.843137,0,0,16,16,false,false,false,0.213,0.787
253,300,-47,21.083333,25,-47,1030,1014,16,0,1,0,0.083333,20,12,12,1.65,0,0,18,10,false,false,false,0.028,0.972
92,110,-18,23,27.5,-18,1227,1189,38,0,0,0,0,69,4,4,0.507246,0,0,12,18,false,false,false,0.239,0.761
268,267,1,24.363636,26.7,1,1167,1245,-78,1,0,0.090909,0,11,11,10,2.545455,1,0,8,13,false,false,true,0.652,0.348
204,203,1,20.4,22.555556,1,939,969,-30,0,0,0,0,25,10,9,1.32,0,0,13,14,false,false,false,0.251,0.749
229,258,-29,20.818182,23.454545,-29,1063,1134,-71,1,0,0.090909,0,34,11,11,1.294118,0,0,7,20,false,false,false,0.019,0.981
317,284,33,22.642857,21.846154,33,1110,1123,-13,1,1,0.071429,0.076923,4,14,13,8.25,0,1,11,9,false,false,true,0.516,0.484
136,139,-3,12.363636,13.9,-3,163,346,-183,0,0,0,0,28,11,10,1.392857,0,1,16,15,false,false,false,0.106,0.894
276,341,-65,14.526316,17.947368,-65,814,830,-16,0,0,0,0,-26,19,19,-1.576923,0,0,6,2,false,false,false,0,1
346,373,-27,24.714286,28.692308,-27,1344,1208,136,1,1,0.071429,0.076923,-1,14,13,-30,1,0,3,5,false,false,false,0.037,0.963
172,143,29,17.2,14.3,29,671,638,33,0,0,0,0,32,10,10,1.53125,0,0,16,22,false,false,true,0.94,0.06
185,253,-68,30.833333,50.6,-68,1885,1908,-23,1,3,0.166667,0.6,41,6,5,0.560976,0,0,9,25,false,false,false,0.012,0.988
137,162,-25,19.571429,27,-25,804,1080,-276,0,0,0,0,51,7,6,0.666667,0,0,10,20,false,false,false,0.153,0.847
64,55,9,21.333333,18.333333,9,387,683,-296,0,0,0,0,75,3,3,0.453333,1,0,9,9,false,false,true,0.559,0.441
265,379,-114,15.588235,22.294118,-114,1195,1397,-202,0,2,0,0.117647,-4,17,17,-10,0,1,12,6,false,false,false,0,1
413,470,-57,29.5,36.153846,-57,1777,1689,88,1,1,0.071429,0.076923,-11,14,13,-2.454545,0,0,3,1,true,false,false,0,1
112,113,-1,18.666667,22.6,-1,926,973,-47,0,0,0,0,57,6,5,0.614035,0,1,9,8,false,false,false,0.289,0.711
14,21,-7,14,21,-7,1266,1339,-73,0,0,0,0,93,1,1,0.376344,0,0,13,16,false,false,true,0.567,0.433
12,0,12,12,0,12,206,346,-140,0,0,0,0,96,1,0,0.447917,0,0,13,0,false,false,false,0.253,0.747
333,347,-14,15.136364,15.772727,-14,430,542,-112,0,1,0,0.045455,-33,22,22,-1.454545,0,0,1,1,false,false,false,0,1
110,32,78,36.666667,16,78,1777,1689,88,1,0,0.333333,0,77,3,2,0.350649,0,0,18,9,false,false,true,0.837,0.163
274,225,49,21.076923,18.75,49,1094,1041,53,1,0,0.076923,0,12,13,12,3.166667,0,1,17,15,false,false,true,0.963,0.037
185,148,37,26.428571,21.142857,37,1274,1394,-120,0,0,0,0,44,7,7,0.681818,0,1,10,6,false,false,true,0.72,0.28
14,14,0,14,14,0,1399,1210,189,0,0,0,0,92,1,1,0.380435,0,1,13,13,false,false,false,0.447,0.553
283,323,-40,13.47619,16.15,-40,925,1000,-75,0,0,0,0,-26,21,20,-1.692308,0,0,4,1,false,false,false,0,1
100,255,-155,11.111111,28.333333,-155,935,995,-60,0,1,0,0.111111,44,9,9,0.886364,2,0,14,18,false,false,false,0,1
260,255,5,18.571429,18.214286,5,1037,1009,28,0,0,0,0,18,14,14,2.444444,1,1,7,16,false,false,false,0.062,0.938
118,81,37,29.5,20.25,37,1093,1100,-7,1,0,0.25,0,71,4,4,0.43662,0,0,10,23,false,false,true,0.721,0.279
94,66,28,13.428571,11,28,450,427,23,0,0,0,0,55,7,6,0.672727,0,2,16,7,false,false,true,0.832,0.168
150,331,-181,8.823529,19.470588,-181,651,996,-345,0,2,0,0.117647,-7,17,17,-6.428571,0,0,26,8,false,false,false,0,1
118,39,79,29.5,13,79,1093,1100,-7,1,0,0.25,0,75,4,3,0.413333,0,0,10,16,false,false,true,0.938,0.062
84,99,-15,21,33,-15,620,698,-78,0,0,0,0,75,4,3,0.546667,0,0,21,8,false,false,false,0.193,0.807
298,374,-76,11.92,15.583333,-76,595,412,183,0,1,0,0.041667,-22,25,24,-2.363636,0,0,10,11,false,false,false,0,1
58,34,24,14.5,11.333333,24,670,576,94,0,0,0,0,72,4,3,0.569444,0,0,19,13,false,false,true,0.708,0.292
221,176,45,31.571429,25.142857,45,1373,1334,39,1,1,0.142857,0.142857,49,7,7,0.653061,0,0,10,19,false,false,true,0.969,0.031
38,45,-7,19,22.5,-7,1270,1261,9,0,0,0,0,84,2,2,0.440476,1,0,10,21,false,false,true,0.783,0.217
93,38,55,31,19,55,1055,840,215,0,0,0,0,79,3,2,0.455696,0,1,10,18,false,false,true,0.835,0.165
130,232,-102,10.833333,21.090909,-102,632,603,29,0,0,0,0,20,12,11,1.9,0,0,17,13,false,false,false,0,1
252,260,-8,21,23.636364,-8,964,1003,-39,0,1,0,0.090909,23,12,11,1.695652,1,0,12,19,false,false,false,0.466,0.534
247,269,-22,19,20.692308,-22,952,870,82,0,0,0,0,8,13,13,4.625,0,0,11,21,false,false,false,0.241,0.759
290,324,-34,16.111111,18,-34,1040,1364,-324,0,0,0,0,-20,18,18,-1.8,0,0,1,9,true,false,false,0,1
386,523,-137,22.705882,32.6875,-137,1586,1633,-47,1,1,0.058824,0.0625,-13,17,16,-2.615385,0,0,2,1,false,false,false,0,1
286,369,-83,16.823529,21.705882,-83,1633,1739,-106,1,0,0.058824,0,-15,17,17,-2.266667,0,0,2,6,true,false,false,0,1
284,298,-14,16.705882,18.625,-14,1310,1477,-167,0,0,0,0,-22,17,16,-1.636364,0,0,3,6,false,false,false,0.064,0.936
313,308,5,34.777778,34.222222,5,1699,1580,119,3,1,0.333333,0.111111,23,9,9,1.304348,0,0,21,14,false,false,true,0.967,0.033
217,249,-32,11.421053,13.833333,-32,1220,1202,18,0,0,0,0,-2,19,18,-25,0,1,27,13,false,false,false,0,1
31,17,14,15.5,17,14,1123,1062,61,0,0,0,0,90,2,1,0.488889,0,0,7,25,false,false,false,0.416,0.584
284,317,-33,17.75,19.8125,-33,206,346,-140,1,0,0.0625,0,-11,16,16,-3.909091,0,1,29,8,false,false,false,0,1
64,122,-58,10.666667,20.333333,-58,632,603,29,0,0,0,0,58,6,6,0.655172,1,0,6,23,false,false,false,0.039,0.961
84,114,-30,16.8,22.8,-30,620,698,-78,0,0,0,0,72,5,5,0.569444,0,0,22,18,false,false,false,0.169,0.831
126,143,-17,15.75,17.875,-17,889,855,34,0,0,0,0,49,8,8,0.816327,0,1,25,7,false,false,false,0.377,0.623
206,328,-122,12.875,21.866667,-122,542,605,-63,0,0,0,0,-4,16,15,-9,0,0,8,10,false,false,false,0,1
285,357,-72,19,25.5,-72,1131,1030,101,0,0,0,0,-7,15,14,-4.285714,0,0,2,2,false,false,false,0,1
295,284,11,21.071429,21.846154,11,1043,1003,40,0,1,0,0.076923,7,14,13,5.428571,0,0,10,11,false,false,true,0.714,0.286
149,187,-38,14.9,18.7,-38,613,525,88,0,0,0,0,36,10,10,1.166667,0,1,10,9,false,false,false,0.058,0.942
288,309,-21,16.941176,18.176471,-21,720,437,283,0,0,0,0,-1,17,17,-42,0,0,10,12,false,false,false,0.001,0.999
177,205,-28,22.125,29.285714,-28,1454,1479,-25,1,0,0.125,0,44,8,7,0.704545,0,0,11,7,false,false,false,0.365,0.635
242,398,-156,12.1,20.947368,-156,977,1100,-123,0,1,0,0.052632,-16,20,19,-2.5625,0,0,3,2,false,false,false,0,1
377,456,-79,19.842105,24,-79,724,398,326,1,1,0.052632,0.052632,-28,19,19,-1.392857,0,0,5,5,false,false,false,0,1
309,406,-97,19.3125,27.066667,-97,1232,1448,-216,0,2,0,0.133333,-9,16,15,-3.888889,0,0,7,5,false,false,false,0,1
174,262,-88,12.428571,18.714286,-88,651,700,-49,0,0,0,0,9,14,14,6.222222,1,0,6,13,false,false,false,0.005,0.995
44,20,24,22,10,24,1070,814,256,0,0,0,0,88,2,2,0.375,0,0,17,8,false,false,true,0.785,0.215
84,216,-132,9.333333,27,-132,1422,1510,-88,0,1,0,0.125,55,9,8,0.709091,0,0,21,13,false,false,false,0,1
124,128,-4,41.333333,42.666667,-4,1086,926,160,0,1,0,0.333333,71,3,3,0.394366,1,0,13,19,false,false,true,0.805,0.195
327,366,-39,20.4375,24.4,-39,1030,1014,16,0,1,0,0.066667,-7,16,15,-4.714286,0,0,2,3,false,false,false,0,1
163,188,-25,16.3,18.8,-25,1037,1009,28,0,0,0,0,39,10,10,1.128205,0,1,16,7,false,false,false,0.074,0.926
156,180,-24,19.5,25.714286,-24,1305,1194,111,0,0,0,0,46,8,7,0.717391,0,0,13,11,false,false,false,0.201,0.799
252,498,-246,21,41.5,-246,1539,1891,-352,0,2,0,0.166667,-9,12,12,-2.777778,1,1,8,8,false,false,false,0,1
378,523,-145,23.625,32.6875,-145,1586,1633,-47,1,1,0.0625,0.0625,-11,16,16,-3.090909,0,0,2,1,false,false,false,0,1
192,225,-33,21.333333,28.125,-33,1126,1277,-151,0,0,0,0,31,9,8,1.129032,1,0,11,16,false,false,false,0.032,0.968
8,0,8,8,0,8,1245,1148,97,0,0,0,0,96,1,0,0.364583,0,0,20,0,false,false,true,0.678,0.322
24,0,24,24,0,24,1227,1189,38,0,0,0,0,95,1,0,0.368421,0,0,12,0,false,false,true,0.683,0.317
223,294,-71,24.777778,36.75,-71,1415,1361,54,0,1,0,0.125,31,9,8,1,0,0,12,20,false,false,false,0,1
176,263,-87,16,23.909091,-87,711,746,-35,0,0,0,0,26,11,11,1.461538,0,0,12,10,false,false,false,0,1
285,321,-36,16.764706,20.0625,-36,995,965,30,0,1,0,0.0625,-7,17,16,-5.714286,0,0,5,7,false,false,false,0,1
266,245,21,16.625,16.333333,21,670,576,94,0,0,0,0,-2,16,15,-20.5,0,0,7,12,false,false,true,0.694,0.306
133,178,-45,19,29.666667,-45,1633,1620,13,0,0,0,0,46,7,6,0.782609,0,0,11,9,false,false,false,0.191,0.809
156,152,4,19.5,21.714286,4,1422,1583,-161,0,1,0,0.142857,50,8,7,0.82,0,0,10,23,false,false,false,0.042,0.958
144,187,-43,18,23.375,-43,1493,1453,40,0,0,0,0,44,8,8,0.795455,0,0,12,11,false,false,false,0.199,0.801
324,467,-143,21.6,33.357143,-143,1554,1685,-131,0,2,0,0.142857,-7,15,14,-4.571429,0,0,1,3,false,false,false,0,1
281,364,-83,10.035714,13.481481,-83,651,700,-49,0,0,0,0,-49,28,27,-1.142857,0,0,14,9,false,false,false,0,1
83,121,-38,13.833333,20.166667,-38,500,509,-9,0,0,0,0,60,6,6,0.683333,0,0,14,17,false,false,false,0.051,0.949
239,276,-37,19.916667,25.090909,-37,954,939,15,1,0,0.083333,0,15,12,11,2.4,0,1,8,7,false,false,false,0.001,0.999
105,106,-1,21,21.2,-1,985,1062,-77,0,0,0,0,62,5,5,0.596774,0,1,13,15,false,false,false,0.25,0.75
191,241,-50,23.875,34.428571,-50,1021,897,124,0,2,0,0.285714,36,8,7,1.027778,0,0,22,13,false,false,false,0.087,0.913
144,152,-8,36,38,-8,1086,926,160,0,1,0,0.25,65,4,4,0.430769,1,0,16,12,false,false,true,0.865,0.135
272,402,-130,20.923077,33.5,-130,1636,1727,-91,0,2,0,0.166667,2,13,12,15,0,0,8,19,false,false,false,0,1
123,131,-8,20.5,26.2,-8,1484,1556,-72,0,1,0,0.2,54,6,5,0.574074,1,0,14,12,false,false,true,0.512,0.488
330,362,-32,22,24.133333,-32,1331,1347,-16,1,1,0.066667,0.066667,-22,15,15,-1.454545,0,0,2,1,false,false,false,0.001,0.999
19,66,-47,4.75,16.5,-47,1078,983,95,0,0,0,0,79,4,4,0.607595,1,0,8,9,false,false,false,0.207,0.793
110,93,17,22,23.25,17,1205,1216,-11,0,0,0,0,70,5,4,0.471429,0,0,11,26,false,false,false,0.223,0.777
268,344,-76,11.166667,14.333333,-76,813,698,115,1,0,0.041667,0,-27,24,24,-1.777778,0,0,1,4,true,false,false,0,1
48,79,-31,12,26.333333,-31,1131,1030,101,0,0,0,0,74,4,3,0.405405,1,0,18,10,false,false,false,0.296,0.704
313,360,-47,20.866667,24,-47,1266,1339,-73,0,1,0,0.066667,1,15,15,35,0,0,4,3,false,false,false,0,1
160,108,52,16,12,52,670,576,94,0,0,0,0,37,10,9,1.108108,1,0,13,12,false,false,true,0.968,0.032
150,184,-34,15,18.4,-34,840,1055,-215,0,0,0,0,32,10,10,1.09375,0,0,16,16,false,false,false,0.064,0.936
121,170,-49,15.125,24.285714,-49,726,818,-92,0,0,0,0,49,8,7,0.714286,0,1,14,9,false,false,false,0.004,0.996
70,97,-27,11.666667,19.4,-27,951,976,-25,0,0,0,0,66,6,5,0.666667,1,1,22,24,false,false,false,0.004,0.996
176,160,16,17.6,17.777778,16,803,786,17,0,0,0,0,41,10,9,0.780488,0,0,13,15,false,false,false,0.215,0.785
286,381,-95,22,29.307692,-95,1422,1798,-376,0,2,0,0.153846,5,13,13,6.4,0,0,11,10,false,false,false,0,1
75,96,-21,15,19.2,-21,1176,1211,-35,0,0,0,0,60,5,5,0.55,1,0,7,14,false,false,true,0.628,0.372
94,3,91,47,3,91,1237,1265,-28,1,0,0.5,0,84,2,1,0.428571,0,1,22,7,false,false,true,0.792,0.208
75,150,-75,12.5,30,-75,1454,1479,-25,0,0,0,0,60,6,5,0.516667,1,0,8,16,false,false,false,0.133,0.867
23,27,-4,11.5,27,-4,226,361,-135,0,0,0,0,89,2,1,0.494382,0,1,11,6,false,false,false,0.02,0.98
273,357,-84,19.5,25.5,-84,1131,1030,101,0,0,0,0,-5,14,14,-6,0,0,2,2,false,false,false,0,1
112,104,8,14,14.857143,8,814,830,-16,0,0,0,0,52,8,7,0.788462,0,0,17,20,false,false,false,0.119,0.881
279,305,-26,18.6,21.785714,-26,1063,1134,-71,1,0,0.066667,0,20,15,14,2.2,0,1,10,12,false,false,false,0,1
62,97,-35,20.666667,32.333333,-35,835,786,49,0,0,0,0,76,3,3,0.447368,1,0,15,12,false,false,false,0.452,0.548
379,389,-10,19.947368,21.611111,-10,1436,1489,-53,1,1,0.052632,0.055556,-12,19,18,-3.083333,0,0,1,3,true,false,false,0.167,0.833
118,203,-85,16.857143,29,-85,1572,1777,-205,0,1,0,0.142857,43,7,7,0.767442,0,1,8,9,false,false,false,0.007,0.993
84,191,-107,16.8,38.2,-107,935,995,-60,0,1,0,0.2,65,5,5,0.6,2,0,14,19,false,false,false,0.03,0.97
305,349,-44,16.944444,19.388889,-44,1220,1185,35,0,1,0,0.055556,-6,18,18,-7.833333,0,0,14,10,false,false,false,0,1
138,212,-74,11.5,17.666667,-74,668,363,305,0,0,0,0,29,12,12,1.62069,1,0,16,16,false,false,false,0.008,0.992
255,258,-3,13.421053,14.333333,-3,999,1071,-72,0,0,0,0,-15,19,18,-2.666667,0,0,2,9,false,false,false,0.057,0.943
24,0,24,24,0,24,889,855,34,0,0,0,0,95,1,0,0.421053,0,0,12,0,false,false,true,0.687,0.313
37,151,-114,7.4,30.2,-114,1793,1869,-76,0,1,0,0.2,69,5,5,0.434783,0,0,13,8,false,false,false,0.005,0.995
46,59,-13,15.333333,19.666667,-13,840,1055,-215,0,0,0,0,77,3,3,0.454545,0,0,14,17,false,false,false,0.251,0.749
172,148,24,21.5,18.5,24,664,786,-122,0,0,0,0,48,8,8,0.6875,0,0,12,8,false,false,true,0.663,0.337
157,191,-34,15.7,19.1,-34,1310,1477,-167,0,0,0,0,26,10,10,1.384615,1,0,16,10,false,false,false,0.145,0.855
85,90,-5,17,22.5,-5,566,742,-176,0,0,0,0,68,5,4,0.470588,0,1,20,15,false,false,false,0.038,0.962
127,141,-14,31.75,35.25,-14,1173,1256,-83,1,0,0.25,0,70,4,4,0.442857,0,1,8,8,false,false,false,0.02,0.98
166,205,-39,23.714286,29.285714,-39,1636,1727,-91,0,2,0,0.285714,44,7,7,0.681818,1,1,12,8,false,false,false,0.275,0.725
211,312,-101,19.181818,28.363636,-101,1131,1030,101,0,0,0,0,17,11,11,1.764706,1,0,7,17,false,false,false,0,1
141,166,-25,12.818182,15.090909,-25,814,830,-16,0,0,0,0,27,11,11,1.518519,0,0,19,28,false,false,false,0.048,0.952
234,260,-26,11.7,13.684211,-26,342,53,289,0,0,0,0,-29,20,19,-1.413793,0,0,2,1,false,false,false,0.008,0.992
278,334,-56,23.166667,30.363636,-56,1606,1593,13,1,1,0.083333,0.090909,8,12,11,3.625,0,0,11,16,false,false,false,0,1
245,357,-112,11.666667,17.85,-112,1248,1220,28,0,1,0,0.05,-6,21,20,-8.666667,1,0,6,9,false,false,false,0,1
326,335,-9,17.157895,18.611111,-9,206,346,-140,1,0,0.052632,0,-24,19,18,-1.791667,0,0,12,3,false,false,false,0,1
213,257,-44,26.625,36.714286,-44,1761,1770,-9,0,1,0,0.142857,35,8,7,0.742857,1,0,6,10,false,false,false,0.045,0.955
234,299,-65,16.714286,21.357143,-65,725,668,57,0,0,0,0,10,14,14,3.5,1,0,6,11,false,false,false,0.018,0.982
41,50,-9,10.25,16.666667,-9,1344,1314,30,0,1,0,0.333333,76,4,3,0.447368,0,0,21,11,false,false,false,0.23,0.77
242,288,-46,17.285714,20.571429,-46,1040,1364,-324,0,0,0,0,-1,14,14,-36,0,0,7,19,false,false,false,0,1
36,39,-3,18,19.5,-3,613,525,88,0,0,0,0,83,2,2,0.506024,0,2,17,8,false,false,false,0.157,0.843
280,336,-56,18.666667,22.4,-56,668,771,-103,0,0,0,0,5,15,15,8,0,1,7,9,false,false,false,0,1
34,48,-14,17,24,-14,1229,1220,9,0,0,0,0,85,2,2,0.435294,0,1,9,13,false,false,true,0.582,0.418
186,250,-64,31,50,-64,1689,1777,-88,1,1,0.166667,0.2,44,6,5,0.681818,0,0,22,19,false,false,false,0.143,0.857
24,50,-26,6,12.5,-26,288,359,-71,0,0,0,0,79,4,4,0.341772,0,0,19,11,false,false,false,0.252,0.748
20,0,20,20,0,20,670,576,94,0,0,0,0,95,1,0,0.431579,0,0,8,0,false,false,true,0.688,0.312
191,150,41,27.285714,25,41,1495,1597,-102,0,0,0,0,51,7,6,0.627451,0,1,10,10,false,false,true,0.581,0.419
28,0,28,14,0,28,1127,995,132,0,0,0,0,94,2,1,0.351064,0,0,13,9,false,false,true,0.698,0.302
195,229,-34,19.5,22.9,-34,967,856,111,0,0,0,0,32,10,10,1.03125,0,1,20,11,false,false,false,0.189,0.811
171,225,-54,19,28.125,-54,1038,917,121,1,1,0.111111,0.125,39,9,8,0.897436,0,0,11,10,false,false,false,0.096,0.904
148,136,12,21.142857,19.428571,12,1131,1030,101,0,0,0,0,51,7,7,0.588235,1,0,9,21,false,false,true,0.541,0.459
361,395,-34,25.785714,30.384615,-34,1770,1745,25,2,1,0.142857,0.076923,1,14,13,33,0,0,11,9,false,false,false,0,1
144,208,-64,14.4,20.8,-64,95,453,-358,0,0,0,0,35,10,10,1.114286,0,0,7,27,false,false,false,0,1
10,0,10,10,0,10,803,786,17,0,0,0,0,97,1,0,0.329897,0,0,10,0,false,false,true,0.581,0.419
95,115,-20,10.555556,14.375,-20,970,1030,-60,0,0,0,0,45,9,8,0.888889,0,0,23,10,false,false,false,0.142,0.858
166,219,-53,18.444444,24.333333,-53,653,820,-167,0,0,0,0,28,9,9,1.357143,0,0,7,16,false,false,false,0.039,0.961
110,175,-65,10,15.909091,-65,999,1165,-166,0,0,0,0,35,11,11,1.314286,0,0,22,12,false,false,false,0.034,0.966
176,231,-55,17.6,23.1,-55,653,820,-167,0,0,0,0,22,10,10,1.727273,1,1,6,14,false,false,false,0.003,0.997
91,191,-100,10.111111,21.222222,-100,651,996,-345,0,1,0,0.111111,35,9,9,1.285714,0,1,13,7,false,false,false,0.003,0.997
242,196,46,26.888889,24.5,46,691,695,-4,1,0,0.111111,0,38,9,8,0.842105,0,0,18,17,false,false,true,0.692,0.308
245,269,-24,15.3125,17.933333,-24,1312,1334,-22,0,0,0,0,-6,16,15,-6.5,0,0,10,12,false,false,false,0.138,0.862
201,291,-90,15.461538,22.384615,-90,341,416,-75,0,0,0,0,13,13,13,3,0,0,8,12,false,false,false,0,1
345,367,-22,21.5625,22.9375,-22,1436,1489,-53,1,1,0.0625,0.0625,-2,16,16,-18.5,0,0,6,5,false,false,false,0,1
278,451,-173,13.9,23.736842,-173,1422,1510,-88,0,2,0,0.105263,-19,20,19,-2.052632,0,0,5,2,true,false,false,0,1
215,254,-39,16.538462,21.166667,-39,603,721,-118,0,0,0,0,21,13,12,2.047619,0,0,8,13,false,false,false,0.017,0.983
280,342,-62,12.173913,14.869565,-62,1040,1091,-51,0,0,0,0,-34,23,23,-1.382353,0,0,6,1,false,false,false,0,1
184,152,32,16.727273,13.818182,32,671,638,33,0,0,0,0,25,11,11,1.96,0,0,16,22,false,false,true,0.927,0.073
261,332,-71,18.642857,23.714286,-71,503,527,-24,0,1,0,0.071429,-9,14,14,-3.666667,0,0,8,6,false,false,false,0,1
298,390,-92,16.555556,22.941176,-92,907,1070,-163,0,1,0,0.058824,-7,18,17,-5,0,2,6,7,true,false,false,0,1
202,223,-21,18.363636,22.3,-21,805,918,-113,0,0,0,0,20,11,10,1.8,0,0,10,25,false,false,false,0.039,0.961
273,307,-34,18.2,21.928571,-34,691,704,-13,0,1,0,0.071429,1,15,14,38,0,0,9,21,false,false,false,0.001,0.999
121,109,12,20.166667,21.8,12,1388,1366,22,0,0,0,0,60,6,5,0.533333,0,2,12,6,false,false,true,0.568,0.432
196,206,-10,19.6,20.6,-10,206,346,-140,1,0,0.1,0,30,10,10,1.433333,0,0,9,9,false,false,false,0.135,0.865
108,144,-36,18,24,-36,915,971,-56,0,0,0,0,57,6,6,0.578947,0,0,7,28,false,false,false,0.038,0.962
286,278,8,22,23.166667,8,1561,1495,66,1,0,0.076923,0,2,13,12,16.5,0,0,10,8,false,false,false,0.243,0.757
336,337,-1,16,16.85,-1,206,346,-140,1,0,0.047619,0,-28,21,20,-1.535714,0,0,11,2,false,false,false,0.001,0.999
202,256,-54,15.538462,21.333333,-54,620,698,-78,1,0,0.076923,0,19,13,12,2.157895,0,0,21,14,false,false,false,0,1
200,315,-115,15.384615,24.230769,-115,480,739,-259,0,0,0,0,16,13,13,2.4375,1,0,9,19,false,false,false,0,1
38,65,-27,19,32.5,-27,1232,1281,-49,0,1,0,0.5,77,2,2,0.402597,0,0,8,18,false,false,false,0.207,0.793
140,181,-41,12.727273,18.1,-41,1075,1189,-114,0,0,0,0,30,11,10,1.333333,0,1,8,17,false,false,false,0.038,0.962
245,234,11,20.416667,19.5,11,664,786,-122,0,0,0,0,15,12,12,2.2,1,0,11,7,false,false,true,0.673,0.327
63,142,-79,12.6,28.4,-79,1270,1424,-154,0,1,0,0.2,69,5,5,0.507246,0,0,11,8,false,false,false,0.039,0.961
130,176,-46,11.818182,17.6,-46,668,363,305,0,0,0,0,36,11,10,1.305556,0,0,17,14,false,false,false,0.117,0.883
231,187,44,16.5,14.384615,44,670,576,94,0,0,0,0,12,14,13,3.416667,1,1,10,19,false,false,true,0.793,0.207
74,104,-30,12.333333,17.333333,-30,391,542,-151,1,0,0.166667,0,59,6,6,0.779661,0,0,7,8,false,false,false,0.244,0.756
281,342,-61,11.24,14.25,-61,651,700,-49,0,0,0,0,-41,25,24,-1.365854,0,0,14,11,false,false,false,0,1
254,283,-29,19.538462,23.583333,-29,1205,1216,-11,0,0,0,0,14,13,12,2.357143,0,0,7,12,false,false,false,0.123,0.877
365,414,-49,28.076923,31.846154,-49,820,718,102,0,2,0,0.153846,-11,13,13,-2.545455,0,0,6,3,false,false,false,0,1
293,425,-132,22.538462,35.416667,-132,786,848,-62,0,2,0,0.166667,9,13,12,3.444444,0,0,8,9,false,false,false,0,1
88,51,37,22,12.75,37,1110,1123,-13,0,0,0,0,66,4,4,0.5,0,0,12,10,false,false,true,0.809,0.191
312,301,11,17.333333,17.705882,11,675,570,105,0,0,0,0,-23,18,17,-1.521739,0,0,14,2,true,false,false,0.455,0.545
56,25,31,28,12.5,31,387,683,-296,0,0,0,0,82,2,2,0.414634,1,0,9,8,false,false,true,0.635,0.365
302,353,-51,20.133333,23.533333,-51,980,965,15,0,0,0,0,-2,15,15,-19,0,0,10,10,false,false,false,0,1
14,0,14,14,0,14,1266,1339,-73,0,0,0,0,96,1,0,0.364583,0,0,13,0,false,false,false,0.5,0.5
110,175,-65,13.75,21.875,-65,1161,1176,-15,0,1,0,0.125,42,8,8,0.904762,0,0,13,10,false,false,false,0.178,0.822
155,192,-37,14.090909,17.454545,-37,848,976,-128,0,0,0,0,32,11,11,1.25,0,0,19,12,false,false,false,0.04,0.96
38,56,-18,12.666667,18.666667,-18,1270,1261,9,0,0,0,0,81,3,3,0.45679,1,0,10,16,false,false,true,0.572,0.428
140,155,-15,17.5,19.375,-15,711,746,-35,0,0,0,0,47,8,8,0.808511,0,0,10,19,false,false,false,0.047,0.953
268,401,-133,17.866667,26.733333,-133,1038,917,121,1,2,0.066667,0.133333,-10,15,15,-3.5,0,0,11,4,false,false,false,0,1
204,363,-159,17,30.25,-159,1045,1100,-55,0,1,0,0.083333,19,12,12,1.789474,0,0,10,15,false,false,false,0,1
286,299,-13,22,23,-13,1354,1210,144,0,1,0,0.076923,6,13,13,5.5,0,1,18,9,false,false,false,0.015,0.985
222,187,35,22.2,18.7,35,540,498,42,1,0,0.1,0,30,10,10,1.533333,0,1,10,17,false,false,false,0.061,0.939
76,59,17,15.2,14.75,17,725,668,57,0,0,0,0,70,5,4,0.5,0,0,15,29,false,false,false,0.29,0.71
60,75,-15,20,37.5,-15,452,698,-246,0,1,0,0.5,83,3,2,0.493976,0,0,22,17,false,false,false,0.4,0.6
117,82,35,23.4,20.5,35,1071,1181,-110,0,0,0,0,73,5,4,0.465753,0,0,7,11,false,false,false,0.271,0.729
161,190,-29,17.888889,23.75,-29,450,624,-174,0,0,0,0,35,9,8,0.942857,0,0,19,8,false,false,false,0.24,0.76
62,72,-10,12.4,14.4,-10,530,683,-153,0,0,0,0,72,5,5,0.555556,0,1,9,7,false,false,false,0.253,0.747
260,414,-154,12.380952,20.7,-154,1078,983,95,1,0,0.047619,0,-19,21,20,-2.526316,0,0,8,12,false,false,false,0,1
238,219,19,21.636364,19.909091,19,1168,1062,106,0,0,0,0,33,11,11,1.30303,1,0,7,9,false,false,true,0.653,0.347
46,75,-29,15.333333,25,-29,952,826,126,0,0,0,0,83,3,3,0.518072,0,0,7,7,false,false,false,0.288,0.712
49,29,20,24.5,29,20,1159,1131,28,0,0,0,0,90,2,1,0.411111,0,1,12,6,false,false,true,0.681,0.319
275,282,-7,17.1875,17.625,-7,720,437,283,0,0,0,0,5,16,16,8.4,0,0,10,16,false,false,true,0.61,0.39
184,284,-100,16.727273,28.4,-100,726,818,-92,0,1,0,0.1,25,11,10,1.4,0,0,11,17,false,false,false,0,1
191,201,-10,17.363636,18.272727,-10,1220,1185,35,0,0,0,0,37,11,11,1.27027,0,1,18,6,false,false,false,0.198,0.802
122,46,76,61,23,76,1373,1334,39,1,0,0.5,0,81,2,2,0.395062,0,0,12,7,false,false,true,0.842,0.158
280,349,-69,14.736842,18.368421,-69,620,698,-78,1,0,0.052632,0,-21,19,19,-1.952381,1,0,13,1,false,false,false,0,1
206,290,-84,12.875,19.333333,-84,388,542,-154,0,0,0,0,-1,16,15,-37,0,1,8,6,false,false,false,0,1
292,306,-14,16.222222,18,-14,822,845,-23,0,0,0,0,-13,18,17,-2.692308,0,0,9,2,true,false,false,0.01,0.99
78,109,-31,11.142857,18.166667,-31,1071,1000,71,0,0,0,0,63,7,6,0.746032,1,0,6,19,false,false,false,0.195,0.805
207,222,-15,14.785714,15.857143,-15,526,502,24,0,0,0,0,18,14,14,2.777778,0,0,10,13,false,false,false,0.22,0.78
96,60,36,16,12,36,1193,1220,-27,0,0,0,0,62,6,5,0.693548,1,1,9,20,false,false,true,0.575,0.425
35,95,-60,7,19,-60,1473,1500,-27,0,1,0,0.2,70,5,5,0.557143,0,1,17,8,false,false,false,0.182,0.818
169,311,-142,18.777778,34.555556,-142,834,844,-10,0,2,0,0.222222,29,9,9,1.241379,0,0,11,10,false,true,false,0,1
274,243,31,27.4,27,31,791,885,-94,1,1,0.1,0.111111,28,10,9,1.357143,0,0,15,9,false,true,true,0.901,0.099
66,74,-8,22,37,-8,1636,1576,60,0,1,0,0.5,72,3,2,0.472222,0,0,17,13,false,true,false,0.222,0.778
363,363,0,22.6875,22.6875,0,1636,1576,60,0,2,0,0.125,-15,16,16,-2.266667,0,0,1,13,false,true,true,1,0
265,189,76,22.083333,15.75,76,1045,1009,36,1,0,0.083333,0,23,12,12,1.652174,1,0,8,19,false,true,true,1,0
0,0,0,0,0,0,1142,1095,47,0,0,0,0,100,1,0,0.35,1,0,8,0,false,true,true,0.677,0.323
350,220,130,15.909091,10.47619,130,871,867,4,0,0,0,0,-18,22,21,-2.388889,0,0,6,9,true,true,true,1,0
161,122,39,32.2,24.4,39,908,1070,-162,1,0,0.2,0,60,5,5,0.5,1,0,13,16,false,true,false,0.259,0.741
301,156,145,17.705882,9.75,145,1176,1076,100,0,0,0,0,28,17,16,2.107143,0,0,12,15,false,true,true,1,0
184,120,64,20.444444,13.333333,64,1413,1422,-9,0,0,0,0,44,9,9,1.295455,2,0,16,9,false,true,true,0.994,0.006
368,364,4,21.647059,22.75,4,992,1100,-108,2,0,0.117647,0,-15,17,16,-2.266667,0,0,1,1,false,true,true,0.686,0.314
251,268,-17,27.888889,29.777778,-17,1256,1232,24,1,0,0.111111,0,28,9,9,1.071429,0,0,12,14,false,true,false,0.256,0.744
261,218,43,17.4,14.533333,43,786,788,-2,0,0,0,0,-9,15,15,-3.777778,1,0,7,16,false,true,true,0.999,0.001
120,92,28,17.142857,15.333333,28,1176,1127,49,0,0,0,0,52,7,6,0.711538,0,0,14,16,false,true,true,0.645,0.355
39,10,29,19.5,10,29,939,913,26,0,0,0,0,91,2,1,0.43956,0,0,9,7,false,true,true,0.691,0.309
0,0,0,0,0,0,299,315,-16,0,0,0,0,100,1,0,0.42,0,0,7,0,false,true,false,0.251,0.749
8,0,8,8,0,8,1334,1256,78,0,0,0,0,96,1,0,0.322917,1,0,16,0,false,true,true,0.693,0.307
276,175,101,23,15.909091,101,1004,653,351,0,0,0,0,11,12,11,3.181818,0,1,14,24,false,true,true,1,0
32,14,18,16,14,18,1277,1166,111,0,0,0,0,89,2,1,0.404494,0,0,20,13,false,true,true,0.677,0.323
114,149,-35,19,29.8,-35,947,810,137,0,1,0,0.2,58,6,5,0.724138,0,1,19,13,false,true,false,0.197,0.803
326,313,13,18.111111,18.411765,13,1782,1512,270,1,1,0.055556,0.058824,-16,18,17,-2.625,0,0,3,7,false,true,true,1,0
364,179,185,14.56,7.458333,185,859,719,140,0,1,0,0.041667,-36,25,24,-1.472222,0,1,11,9,false,true,true,1,0
178,103,75,29.666667,17.166667,75,746,796,-50,0,1,0,0.166667,46,6,6,1.043478,0,0,10,10,false,true,true,0.97,0.03
326,298,28,25.076923,22.923077,28,1093,1090,3,1,2,0.076923,0.153846,11,13,13,3.090909,0,0,18,9,false,true,true,0.944,0.056
357,310,47,17,15.5,47,725,771,-46,0,1,0,0.05,-27,21,20,-1.703704,0,0,3,4,false,true,true,1,0
163,67,96,20.375,9.571429,96,993,897,96,1,0,0.125,0,46,8,7,1.021739,0,0,13,16,false,true,true,0.97,0.03
357,243,114,32.454545,24.3,114,1507,1554,-47,1,2,0.090909,0.2,11,11,10,2.636364,0,0,13,12,false,true,true,1,0
168,127,41,24,21.166667,41,1127,1134,-7,0,0,0,0,49,7,6,0.612245,0,0,8,13,false,true,true,0.733,0.267
150,135,15,18.75,16.875,15,613,502,111,0,0,0,0,46,8,8,1.065217,0,0,12,26,false,true,true,0.68,0.32
224,171,53,18.666667,14.25,53,620,513,107,0,0,0,0,24,12,12,1.875,0,0,19,9,false,true,true,0.97,0.03
257,229,28,18.357143,17.615385,28,671,725,-54,0,0,0,0,6,14,13,6.166667,0,0,14,7,false,true,true,0.931,0.069
209,149,60,26.125,21.285714,60,1034,1040,-6,1,0,0.125,0,43,8,7,0.813953,1,0,7,18,false,true,true,0.953,0.047
141,97,44,23.5,19.4,44,941,926,15,1,0,0.166667,0,61,6,5,0.622951,0,0,14,7,false,true,true,0.868,0.132
345,240,105,31.363636,21.818182,105,1023,1070,-47,2,0,0.181818,0,14,11,11,2.285714,0,0,18,21,false,true,true,1,0
248,219,29,22.545455,21.9,29,290,416,-126,0,0,0,0,26,11,10,1.307692,0,0,9,15,false,true,true,0.596,0.404
189,189,0,18.9,18.9,0,1547,1439,108,1,0,0.1,0,33,10,10,1.121212,0,0,15,10,false,true,false,0.283,0.717
99,54,45,24.75,18,45,1397,1195,202,0,0,0,0,74,4,3,0.472973,0,0,11,23,false,true,false,0.457,0.543
241,167,74,17.214286,11.928571,74,1128,889,239,0,1,0,0.071429,20,14,14,2.35,0,0,18,19,false,true,true,1,0
93,91,2,15.5,18.2,2,1221,1266,-45,0,0,0,0,60,6,5,0.583333,0,0,7,7,false,true,true,0.662,0.338
32,55,-23,10.666667,18.333333,-23,218,86,132,0,0,0,0,76,3,3,0.526316,0,0,17,7,false,true,true,0.678,0.322
70,51,19,17.5,17,19,725,771,-46,0,1,0,0.333333,71,4,3,0.647887,0,1,23,22,false,true,true,0.595,0.405
378,330,48,25.2,22,48,1093,1090,3,1,2,0.066667,0.133333,0,15,15,0,0,0,8,8,false,true,true,1,0
184,90,94,30.666667,15,94,1439,1353,86,1,0,0.166667,0,55,6,6,0.545455,0,0,14,13,false,true,true,0.968,0.032
208,207,1,17.333333,18.818182,1,1547,1439,108,1,0,0.083333,0,24,12,11,1.541667,0,0,26,8,false,true,false,0.226,0.774
0,0,0,0,0,0,1519,1782,-263,0,0,0,0,100,1,0,0.33,0,0,15,0,false,true,false,0.251,0.749
371,329,42,19.526316,18.277778,42,1244,1361,-117,2,1,0.105263,0.055556,-10,19,18,-3.8,0,0,2,5,false,true,true,1,0
113,136,-23,12.555556,15.111111,-23,480,518,-38,0,0,0,0,52,9,9,0.884615,0,1,16,7,false,true,false,0.121,0.879
329,237,92,27.416667,21.545455,92,1556,1591,-35,1,0,0.083333,0,15,12,11,2.4,0,0,11,7,false,true,true,1,0
383,344,39,21.277778,20.235294,39,880,952,-72,0,0,0,0,-13,18,17,-2.692308,0,0,1,2,true,true,true,1,0
281,203,78,35.125,29,78,1645,1777,-132,2,0,0.25,0,28,8,7,0.892857,0,0,15,9,false,true,true,0.999,0.001
84,29,55,21,9.666667,55,527,581,-54,0,0,0,0,77,4,3,0.545455,1,0,7,10,false,true,true,0.766,0.234
297,302,-5,14.142857,14.380952,-5,613,549,64,0,0,0,0,-32,21,21,-1.375,0,0,1,1,false,true,true,0.858,0.142
0,0,0,0,0,0,1539,1537,2,0,0,0,0,100,1,0,0.32,0,0,17,0,false,true,true,0.677,0.323
337,233,104,42.125,33.285714,104,1348,1331,17,2,0,0.25,0,30,8,7,0.8,0,0,10,17,false,true,true,1,0
372,300,72,31,27.272727,72,1826,1656,170,2,0,0.166667,0,4,12,11,6.75,0,0,15,11,false,true,true,1,0
191,167,24,21.222222,20.875,24,1305,1242,63,1,0,0.111111,0,45,9,8,0.755556,0,1,10,7,false,true,true,0.764,0.236
38,29,9,19,29,9,1203,1221,-18,0,0,0,0,90,2,1,0.388889,1,0,9,22,false,true,true,0.757,0.243
149,148,1,24.833333,24.666667,1,1227,1060,167,0,1,0,0.166667,58,6,6,0.689655,0,0,16,9,false,true,false,0.258,0.742
268,186,82,16.75,11.625,82,498,43,455,0,0,0,0,-4,16,16,-9.25,0,0,7,7,false,true,true,1,0
124,81,43,17.714286,13.5,43,527,581,-54,0,0,0,0,54,7,6,0.777778,1,0,11,20,false,true,true,0.717,0.283
246,191,55,30.75,27.285714,55,1659,1782,-123,1,0,0.125,0,32,8,7,0.90625,0,0,22,11,false,true,true,0.794,0.206
305,241,64,23.461538,20.083333,64,1302,1082,220,0,0,0,0,1,13,12,30,1,0,7,12,false,true,true,1,0
22,0,22,22,0,22,1176,1127,49,0,0,0,0,95,1,0,0.389474,0,0,19,0,false,true,true,0.683,0.317
214,168,46,19.454545,15.272727,46,620,658,-38,0,0,0,0,27,11,11,1.333333,0,0,28,7,false,true,true,0.97,0.03
36,11,25,18,11,25,1030,1045,-15,0,0,0,0,93,2,1,0.494624,0,0,15,10,false,true,true,0.636,0.364
46,34,12,15.333333,11.333333,12,1069,1040,29,0,0,0,0,78,3,3,0.564103,0,1,22,11,false,true,true,0.709,0.291
387,296,91,27.642857,21.142857,91,1331,1399,-68,1,0,0.071429,0,-7,14,14,-5,0,0,7,7,false,true,true,1,0
176,97,79,25.142857,16.166667,79,1245,1232,13,1,0,0.142857,0,43,7,6,0.674419,1,0,14,22,false,true,true,0.969,0.031
150,134,16,25,22.333333,16,306,169,137,0,0,0,0,52,6,6,0.653846,0,0,11,7,false,true,true,0.911,0.089
162,121,41,18,13.444444,41,1030,1045,-15,0,0,0,0,47,9,9,0.978723,0,0,7,24,false,true,true,0.704,0.296
167,171,-4,15.181818,17.1,-4,450,412,38,0,0,0,0,25,11,10,1.52,0,0,10,14,false,true,false,0.276,0.724
74,49,25,18.5,16.333333,25,808,639,169,0,0,0,0,72,4,3,0.569444,0,0,26,9,false,true,true,0.717,0.283
344,168,176,24.571429,12.923077,176,1413,1422,-9,0,0,0,0,16,14,13,3.5625,0,0,9,13,false,true,true,1,0
409,211,198,34.083333,19.181818,198,1550,1624,-74,2,0,0.166667,0,17,12,11,1.764706,1,0,8,9,false,true,true,1,0
390,237,153,19.5,12.473684,153,1586,1782,-196,0,0,0,0,-27,20,19,-1.481481,1,0,0,2,false,true,true,1,0
121,128,-7,20.166667,21.333333,-7,995,912,83,1,0,0.166667,0,65,6,6,0.676923,1,0,16,18,false,true,true,0.851,0.149
119,102,17,17,17,17,1029,1075,-46,0,0,0,0,58,7,6,0.827586,1,0,10,11,false,true,true,0.663,0.337
114,42,72,28.5,14,72,1210,1253,-43,0,0,0,0,70,4,3,0.485714,0,1,22,8,false,true,true,0.847,0.153
305,256,49,23.461538,21.333333,49,1109,1065,44,0,0,0,0,-3,13,12,-11,0,0,19,11,false,true,true,0.977,0.023
176,171,5,22,21.375,5,892,788,104,1,0,0.125,0,50,8,8,0.86,0,0,12,16,false,true,true,0.89,0.11
79,56,23,26.333333,18.666667,23,939,907,32,0,0,0,0,81,3,3,0.493827,0,0,18,13,false,true,true,0.728,0.272
119,26,93,39.666667,13,93,1824,1793,31,1,0,0.333333,0,81,3,2,0.345679,1,0,23,13,false,true,true,0.986,0.014
413,407,6,27.533333,27.133333,6,1428,1452,-24,1,2,0.066667,0.133333,-14,15,15,-2.214286,0,0,1,2,false,true,true,1,0
119,158,-39,14.875,19.75,-39,95,378,-283,0,0,0,0,45,8,8,0.777778,0,0,14,9,false,true,false,0.224,0.776
323,313,10,19,18.411765,10,1127,1176,-49,0,0,0,0,-10,17,17,-4.2,0,0,4,4,false,true,true,0.947,0.053
247,250,-3,16.466667,17.857143,-3,1043,1055,-12,0,0,0,0,5,15,14,7.4,1,0,17,11,false,true,true,0.598,0.402
281,251,30,17.5625,16.733333,30,671,725,-54,0,0,0,0,-7,16,15,-5.285714,0,0,13,5,false,true,true,0.932,0.068
352,265,87,19.555556,15.588235,87,971,658,313,0,0,0,0,-19,18,17,-1.894737,0,0,1,3,false,true,true,1,0
343,243,100,18.052632,13.5,100,1048,1000,48,0,0,0,0,-13,19,18,-3.076923,0,1,1,3,false,true,true,1,0
379,324,55,25.266667,23.142857,55,1885,1846,39,1,1,0.066667,0.071429,-10,15,14,-2.9,0,0,3,2,true,true,true,1,0
273,282,-9,16.058824,17.625,-9,316,306,10,0,2,0,0.125,-10,17,16,-3.8,0,0,4,17,false,true,true,0.98,0.02
365,199,166,26.071429,15.307692,166,778,758,20,0,1,0,0.076923,2,14,13,19.5,0,0,10,15,false,true,true,1,0
194,181,13,14.923077,15.083333,13,500,567,-67,0,0,0,0,32,13,12,1.375,0,1,9,24,false,true,false,0.049,0.951
340,231,109,12.592593,8.884615,109,1428,1302,126,0,0,0,0,-34,27,26,-1.558824,0,1,12,11,true,true,true,1,0
287,262,25,22.076923,20.153846,25,892,819,73,0,1,0,0.076923,7,13,13,4.857143,0,0,14,13,false,true,true,0.801,0.199
76,72,4,15.2,18,4,977,976,1,0,0,0,0,73,5,4,0.465753,0,0,19,9,false,true,true,0.663,0.337
227,204,23,17.461538,15.692308,23,904,857,47,0,0,0,0,14,13,13,2.928571,1,0,13,10,false,true,true,0.917,0.083
276,267,9,23,24.272727,9,1142,1176,-34,1,0,0.083333,0,18,12,11,2,1,0,25,7,false,true,true,0.845,0.155
302,271,31,30.2,30.111111,31,1333,1331,2,1,0,0.1,0,16,10,9,1.875,0,0,15,8,false,true,true,0.865,0.135
367,310,57,33.363636,28.181818,57,1237,1277,-40,0,0,0,0,6,11,11,4.833333,0,0,22,8,false,true,true,1,0
193,138,55,17.545455,13.8,55,872,818,54,0,1,0,0.1,39,11,10,1.051282,0,0,8,8,false,true,true,0.961,0.039
338,279,59,16.095238,13.95,59,1091,1078,13,0,0,0,0,-18,21,20,-2.388889,1,0,4,2,false,true,true,1,0
234,199,35,21.272727,19.9,35,1364,1093,271,0,1,0,0.1,26,11,10,1.461538,1,0,9,7,false,true,true,0.656,0.344
243,144,99,14.294118,8.470588,99,310,359,-49,0,0,0,0,-12,17,17,-4.083333,0,0,9,17,false,true,true,1,0
154,135,19,14,13.5,19,904,857,47,0,0,0,0,34,11,10,1.205882,0,0,10,20,false,true,false,0.288,0.712
88,98,-10,14.666667,16.333333,-10,971,761,210,0,0,0,0,57,6,6,0.526316,1,1,9,26,false,true,false,0.191,0.809
200,271,-71,22.222222,30.111111,-71,1419,1488,-69,0,1,0,0.111111,25,9,9,1.12,1,0,6,7,false,true,false,0.014,0.986
233,228,5,25.888889,25.333333,5,1670,1770,-100,1,1,0.111111,0.111111,36,9,9,0.888889,0,0,10,15,false,true,false,0.442,0.558
298,277,21,19.866667,19.785714,21,613,611,2,0,0,0,0,-8,15,14,-4.75,0,0,11,10,false,true,true,0.74,0.26
181,62,119,20.111111,6.888889,119,1176,1076,100,0,0,0,0,58,9,9,1.017241,0,1,15,15,false,true,true,0.983,0.017
319,265,54,17.722222,15.588235,54,450,412,38,0,0,0,0,-22,18,17,-1.727273,0,0,1,4,false,true,true,1,0
341,280,61,20.058824,16.470588,61,1045,1009,36,1,0,0.058824,0,-9,17,17,-4.222222,0,0,4,6,false,true,true,1,0
292,265,27,15.368421,13.947368,27,371,435,-64,0,0,0,0,-24,19,19,-1.833333,0,0,3,2,false,true,true,0.954,0.046
169,131,38,24.142857,21.833333,38,820,822,-2,0,0,0,0,50,7,6,0.78,0,0,11,7,false,true,true,0.769,0.231
190,167,23,15.833333,15.181818,23,1029,1075,-46,0,0,0,0,35,12,11,1.371429,2,0,6,14,false,true,true,0.856,0.144
23,32,-9,11.5,32,-9,218,86,132,0,0,0,0,90,2,1,0.444444,0,1,12,12,false,true,false,0.084,0.916
39,20,19,19.5,20,19,892,788,104,0,0,0,0,90,2,1,0.477778,1,0,8,12,false,true,true,0.683,0.317
253,182,71,15.8125,12.133333,71,698,742,-44,1,0,0.0625,0,13,16,15,3.153846,0,0,7,23,false,true,true,0.999,0.001
300,252,48,21.428571,18,48,941,926,15,1,0,0.071429,0,10,14,14,3.8,1,0,18,12,false,true,true,1,0
29,17,12,14.5,17,12,892,768,124,0,0,0,0,91,2,1,0.472527,0,0,17,16,false,true,true,0.67,0.33
117,168,-51,16.714286,24,-51,316,306,10,0,2,0,0.285714,52,7,7,0.730769,0,0,16,10,false,true,true,0.996,0.004
352,304,48,17.6,16,48,820,822,-2,0,0,0,0,-21,20,19,-1.857143,0,0,1,1,true,true,true,1,0
396,296,100,26.4,21.142857,100,1331,1399,-68,1,0,0.066667,0,-9,15,14,-3.888889,0,0,5,7,false,true,true,1,0
204,148,56,29.142857,24.666667,56,1731,1691,40,1,0,0.142857,0,48,7,6,0.708333,0,0,11,9,false,true,true,0.817,0.183
342,273,69,20.117647,17.0625,69,791,774,17,1,0,0.058824,0,-1,17,16,-41,0,0,7,7,false,true,true,1,0
261,204,57,20.076923,15.692308,57,746,796,-50,0,1,0,0.076923,12,13,13,4,0,1,23,8,false,true,true,0.971,0.029
26,16,10,13,16,10,518,533,-15,0,0,0,0,90,2,1,0.388889,0,0,10,26,false,true,false,0.248,0.752
207,135,72,29.571429,22.5,72,1397,1195,202,1,0,0.142857,0,47,7,6,0.744681,0,0,21,17,false,true,true,0.957,0.043
40,44,-4,13.333333,22,-4,1221,1438,-217,0,0,0,0,85,3,2,0.529412,0,0,16,11,false,true,false,0.251,0.749
183,135,48,15.25,12.272727,48,1016,1037,-21,0,0,0,0,32,12,11,1.5,0,0,7,19,false,true,true,0.636,0.364
375,285,90,18.75,15,90,844,821,23,0,0,0,0,-8,20,19,-5.25,0,0,3,4,false,true,true,1,0
171,97,74,28.5,16.166667,74,801,925,-124,1,0,0.166667,0,51,6,6,0.686275,0,0,13,16,false,true,true,0.847,0.153
83,71,12,16.6,17.75,12,620,658,-38,0,0,0,0,67,5,4,0.537313,1,0,16,7,false,true,true,0.737,0.263
97,14,83,48.5,7,83,1004,653,351,0,0,0,0,81,2,2,0.432099,0,0,10,12,false,true,true,0.857,0.143
300,224,76,25,20.363636,76,1305,1218,87,1,0,0.083333,0,16,12,11,2.375,0,0,17,9,false,true,true,1,0
326,305,21,21.733333,21.785714,21,1100,1008,92,1,0,0.066667,0,-3,15,14,-12,0,0,7,10,false,true,true,0.998,0.002
201,124,77,25.125,17.714286,77,1550,1546,4,0,0,0,0,52,8,7,0.576923,1,0,13,7,false,true,true,0.993,0.007
101,101,0,20.2,20.2,0,784,758,26,0,0,0,0,63,5,5,0.555556,0,0,7,10,false,true,true,0.678,0.322
152,181,-29,19,25.857143,-29,869,820,49,0,1,0,0.142857,53,8,7,0.698113,0,0,10,8,false,true,false,0.201,0.799
282,213,69,31.333333,23.666667,69,1510,1583,-73,1,0,0.111111,0,27,9,9,1.185185,0,0,7,13,false,true,true,1,0
272,267,5,16,15.705882,5,500,567,-67,0,0,0,0,4,17,17,11,0,0,7,12,false,true,false,0.437,0.563
287,149,138,23.916667,12.416667,138,554,342,212,0,0,0,0,14,12,12,2.571429,1,0,7,19,false,true,true,1,0
295,234,61,22.692308,18,61,960,1070,-110,1,0,0.076923,0,14,13,13,2.5,1,1,19,9,false,true,true,0.864,0.136
107,26,81,53.5,26,81,1762,1616,146,1,0,0.5,0,87,2,1,0.344828,0,0,10,12,false,true,true,0.841,0.159
142,126,16,20.285714,18,16,808,812,-4,0,0,0,0,46,7,7,0.804348,1,0,18,17,false,true,true,0.924,0.076
343,224,119,22.866667,16,119,526,370,156,0,0,0,0,-5,15,14,-7,0,0,12,12,false,true,true,1,0
208,181,27,20.8,18.1,27,939,907,32,0,0,0,0,41,10,10,0.97561,1,0,15,8,false,true,true,0.944,0.056
199,133,66,19.9,14.777778,66,620,658,-38,0,0,0,0,36,10,9,1,0,0,29,7,false,true,true,0.97,0.03
29,35,-6,9.666667,17.5,-6,523,480,43,0,0,0,0,84,3,2,0.392857,0,0,25,7,false,true,true,0.666,0.334
204,161,43,22.666667,20.125,43,901,1159,-258,2,0,0.222222,0,38,9,8,0.921053,0,0,13,10,false,true,true,0.784,0.216
37,12,25,18.5,12,25,1439,1413,26,0,0,0,0,90,2,1,0.4,0,0,13,8,false,true,true,0.68,0.32
124,130,-6,31,32.5,-6,1782,1512,270,1,1,0.25,0.25,67,4,4,0.626866,0,0,17,7,false,true,true,1,0
302,272,30,18.875,18.133333,30,527,514,13,0,0,0,0,-7,16,15,-5.571429,0,0,8,8,false,true,true,0.856,0.144
222,153,69,17.076923,11.769231,69,346,231,115,0,0,0,0,-3,13,13,-13.666667,0,0,11,14,false,true,true,0.971,0.029
347,274,73,21.6875,18.266667,73,941,926,15,1,0,0.0625,0,-1,16,15,-38,0,0,10,7,false,true,true,1,0
243,171,72,17.357143,12.214286,72,872,818,54,0,1,0,0.071429,21,14,14,1.952381,1,0,19,7,false,true,true,0.997,0.003
283,277,6,16.647059,17.3125,6,725,771,-46,0,1,0,0.0625,-3,17,16,-15.333333,1,0,13,7,false,true,false,0.422,0.578
84,50,34,21,12.5,34,527,581,-54,0,0,0,0,74,4,4,0.567568,1,0,7,13,false,true,true,0.713,0.287
61,39,22,20.333333,19.5,22,1513,1479,34,0,0,0,0,82,3,2,0.414634,1,0,22,9,false,true,true,0.928,0.072
39,71,-32,19.5,71,-32,1076,1176,-100,0,1,0,1,84,2,1,0.380952,0,0,13,18,false,true,false,0.201,0.799
291,288,3,13.227273,13.714286,3,1029,1075,-46,0,0,0,0,-17,22,21,-2.823529,1,0,4,4,false,true,true,0.954,0.046
355,326,29,25.357143,23.285714,29,1014,948,66,1,0,0.071429,0,-4,14,14,-8.25,0,0,11,5,false,true,true,1,0
297,102,195,37.125,14.571429,195,1054,917,137,2,0,0.25,0,35,8,7,1,0,0,17,8,false,true,true,1,0
59,77,-18,29.5,77,-18,1394,1424,-30,0,1,0,1,85,2,1,0.376471,0,0,13,7,false,true,false,0.201,0.799
222,166,56,22.2,18.444444,56,1221,1266,-45,0,0,0,0,29,10,9,1.206897,1,0,15,8,false,true,true,0.951,0.049
0,0,0,0,0,0,1093,1100,-7,0,0,0,0,100,1,1,0.32,0,1,12,11,false,true,false,0.251,0.749
121,87,34,24.2,17.4,34,421,306,115,0,1,0,0.2,55,5,5,0.8,0,0,10,10,false,true,true,0.97,0.03
50,39,11,25,39,11,1331,1399,-68,0,0,0,0,82,2,1,0.426829,1,0,13,10,false,true,true,0.926,0.074
165,173,-8,16.5,17.3,-8,95,378,-283,0,0,0,0,28,10,10,1.25,0,0,7,13,false,true,true,0.65,0.35
383,321,62,18.238095,16.05,62,1551,1550,1,0,0,0,0,-38,21,20,-1.105263,0,0,1,2,false,true,true,1,0
121,126,-5,20.166667,21,-5,1167,1216,-49,0,0,0,0,62,6,6,0.66129,1,0,6,15,false,true,false,0.459,0.541
248,179,69,27.555556,22.375,69,1803,1552,251,1,1,0.111111,0.125,37,9,8,0.756757,1,0,7,7,false,true,true,0.995,0.005
202,104,98,28.857143,17.333333,98,371,336,35,2,0,0.285714,0,38,7,6,1,0,0,7,22,false,true,true,0.892,0.108
252,202,50,21,16.833333,50,1516,1397,119,0,1,0,0.083333,9,12,12,3.666667,0,0,30,9,false,true,true,0.998,0.002
10,0,10,10,0,10,1550,1466,84,0,0,0,0,97,1,0,0.381443,1,0,8,0,false,true,true,0.73,0.27
41,59,-18,13.666667,19.666667,-18,1885,1846,39,0,1,0,0.333333,70,3,3,0.414286,1,0,9,9,false,true,false,0.418,0.582
20,0,20,20,0,20,1091,1078,13,0,0,0,0,97,1,0,0.443299,0,0,16,0,false,true,true,0.68,0.32
362,275,87,18.1,14.473684,87,1606,1544,62,0,0,0,0,-13,20,19,-3.461538,0,0,3,2,false,true,true,1,0
345,171,174,34.5,17.1,174,820,783,37,1,0,0.1,0,26,10,10,1.269231,0,0,11,14,false,true,true,1,0
324,308,16,19.058824,18.117647,16,1295,1281,14,0,0,0,0,1,17,17,38,0,0,16,5,false,true,true,0.945,0.055
213,147,66,21.3,14.7,66,561,526,35,0,0,0,0,19,10,10,1.842105,0,0,10,13,false,true,true,0.97,0.03
166,125,41,18.444444,15.625,41,786,976,-190,0,0,0,0,50,9,8,0.64,0,0,12,8,false,true,true,0.623,0.377
246,202,44,35.142857,33.666667,44,1633,1580,53,2,0,0.285714,0,44,7,6,0.636364,0,0,9,15,false,true,true,0.697,0.303
83,65,18,16.6,16.25,18,540,518,22,0,0,0,0,72,5,4,0.555556,0,0,9,18,false,true,false,0.315,0.685
317,285,32,18.647059,17.8125,32,784,758,26,0,0,0,0,-16,17,16,-2.1875,1,0,1,2,false,true,true,1,0
362,277,85,32.909091,25.181818,85,1684,1320,364,1,0,0.090909,0,5,11,11,6,0,0,8,13,false,true,true,1,0
52,57,-5,13,14.25,-5,1128,889,239,0,1,0,0.25,72,4,4,0.652778,1,0,8,7,false,true,true,0.996,0.004
167,83,84,18.555556,10.375,84,595,543,52,0,0,0,0,50,9,8,0.94,1,0,15,17,false,true,true,0.97,0.03
23,8,15,11.5,8,15,1128,889,239,0,0,0,0,91,2,1,0.516484,1,0,7,15,false,true,true,0.618,0.382
321,189,132,26.75,17.181818,132,939,907,32,1,0,0.083333,0,27,12,11,1.481481,0,0,15,10,false,true,true,1,0
255,212,43,23.181818,19.272727,43,902,866,36,0,0,0,0,10,11,11,3.2,0,0,15,7,false,true,true,0.967,0.033
24,0,24,24,0,24,719,651,68,0,0,0,0,97,1,0,0.463918,1,0,24,0,false,true,true,0.695,0.305
324,315,9,21.6,21,9,1493,1513,-20,1,0,0.066667,0,0,15,15,0,0,1,10,4,false,true,true,0.791,0.209
332,312,20,19.529412,18.352941,20,594,605,-11,0,0,0,0,-17,17,17,-2.176471,0,0,2,1,false,true,true,0.997,0.003
203,194,9,29,27.714286,9,1096,1009,87,1,0,0.142857,0,59,7,7,0.745763,0,1,11,12,false,true,false,0.046,0.954
118,97,21,19.666667,16.166667,21,1094,1030,64,0,0,0,0,61,6,6,0.590164,1,0,6,11,false,true,true,0.746,0.254
184,165,19,18.4,16.5,19,786,976,-190,0,0,0,0,37,10,10,0.864865,0,0,12,10,false,true,true,0.636,0.364
87,64,23,17.4,12.8,23,1253,1166,87,0,0,0,0,68,5,5,0.632353,1,0,9,18,false,true,true,0.692,0.308
284,291,-7,16.705882,18.1875,-7,1388,1477,-89,1,0,0.058824,0,-1,17,16,-48,1,0,7,20,false,true,true,0.725,0.275
342,317,25,20.117647,19.8125,25,1344,1209,135,1,1,0.058824,0.0625,-21,17,16,-1.619048,0,0,3,1,false,true,true,0.972,0.028
226,135,91,14.125,9,91,310,359,-49,0,0,0,0,0,16,15,0,0,0,7,16,false,true,true,0.965,0.035
326,192,134,29.636364,19.2,134,1270,1322,-52,1,0,0.090909,0,27,11,10,1.407407,0,0,10,18,false,true,true,1,0
271,266,5,15.055556,15.647059,5,262,306,-44,0,0,0,0,-14,18,17,-3.285714,0,0,8,15,false,true,false,0.292,0.708
76,39,37,15.2,7.8,37,1176,1076,100,0,0,0,0,76,5,5,0.776316,0,0,18,7,false,true,true,0.843,0.157
345,252,93,23,18,93,1516,1397,119,0,1,0,0.071429,-4,15,14,-8.25,0,1,5,8,false,true,true,1,0
68,59,9,17,19.666667,9,1885,1846,39,0,1,0,0.333333,67,4,3,0.432836,1,0,11,9,false,true,true,0.765,0.235
156,110,46,39,36.666667,46,1302,1349,-47,0,0,0,0,66,4,3,0.424242,0,0,10,7,false,true,true,0.696,0.304
209,213,-4,17.416667,19.363636,-4,721,689,32,0,0,0,0,6,12,11,5.666667,0,1,22,6,false,true,false,0.478,0.522
162,209,-47,20.25,29.857143,-47,758,952,-194,0,0,0,0,38,8,7,1.052632,1,0,13,7,false,true,false,0.022,0.978
257,238,19,25.7,23.8,19,1244,1361,-117,2,1,0.2,0.1,36,10,10,1.055556,0,0,17,12,false,true,true,0.837,0.163
98,49,49,24.5,16.333333,49,719,651,68,0,0,0,0,81,4,3,0.555556,1,0,26,9,false,true,true,0.955,0.045
151,140,11,18.875,20,11,628,658,-30,0,0,0,0,48,8,7,0.958333,0,0,19,10,false,true,false,0.414,0.586
396,321,75,22,17.833333,75,1556,1591,-35,2,0,0.111111,0,-26,18,18,-1.384615,0,0,1,1,true,true,true,1,0
238,150,88,26.444444,18.75,88,758,796,-38,0,0,0,0,37,9,8,1.027027,0,0,12,14,false,true,true,0.971,0.029
113,156,-43,14.125,22.285714,-43,1075,989,86,0,0,0,0,60,8,7,0.65,0,0,27,14,false,true,false,0.194,0.806
247,236,11,20.583333,21.454545,11,1304,1040,264,1,0,0.083333,0,23,12,11,1.434783,0,0,17,9,false,true,false,0.332,0.668
42,41,1,14,13.666667,1,1156,1114,42,0,0,0,0,72,3,3,0.444444,1,0,8,7,false,true,true,0.678,0.322
22,17,5,22,17,5,630,786,-156,0,0,0,0,89,1,1,0.393258,0,0,10,12,false,true,false,0.252,0.748
191,205,-14,17.363636,20.5,-14,721,689,32,0,0,0,0,14,11,10,2.428571,0,0,21,10,false,true,false,0.26,0.74
385,285,100,18.333333,14.25,100,844,821,23,0,0,0,0,-12,21,20,-3.5,0,0,3,4,false,true,true,1,0
191,145,46,17.363636,14.5,46,272,288,-16,0,0,0,0,45,11,10,1.155556,0,1,17,13,false,true,true,0.629,0.371
143,107,36,23.833333,21.4,36,1153,1065,88,0,1,0,0.2,53,6,5,0.528302,0,0,19,17,false,true,true,0.727,0.273
333,287,46,33.3,28.7,46,1302,1349,-47,0,1,0,0.1,16,10,10,1.75,0,1,13,8,false,true,true,0.918,0.082
14,22,-8,14,22,-8,1221,1266,-45,0,0,0,0,92,1,1,0.380435,0,0,12,11,false,true,true,0.674,0.326
428,326,102,30.571429,23.285714,102,1197,1127,70,0,0,0,0,-12,14,14,-2.5,0,0,3,5,false,true,true,1,0
80,71,9,26.666667,23.666667,9,1645,1777,-132,1,0,0.333333,0,70,3,3,0.357143,1,0,18,9,false,true,true,0.885,0.115
65,42,23,16.25,14,23,1075,989,86,0,0,0,0,75,4,3,0.52,0,0,28,16,false,true,true,0.687,0.313
225,244,-19,22.5,24.4,-19,758,952,-194,0,0,0,0,24,10,10,1.666667,1,0,6,7,false,true,true,0.513,0.487
400,232,168,22.222222,12.888889,168,1295,1477,-182,3,0,0.166667,0,-7,18,18,-6.571429,0,0,13,10,false,true,true,1,0
242,190,52,26.888889,21.111111,52,1023,1070,-47,1,0,0.111111,0,31,9,9,1.032258,1,0,14,22,false,true,true,0.973,0.027
12,0,12,12,0,12,1210,1253,-43,0,0,0,0,96,1,0,0.354167,1,0,8,0,false,true,true,0.655,0.345
188,124,64,26.857143,17.714286,64,1482,1394,88,1,0,0.142857,0,53,7,7,0.679245,1,0,9,16,false,true,true,0.975,0.025
418,234,184,17.416667,10.173913,184,1176,1076,100,0,0,0,0,-10,24,23,-5.9,0,0,7,18,false,true,true,1,0
273,171,102,21,14.25,102,1606,1544,62,0,0,0,0,31,13,12,1.451613,0,1,16,6,false,true,true,0.986,0.014
242,208,34,20.166667,18.909091,34,804,988,-184,1,0,0.083333,0,18,12,11,1.833333,1,0,6,19,false,true,false,0.279,0.721
413,335,78,25.8125,20.9375,78,1394,1424,-30,1,1,0.0625,0.0625,-8,16,16,-4,0,0,1,6,true,true,true,1,0
255,228,27,17,16.285714,27,808,812,-4,0,0,0,0,3,15,14,12.333333,1,0,13,11,false,true,true,0.851,0.149
188,96,92,26.857143,16,92,866,949,-83,0,0,0,0,54,7,6,0.740741,0,1,21,9,false,true,true,0.881,0.119
156,113,43,22.285714,16.142857,43,1388,1477,-89,1,0,0.142857,0,49,7,7,0.979592,0,0,15,10,false,true,true,0.846,0.154
64,97,-33,16,24.25,-33,1102,1245,-143,0,0,0,0,62,4,4,0.451613,0,1,18,15,false,true,false,0.226,0.774
268,115,153,22.333333,10.454545,153,1067,95,972,1,0,0.083333,0,25,12,11,1.36,0,0,17,9,false,true,true,1,0
11,28,-17,5.5,28,-17,1554,1622,-68,1,0,0.5,0,88,2,1,0.352273,0,0,15,18,false,true,false,0.318,0.682
324,250,74,20.25,15.625,74,719,651,68,0,1,0,0.0625,7,16,16,6.428571,0,0,8,8,false,true,true,1,0
177,106,71,29.5,21.2,71,880,952,-72,0,0,0,0,60,6,5,0.583333,0,0,15,10,false,true,true,0.938,0.062
185,311,-126,18.5,34.555556,-126,834,844,-10,0,2,0,0.222222,24,10,9,1.5,0,0,7,10,false,true,false,0,1
268,270,-2,22.333333,22.5,-2,1406,1454,-48,0,2,0,0.166667,8,12,12,4.25,1,0,11,9,false,true,true,0.54,0.46
249,308,-59,20.75,25.666667,-59,1501,1473,28,0,0,0,0,15,12,12,2.4,0,1,10,6,false,true,false,0.003,0.997
85,67,18,21.25,16.75,18,1439,1397,42,0,1,0,0.25,68,4,4,0.5,0,0,8,14,false,true,true,0.639,0.361
22,0,22,22,0,22,826,771,55,0,0,0,0,95,1,0,0.473684,0,0,9,0,false,true,true,0.686,0.314
123,49,74,41,24.5,74,1004,840,164,1,0,0.333333,0,75,3,2,0.4,1,0,13,19,false,true,true,0.988,0.012
306,292,14,25.5,24.333333,14,907,752,155,0,1,0,0.083333,15,12,12,2.2,0,0,8,17,false,true,true,0.832,0.168
352,336,16,23.466667,24,16,908,1070,-162,2,0,0.133333,0,-10,15,14,-3,0,0,2,3,false,true,true,0.999,0.001
198,131,67,18,11.909091,67,1069,1040,29,0,0,0,0,23,11,11,1.913043,0,2,8,8,false,true,true,0.987,0.013
313,298,15,24.076923,22.923077,15,1355,1210,145,1,0,0.076923,0,10,13,13,3,1,0,6,8,false,true,true,0.998,0.002
397,298,99,28.357143,21.285714,99,1396,1454,-58,2,0,0.142857,0,1,14,14,33,0,0,9,6,false,true,true,1,0
271,224,47,24.636364,22.4,47,1519,1782,-263,1,0,0.090909,0,25,11,10,1.32,0,0,10,11,false,true,true,0.614,0.386
152,82,70,50.666667,27.333333,70,1397,1361,36,1,0,0.333333,0,74,3,3,0.391892,0,0,10,7,false,true,true,0.845,0.155
133,106,27,22.166667,17.666667,27,1572,1550,22,1,0,0.166667,0,59,6,6,0.661017,0,0,29,10,false,true,true,0.791,0.209
202,163,39,18.363636,14.818182,39,1413,1422,-9,0,0,0,0,32,11,11,1.78125,2,0,15,7,false,true,true,0.989,0.011
28,0,28,28,0,28,1050,1144,-94,0,0,0,0,95,1,0,0.4,0,0,10,0,false,true,false,0.29,0.71
119,108,11,19.833333,18,11,613,461,152,0,0,0,0,56,6,6,0.660714,0,0,8,11,false,true,true,0.731,0.269
241,207,34,24.1,20.7,34,1210,1252,-42,1,0,0.1,0,27,10,10,1.185185,0,0,10,18,false,true,true,0.962,0.038
107,157,-50,21.4,39.25,-50,1431,825,606,0,1,0,0.25,59,5,4,0.576271,1,0,12,16,false,true,true,1,0
294,236,58,21,18.153846,58,1295,1281,14,0,0,0,0,20,14,13,1.9,0,1,7,9,false,true,true,0.858,0.142
356,314,42,16.952381,15.7,42,795,830,-35,1,1,0.047619,0.05,-25,21,20,-1.68,0,0,1,4,false,true,true,1,0
133,89,44,19,14.833333,44,1164,1201,-37,0,0,0,0,56,7,6,0.75,0,1,19,9,false,true,true,0.808,0.192
328,293,35,16.4,15.421053,35,334,446,-112,0,0,0,0,-34,20,19,-1.176471,0,0,2,3,false,true,true,1,0
411,316,95,31.615385,24.307692,95,1197,1127,70,0,0,0,0,-5,13,13,-6,0,0,7,9,false,true,true,1,0
20,0,20,20,0,20,1554,1716,-162,0,0,0,0,95,1,0,0.368421,1,0,6,0,false,true,false,0.311,0.689
255,238,17,21.25,21.636364,17,315,294,21,0,1,0,0.090909,10,12,11,3.5,0,0,17,12,false,true,true,0.923,0.077
96,49,47,32,16.333333,47,742,696,46,0,0,0,0,75,3,3,0.426667,0,1,13,11,false,true,true,0.845,0.155
6,17,-11,6,17,-11,825,907,-82,0,0,0,0,92,1,1,0.434783,1,0,10,10,false,true,false,0.269,0.731
42,41,1,21,20.5,1,1029,1227,-198,0,0,0,0,83,2,2,0.385542,0,0,17,16,false,true,false,0.251,0.749
271,206,65,20.846154,15.846154,65,830,907,-77,1,0,0.076923,0,15,13,13,2.6,0,0,11,13,false,true,true,0.957,0.043
42,27,15,21,13.5,15,1556,1591,-35,0,0,0,0,86,2,2,0.418605,0,0,29,18,false,true,true,0.681,0.319
22,0,22,22,0,22,1875,1793,82,0,0,0,0,98,1,0,0.306122,0,0,14,0,false,true,true,0.689,0.311
403,290,113,25.1875,19.333333,113,996,1063,-67,1,1,0.0625,0.066667,-14,16,15,-2.285714,1,0,2,6,false,true,true,1,0
18,0,18,18,0,18,1571,1554,17,0,0,0,0,97,1,0,0.340206,0,0,12,0,false,true,true,0.679,0.321
321,304,17,17.833333,16.888889,17,942,976,-34,0,0,0,0,-18,18,18,-2.222222,0,0,2,6,false,true,true,1,0
400,217,183,17.391304,9.863636,183,1176,1076,100,0,0,0,0,-4,23,22,-14.75,0,0,10,19,false,true,true,1,0
280,240,40,23.333333,21.818182,40,856,897,-41,0,1,0,0.090909,8,12,11,4.375,0,0,23,10,false,true,true,0.968,0.032
159,98,61,22.714286,16.333333,61,1211,1173,38,0,0,0,0,59,7,6,0.59322,0,1,18,6,false,true,true,0.85,0.15
181,206,-25,15.083333,18.727273,-25,262,306,-44,0,0,0,0,27,12,11,1.703704,0,0,12,11,false,true,false,0.095,0.905
341,326,15,17.05,16.3,15,1388,1477,-89,1,0,0.05,0,-22,20,20,-2.181818,1,0,3,7,false,true,true,1,0
215,216,-1,26.875,27,-1,1096,1009,87,1,0,0.125,0,52,8,8,0.846154,0,0,11,13,false,true,true,0.514,0.486
72,82,-10,12,16.4,-10,580,620,-40,0,0,0,0,68,6,5,0.632353,1,0,15,11,false,true,false,0.348,0.652
14,0,14,14,0,14,671,725,-54,0,0,0,0,96,1,0,0.385417,0,0,10,0,false,true,false,0.254,0.746
168,150,18,21,18.75,18,1073,1177,-104,0,0,0,0,45,8,8,0.711111,0,0,9,17,false,true,false,0.278,0.722
91,78,13,15.166667,13,13,491,398,93,0,0,0,0,66,6,6,0.545455,0,1,10,16,false,true,false,0.438,0.562
90,35,55,22.5,11.666667,55,527,503,24,0,0,0,0,79,4,3,0.518987,0,0,16,10,false,true,true,0.909,0.091
133,127,6,22.166667,21.166667,6,758,796,-38,0,0,0,0,54,6,6,0.703704,0,0,16,7,false,true,true,0.678,0.322
58,14,44,29,14,44,1127,1176,-49,0,0,0,0,86,2,1,0.488372,0,0,17,11,false,true,true,0.72,0.28
165,94,71,27.5,15.666667,71,1334,1256,78,1,0,0.166667,0,59,6,6,0.525424,0,0,13,9,false,true,true,0.941,0.059
352,290,62,19.555556,17.058824,62,719,785,-66,0,1,0,0.058824,-15,18,17,-2.4,0,0,4,2,false,true,true,1,0
69,78,-9,13.8,15.6,-9,954,1078,-124,0,1,0,0.2,62,5,5,0.612903,1,0,25,10,false,true,true,0.829,0.171
239,207,32,26.555556,23,32,1189,1266,-77,1,0,0.111111,0,33,9,9,1.030303,0,0,14,14,false,true,true,0.92,0.08
235,212,23,16.785714,15.142857,23,916,876,40,0,0,0,0,-2,14,14,-17,2,0,15,21,false,true,true,0.978,0.022
87,93,-6,14.5,18.6,-6,825,907,-82,0,0,0,0,65,6,5,0.615385,2,0,5,11,false,true,true,0.894,0.106
99,71,28,11,8.875,28,310,359,-49,0,0,0,0,40,9,8,1.225,1,0,6,20,false,true,true,0.7,0.3
183,150,33,20.333333,16.666667,33,1127,1176,-49,0,0,0,0,36,9,9,1.166667,0,0,9,12,false,true,true,0.831,0.169
167,125,42,20.875,15.625,42,609,620,-11,0,0,0,0,45,8,8,0.822222,0,1,13,9,false,true,true,0.617,0.383
260,224,36,18.571429,16,36,804,683,121,0,0,0,0,14,14,14,3.214286,0,1,12,9,false,true,true,0.899,0.101
199,160,39,28.428571,22.857143,39,695,671,24,0,0,0,0,45,7,7,0.733333,0,0,9,13,false,true,true,0.958,0.042
33,43,-10,16.5,21.5,-10,1167,1216,-49,0,0,0,0,84,2,2,0.488095,1,0,8,16,false,true,true,0.672,0.328
334,240,94,22.266667,17.142857,94,1731,1691,40,1,0,0.066667,0,-5,15,14,-6.8,0,0,8,26,false,true,true,1,0
315,304,11,16.578947,16,11,527,514,13,0,0,0,0,-18,19,19,-2.166667,0,0,3,1,false,true,true,0.903,0.097
288,289,-1,22.153846,24.083333,-1,1127,1134,-7,0,1,0,0.083333,5,13,12,6,0,0,10,15,false,true,false,0.306,0.694
148,90,58,24.666667,15,58,960,1070,-110,1,0,0.166667,0,57,6,6,0.614035,0,0,21,17,false,true,true,0.842,0.158
204,229,-25,17,20.818182,-25,316,306,10,0,2,0,0.181818,20,12,11,1.9,0,0,11,21,false,true,true,0.993,0.007
283,134,149,21.769231,11.166667,149,925,801,124,1,0,0.076923,0,24,13,12,1.666667,1,0,9,25,false,true,true,1,0
68,43,25,22.666667,21.5,25,290,416,-126,0,0,0,0,81,3,2,0.419753,0,0,14,12,false,true,false,0.272,0.728
20,0,20,20,0,20,1047,1094,-47,0,0,0,0,96,1,0,0.375,0,0,13,0,false,true,true,0.519,0.481
108,30,78,36,10,78,1004,653,351,0,0,0,0,71,3,3,0.492958,0,0,9,12,false,true,true,0.862,0.138
217,177,40,19.727273,17.7,40,791,774,17,1,0,0.090909,0,40,11,10,1.025,0,0,11,11,false,true,true,0.841,0.159
272,189,83,20.923077,15.75,83,1159,1031,128,1,0,0.076923,0,10,13,12,3.9,0,0,7,14,false,true,true,1,0
307,277,30,23.615385,21.307692,30,976,965,11,1,0,0.076923,0,-1,13,13,-32,1,0,9,9,false,true,true,0.999,0.001
395,296,99,28.214286,22.769231,99,1093,1100,-7,3,3,0.214286,0.230769,-2,14,13,-16,0,1,7,7,false,true,true,1,0
204,170,34,15.692308,13.076923,34,691,675,16,0,0,0,0,13,13,13,2.923077,0,0,13,19,false,true,true,0.899,0.101
352,285,67,16.761905,14.25,67,1253,1166,87,1,0,0.047619,0,-24,21,20,-1.791667,0,0,1,2,false,true,true,1,0
166,133,33,27.666667,22.166667,33,1170,1156,14,1,0,0.166667,0,58,6,6,0.655172,0,0,18,17,false,true,true,0.905,0.095
26,0,26,26,0,26,1890,2020,-130,0,0,0,0,95,1,0,0.305263,0,0,15,0,false,true,true,0.675,0.325
179,114,65,17.9,12.666667,65,1281,1339,-58,0,0,0,0,48,10,9,0.854167,1,1,14,9,false,true,true,0.928,0.072
403,288,115,25.1875,18,115,1489,1445,44,1,0,0.0625,0,-11,16,16,-2.909091,0,0,2,4,true,true,true,1,0
67,26,41,22.333333,13,41,262,306,-44,0,0,0,0,87,3,2,0.528736,0,0,14,14,false,true,true,0.656,0.344
217,167,50,14.466667,11.928571,50,1016,1037,-21,0,0,0,0,17,15,14,2.823529,1,0,11,26,false,true,true,0.6,0.4
327,279,48,19.235294,17.4375,48,1075,989,86,1,0,0.058824,0,2,17,16,19.5,0,0,15,12,false,true,true,1,0
358,327,31,19.888889,18.166667,31,1710,1636,74,1,1,0.055556,0.055556,-18,18,18,-2,0,0,1,2,true,true,true,1,0
103,49,54,25.75,12.25,54,1014,948,66,0,0,0,0,72,4,4,0.458333,0,1,17,17,false,true,true,0.847,0.153
312,268,44,24,20.615385,44,904,668,236,0,0,0,0,-8,13,13,-4.25,0,0,11,8,false,true,true,0.999,0.001
232,188,44,29,26.857143,44,908,1070,-162,1,0,0.125,0,42,8,7,0.714286,0,0,10,12,false,true,true,0.686,0.314
341,309,32,28.416667,25.75,32,1793,1897,-104,2,0,0.166667,0,8,12,12,3.75,0,0,14,8,false,true,true,1,0
319,246,73,21.266667,16.4,73,859,811,48,0,0,0,0,-1,15,15,-36,1,1,9,11,false,true,true,1,0
151,124,27,21.571429,17.714286,27,825,907,-82,1,0,0.142857,0,53,7,7,0.754717,0,0,18,8,false,true,true,0.789,0.211
302,212,90,23.230769,16.307692,90,580,620,-40,1,0,0.076923,0,17,13,13,2.529412,0,0,11,14,false,true,true,1,0
220,139,81,22,13.9,81,1033,1037,-4,0,1,0,0.1,35,10,10,1.285714,0,0,26,10,false,true,true,0.971,0.029
271,243,28,19.357143,18.692308,28,1176,1127,49,0,0,0,0,5,14,13,7.4,0,0,14,15,false,true,true,0.603,0.397
26,49,-23,13,24.5,-23,1606,1544,62,0,0,0,0,90,2,2,0.5,1,0,14,7,false,true,true,0.884,0.116
283,141,142,28.3,14.1,142,1211,1173,38,0,0,0,0,37,10,10,0.945946,0,1,12,15,false,true,true,1,0
296,300,-4,29.6,30,-4,1265,1237,28,1,0,0.1,0,15,10,10,2,0,1,9,21,false,true,false,0.02,0.98
218,141,77,36.333333,23.5,77,1571,1554,17,2,1,0.333333,0.166667,46,6,6,0.717391,0,0,7,8,false,true,true,0.97,0.03
336,307,29,22.4,21.928571,29,1096,1009,87,2,0,0.133333,0,16,15,14,2.75,0,0,7,8,false,true,true,0.992,0.008
135,69,66,22.5,13.8,66,859,811,48,0,0,0,0,60,6,5,0.6,0,0,12,17,false,true,true,0.924,0.076
255,169,86,36.428571,24.142857,86,1397,1361,36,1,0,0.142857,0,40,7,7,0.725,0,0,11,7,false,true,true,0.991,0.009
359,283,76,18.894737,15.722222,76,505,95,410,0,1,0,0.055556,-10,19,18,-4.4,0,0,5,12,false,true,true,1,0
157,157,0,17.444444,17.444444,0,613,549,64,0,0,0,0,37,9,9,1.189189,0,1,17,17,false,true,false,0.242,0.758
331,316,15,15.045455,14.363636,15,1030,1045,-15,1,1,0.045455,0.045455,-33,22,22,-1.393939,0,0,1,4,false,true,true,1,0
280,261,19,23.333333,21.75,19,856,897,-41,0,1,0,0.083333,5,12,12,7,0,0,23,8,false,true,true,0.965,0.035
70,81,-11,23.333333,27,-11,1096,1009,87,0,0,0,0,85,3,3,0.517647,1,0,21,12,false,true,true,0.925,0.075
260,145,115,21.666667,13.181818,115,1606,1544,62,0,0,0,0,36,12,11,1.25,0,1,9,9,false,true,true,0.99,0.01
207,221,-14,15.923077,17,-14,361,493,-132,1,0,0.076923,0,3,13,13,13.666667,0,0,7,23,false,true,false,0.321,0.679
35,32,3,11.666667,10.666667,3,721,689,32,0,0,0,0,74,3,3,0.459459,0,0,14,14,false,true,true,0.683,0.317
148,193,-45,18.5,24.125,-45,1519,1782,-263,0,0,0,0,45,8,8,0.733333,1,0,7,7,false,true,false,0.13,0.87
258,183,75,23.454545,18.3,75,1110,1039,71,0,0,0,0,23,11,10,1.565217,0,0,16,13,false,true,true,0.972,0.028
130,84,46,18.571429,14,46,527,503,24,0,0,0,0,64,7,6,0.640625,0,0,21,15,false,true,true,0.894,0.106
107,46,61,35.666667,23,61,1550,1466,84,1,0,0.333333,0,79,3,2,0.468354,0,0,9,24,false,true,true,0.727,0.273
267,274,-7,14.833333,16.117647,-7,576,494,82,0,0,0,0,-6,18,17,-7.333333,0,1,10,6,false,true,false,0.297,0.703
335,285,50,23.928571,20.357143,50,1014,1303,-289,1,0,0.071429,0,-2,14,14,-19,0,0,7,18,false,true,true,1,0
73,51,22,24.333333,17,22,1127,1134,-7,0,0,0,0,75,3,3,0.4,1,0,14,15,false,true,true,0.752,0.248
211,148,63,26.375,18.5,63,1051,1030,21,0,0,0,0,40,8,8,0.75,0,0,16,10,false,true,true,0.964,0.036
277,192,85,13.85,10.105263,85,416,222,194,0,0,0,0,-11,20,19,-5,0,0,9,26,false,true,true,1,0
49,104,-55,12.25,26,-55,1554,1622,-68,1,0,0.25,0,68,4,4,0.455882,0,1,10,7,false,true,false,0.268,0.732
14,0,14,14,0,14,1040,925,115,0,0,0,0,96,1,0,0.447917,0,0,16,0,false,true,true,0.68,0.32
14,0,14,14,0,14,1501,1473,28,0,0,0,0,96,1,0,0.375,0,0,21,0,false,true,true,0.678,0.322
236,176,60,26.222222,19.555556,60,1216,1217,-1,1,0,0.111111,0,33,9,9,1.030303,1,0,7,20,false,true,true,0.991,0.009
46,25,21,23,25,21,786,976,-190,0,0,0,0,89,2,1,0.359551,0,0,7,10,false,true,false,0.251,0.749
14,0,14,14,0,14,1093,1197,-104,0,0,0,0,97,1,0,0.319588,0,0,15,0,false,true,false,0.255,0.745
267,204,63,17.8,14.571429,63,758,750,8,0,0,0,0,3,15,14,12.333333,0,1,10,7,false,true,true,0.984,0.016
165,109,56,20.625,15.571429,56,1164,1201,-37,0,0,0,0,49,8,7,0.857143,0,1,10,11,false,true,true,0.811,0.189
150,58,92,21.428571,9.666667,92,1413,1422,-9,0,0,0,0,56,7,6,1.017857,2,0,13,16,false,true,true,0.994,0.006
176,159,17,17.6,15.9,17,864,808,56,1,0,0.1,0,23,10,10,1.478261,0,1,14,6,false,true,true,0.845,0.155
157,143,14,22.428571,20.428571,14,613,569,44,0,0,0,0,49,7,7,0.795918,2,0,6,8,false,true,true,0.969,0.031
317,270,47,17.611111,15.882353,47,334,446,-112,0,0,0,0,-21,18,17,-1.904762,0,1,4,11,false,true,true,0.996,0.004
283,186,97,17.6875,12.4,97,913,871,42,0,0,0,0,7,16,15,6.142857,0,0,9,22,false,true,true,1,0
81,96,-15,13.5,19.2,-15,576,494,82,0,0,0,0,66,6,5,0.666667,0,0,10,18,false,true,false,0.155,0.845
193,140,53,24.125,17.5,53,746,796,-50,0,1,0,0.125,38,8,8,1.263158,0,0,11,11,false,true,true,0.97,0.03
360,291,69,18.947368,15.315789,69,939,913,26,0,1,0,0.052632,-22,19,19,-1.818182,1,0,0,1,false,true,true,1,0
38,55,-17,9.5,18.333333,-17,218,86,132,0,0,0,0,73,4,3,0.547945,0,0,17,7,false,true,true,0.674,0.326
117,99,18,16.714286,14.142857,18,371,435,-64,0,0,0,0,47,7,7,0.93617,0,0,14,9,false,true,true,0.691,0.309
221,228,-7,15.785714,17.538462,-7,527,514,13,0,0,0,0,3,14,13,13,0,0,12,11,false,true,false,0.426,0.574
98,87,11,19.6,21.75,11,1826,1656,170,0,0,0,0,66,5,4,0.409091,0,0,10,11,false,true,false,0.354,0.646
449,312,137,28.0625,19.5,137,1519,1782,-263,2,0,0.125,0,-12,16,16,-2.75,0,0,2,2,false,true,true,1,0
200,162,38,22.222222,20.25,38,1334,1270,64,1,0,0.111111,0,41,9,8,0.902439,0,0,17,7,false,true,true,0.84,0.16
137,119,18,19.571429,19.833333,18,872,818,54,0,1,0,0.166667,56,7,6,0.732143,0,0,7,8,false,true,true,0.639,0.361
191,216,-25,17.363636,19.636364,-25,1077,1094,-17,0,0,0,0,29,11,11,1.448276,0,0,7,9,false,true,false,0.123,0.877
325,202,123,21.666667,14.428571,123,1011,921,90,1,0,0.066667,0,11,15,14,4.454545,1,0,9,10,false,true,true,1,0
89,108,-19,22.25,27,-19,1710,1636,74,0,0,0,0,72,4,4,0.5,0,0,7,8,false,true,false,0.215,0.785
137,121,16,19.571429,17.285714,16,872,818,54,0,1,0,0.142857,54,7,7,0.759259,0,0,7,11,false,true,true,0.794,0.206
331,250,81,15.761905,11.904762,81,1128,889,239,0,1,0,0.047619,-22,21,21,-2.136364,0,0,4,2,false,true,true,1,0
18,37,-19,9,18.5,-19,1221,1258,-37,0,0,0,0,88,2,2,0.443182,0,0,13,10,false,true,true,0.641,0.359
109,96,13,36.333333,32,13,1348,1331,17,0,0,0,0,70,3,3,0.342857,1,0,12,21,false,true,true,0.929,0.071
67,41,26,16.75,10.25,26,584,565,19,0,0,0,0,72,4,4,0.638889,0,0,16,22,false,true,true,0.796,0.204
291,270,21,15.315789,14.210526,21,272,238,34,0,1,0,0.052632,-28,19,19,-1.428571,0,0,7,1,false,true,true,0.848,0.152
111,79,32,18.5,15.8,32,698,742,-44,0,0,0,0,70,6,5,0.585714,0,0,10,14,false,true,false,0.336,0.664
142,90,52,17.75,12.857143,52,1069,1040,29,0,0,0,0,46,8,7,0.956522,0,2,9,6,false,true,true,0.977,0.023
323,267,56,14.681818,12.136364,56,1016,1037,-21,0,0,0,0,-19,22,22,-2.526316,0,0,4,12,false,true,true,1,0
96,70,26,32,35,26,1489,1558,-69,0,1,0,0.5,74,3,2,0.378378,0,0,20,14,false,true,true,0.675,0.325
153,151,2,15.3,16.777778,2,908,859,49,0,0,0,0,38,10,9,1.026316,0,1,14,7,false,true,false,0.238,0.762
308,165,143,25.666667,15,143,742,696,46,0,0,0,0,16,12,11,2,0,0,15,16,false,true,true,1,0
116,73,43,19.333333,12.166667,43,1277,1166,111,0,0,0,0,61,6,6,0.590164,0,2,10,8,false,true,true,0.915,0.085
211,199,12,35.166667,33.166667,12,1333,1331,2,1,0,0.166667,0,47,6,6,0.638298,0,0,9,8,false,true,true,0.679,0.321
186,134,52,37.2,26.8,52,1571,1554,17,2,1,0.4,0.2,55,5,5,0.6,0,0,9,8,false,true,true,0.949,0.051
80,28,52,20,9.333333,52,901,889,12,0,0,0,0,82,4,3,0.52439,1,1,8,9,false,true,true,0.56,0.44
250,225,25,16.666667,16.071429,25,904,857,47,0,0,0,0,6,15,14,6.833333,1,0,15,9,false,true,true,0.755,0.245
0,18,-18,0,18,-18,1144,1014,130,0,0,0,0,97,1,1,0.371134,0,0,10,9,false,true,false,0.256,0.744
61,69,-8,15.25,17.25,-8,1050,1144,-94,0,0,0,0,75,4,4,0.506667,0,0,7,9,false,true,false,0.26,0.74
112,156,-44,12.444444,17.333333,-44,576,494,82,0,0,0,0,43,9,9,1.023256,1,0,15,10,false,true,false,0.305,0.695
340,307,33,30.909091,30.7,33,1489,1558,-69,0,1,0,0.1,14,11,10,2,0,1,17,6,false,true,false,0.396,0.604
181,143,38,22.625,20.428571,38,613,569,44,0,0,0,0,43,8,7,0.906977,2,0,14,8,false,true,true,0.975,0.025
397,338,59,30.538462,26,59,1237,1277,-40,0,0,0,0,-10,13,13,-2.9,0,0,9,1,false,true,true,1,0
321,202,119,22.928571,14.428571,119,1011,921,90,1,0,0.071429,0,13,14,14,3.769231,1,0,9,10,false,true,true,1,0
72,42,30,14.4,10.5,30,719,614,105,0,0,0,0,69,5,4,0.623188,0,2,10,10,false,true,true,0.801,0.199
146,130,16,29.2,26,16,1782,1512,270,1,1,0.2,0.2,64,5,5,0.65625,0,0,13,10,false,true,true,1,0
346,279,67,21.625,17.4375,67,859,811,48,0,0,0,0,-10,16,16,-3.6,0,1,7,4,false,true,true,1,0
207,229,-22,20.7,25.444444,-22,1434,1493,-59,1,0,0.1,0,24,10,9,1.541667,1,1,19,10,false,true,false,0.066,0.934
397,328,69,30.538462,27.333333,69,1237,1277,-40,0,0,0,0,-7,13,12,-4.142857,0,0,9,3,false,true,true,1,0
6,0,6,6,0,6,904,783,121,0,0,0,0,97,1,0,0.43299,0,0,19,0,false,true,true,0.679,0.321
124,100,24,20.666667,16.666667,24,1037,950,87,1,0,0.166667,0,58,6,6,0.534483,0,0,14,17,false,true,true,0.846,0.154
357,291,66,16.227273,13.227273,66,416,374,42,0,0,0,0,-23,22,22,-2,0,0,1,1,false,true,true,1,0
175,118,57,25,19.666667,57,1034,1040,-6,0,0,0,0,54,7,6,0.648148,0,1,14,9,false,true,true,0.842,0.158
189,139,50,18.9,13.9,50,871,867,4,0,0,0,0,36,10,10,1.194444,0,0,10,10,false,true,true,0.967,0.033
217,231,-14,19.727273,23.1,-14,869,820,49,0,1,0,0.1,31,11,10,1.193548,0,1,11,6,false,true,false,0.202,0.798
19,22,-3,9.5,11,-3,613,461,152,0,0,0,0,85,2,2,0.435294,1,0,6,20,false,true,true,0.72,0.28
84,53,31,28,17.666667,31,901,1159,-258,1,0,0.333333,0,79,3,3,0.443038,1,0,6,18,false,true,true,0.624,0.376
39,25,14,13,12.5,14,847,952,-105,0,0,0,0,89,3,2,0.404494,0,0,20,19,false,true,false,0.252,0.748
151,72,79,15.1,7.2,79,1428,1302,126,0,0,0,0,42,10,10,1.261905,0,1,15,15,false,true,true,0.859,0.141
53,53,0,13.25,13.25,0,1519,1782,-263,0,0,0,0,79,4,4,0.417722,0,1,15,6,false,true,false,0.251,0.749
143,140,3,14.3,14,3,416,374,42,0,0,0,0,44,10,10,1.045455,1,0,6,10,false,true,true,0.71,0.29
151,106,45,21.571429,17.666667,45,825,907,-82,1,0,0.142857,0,55,7,6,0.727273,0,0,18,11,false,true,true,0.806,0.194
299,244,55,19.933333,16.266667,55,880,952,-72,0,0,0,0,-1,15,15,-41,0,0,20,11,false,true,true,0.998,0.002
184,61,123,23,8.714286,123,896,818,78,0,0,0,0,62,8,7,0.709677,0,0,12,7,false,true,true,0.97,0.03
49,45,4,16.333333,15,4,620,658,-38,0,0,0,0,80,3,3,0.45,1,0,7,11,false,true,false,0.369,0.631
301,212,89,21.5,16.307692,89,1170,1156,14,1,0,0.071429,0,7,14,13,5.428571,0,0,8,10,false,true,true,1,0
247,168,79,35.285714,28,79,1890,2020,-130,1,1,0.142857,0.166667,39,7,6,0.74359,0,0,13,12,false,true,true,0.883,0.117
157,234,-77,14.272727,21.272727,-77,613,611,2,0,0,0,0,20,11,11,1.9,1,0,16,7,false,true,false,0.129,0.871
226,154,72,22.6,15.4,72,1253,1166,87,1,0,0.1,0,38,10,10,1.131579,0,0,8,23,false,true,true,0.981,0.019
271,193,78,30.111111,21.444444,78,1431,825,606,1,1,0.111111,0.111111,26,9,9,1.307692,0,0,17,16,false,true,true,1,0
134,60,74,33.5,20,74,791,885,-94,1,0,0.25,0,70,4,3,0.542857,0,0,21,12,false,true,true,0.861,0.139
134,58,76,22.333333,9.666667,76,1413,1422,-9,0,0,0,0,59,6,6,0.966102,2,0,16,16,false,true,true,0.994,0.006
156,129,27,19.5,18.428571,27,1305,1390,-85,0,0,0,0,49,8,7,0.734694,0,0,10,18,false,true,false,0.349,0.651
300,237,63,27.272727,21.545455,63,1556,1591,-35,1,0,0.090909,0,18,11,11,2,0,0,15,7,false,true,true,0.999,0.001
24,19,5,12,9.5,5,468,542,-74,0,0,0,0,88,2,2,0.443182,0,0,21,14,false,true,false,0.26,0.74
263,278,-15,16.4375,18.533333,-15,316,306,10,0,2,0,0.133333,-3,16,15,-12.666667,0,0,10,15,false,true,true,0.983,0.017
177,161,16,25.285714,23,16,1078,1130,-52,0,1,0,0.142857,50,7,7,0.78,0,0,7,7,false,true,true,0.776,0.224
74,27,47,37,13.5,47,1075,1152,-77,0,0,0,0,82,2,2,0.487805,0,1,16,16,false,true,true,0.57,0.43
311,183,128,20.733333,13.071429,128,925,801,124,1,0,0.066667,0,9,15,14,4.444444,0,0,7,10,false,true,true,1,0
358,265,93,18.842105,14.722222,93,719,651,68,0,1,0,0.055556,-11,19,18,-4.090909,0,0,7,10,false,true,true,1,0
165,46,119,55,23,119,1349,1302,47,0,0,0,0,76,3,2,0.381579,0,0,14,8,false,true,true,0.894,0.106
391,314,77,27.928571,24.153846,77,1333,1331,2,1,0,0.071429,0,-11,14,13,-2.727273,0,0,3,8,false,true,true,1,0
163,110,53,18.111111,13.75,53,1048,1000,48,0,0,0,0,47,9,8,0.851064,0,1,8,21,false,true,true,0.536,0.464
50,0,50,50,0,50,1127,1176,-49,0,0,0,0,95,1,0,0.442105,0,0,15,0,false,true,true,0.791,0.209
275,122,153,34.375,15.25,153,918,619,299,2,0,0.25,0,42,8,8,0.833333,1,0,9,13,false,true,true,1,0
122,163,-41,13.555556,18.111111,-41,272,238,34,0,0,0,0,40,9,9,1,0,0,17,9,false,true,false,0.076,0.924
233,202,31,25.888889,22.444444,31,1034,1040,-6,1,0,0.111111,0,32,9,9,1.09375,1,0,6,15,false,true,true,0.923,0.077
388,297,91,27.714286,21.214286,91,1550,1546,4,0,1,0,0.071429,2,14,14,15,1,0,7,7,false,true,true,1,0
163,142,21,16.3,14.2,21,448,598,-150,0,0,0,0,30,10,10,1.2,1,0,13,11,false,true,true,0.713,0.287
80,67,13,16,16.75,13,1176,1127,49,0,0,0,0,68,5,4,0.544118,0,0,11,8,false,true,true,0.673,0.327
233,171,62,29.125,21.375,62,1731,1691,40,1,0,0.125,0,36,8,8,0.944444,0,0,8,8,false,true,true,0.856,0.144
249,299,-50,20.75,24.916667,-50,1076,1176,-100,0,1,0,0.083333,12,12,12,2.666667,0,0,18,10,false,true,false,0.02,0.98
142,98,44,20.285714,16.333333,44,808,812,-4,0,0,0,0,49,7,6,0.755102,1,0,18,26,false,true,true,0.929,0.071
84,69,15,16.8,13.8,15,808,812,-4,0,0,0,0,61,5,5,0.606557,0,1,16,9,false,true,true,0.744,0.256
247,274,-27,14.529412,17.125,-27,576,494,82,0,0,0,0,-3,17,16,-14.666667,0,1,9,6,false,true,false,0.013,0.987
212,213,-1,26.5,26.625,-1,1030,1144,-114,0,1,0,0.125,44,8,8,0.795455,0,1,15,7,false,true,false,0.221,0.779
363,294,69,22.6875,19.6,69,1302,1234,68,1,1,0.0625,0.066667,-11,16,15,-2.818182,0,0,4,2,true,true,true,1,0
330,216,114,30,19.636364,114,1334,1256,78,2,0,0.181818,0,18,11,11,1.722222,0,0,7,9,false,true,true,1,0
26,23,3,13,11.5,3,1210,1253,-43,0,0,0,0,85,2,2,0.4,1,0,9,10,false,true,true,0.676,0.324
129,52,77,32.25,13,77,942,1003,-61,0,0,0,0,70,4,4,0.642857,0,0,7,16,false,true,true,0.91,0.09
366,323,43,24.4,23.071429,43,1154,1062,92,2,0,0.133333,0,2,15,14,17.5,0,0,6,6,false,true,true,1,0
322,267,55,20.125,16.6875,55,1551,1550,1,0,0,0,0,-8,16,16,-5.25,0,1,12,9,false,true,true,1,0
129,132,-3,16.125,16.5,-3,1043,1055,-12,0,0,0,0,46,8,8,0.804348,1,0,22,14,false,true,true,0.817,0.183
55,62,-7,27.5,31,-7,1431,802,629,0,0,0,0,81,2,2,0.395062,0,1,18,10,false,true,true,1,0
364,320,44,21.411765,20,44,1397,1422,-25,3,1,0.176471,0.0625,-2,17,16,-18,0,0,8,16,false,true,true,0.999,0.001
35,13,22,17.5,13,22,527,503,24,0,0,0,0,88,2,1,0.465909,2,0,11,7,false,true,true,0.987,0.013
22,0,22,22,0,22,999,1011,-12,0,0,0,0,95,1,0,0.484211,0,0,10,0,false,true,true,0.668,0.332
344,243,101,21.5,16.2,101,1394,1230,164,0,1,0,0.066667,-6,16,15,-6.333333,0,0,21,22,false,true,true,1,0
376,248,128,25.066667,17.714286,128,695,671,24,0,0,0,0,0,15,14,0,0,1,9,13,false,true,true,1,0
190,187,3,19,20.777778,3,838,786,52,0,1,0,0.111111,32,10,9,1,1,0,13,7,false,true,true,0.767,0.233
183,150,33,16.636364,13.636364,33,947,909,38,0,0,0,0,26,11,11,1.769231,0,0,7,32,false,true,true,0.777,0.223
182,150,32,18.2,16.666667,32,416,306,110,0,0,0,0,36,10,9,1.166667,0,0,14,8,false,true,true,0.965,0.035
345,250,95,20.294118,15.625,95,719,651,68,0,1,0,0.0625,4,17,16,11.25,0,0,10,8,false,true,true,1,0
322,208,114,20.125,13,114,1281,1339,-58,0,0,0,0,9,16,16,4.555556,0,0,13,8,false,true,true,1,0
259,239,20,17.266667,17.071429,20,658,817,-159,0,0,0,0,13,15,14,2.923077,1,0,8,14,false,true,false,0.438,0.562
144,111,33,20.571429,15.857143,33,1027,856,171,1,0,0.142857,0,44,7,7,0.75,0,1,9,10,false,true,true,0.846,0.154
104,52,52,34.666667,17.333333,52,1216,1230,-14,1,0,0.333333,0,75,3,3,0.426667,0,0,20,7,false,true,true,0.829,0.171
338,276,62,16.095238,13.142857,62,892,768,124,0,0,0,0,-17,21,21,-2.529412,0,0,5,4,false,true,true,1,0
127,130,-3,21.166667,21.666667,-3,926,854,72,0,0,0,0,64,6,6,0.53125,0,0,18,9,false,true,true,0.625,0.375
214,181,33,21.4,20.111111,33,941,926,15,1,0,0.1,0,34,10,9,1.117647,1,0,20,7,false,true,true,0.939,0.061
157,123,34,31.4,24.6,34,948,933,15,1,0,0.2,0,65,5,5,0.584615,0,0,7,8,false,true,true,0.848,0.152
53,43,10,17.666667,21.5,10,1659,1782,-123,0,0,0,0,83,3,2,0.349398,0,0,9,13,false,true,true,0.618,0.382
26,0,26,26,0,26,1302,1082,220,0,0,0,0,95,1,0,0.315789,0,0,9,0,false,true,true,0.694,0.306
296,291,5,18.5,18.1875,5,1214,1176,38,0,0,0,0,3,16,16,12,0,0,13,7,false,true,true,0.713,0.287
227,182,45,18.916667,15.166667,45,786,788,-2,0,0,0,0,10,12,12,3.4,1,1,9,12,false,true,true,0.983,0.017
84,23,61,28,11.5,61,1295,1477,-182,1,0,0.333333,0,83,3,2,0.554217,1,0,10,9,false,true,false,0.465,0.535
395,283,112,28.214286,21.769231,112,1189,1266,-77,1,0,0.071429,0,-4,14,13,-8.5,0,0,14,4,false,true,true,1,0
74,52,22,24.666667,17.333333,22,1022,1095,-73,0,0,0,0,78,3,3,0.423077,0,0,28,9,false,true,true,0.705,0.295
312,155,157,34.666667,19.375,157,1684,1320,364,1,0,0.111111,0,27,9,8,1.111111,0,1,9,15,false,true,true,1,0
0,18,-18,0,18,-18,791,774,17,0,0,0,0,97,1,1,0.42268,0,0,14,15,false,true,false,0.296,0.704
32,49,-17,10.666667,16.333333,-17,613,461,152,0,0,0,0,78,3,3,0.474359,1,1,15,13,false,true,true,0.585,0.415
189,230,-41,27,38.333333,-41,1636,1576,60,0,2,0,0.333333,40,7,6,0.85,0,0,12,21,false,true,false,0.113,0.887
222,163,59,22.2,16.3,59,518,533,-15,1,0,0.1,0,26,10,10,1.346154,1,0,14,10,false,true,true,0.968,0.032
12,0,12,12,0,12,885,719,166,0,0,0,0,97,1,0,0.391753,0,0,22,0,false,true,true,0.682,0.318
282,202,80,21.692308,16.833333,80,1022,1095,-73,0,0,0,0,7,13,12,4.714286,0,1,16,8,false,true,true,0.987,0.013
265,183,82,20.384615,15.25,82,576,532,44,0,0,0,0,21,13,12,2.190476,0,0,12,7,false,true,true,0.973,0.027
297,302,-5,14.142857,15.1,-5,613,549,64,0,0,0,0,-32,21,20,-1.375,0,0,1,1,false,true,false,0.496,0.504
148,165,-17,16.444444,18.333333,-17,527,514,13,0,0,0,0,36,9,9,1.083333,0,0,8,14,false,true,false,0.162,0.838
256,226,30,23.272727,20.545455,30,948,933,15,1,0,0.090909,0,32,11,11,1.1875,0,0,7,15,false,true,true,0.839,0.161
261,177,84,23.727273,17.7,84,1305,1390,-85,0,1,0,0.1,21,11,10,1.714286,0,1,10,22,false,true,true,0.841,0.159
200,133,67,22.222222,14.777778,67,1551,1550,1,0,0,0,0,40,9,9,1.05,0,1,8,17,false,true,true,0.837,0.163
287,217,70,13.666667,10.333333,70,416,222,194,0,0,0,0,-18,21,21,-3.055556,0,0,21,13,false,true,true,1,0
426,193,233,35.5,17.545455,233,1431,825,606,2,1,0.166667,0.090909,12,12,11,2.833333,0,0,9,16,false,true,true,1,0
99,81,18,24.75,20.25,18,1397,1195,202,0,0,0,0,71,4,4,0.492958,0,0,11,18,false,true,false,0.301,0.699
145,114,31,20.714286,19,31,505,95,410,0,1,0,0.166667,66,7,6,0.666667,0,0,14,8,false,true,true,1,0
221,177,44,27.625,25.285714,44,974,995,-21,0,1,0,0.142857,39,8,7,0.846154,0,0,21,15,false,true,true,0.964,0.036
22,26,-4,22,26,-4,826,771,55,0,0,0,0,92,1,1,0.48913,0,0,9,9,false,true,true,0.678,0.322
78,65,13,26,21.666667,13,1364,1093,271,0,0,0,0,77,3,3,0.493506,0,1,15,6,false,true,true,0.673,0.327
210,209,1,16.153846,17.416667,1,613,549,64,0,0,0,0,19,13,12,2.315789,1,0,11,13,false,true,true,0.592,0.408
86,49,37,21.5,16.333333,37,1691,1692,-1,0,0,0,0,69,4,3,0.434783,0,0,13,14,false,true,true,0.685,0.315
40,34,6,20,17,6,1034,1040,-6,0,0,0,0,86,2,2,0.406977,0,0,21,10,false,true,true,0.68,0.32
109,49,60,27.25,16.333333,60,1127,1176,-49,0,0,0,0,73,4,3,0.575342,0,0,14,12,false,true,true,0.825,0.175
196,203,-7,19.6,22.555556,-7,1277,1166,111,0,1,0,0.111111,34,10,9,1.058824,0,0,10,9,false,true,false,0.186,0.814
149,213,-64,18.625,30.428571,-64,1265,1045,220,0,1,0,0.142857,38,8,7,1.105263,0,0,18,10,false,true,false,0.144,0.856
229,186,43,28.625,23.25,43,1101,1078,23,0,0,0,0,42,8,8,0.785714,0,1,8,7,false,true,true,0.848,0.152
347,278,69,15.086957,12.636364,69,272,288,-16,0,0,0,0,-24,23,22,-2.166667,0,0,2,2,false,true,true,1,0
174,144,30,17.4,16,30,695,523,172,0,0,0,0,27,10,9,1.37037,0,0,12,26,false,true,true,0.676,0.324
342,236,106,31.090909,23.6,106,1093,1100,-7,3,2,0.272727,0.2,25,11,10,1.28,0,0,14,9,false,true,true,1,0
269,184,85,20.692308,15.333333,85,1055,1050,5,0,0,0,0,17,13,12,2,1,0,16,13,false,true,true,0.999,0.001
51,31,20,17,15.5,20,1261,1349,-88,0,0,0,0,81,3,2,0.160494,0,0,13,25,false,true,false,0.3,0.7
146,135,11,10.428571,9.642857,11,416,222,194,0,0,0,0,24,14,14,2.291667,1,0,10,20,false,true,true,0.803,0.197
314,227,87,20.933333,16.214286,87,1170,1156,14,1,0,0.066667,0,0,15,14,0,0,0,7,7,false,true,true,1,0
294,237,57,29.4,23.7,57,1203,1221,-18,2,0,0.2,0,33,10,10,1.060606,0,0,19,7,false,true,true,0.969,0.031
357,288,69,23.8,20.571429,69,1245,1232,13,1,0,0.066667,0,-23,15,14,-1.26087,0,0,2,2,true,true,true,1,0
320,270,50,22.857143,20.769231,50,416,282,134,1,0,0.071429,0,-1,14,13,-34,1,0,9,8,false,true,true,1,0
328,246,82,27.333333,22.363636,82,1550,1466,84,1,0,0.083333,0,16,12,11,2.3125,0,0,10,10,false,true,true,1,0
400,327,73,25,21.8,73,1554,1573,-19,1,0,0.0625,0,-4,16,15,-8.5,0,1,2,8,false,true,true,1,0
264,150,114,26.4,16.666667,114,1014,948,66,1,0,0.1,0,37,10,9,0.891892,0,0,8,21,false,true,true,1,0
132,128,4,22,25.6,4,1431,802,629,0,0,0,0,52,6,5,0.615385,0,0,14,13,false,true,true,0.997,0.003
296,288,8,17.411765,16.941176,8,908,859,49,0,0,0,0,-7,17,17,-5.571429,0,0,9,4,false,true,true,0.803,0.197
262,102,160,18.714286,7.285714,160,859,719,140,0,1,0,0.071429,10,14,14,5.3,0,1,12,16,false,true,true,1,0
418,237,181,32.153846,19.75,181,1550,1624,-74,2,0,0.153846,0,13,13,12,2.307692,1,0,10,8,false,true,true,1,0
334,274,60,22.266667,18.266667,60,941,926,15,1,0,0.066667,0,1,15,15,38,0,0,12,7,false,true,true,1,0
266,256,10,16.625,16,10,613,549,64,0,0,0,0,-6,16,16,-7.333333,0,0,13,6,false,true,true,0.801,0.199
361,320,41,30.083333,29.090909,41,1489,1558,-69,0,1,0,0.090909,5,12,11,5.6,0,0,10,15,false,true,true,1,0
178,99,79,25.428571,16.5,79,1065,1030,35,0,0,0,0,56,7,6,0.607143,0,0,14,10,false,true,true,0.939,0.061
187,133,54,20.777778,14.777778,54,620,658,-38,0,0,0,0,40,9,9,0.9,0,0,31,7,false,true,true,0.97,0.03
20,11,9,20,11,9,820,783,37,0,0,0,0,94,1,1,0.351064,0,0,10,23,false,true,true,0.598,0.402
224,181,43,28,22.625,43,1210,1253,-43,0,1,0,0.125,34,8,8,1,0,0,12,16,false,true,true,0.951,0.049
353,305,48,23.533333,21.785714,48,965,1013,-48,1,0,0.066667,0,-8,15,14,-4.125,0,1,6,8,false,true,true,1,0
109,49,60,21.8,12.25,60,1670,1770,-100,1,0,0.2,0,69,5,4,0.463768,0,0,18,10,false,true,true,0.822,0.178
354,179,175,16.090909,8.136364,175,859,719,140,0,1,0,0.045455,-31,22,22,-1.709677,0,1,14,9,false,true,true,1,0
69,78,-9,17.25,19.5,-9,892,788,104,0,0,0,0,74,4,4,0.581081,1,0,13,20,false,true,true,0.519,0.481
226,223,3,18.833333,20.272727,3,971,658,313,0,0,0,0,18,12,11,2,0,0,19,9,false,true,false,0.237,0.763
202,136,66,18.363636,13.6,66,1413,1422,-9,0,0,0,0,36,11,10,1.583333,2,0,15,9,false,true,true,0.992,0.008
333,241,92,27.75,20.083333,92,977,976,1,1,0,0.083333,0,17,12,12,2,1,0,9,7,false,true,true,1,0
93,34,59,31,17,59,1197,1127,70,0,0,0,0,82,3,2,0.365854,1,0,8,19,false,true,true,0.935,0.065
39,38,1,13,12.666667,1,801,807,-6,0,0,0,0,77,3,3,0.454545,0,0,10,17,false,true,true,0.612,0.388
275,149,126,22.916667,13.545455,126,1033,1037,-4,0,1,0,0.090909,25,12,11,1.8,0,0,18,9,false,true,true,0.983,0.017
79,88,-9,13.166667,14.666667,-9,299,315,-16,0,0,0,0,62,6,6,0.677419,0,0,7,17,false,true,false,0.272,0.728
88,106,-18,17.6,26.5,-18,594,605,-11,0,0,0,0,73,5,4,0.506849,1,0,8,15,false,true,false,0.02,0.98
20,0,20,20,0,20,1406,1454,-48,0,0,0,0,96,1,0,0.354167,0,0,14,0,false,true,true,0.675,0.325
143,81,62,20.428571,13.5,62,804,683,121,0,0,0,0,55,7,6,0.818182,0,1,16,13,false,true,true,0.849,0.151
236,253,-17,14.75,15.8125,-17,699,448,251,0,0,0,0,3,16,16,13.333333,0,0,13,7,false,true,true,0.623,0.377
302,187,115,30.2,18.7,115,1826,1803,23,1,0,0.1,0,23,10,10,1.304348,1,0,15,10,false,true,true,1,0
16,9,7,16,9,7,1075,1009,66,0,0,0,0,93,1,1,0.344086,1,0,15,14,false,true,true,0.691,0.309
237,185,52,14.8125,12.333333,52,1016,1037,-21,0,0,0,0,12,16,15,4,1,0,8,23,false,true,true,0.897,0.103
445,170,275,29.666667,12.142857,275,1054,917,137,2,0,0.133333,0,-12,15,14,-2.916667,0,0,23,10,false,true,true,1,0
267,160,107,20.538462,13.333333,107,1011,921,90,1,0,0.076923,0,23,13,12,2.130435,1,0,16,17,false,true,true,1,0
448,246,202,29.866667,16.4,202,918,619,299,2,0,0.133333,0,-8,15,15,-4.375,0,0,9,3,false,true,true,1,0
281,212,69,25.545455,19.272727,69,1394,1118,276,0,1,0,0.090909,20,11,11,1.85,0,0,11,13,false,true,true,1,0
116,136,-20,16.571429,22.666667,-20,856,897,-41,0,0,0,0,50,7,6,0.7,1,0,7,17,false,true,false,0.16,0.84
312,193,119,31.2,19.3,119,1431,825,606,1,1,0.1,0.1,23,10,10,1.478261,0,0,9,16,false,true,true,1,0
264,266,-2,15.529412,15.647059,-2,262,306,-44,0,0,0,0,-11,17,17,-4.181818,0,0,8,15,false,true,false,0.319,0.681
238,180,58,15.866667,12.857143,58,539,632,-93,0,0,0,0,19,15,14,2.421053,0,0,17,8,false,true,true,0.934,0.066
409,320,89,22.722222,17.777778,89,1050,1144,-94,0,1,0,0.055556,-24,18,18,-1.583333,0,0,1,1,false,true,true,1,0
69,45,24,17.25,15,24,1261,1349,-88,0,0,0,0,76,4,3,0.171053,0,0,13,28,false,true,false,0.234,0.766
51,46,5,17,23,5,954,1078,-124,0,0,0,0,80,3,2,0.475,1,0,27,13,false,true,false,0.317,0.683
364,191,173,33.090909,17.363636,173,820,783,37,1,0,0.090909,0,20,11,11,1.65,0,0,8,12,false,true,true,1,0
42,20,22,21,20,22,613,611,2,0,0,0,0,89,2,1,0.426966,0,0,10,19,false,true,false,0.425,0.575
352,259,93,27.076923,21.583333,93,1203,1221,-18,2,0,0.153846,0,17,13,12,2.058824,0,0,7,9,false,true,true,1,0
22,0,22,22,0,22,1735,1770,-35,0,0,0,0,94,1,0,0.297872,0,0,11,0,false,true,true,0.679,0.321
305,203,102,38.125,25.375,102,1890,2020,-130,1,1,0.125,0.125,28,8,8,1.035714,0,0,10,9,false,true,true,1,0
30,28,2,15,28,2,804,988,-184,0,0,0,0,89,2,1,0.370787,0,0,7,12,false,true,false,0.251,0.749
273,148,125,30.333333,18.5,125,1482,1394,88,2,0,0.222222,0,41,9,8,0.878049,0,0,8,9,false,true,true,1,0
122,125,-3,11.090909,11.363636,-3,416,222,194,0,0,0,0,38,11,11,1.447368,1,0,7,23,false,true,true,0.623,0.377
307,224,83,18.058824,14,83,576,532,44,0,0,0,0,-4,17,16,-11.5,0,0,11,10,false,true,true,1,0
147,82,65,24.5,13.666667,65,1550,1546,4,0,0,0,0,61,6,6,0.491803,1,0,12,16,false,true,true,0.989,0.011
70,62,8,17.5,15.5,8,500,567,-67,0,0,0,0,78,4,4,0.564103,0,0,10,10,false,true,false,0.271,0.729
105,75,30,26.25,18.75,30,1388,1506,-118,1,1,0.25,0.25,67,4,4,0.507463,1,0,9,27,false,true,true,0.921,0.079
183,126,57,36.6,25.2,57,1245,1241,4,1,1,0.2,0.2,59,5,5,0.491525,0,0,19,17,false,true,true,0.97,0.03
297,236,61,24.75,21.454545,61,1109,1065,44,0,0,0,0,4,12,11,8.25,0,0,18,10,false,true,true,0.992,0.008
236,205,31,18.153846,17.083333,31,1214,1176,38,0,0,0,0,25,13,12,1.44,0,0,10,11,false,true,false,0.427,0.573
250,252,-2,19.230769,19.384615,-2,1782,1512,270,1,1,0.076923,0.076923,15,13,13,2.8,0,0,15,12,false,true,true,0.999,0.001
87,60,27,29,30,27,1153,1065,88,0,1,0,0.5,76,3,2,0.368421,0,0,16,17,false,true,true,0.571,0.429
129,244,-115,18.428571,34.857143,-115,1762,1538,224,0,2,0,0.285714,44,7,7,0.772727,1,0,9,8,false,true,true,1,0
77,51,26,19.25,17,26,695,523,172,0,0,0,0,69,4,3,0.536232,0,1,10,6,false,true,true,0.748,0.252
53,19,34,26.5,19,34,880,952,-72,0,0,0,0,90,2,1,0.388889,0,0,22,7,false,true,true,0.593,0.407
204,149,55,22.666667,18.625,55,844,821,23,0,0,0,0,53,9,8,0.792453,1,0,20,12,false,true,true,0.959,0.041
54,58,-4,18,19.333333,-4,1245,1232,13,1,0,0.333333,0,71,3,3,0.408451,0,0,21,8,false,true,true,0.678,0.322
449,312,137,26.411765,19.5,137,1519,1782,-263,2,0,0.117647,0,-12,17,16,-2.75,0,0,2,2,true,true,true,1,0
123,77,46,20.5,12.833333,46,791,774,17,1,0,0.166667,0,67,6,6,0.61194,0,0,9,18,false,true,true,0.852,0.148
238,165,73,23.8,16.5,73,1439,1294,145,1,0,0.1,0,31,10,10,1.16129,0,0,10,35,false,true,true,1,0
271,260,11,20.846154,20,11,1530,1550,-20,0,1,0,0.076923,6,13,13,5.666667,1,0,8,10,false,true,true,0.604,0.396
200,198,2,16.666667,18,2,671,725,-54,0,0,0,0,20,12,11,1.85,1,0,9,12,false,true,true,0.529,0.471
117,177,-60,14.625,25.285714,-60,613,611,2,0,0,0,0,44,8,7,0.863636,0,0,8,15,false,true,false,0.038,0.962
351,334,17,18.473684,18.555556,17,869,820,49,0,1,0,0.055556,-25,19,18,-1.48,0,0,1,2,true,true,true,0.999,0.001
126,117,9,11.454545,11.7,9,892,768,124,0,0,0,0,47,11,10,0.914894,1,0,6,15,false,true,true,0.557,0.443
20,0,20,20,0,20,1885,1793,92,0,0,0,0,96,1,0,0.28125,0,0,22,0,false,true,true,0.707,0.293
216,199,17,13.5,13.266667,17,611,584,27,0,0,0,0,12,16,15,3.666667,0,0,9,15,false,true,false,0.384,0.616
381,275,106,25.4,18.333333,106,1069,917,152,1,1,0.066667,0.066667,-5,15,15,-6.8,0,0,6,7,false,true,true,1,0
233,196,37,17.923077,15.076923,37,864,808,56,1,0,0.076923,0,1,13,13,34,0,1,11,10,false,true,true,0.846,0.154
253,162,91,25.3,18,91,1050,1144,-94,0,1,0,0.111111,40,10,9,0.95,1,0,10,11,false,true,true,0.971,0.029
216,117,99,21.6,13,99,1586,1782,-196,0,0,0,0,34,10,9,1.176471,1,0,12,12,false,true,true,0.971,0.029
110,47,63,22,11.75,63,1295,1477,-182,1,0,0.2,0,71,5,4,0.647887,1,0,9,7,false,true,true,0.692,0.308
274,195,79,27.4,21.666667,79,1210,1253,-43,0,1,0,0.111111,22,10,9,1.545455,0,0,10,14,false,true,true,0.981,0.019
324,292,32,17.052632,16.222222,32,1176,1127,49,0,0,0,0,-20,19,18,-1.85,0,0,1,1,true,true,true,0.999,0.001
349,290,59,20.529412,17.058824,59,948,933,15,1,0,0.058824,0,2,17,17,19,0,0,8,5,false,true,true,1,0
97,64,33,24.25,16,33,1875,1793,82,1,0,0.25,0,73,4,4,0.410959,1,0,17,8,false,true,true,0.929,0.071
74,0,74,37,0,74,2219,2106,113,0,0,0,0,91,2,1,0.296703,0,1,10,22,false,true,true,0.959,0.041
66,31,35,22,15.5,35,1069,917,152,0,0,0,0,80,3,2,0.425,0,1,12,11,false,true,true,0.75,0.25
8,0,8,8,0,8,1516,1397,119,0,0,0,0,96,1,0,0.34375,0,0,14,0,false,true,true,0.678,0.322
321,235,86,24.692308,18.076923,86,1220,1261,-41,2,0,0.153846,0,22,13,13,2.045455,1,0,12,11,false,true,true,1,0
289,167,122,36.125,23.857143,122,1507,1554,-47,1,2,0.125,0.285714,29,8,7,1,0,0,14,16,false,true,true,1,0
213,150,63,23.666667,16.666667,63,960,1070,-110,1,0,0.111111,0,37,9,9,0.945946,0,0,14,16,false,true,true,0.845,0.155
171,160,11,15.545455,16,11,658,817,-159,0,0,0,0,39,11,10,0.974359,0,0,19,10,false,true,true,0.505,0.495
68,40,28,22.666667,20,28,1014,948,66,0,0,0,0,79,3,2,0.417722,1,1,12,14,false,true,true,0.891,0.109
331,243,88,16.55,12.789474,88,892,768,124,0,0,0,0,-7,20,19,-6.142857,0,0,6,11,false,true,true,1,0
36,43,-7,12,21.5,-7,804,988,-184,0,0,0,0,82,3,2,0.402439,1,0,6,19,false,true,false,0.248,0.752
164,98,66,23.428571,16.333333,66,1014,948,66,0,0,0,0,60,7,6,0.55,0,0,10,13,false,true,true,0.911,0.089
270,212,58,22.5,17.666667,58,866,949,-83,0,0,0,0,17,12,12,2.352941,1,0,8,17,false,true,true,0.999,0.001
73,44,29,14.6,11,29,1069,1040,29,0,0,0,0,68,5,4,0.647059,0,2,22,8,false,true,true,0.858,0.142
52,60,-8,17.333333,20,-8,921,1072,-151,0,0,0,0,79,3,3,0.481013,0,0,9,9,false,true,false,0.251,0.749
78,50,28,19.5,16.666667,28,1051,1030,21,0,0,0,0,72,4,3,0.416667,0,0,11,10,false,true,true,0.69,0.31
227,137,90,25.222222,15.222222,90,904,668,236,0,0,0,0,29,9,9,1.172414,0,1,12,9,false,true,true,0.883,0.117
102,57,45,17,9.5,45,584,565,19,0,0,0,0,60,6,6,0.766667,0,0,13,22,false,true,true,0.962,0.038
18,0,18,18,0,18,1036,1181,-145,0,0,0,0,96,1,0,0.354167,0,0,19,0,false,true,false,0.252,0.748
50,60,-10,25,30,-10,1331,1399,-68,0,0,0,0,79,2,2,0.443038,1,0,13,7,false,true,true,0.922,0.078
168,150,18,24,21.428571,18,1127,1134,-7,0,0,0,0,46,7,7,0.652174,0,1,8,9,false,true,true,0.722,0.278
280,305,-25,17.5,19.0625,-25,491,398,93,0,0,0,0,-3,16,16,-12,1,0,11,10,false,true,true,0.632,0.368
69,26,43,23,13,43,786,757,29,0,0,0,0,79,3,2,0.493671,0,0,8,17,false,true,true,0.75,0.25
210,202,8,21,20.2,8,1127,1134,-7,0,0,0,0,25,10,10,1.2,0,1,21,9,false,true,true,0.666,0.334
58,18,40,29,9,40,1127,1176,-49,0,0,0,0,83,2,2,0.506024,0,0,17,11,false,true,true,0.804,0.196
47,45,2,15.666667,15,2,786,847,-61,0,0,0,0,81,3,3,0.419753,0,1,13,7,false,true,false,0.258,0.742
258,198,60,17.2,13.2,60,566,542,24,0,0,0,0,9,15,15,4.555556,0,1,22,6,false,true,true,0.981,0.019
223,88,135,27.875,12.571429,135,1014,1303,-289,1,0,0.125,0,46,8,7,0.826087,0,1,9,8,false,true,true,0.768,0.232
378,303,75,17.181818,14.428571,75,505,95,410,0,1,0,0.047619,-26,22,21,-1.692308,0,0,2,4,false,true,true,1,0
136,139,-3,17,19.857143,-3,613,549,64,0,0,0,0,44,8,7,1,0,0,26,20,false,true,false,0.297,0.703
271,212,59,27.1,23.555556,59,1305,1218,87,1,0,0.1,0,27,10,9,1.407407,0,0,24,8,false,true,true,0.97,0.03
305,254,51,16.052632,14.111111,51,804,683,121,0,0,0,0,-9,19,18,-5,0,1,15,11,false,true,true,0.969,0.031
105,69,36,26.25,23,36,1388,1506,-118,1,1,0.25,0.333333,70,4,3,0.485714,1,0,9,27,false,true,true,0.922,0.078
310,295,15,15.5,15.526316,15,500,567,-67,0,0,0,0,-12,20,19,-3.666667,0,0,4,15,false,true,true,0.998,0.002
146,132,14,18.25,18.857143,14,416,306,110,0,0,0,0,51,8,7,0.823529,0,0,10,12,false,true,true,0.763,0.237
12,18,-6,12,18,-6,1156,1184,-28,0,0,0,0,92,1,1,0.304348,0,0,24,10,false,true,true,0.677,0.323
272,179,93,18.133333,12.785714,93,691,675,16,0,0,0,0,4,15,14,9.5,0,0,11,17,false,true,true,1,0
166,111,55,18.444444,12.333333,55,299,315,-16,0,0,0,0,43,9,9,0.976744,1,0,6,17,false,true,true,0.858,0.142
103,118,-15,20.6,23.6,-15,1101,1078,23,0,0,0,0,65,5,5,0.507692,1,1,7,17,false,true,false,0.172,0.828
278,240,38,19.857143,18.461538,38,1334,1270,64,1,0,0.071429,0,16,14,13,2.3125,1,0,14,16,false,true,true,0.945,0.055
334,285,49,27.833333,25.909091,49,1075,1009,66,2,0,0.166667,0,12,12,11,2.666667,0,0,18,7,false,true,true,1,0
140,121,19,20,17.285714,19,526,370,156,0,0,0,0,51,7,7,0.686275,0,0,16,15,false,true,true,0.939,0.061
35,30,5,17.5,15,5,526,370,156,0,0,0,0,86,2,2,0.406977,0,0,11,17,false,true,true,0.686,0.314
114,81,33,16.285714,13.5,33,954,1078,-124,0,1,0,0.166667,51,7,6,0.745098,1,0,17,10,false,true,true,0.932,0.068
79,14,65,39.5,14,65,809,868,-59,1,0,0.5,0,86,2,1,0.372093,0,0,16,11,false,true,false,0.435,0.565
146,123,23,24.333333,20.5,23,1334,1270,64,1,0,0.166667,0,59,6,6,0.627119,0,0,22,10,false,true,true,0.777,0.223
63,88,-25,15.75,22,-25,316,306,10,0,1,0,0.25,75,4,4,0.506667,0,0,9,9,false,true,true,0.602,0.398
280,230,50,21.538462,19.166667,50,1069,917,152,0,1,0,0.083333,13,13,12,2.615385,0,0,16,11,false,true,true,0.802,0.198
236,220,16,19.666667,18.333333,16,1266,1247,19,0,0,0,0,19,12,12,1.684211,1,0,10,25,false,true,true,0.629,0.371
333,323,10,23.785714,23.071429,10,1305,1242,63,2,1,0.142857,0.071429,-1,14,14,-34,0,0,14,8,false,true,true,0.795,0.205
62,41,21,20.666667,13.666667,21,904,783,121,0,0,0,0,77,3,3,0.545455,1,0,14,23,false,true,true,0.839,0.161
113,164,-51,18.833333,27.333333,-51,1076,1176,-100,0,1,0,0.166667,55,6,6,0.581818,0,1,18,15,false,true,false,0.04,0.96
204,173,31,22.666667,21.625,31,1782,1512,270,1,1,0.111111,0.125,44,9,8,0.954545,0,0,11,10,false,true,true,1,0
406,323,83,25.375,20.1875,83,1075,1027,48,2,1,0.125,0.0625,-16,16,16,-2.3125,0,0,5,4,false,true,true,1,0
100,127,-27,20,25.4,-27,1710,1636,74,0,0,0,0,67,5,5,0.537313,0,0,12,7,false,true,false,0.203,0.797
253,246,7,19.461538,20.5,7,869,820,49,0,1,0,0.083333,17,13,12,2.176471,0,1,12,7,false,true,false,0.356,0.644
36,24,12,18,24,12,1551,1550,1,0,0,0,0,89,2,1,0.47191,0,0,19,22,false,true,true,0.552,0.448
287,292,-5,20.5,22.461538,-5,971,906,65,0,0,0,0,1,14,13,32,1,0,9,10,false,true,false,0.495,0.505
127,89,38,15.875,11.125,38,272,288,-16,0,0,0,0,59,8,8,0.881356,1,0,17,19,false,true,true,0.825,0.175
59,100,-41,9.833333,16.666667,-41,416,374,42,0,0,0,0,70,6,6,0.657143,1,0,9,11,false,true,false,0.116,0.884
99,66,33,14.142857,11,33,1159,1051,108,0,0,0,0,64,7,6,0.625,0,0,27,17,false,true,true,0.702,0.298
12,14,-2,12,14,-2,580,620,-40,0,0,0,0,94,1,1,0.457447,0,0,11,10,false,true,false,0.256,0.744
148,133,15,21.142857,19,15,784,758,26,0,0,0,0,44,7,7,0.795455,0,0,13,7,false,true,true,0.74,0.26
99,112,-13,16.5,18.666667,-13,416,306,110,0,0,0,0,61,6,6,0.688525,0,1,17,12,false,true,false,0.324,0.676
148,67,81,24.666667,13.4,81,960,1070,-110,1,0,0.166667,0,59,6,5,0.59322,0,0,21,23,false,true,true,0.841,0.159
103,85,18,17.166667,17,18,1606,1544,62,0,0,0,0,72,6,5,0.625,1,0,14,9,false,true,true,0.876,0.124
79,62,17,26.333333,20.666667,17,554,342,212,0,0,0,0,76,3,3,0.473684,0,1,14,7,false,true,true,0.794,0.206
204,168,36,25.5,21,36,986,856,130,1,0,0.125,0,37,8,8,0.837838,1,0,6,9,false,true,true,0.956,0.044
344,275,69,21.5,17.1875,69,1364,1093,271,0,1,0,0.0625,-3,16,16,-12.666667,0,0,10,9,false,true,true,1,0
73,7,66,36.5,7,66,942,1003,-61,0,0,0,0,86,2,1,0.523256,0,0,16,14,false,true,true,0.811,0.189
59,35,24,29.5,35,24,991,996,-5,0,0,0,0,87,2,1,0.344828,0,0,11,10,false,true,true,0.68,0.32
145,133,12,16.111111,14.777778,12,777,830,-53,0,0,0,0,42,9,9,0.97619,0,0,14,12,false,true,false,0.466,0.534
272,261,11,16,15.352941,11,808,812,-4,0,0,0,0,-13,17,17,-2.846154,1,0,8,1,false,true,true,0.901,0.099
314,268,46,24.153846,22.333333,46,1142,1095,47,1,0,0.076923,0,6,13,12,5.833333,0,0,11,11,false,true,true,1,0
177,179,-2,29.5,29.833333,-2,1256,1232,24,1,0,0.166667,0,50,6,6,0.6,0,0,16,19,false,true,true,0.671,0.329
272,268,4,16,15.764706,4,628,658,-30,0,0,0,0,1,17,17,46,0,0,12,7,false,true,false,0.393,0.607
216,185,31,24,23.125,31,1793,1897,-104,1,0,0.111111,0,37,9,8,0.810811,0,0,8,7,false,true,true,0.696,0.304
171,117,54,24.428571,16.714286,54,939,907,32,0,0,0,0,56,7,7,0.714286,1,0,15,16,false,true,true,0.968,0.032
303,129,174,16.833333,7.166667,174,859,719,140,0,1,0,0.055556,-12,18,18,-4.416667,0,1,24,16,false,true,true,1,0
236,228,8,16.857143,16.285714,8,808,812,-4,0,0,0,0,7,14,14,5.285714,1,0,12,11,false,true,true,0.744,0.256
26,14,12,13,14,12,580,620,-40,0,0,0,0,91,2,1,0.472527,0,0,12,10,false,true,false,0.255,0.745
394,247,147,26.266667,16.466667,147,1221,1266,-45,1,0,0.066667,0,-12,15,15,-2.916667,0,0,16,10,false,true,true,1,0
400,305,95,30.769231,25.416667,95,1684,1320,364,1,0,0.076923,0,-4,13,12,-7.5,0,0,10,13,false,true,true,1,0
76,66,10,19,22,10,1227,1060,167,0,0,0,0,78,4,3,0.512821,0,1,17,8,false,true,false,0.469,0.531
82,72,10,16.4,18,10,1027,856,171,1,0,0.2,0,59,5,4,0.559322,0,1,13,7,false,true,true,0.687,0.313
95,95,0,15.833333,15.833333,0,1047,1094,-47,0,0,0,0,60,6,6,0.6,0,1,8,10,false,true,false,0.262,0.738
369,245,124,21.705882,15.3125,124,526,370,156,0,0,0,0,-17,17,16,-2.058824,0,0,1,3,false,true,true,1,0
30,0,30,30,0,30,1586,1782,-196,0,0,0,0,95,1,0,0.421053,0,0,18,0,false,true,false,0.263,0.737
108,152,-44,15.428571,21.714286,-44,719,785,-66,0,1,0,0.142857,50,7,7,0.72,0,0,17,17,false,true,false,0.063,0.937
134,184,-50,19.142857,30.666667,-50,1265,1045,220,0,1,0,0.166667,47,7,6,0.893617,0,0,16,10,false,true,false,0.139,0.861
327,292,35,18.166667,16.222222,35,1040,925,115,0,0,0,0,-23,18,18,-1.869565,0,0,12,3,false,true,true,1,0
307,224,83,18.058824,13.176471,83,576,532,44,0,0,0,0,-4,17,17,-11.5,0,0,11,20,false,true,true,1,0
390,199,191,30,16.583333,191,1216,1230,-14,1,0,0.076923,0,11,13,12,2.909091,0,0,8,26,false,true,true,1,0
290,217,73,29,24.111111,73,1004,840,164,1,0,0.1,0,19,10,9,1.578947,0,0,10,13,false,true,true,1,0
120,59,61,20,9.833333,61,1067,95,972,0,0,0,0,66,6,6,0.515152,0,0,15,7,false,true,true,1,0
61,53,8,15.25,13.25,8,1159,1031,128,0,0,0,0,68,4,4,0.573529,1,0,13,17,false,true,true,0.672,0.328
179,191,-12,17.9,19.1,-12,613,549,64,0,0,0,0,32,10,10,1.375,0,1,14,10,false,true,false,0.139,0.861
313,262,51,22.357143,20.153846,51,892,819,73,0,1,0,0.076923,5,14,13,6.8,0,0,14,13,false,true,true,0.907,0.093
221,216,5,17,16.615385,5,527,581,-54,0,0,0,0,12,13,13,3.5,0,0,17,16,false,true,false,0.455,0.545
103,143,-40,17.166667,23.833333,-40,965,1013,-48,0,0,0,0,54,6,6,0.611111,1,1,8,10,false,true,false,0.015,0.985
385,233,152,20.263158,12.944444,152,786,757,29,1,0,0.052632,0,-19,19,18,-2.052632,0,0,19,4,false,true,true,1,0
47,40,7,23.5,20,7,939,907,32,0,0,0,0,87,2,2,0.45977,0,0,24,18,false,true,true,0.681,0.319
82,72,10,20.5,18,10,526,370,156,0,0,0,0,72,4,4,0.486111,0,0,15,23,false,true,true,0.689,0.311
327,281,46,16.35,14.05,46,699,448,251,0,0,0,0,-17,20,20,-2.352941,0,0,2,7,true,true,true,1,0
362,314,48,16.454545,14.272727,48,725,771,-46,0,1,0,0.045455,-33,22,22,-1.393939,0,0,1,1,false,true,true,1,0
246,229,17,27.333333,25.444444,17,1428,1452,-24,0,1,0,0.111111,34,9,9,0.911765,0,0,7,12,false,true,false,0.292,0.708
91,105,-14,18.2,21,-14,999,1011,-12,0,0,0,0,65,5,5,0.707692,0,0,12,22,false,true,false,0.166,0.834
169,171,-2,18.777778,21.375,-2,838,786,52,0,1,0,0.125,39,9,8,0.820513,1,0,9,7,false,true,true,0.713,0.287
434,286,148,16.692308,11,148,1176,1076,100,0,0,0,0,-24,26,26,-2.458333,0,0,4,4,false,true,true,1,0
383,383,0,25.533333,27.357143,0,1256,1232,24,1,0,0.066667,0,-12,15,14,-2.5,1,0,2,2,false,true,true,1,0
77,56,21,19.25,18.666667,21,1189,1266,-77,0,0,0,0,77,4,3,0.441558,1,0,17,9,false,true,true,0.685,0.315
62,22,40,20.666667,11,40,498,43,455,0,0,0,0,82,3,2,0.45122,2,0,5,20,false,true,true,1,0
353,351,2,25.214286,25.071429,2,1030,1144,-114,0,2,0,0.142857,1,14,14,35,1,0,14,8,false,true,true,0.842,0.158
408,338,70,29.142857,26,70,1237,1277,-40,0,0,0,0,-12,14,13,-2.416667,0,0,6,1,false,true,true,1,0
334,233,101,18.555556,13.705882,101,1048,1000,48,0,0,0,0,-8,18,17,-5,0,1,3,7,false,true,true,1,0
356,291,65,29.666667,26.454545,65,1333,1331,2,1,0,0.083333,0,1,12,11,30,0,0,10,12,false,true,true,1,0
70,36,34,23.333333,12,34,771,754,17,0,0,0,0,77,3,3,0.415584,0,0,11,8,false,true,true,0.818,0.182
325,226,99,21.666667,15.066667,99,1011,921,90,1,0,0.066667,0,9,15,15,5.444444,1,0,9,11,false,true,true,1,0
372,302,70,19.578947,16.777778,70,580,620,-40,1,0,0.052632,0,-19,19,18,-2.263158,0,0,5,9,false,true,true,1,0
403,341,62,26.866667,22.733333,62,1408,1454,-46,1,0,0.066667,0,-4,15,15,-8,0,0,2,5,false,true,true,1,0
172,136,36,24.571429,22.666667,36,948,933,15,1,0,0.142857,0,54,7,6,0.703704,0,0,7,14,false,true,true,0.857,0.143
245,225,20,20.416667,18.75,20,1210,1253,-43,0,1,0,0.083333,14,12,12,2.5,1,0,9,17,false,true,true,0.723,0.277
280,290,-10,15.555556,16.111111,-10,613,549,64,0,0,0,0,-17,18,18,-2.588235,0,0,4,3,false,true,true,0.708,0.292
28,18,10,28,18,10,939,907,32,0,0,0,0,93,1,1,0.430108,0,0,24,15,false,true,true,0.683,0.317
298,297,1,19.866667,19.8,1,613,611,2,0,0,0,0,-10,15,15,-3.8,0,0,11,5,false,true,true,0.71,0.29
172,145,27,15.636364,14.5,27,913,871,42,0,0,0,0,34,11,10,1.264706,0,0,23,19,false,true,true,0.657,0.343
94,103,-9,18.8,25.75,-9,965,1013,-48,0,0,0,0,65,5,4,0.507692,1,0,6,9,false,true,true,0.656,0.344
46,59,-13,15.333333,19.666667,-13,1880,1777,103,0,0,0,0,79,3,3,0.35443,0,1,9,6,false,true,false,0.22,0.78
134,73,61,26.8,18.25,61,939,907,32,0,0,0,0,71,5,4,0.56338,0,0,19,10,false,true,true,0.86,0.14
394,277,117,21.888889,15.388889,117,778,758,20,0,1,0,0.055556,-22,18,18,-1.772727,0,0,2,1,false,true,true,1,0
162,195,-33,14.727273,17.727273,-33,916,876,40,0,0,0,0,18,11,11,1.888889,1,0,12,16,false,true,false,0.252,0.748
224,179,45,20.363636,17.9,45,885,719,166,0,0,0,0,30,11,10,1.266667,1,0,8,12,false,true,true,0.875,0.125
284,296,-12,15.777778,16.444444,-12,316,306,10,0,2,0,0.111111,-18,18,18,-2.111111,0,0,1,5,false,true,true,0.984,0.016
89,38,51,17.8,9.5,51,1030,1045,-15,0,0,0,0,74,5,4,0.621622,0,0,13,10,false,true,true,0.827,0.173
218,173,45,24.222222,19.222222,45,901,889,12,0,1,0,0.111111,42,9,9,1.02381,0,0,15,9,false,true,true,0.97,0.03
170,77,93,28.333333,15.4,93,371,336,35,2,0,0.333333,0,47,6,5,0.808511,1,0,15,14,false,true,true,0.717,0.283
293,250,43,24.416667,20.833333,43,904,668,236,0,0,0,0,1,12,12,34,0,0,8,10,false,true,true,0.997,0.003
375,301,74,18.75,15.05,74,527,581,-54,0,0,0,0,-33,20,20,-1.272727,0,0,1,4,false,true,true,1,0
144,39,105,36,13,105,1507,1554,-47,1,0,0.25,0,71,4,3,0.408451,0,0,12,7,false,true,true,0.859,0.141
268,223,45,20.615385,17.153846,45,1040,925,115,0,0,0,0,6,13,13,7.166667,1,0,11,10,false,true,true,0.977,0.023
214,171,43,19.454545,17.1,43,1221,1258,-37,1,0,0.090909,0,34,11,10,1.147059,0,0,23,12,false,true,true,0.955,0.045
404,238,166,18.363636,10.818182,166,1033,1037,-4,0,1,0,0.045455,-27,22,22,-1.666667,0,1,2,1,false,true,true,1,0
77,33,44,38.5,16.5,44,974,995,-21,0,0,0,0,82,2,2,0.402439,0,0,15,8,false,true,true,0.827,0.173
42,53,-11,14,17.666667,-11,371,435,-64,0,0,0,0,77,3,3,0.571429,1,0,17,10,false,true,false,0.467,0.533
199,120,79,22.111111,15,79,1091,1078,13,0,0,0,0,50,9,8,0.86,0,0,17,12,false,true,true,0.969,0.031
159,199,-40,13.25,18.090909,-40,1075,989,86,0,0,0,0,33,12,11,1.181818,0,0,21,17,false,true,false,0.182,0.818
371,217,154,20.611111,12.764706,154,1033,1037,-4,0,1,0,0.058824,-10,18,17,-4.5,1,1,12,9,false,true,true,1,0
197,193,4,28.142857,27.571429,4,416,282,134,1,0,0.142857,0,50,7,7,0.68,0,0,9,9,false,true,false,0.48,0.52
71,106,-35,14.2,21.2,-35,1583,1422,161,0,0,0,0,69,5,5,0.73913,0,0,21,9,false,true,false,0.217,0.783
74,35,39,37,35,39,1256,1232,24,1,0,0.5,0,85,2,1,0.352941,0,1,19,8,false,true,false,0.13,0.87
216,227,-11,15.428571,16.214286,-11,361,493,-132,1,0,0.071429,0,-5,14,14,-8.2,1,0,6,23,false,true,false,0.126,0.874
353,241,112,25.214286,17.214286,112,1029,1227,-198,1,0,0.071429,0,-15,14,14,-2.133333,0,0,5,5,false,true,true,1,0
247,202,45,16.466667,14.428571,45,371,435,-64,0,0,0,0,2,15,14,22,0,0,17,8,false,true,true,0.897,0.103
131,92,39,21.833333,18.4,39,1547,1439,108,1,0,0.166667,0,62,6,5,0.596774,0,0,17,20,false,true,true,0.745,0.255
360,323,37,25.714286,23.071429,37,1154,1062,92,2,0,0.142857,0,5,14,14,7,0,0,10,6,false,true,true,1,0
203,197,6,29,32.833333,6,1075,1009,66,1,0,0.142857,0,46,7,6,0.695652,0,0,7,9,false,true,false,0.483,0.517
157,156,1,19.625,19.5,1,1161,1166,-5,1,0,0.125,0,40,8,8,0.875,0,1,10,14,false,true,true,0.548,0.452
50,35,15,16.666667,17.5,15,769,527,242,0,0,0,0,79,3,2,0.455696,0,0,11,7,false,true,true,0.682,0.318
273,223,50,19.5,17.153846,50,1040,925,115,0,0,0,0,3,14,13,14.333333,1,0,9,10,false,true,true,0.967,0.033
29,36,-7,9.666667,12,-7,904,857,47,0,0,0,0,79,3,3,0.518987,0,1,27,16,false,true,true,0.647,0.353
168,142,26,18.666667,17.75,26,613,461,152,0,0,0,0,35,9,8,1.057143,0,0,12,9,false,true,true,0.815,0.185
317,185,132,35.222222,23.125,132,1489,1405,84,2,0,0.222222,0,36,9,8,0.777778,0,0,10,7,false,true,true,1,0
44,33,11,22,16.5,11,786,788,-2,0,0,0,0,81,2,2,0.419753,0,0,18,22,false,true,true,0.673,0.327
299,290,9,24.916667,24.166667,9,1320,1339,-19,2,1,0.166667,0.083333,14,12,12,2.785714,0,0,19,16,false,true,true,0.954,0.046
256,228,28,16,15.2,28,272,238,34,0,0,0,0,-7,16,15,-5.714286,0,1,25,6,false,true,true,0.973,0.027
52,20,32,26,10,32,1266,1144,122,0,0,0,0,82,2,2,0.414634,0,1,8,12,false,true,true,0.796,0.204
129,51,78,64.5,25.5,78,1397,1361,36,1,0,0.5,0,81,2,2,0.358025,0,0,8,10,false,true,true,0.842,0.158
262,201,61,18.714286,15.461538,61,844,821,23,0,0,0,0,31,14,13,1.354839,0,0,16,8,false,true,true,0.828,0.172
276,237,39,25.090909,23.7,39,1142,1095,47,1,0,0.090909,0,19,11,10,1.842105,0,0,14,16,false,true,true,0.966,0.034
187,97,90,23.375,13.857143,90,1004,653,351,0,0,0,0,41,8,7,0.853659,0,0,8,21,false,true,true,0.951,0.049
279,228,51,19.928571,16.285714,51,505,95,410,0,1,0,0.071429,18,14,14,2.444444,0,0,8,10,false,true,true,1,0
73,77,-4,14.6,15.4,-4,721,689,32,0,0,0,0,59,5,5,0.576271,0,0,14,19,false,true,true,0.658,0.342
97,78,19,24.25,19.5,19,1034,1040,-6,0,0,0,0,72,4,4,0.486111,0,1,25,6,false,true,true,0.747,0.253
57,39,18,28.5,19.5,18,1513,1479,34,0,0,0,0,85,2,2,0.4,1,0,16,9,false,true,true,0.929,0.071
178,134,44,19.777778,16.75,44,711,876,-165,0,0,0,0,42,9,8,1.02381,0,0,8,17,false,true,true,0.759,0.241
73,34,39,36.5,17,39,942,1003,-61,0,0,0,0,82,2,2,0.54878,0,0,16,7,false,true,true,0.805,0.195
367,261,106,33.363636,26.1,106,1645,1777,-132,2,0,0.181818,0,4,11,10,6.25,0,0,10,7,false,true,true,1,0
306,281,25,15.3,14.789474,25,95,360,-265,0,1,0,0.052632,-29,20,19,-1.37931,0,0,2,1,false,true,true,0.846,0.154
257,175,82,21.416667,15.909091,82,505,95,410,0,1,0,0.090909,37,12,11,1.189189,0,1,7,10,false,true,true,0.999,0.001
263,221,42,16.4375,13.8125,42,346,231,115,0,0,0,0,-22,16,16,-1.863636,0,1,31,9,false,true,true,0.987,0.013
59,52,7,19.666667,17.333333,7,1394,1118,276,0,0,0,0,76,3,3,0.486842,0,0,11,10,false,true,true,0.687,0.313
119,45,74,39.666667,15,74,1824,1793,31,1,0,0.333333,0,77,3,3,0.363636,1,0,23,12,false,true,true,0.979,0.021
208,164,44,20.8,18.222222,44,939,907,32,0,0,0,0,43,10,9,0.930233,1,0,15,8,false,true,true,0.946,0.054
149,236,-87,18.625,29.5,-87,1265,1045,220,0,1,0,0.125,36,8,8,1.166667,0,0,18,7,false,true,true,0.735,0.265
347,271,76,28.916667,24.636364,76,1153,1065,88,0,1,0,0.090909,-5,12,11,-5.6,0,0,12,15,false,true,true,1,0
24,0,24,24,0,24,758,796,-38,0,0,0,0,94,1,0,0.404255,1,0,9,0,false,true,false,0.494,0.506
129,59,70,25.8,14.75,70,415,518,-103,0,0,0,0,66,5,4,0.575758,0,0,7,21,false,true,true,0.835,0.165
10,0,10,10,0,10,1216,1228,-12,0,0,0,0,96,1,0,0.34375,0,0,15,0,false,true,true,0.674,0.326
239,188,51,21.727273,17.090909,51,830,907,-77,1,0,0.090909,0,25,11,11,1.56,0,0,18,23,false,true,true,0.846,0.154
302,260,42,18.875,16.25,42,363,668,-305,0,0,0,0,3,16,16,14.333333,0,1,12,12,false,true,true,0.691,0.309
155,65,90,38.75,16.25,90,1824,1793,31,1,0,0.25,0,70,4,4,0.4,1,0,19,12,false,true,true,0.994,0.006
315,184,131,22.5,14.153846,131,303,342,-39,0,0,0,0,15,14,13,2.533333,0,0,7,10,false,true,true,1,0
286,242,44,15.052632,12.736842,44,584,565,19,0,0,0,0,-19,19,19,-2.421053,0,0,19,7,false,true,true,0.996,0.004
338,276,62,24.142857,19.714286,62,1127,1075,52,1,1,0.071429,0.071429,-5,14,14,-6.2,0,1,10,2,false,true,true,0.98,0.02
103,71,32,25.75,23.666667,32,1645,1777,-132,1,0,0.25,0,68,4,3,0.367647,1,0,18,9,false,true,true,0.839,0.161
208,192,16,18.909091,19.2,16,921,1072,-151,1,0,0.090909,0,35,11,10,1.085714,0,0,17,7,false,true,true,0.682,0.318
62,52,10,20.666667,17.333333,10,786,976,-190,0,0,0,0,84,3,3,0.380952,0,0,8,9,false,true,false,0.255,0.745
338,212,126,24.142857,16.307692,126,1651,1691,-40,1,0,0.071429,0,10,14,13,3.4,1,0,6,10,false,true,true,1,0
165,111,54,18.333333,13.875,54,371,435,-64,0,0,0,0,36,9,8,1.222222,0,0,9,11,false,true,true,0.899,0.101
209,201,8,23.222222,25.125,8,1023,1110,-87,1,1,0.111111,0.125,28,9,8,1.071429,0,0,19,19,false,true,true,0.905,0.095
44,40,4,11,13.333333,4,1142,1176,-34,0,0,0,0,76,4,3,0.473684,0,0,14,17,false,true,true,0.583,0.417
67,26,41,22.333333,13,41,1439,1397,42,0,0,0,0,82,3,2,0.414634,0,0,8,11,false,true,true,0.707,0.293
178,95,83,29.666667,19,83,769,527,242,1,0,0.166667,0,53,6,5,0.679245,0,0,13,9,false,true,true,0.97,0.03
511,394,117,51.1,43.777778,117,1370,1431,-61,3,1,0.3,0.111111,8,10,9,2.875,0,0,15,10,false,true,true,1,0
51,88,-37,17,44,-37,316,306,10,0,1,0,0.5,78,3,2,0.487179,0,0,8,9,false,true,false,0.216,0.784
0,12,-12,0,12,-12,1880,1777,103,0,0,0,0,97,1,1,0.28866,0,0,11,14,false,true,false,0.223,0.777
382,330,52,17.363636,15.714286,52,580,620,-40,1,0,0.045455,0,-30,22,21,-1.433333,0,0,1,1,true,true,true,1,0
67,46,21,16.75,11.5,21,777,830,-53,0,0,0,0,73,4,4,0.561644,0,0,14,7,false,true,true,0.616,0.384
136,121,15,34,30.25,15,1344,1209,135,0,1,0,0.25,66,4,4,0.515152,0,0,10,15,false,true,false,0.345,0.655
14,0,14,14,0,14,871,867,4,0,0,0,0,96,1,0,0.447917,0,0,21,0,false,true,true,0.659,0.341
301,146,155,18.8125,9.125,155,993,897,96,1,0,0.0625,0,-1,16,16,-47,0,1,27,20,false,true,true,1,0
16,19,-3,16,19,-3,1659,1782,-123,0,0,0,0,94,1,1,0.308511,0,0,9,16,false,true,true,0.506,0.494
53,27,26,17.666667,9,26,584,565,19,0,0,0,0,79,3,3,0.582278,0,0,13,24,false,true,true,0.589,0.411
281,260,21,21.615385,20,21,1270,1348,-78,0,0,0,0,15,13,13,2.533333,0,0,11,7,false,true,false,0.473,0.527
291,264,27,15.315789,14.666667,27,272,238,34,0,1,0,0.055556,-26,19,18,-1.538462,0,0,7,2,false,true,true,0.824,0.176
125,77,48,20.833333,15.4,48,834,758,76,0,0,0,0,63,6,5,0.571429,0,1,20,12,false,true,true,0.842,0.158
147,83,64,18.375,11.857143,64,595,543,52,0,0,0,0,53,8,7,0.886792,1,0,6,15,false,true,true,0.969,0.031
171,221,-50,13.153846,17,-50,628,658,-30,0,0,0,0,25,13,13,1.84,0,0,16,12,false,true,false,0.019,0.981
276,235,41,23,19.583333,41,1065,1030,35,0,1,0,0.083333,13,12,12,2.615385,1,0,11,10,false,true,true,0.961,0.039
24,14,10,12,14,10,1055,1050,5,0,0,0,0,88,2,1,0.386364,0,0,14,8,false,true,true,0.678,0.322
204,130,74,34,21.666667,74,971,621,350,2,0,0.333333,0,49,6,6,0.653061,0,0,17,13,false,true,true,0.97,0.03
97,50,47,24.25,16.666667,47,1034,1040,-6,0,0,0,0,76,4,3,0.460526,0,0,25,10,false,true,true,0.795,0.205
127,140,-13,18.142857,20,-13,628,658,-30,0,0,0,0,53,7,7,0.867925,0,0,22,10,false,true,false,0.309,0.691
283,222,61,21.769231,17.076923,61,866,949,-83,0,0,0,0,11,13,13,3.636364,1,0,8,17,false,true,true,1,0
269,269,0,17.933333,17.933333,0,1214,1176,38,0,0,0,0,10,15,15,3.6,0,0,9,10,false,true,false,0.378,0.622
32,10,22,16,10,22,671,725,-54,0,0,0,0,86,2,1,0.430233,1,0,8,18,false,true,false,0.312,0.688
39,50,-11,19.5,25,-11,1431,825,606,0,0,0,0,86,2,2,0.395349,0,1,11,8,false,true,true,0.998,0.002
50,49,1,25,24.5,1,1004,840,164,0,0,0,0,82,2,2,0.365854,1,0,9,19,false,true,true,0.872,0.128
352,194,158,14.666667,8.434783,158,993,897,96,1,0,0.041667,0,-25,24,23,-1.88,0,0,3,25,true,true,true,1,0
220,123,97,22,13.666667,97,1033,1037,-4,0,1,0,0.111111,37,10,9,1.216216,0,0,26,10,false,true,true,0.971,0.029
304,292,12,16.888889,17.176471,12,95,378,-283,0,0,0,0,-20,18,17,-1.75,0,0,3,1,true,true,true,0.89,0.11
431,261,170,26.9375,16.3125,170,971,621,350,2,0,0.125,0,-21,16,16,-1.52381,0,0,1,6,true,true,true,1,0
92,71,21,23,23.666667,21,1539,1537,2,0,0,0,0,78,4,3,0.410256,1,0,6,16,false,true,true,0.917,0.083
247,177,70,27.444444,19.666667,70,1731,1691,40,1,0,0.111111,0,28,9,9,1.214286,0,0,8,8,false,true,true,0.903,0.097
310,258,52,17.222222,15.176471,52,613,461,152,0,1,0,0.058824,-23,18,17,-1.608696,0,0,2,1,false,true,true,0.957,0.043
273,98,175,45.5,19.6,175,1824,1793,31,1,0,0.166667,0,57,6,5,0.491228,1,0,6,7,false,true,true,1,0
94,144,-50,23.5,36,-50,834,844,-10,0,1,0,0.25,66,4,4,0.545455,0,0,11,8,false,true,false,0.221,0.779
158,109,49,22.571429,18.166667,49,691,473,218,0,0,0,0,51,7,6,0.705882,0,0,17,7,false,true,true,0.917,0.083
311,219,92,18.294118,13.6875,92,758,750,8,0,0,0,0,-10,17,16,-3.7,0,1,10,7,false,true,true,1,0
344,209,135,20.235294,13.0625,135,1413,1422,-9,0,0,0,0,4,17,16,14.25,0,0,11,17,false,true,true,1,0
192,200,-8,27.428571,28.571429,-8,791,885,-94,1,1,0.142857,0.142857,47,7,7,0.808511,0,0,22,7,false,true,true,0.763,0.237
44,12,32,14.666667,6,32,576,494,82,0,0,0,0,85,3,2,0.517647,0,0,9,31,false,true,false,0.47,0.53
162,156,6,16.2,15.6,6,540,518,22,0,0,0,0,37,10,10,1.081081,0,0,8,13,false,true,true,0.611,0.389
48,52,-4,24,26,-4,1482,1394,88,0,0,0,0,86,2,2,0.418605,0,0,9,22,false,true,false,0.238,0.762
215,205,10,19.545455,20.5,10,971,658,313,0,0,0,0,26,11,10,1.384615,0,0,14,12,false,true,false,0.234,0.766
48,120,-72,12,40,-72,947,810,137,0,1,0,0.333333,69,4,3,0.608696,0,0,10,16,false,true,false,0.017,0.983
0,14,-14,0,14,-14,1127,1075,52,0,0,0,0,96,1,1,0.322917,0,0,14,16,false,true,false,0.342,0.658
131,59,72,32.75,19.666667,72,2219,2106,113,0,0,0,0,75,4,3,0.36,0,1,12,7,false,true,true,0.97,0.03
152,97,55,21.714286,16.166667,55,1073,1177,-104,0,0,0,0,55,7,6,0.581818,0,0,9,19,false,true,false,0.492,0.508
472,193,279,36.307692,16.083333,279,1431,825,606,2,1,0.153846,0.083333,7,13,12,4.857143,0,0,16,16,false,true,true,1,0
328,269,59,20.5,17.933333,59,791,774,17,1,0,0.0625,0,5,16,15,8.2,0,0,11,7,false,true,true,1,0
156,110,46,31.2,22,46,1493,1513,-20,1,0,0.2,0,64,5,5,0.515625,0,1,10,6,false,true,true,0.837,0.163
94,146,-52,15.666667,24.333333,-52,719,785,-66,0,1,0,0.166667,55,6,6,0.654545,0,0,11,16,false,true,false,0.067,0.933
206,120,86,29.428571,20,86,880,952,-72,0,0,0,0,54,7,6,0.648148,0,0,14,13,false,true,true,0.962,0.038
78,72,6,15.6,18,6,1011,921,90,0,0,0,0,68,5,4,0.720588,0,0,10,14,false,true,false,0.459,0.541
193,119,74,27.571429,17,74,1051,1030,21,0,0,0,0,48,7,7,0.625,0,0,11,13,false,true,true,0.964,0.036
229,251,-22,15.266667,16.733333,-22,719,614,105,0,1,0,0.066667,2,15,15,21.5,0,0,19,8,false,true,true,0.751,0.249
164,137,27,20.5,19.571429,27,1302,1234,68,0,0,0,0,49,8,7,0.632653,2,0,8,8,false,true,true,0.986,0.014
319,284,35,19.9375,17.75,35,1548,1493,55,1,0,0.0625,0,-4,16,16,-10.25,0,0,9,8,false,true,true,1,0
104,111,-7,17.333333,22.2,-7,1261,1349,-88,0,0,0,0,59,6,5,0.220339,1,0,15,19,false,true,false,0.415,0.585
371,318,53,24.733333,22.714286,53,1144,1014,130,0,0,0,0,-3,15,14,-12,0,0,13,9,false,true,true,1,0
393,349,44,24.5625,23.266667,44,1144,1014,130,0,0,0,0,-10,16,15,-3.6,0,0,3,6,false,true,true,1,0
412,320,92,21.684211,17.777778,92,1050,1144,-94,0,1,0,0.055556,-27,19,18,-1.407407,0,0,1,1,false,true,true,1,0
214,178,36,21.4,19.777778,36,1227,1060,167,0,1,0,0.111111,36,10,9,1.111111,0,0,8,16,false,true,true,0.549,0.451
146,129,17,16.222222,16.125,17,523,480,43,1,0,0.111111,0,41,9,8,0.804878,0,0,9,9,false,true,true,0.928,0.072
0,0,0,0,0,0,1897,1793,104,0,0,0,0,100,2,1,0.32,0,0,17,17,false,true,false,0.29,0.71
321,189,132,32.1,18.9,132,1501,1622,-121,2,0,0.2,0,25,10,10,1.24,0,0,14,9,false,true,true,1,0
139,170,-31,15.444444,18.888889,-31,95,378,-283,0,0,0,0,35,9,9,1,0,0,13,12,false,true,false,0.404,0.596
330,325,5,17.368421,17.105263,5,1164,1201,-37,0,0,0,0,-24,19,19,-1.75,0,0,6,3,false,true,true,0.999,0.001
10,34,-24,10,34,-24,1304,1040,264,0,0,0,0,91,1,1,0.362637,0,0,9,15,false,true,false,0.2,0.8
207,147,60,29.571429,21,60,820,783,37,0,0,0,0,46,7,7,0.717391,1,0,18,9,false,true,true,0.982,0.018
83,71,12,20.75,17.75,12,786,976,-190,0,0,0,0,78,4,4,0.410256,0,0,9,7,false,true,false,0.259,0.741
139,210,-71,19.857143,30,-71,834,844,-10,0,1,0,0.142857,44,7,7,0.818182,0,2,13,9,false,true,false,0.004,0.996
55,128,-73,18.333333,42.666667,-73,1454,1531,-77,0,1,0,0.333333,76,3,3,0.394737,1,0,16,8,false,true,true,0.585,0.415
174,96,78,29,16,78,866,949,-83,0,0,0,0,58,6,6,0.689655,0,1,16,9,false,true,true,0.63,0.37
390,304,86,20.526316,16.888889,86,1305,1218,87,1,1,0.052632,0.055556,-36,19,18,-1.055556,0,0,1,1,false,true,true,1,0
90,164,-74,12.857143,23.428571,-74,1156,1184,-28,0,0,0,0,48,7,7,0.583333,1,0,9,7,false,true,false,0.193,0.807
329,161,168,16.45,8.05,168,993,897,96,1,0,0.05,0,-16,20,20,-2.9375,0,1,15,25,false,true,true,1,0
270,133,137,24.545455,12.090909,137,554,342,212,0,0,0,0,20,11,11,1.8,0,0,7,28,false,true,true,1,0
177,94,83,25.285714,15.666667,83,904,668,236,0,0,0,0,50,7,6,0.68,0,0,10,12,false,true,true,0.962,0.038
62,34,28,31,17,28,1197,1127,70,0,0,0,0,85,2,2,0.352941,1,0,9,19,false,true,true,0.92,0.08
278,257,21,39.714286,36.714286,21,1983,2020,-37,1,1,0.142857,0.142857,34,7,7,0.764706,0,0,9,26,false,true,true,0.998,0.002
104,89,15,17.333333,14.833333,15,527,514,13,0,0,0,0,55,6,6,0.709091,0,1,7,11,false,true,true,0.531,0.469
337,297,40,14.652174,13.5,40,826,771,55,0,0,0,0,-26,23,22,-1.730769,0,0,2,1,true,true,true,1,0
152,100,52,25.333333,20,52,691,675,16,0,0,0,0,61,6,5,0.606557,0,1,13,7,false,true,true,0.812,0.188
326,236,90,29.636364,21.454545,90,1245,1232,13,1,0,0.090909,0,4,11,11,7.25,0,1,9,9,false,true,true,1,0
278,253,25,30.888889,28.111111,25,1659,1782,-123,1,0,0.111111,0,19,9,9,1.526316,0,1,10,9,false,true,true,0.718,0.282
69,52,17,23,26,17,363,668,-305,0,0,0,0,86,3,2,0.5,0,0,7,10,false,true,false,0.2,0.8
67,86,-19,16.75,28.666667,-19,613,611,2,0,0,0,0,75,4,3,0.506667,0,0,12,10,false,true,false,0.475,0.525
125,120,5,31.25,30,5,974,995,-21,0,1,0,0.25,64,4,4,0.515625,0,0,10,10,false,true,true,0.681,0.319
263,211,52,17.533333,15.071429,52,916,837,79,0,0,0,0,11,15,14,3.636364,1,0,6,13,false,true,true,0.932,0.068
111,91,20,22.2,22.75,20,711,876,-165,0,0,0,0,66,5,4,0.651515,0,0,10,9,false,true,false,0.253,0.747
14,14,0,7,7,0,1093,1100,-7,0,0,0,0,94,2,2,0.340426,0,1,8,10,false,true,false,0.253,0.747
163,82,81,16.3,9.111111,81,859,719,140,0,1,0,0.111111,33,10,9,1.606061,0,2,19,13,false,true,true,0.999,0.001
89,52,37,14.833333,10.4,37,880,952,-72,0,0,0,0,67,6,5,0.61194,0,0,10,18,false,true,false,0.341,0.659
153,146,7,17,16.222222,7,1583,1422,161,0,0,0,0,53,9,9,0.962264,1,0,16,10,false,true,true,0.57,0.43
298,282,16,14.9,14.1,16,262,306,-44,1,0,0.05,0,-31,20,20,-1.483871,0,0,4,6,false,true,true,0.998,0.002
320,297,23,16.842105,16.5,23,947,810,137,0,1,0,0.055556,-17,19,18,-2.470588,0,0,6,10,false,true,true,0.941,0.059
204,209,-5,17,17.416667,-5,613,549,64,0,0,0,0,22,12,12,2,1,0,11,13,false,true,true,0.621,0.379
39,47,-8,19.5,23.5,-8,907,752,155,0,0,0,0,88,2,2,0.375,0,0,9,13,false,true,true,0.598,0.402
20,0,20,20,0,20,1125,1227,-102,0,0,0,0,95,1,0,0.315789,0,0,21,0,false,true,false,0.307,0.693
272,235,37,30.222222,26.111111,37,1633,1580,53,2,0,0.222222,0,30,9,9,0.933333,0,0,8,14,false,true,true,0.989,0.011
212,168,44,23.555556,18.666667,44,1110,1039,71,0,0,0,0,34,9,9,1.058824,0,0,14,13,false,true,true,0.924,0.076
172,146,26,28.666667,24.333333,26,1078,1130,-52,0,1,0,0.166667,56,6,6,0.696429,0,0,7,9,false,true,true,0.813,0.187
206,197,9,15.846154,15.153846,9,613,502,111,0,0,0,0,13,13,13,3.769231,0,1,10,18,false,true,true,0.551,0.449
277,164,113,25.181818,16.4,113,1216,1230,-14,1,0,0.090909,0,32,11,10,1,0,0,10,10,false,true,true,1,0
190,189,1,23.75,23.625,1,1431,802,629,0,0,0,0,35,8,8,0.914286,0,0,12,14,false,true,true,0.997,0.003
177,109,68,29.5,18.166667,68,1156,1114,42,1,0,0.166667,0,47,6,6,0.680851,0,0,19,13,false,true,true,0.967,0.033
198,234,-36,16.5,19.5,-36,95,360,-265,0,1,0,0.083333,11,12,12,3.636364,2,0,6,7,false,true,false,0.412,0.588
387,259,128,24.1875,16.1875,128,778,758,20,0,1,0,0.0625,-14,16,16,-2.785714,0,0,4,5,false,true,true,1,0
138,130,8,27.6,26,8,1645,1777,-132,1,0,0.2,0,54,5,5,0.462963,2,0,10,17,false,true,true,0.976,0.024
193,103,90,27.571429,17.166667,90,746,796,-50,0,1,0,0.166667,42,7,6,1.142857,0,0,7,10,false,true,true,0.97,0.03
310,293,17,23.846154,22.538462,17,974,995,-21,0,1,0,0.076923,7,13,13,4.714286,0,0,8,10,false,true,true,0.81,0.19
237,203,34,26.333333,22.555556,34,1489,1555,-66,1,0,0.111111,0,33,9,9,0.878788,1,0,10,14,false,true,true,0.937,0.063
324,280,44,23.142857,20,44,1406,1454,-48,0,2,0,0.142857,-3,14,14,-11.333333,0,0,8,11,false,true,true,0.954,0.046
245,208,37,16.333333,13.866667,37,613,502,111,0,0,0,0,0,15,15,0,1,1,7,22,false,true,true,0.937,0.063
328,241,87,29.818182,21.909091,87,1397,1361,36,1,0,0.090909,0,12,11,11,2.416667,1,0,15,19,false,true,true,1,0
319,233,86,21.266667,16.642857,86,859,811,48,0,0,0,0,1,15,14,36,1,1,9,14,false,true,true,1,0
374,305,69,19.684211,16.944444,69,948,933,15,1,0,0.052632,0,-8,19,18,-4.75,0,0,2,3,false,true,true,1,0
38,25,13,19,25,13,719,785,-66,0,0,0,0,89,2,1,0.404494,0,2,13,5,false,true,false,0.021,0.979
148,118,30,21.142857,16.857143,30,916,837,79,0,0,0,0,58,7,7,0.689655,0,0,12,13,false,true,true,0.851,0.149
303,229,74,16.833333,12.722222,74,415,518,-103,0,0,0,0,-18,18,18,-2.111111,0,0,1,11,false,true,true,1,0
261,212,49,17.4,14.133333,49,416,306,110,0,0,0,0,7,15,15,6,0,0,8,9,false,true,true,0.94,0.06
140,106,34,28,21.2,34,880,952,-72,0,0,0,0,63,5,5,0.555556,1,0,18,10,false,true,true,0.935,0.065
394,384,10,28.142857,29.538462,10,1302,1349,-47,0,1,0,0.076923,-9,14,13,-3.111111,0,0,1,12,false,true,true,1,0
262,145,117,21.833333,12.083333,117,786,757,29,1,0,0.083333,0,22,12,12,1.772727,0,0,12,14,false,true,true,1,0
241,241,0,20.083333,21.909091,0,771,754,17,0,0,0,0,20,12,11,1.6,0,1,10,16,false,true,false,0.009,0.991
339,282,57,21.1875,18.8,57,820,822,-2,0,0,0,0,-3,16,15,-13,0,0,7,6,false,true,true,1,0
46,29,17,15.333333,9.666667,17,527,581,-54,0,0,0,0,79,3,3,0.531646,1,0,14,10,false,true,true,0.648,0.352
168,87,81,15.272727,7.909091,81,859,719,140,0,1,0,0.090909,25,11,11,2.12,0,2,19,13,false,true,true,1,0
318,277,41,19.875,18.466667,41,838,786,52,0,1,0,0.066667,-9,16,15,-3.555556,0,0,4,3,false,true,true,0.869,0.131
120,50,70,40,25,70,1344,1325,19,1,0,0.333333,0,75,3,2,0.413333,0,0,12,15,false,true,true,0.804,0.196
443,344,99,36.916667,28.666667,99,1983,2020,-37,2,1,0.166667,0.083333,3,12,12,8.666667,0,0,3,12,false,true,true,1,0
174,162,12,21.75,20.25,12,1334,1270,64,1,0,0.125,0,45,8,8,0.822222,0,0,26,7,false,true,true,0.769,0.231
280,279,1,17.5,17.4375,1,658,817,-159,0,0,0,0,3,16,16,12.666667,1,0,7,7,false,true,true,0.522,0.478
41,32,9,13.666667,16,9,1221,1266,-45,0,0,0,0,81,3,2,0.432099,0,0,19,11,false,true,true,0.675,0.325
14,12,2,14,12,2,576,494,82,0,0,0,0,92,1,1,0.478261,0,0,9,28,false,true,true,0.582,0.418
287,209,78,23.916667,19,78,1302,1082,220,0,0,0,0,6,12,11,5,1,0,10,12,false,true,true,1,0
58,70,-12,14.5,17.5,-12,892,768,124,0,0,0,0,75,4,4,0.573333,0,0,11,16,false,true,false,0.278,0.722
233,142,91,33.285714,20.285714,91,630,786,-156,1,0,0.142857,0,47,7,7,0.744681,0,0,16,23,false,true,true,0.891,0.109
245,226,19,24.5,25.111111,19,1023,1110,-87,1,1,0.1,0.111111,21,10,9,1.428571,1,0,14,16,false,true,true,0.927,0.073
179,118,61,22.375,16.857143,61,916,837,79,0,0,0,0,52,8,7,0.769231,0,0,10,13,false,true,true,0.951,0.049
134,108,26,19.142857,15.428571,26,786,976,-190,0,0,0,0,62,7,7,0.516129,0,0,10,7,false,true,false,0.43,0.57
336,258,78,22.4,18.428571,78,1305,1218,87,1,0,0.066667,0,-5,15,14,-7.6,0,0,10,7,false,true,true,1,0
232,171,61,17.846154,14.25,61,620,513,107,0,0,0,0,21,13,12,2.142857,1,0,24,9,false,true,true,0.989,0.011
511,493,18,51.1,49.3,18,1370,1431,-61,3,1,0.3,0.1,3,10,10,7.666667,0,0,15,4,false,true,true,0.997,0.003
256,207,49,21.333333,18.818182,49,1094,1030,64,0,0,0,0,19,12,11,1.894737,0,0,11,11,false,true,true,0.863,0.137
38,42,-4,12.666667,21,-4,826,771,55,0,0,0,0,86,3,2,0.523256,0,0,7,10,false,true,true,0.645,0.355
307,231,76,21.928571,16.5,76,691,473,218,0,0,0,0,0,14,14,0,1,1,9,13,false,true,true,1,0
234,269,-35,23.4,26.9,-35,907,752,155,0,1,0,0.1,26,10,10,1.269231,0,0,10,15,false,true,false,0.116,0.884
26,35,-9,13,17.5,-9,95,360,-265,0,1,0,0.5,81,2,2,0.493827,0,0,7,17,false,true,true,0.654,0.346
222,160,62,31.714286,22.857143,62,1396,1454,-58,1,0,0.142857,0,48,7,7,0.6875,2,0,8,10,false,true,true,0.989,0.011
32,46,-14,16,23,-14,778,758,20,0,0,0,0,81,2,2,0.481481,0,0,13,9,false,true,true,0.678,0.322
256,137,119,21.333333,12.454545,119,1586,1782,-196,0,0,0,0,22,12,11,1.818182,1,0,9,9,false,true,true,1,0
24,18,6,24,18,6,1305,1218,87,0,0,0,0,91,1,1,0.417582,0,0,15,10,false,true,true,0.679,0.321
257,220,37,21.416667,20,37,926,854,72,0,0,0,0,22,12,11,1.545455,0,1,7,14,false,true,true,0.584,0.416
283,122,161,28.3,13.555556,161,1211,1173,38,0,0,0,0,39,10,9,0.897436,0,1,12,9,false,true,true,1,0
91,103,-12,30.333333,34.333333,-12,974,995,-21,0,1,0,0.333333,71,3,3,0.464789,0,0,11,9,false,true,true,0.672,0.328
39,45,-6,19.5,22.5,-6,892,788,104,0,0,0,0,86,2,2,0.5,1,0,8,22,false,true,true,0.639,0.361
127,153,-26,14.111111,17,-26,699,448,251,0,0,0,0,48,9,9,0.833333,0,1,13,8,false,true,false,0.204,0.796
143,53,90,35.75,17.666667,90,986,856,130,1,0,0.25,0,72,4,3,0.430556,0,0,12,13,false,true,true,0.967,0.033
282,295,-13,14.842105,15.526316,-13,576,494,82,0,0,0,0,-14,19,19,-3.142857,0,0,8,6,false,true,false,0.282,0.718
66,67,-1,16.5,16.75,-1,921,1072,-151,0,0,0,0,74,4,4,0.513514,0,0,10,9,false,true,false,0.252,0.748
446,375,71,31.857143,28.846154,71,1880,1777,103,1,1,0.071429,0.076923,-13,14,13,-2.153846,0,0,3,1,false,true,true,1,0
184,136,48,18.4,15.111111,48,786,976,-190,0,0,0,0,40,10,9,0.8,0,0,12,13,false,true,true,0.806,0.194
261,304,-43,32.625,38,-43,2219,2029,190,0,0,0,0,23,8,8,1.130435,0,0,18,14,false,true,true,0.999,0.001
88,103,-15,12.571429,14.714286,-15,1214,1176,38,0,0,0,0,56,7,7,0.642857,1,1,15,13,false,true,false,0.264,0.736
238,179,59,17,12.785714,59,691,675,16,0,0,0,0,6,14,14,6.333333,0,0,14,17,false,true,true,0.97,0.03
336,248,88,15.272727,11.809524,88,576,532,44,0,0,0,0,-30,22,21,-1.533333,1,0,8,18,false,true,true,1,0
321,205,116,20.0625,13.666667,116,1295,1477,-182,2,0,0.125,0,9,16,15,5.111111,1,0,6,13,false,true,true,1,0
264,236,28,15.529412,13.882353,28,613,502,111,0,0,0,0,-8,17,17,-6.125,1,0,10,21,false,true,true,1,0
245,226,19,16.333333,15.066667,19,613,461,152,0,1,0,0.066667,-12,15,15,-3.083333,0,0,31,10,false,true,true,0.997,0.003
119,34,85,39.666667,17,85,986,856,130,1,0,0.333333,0,78,3,2,0.397436,0,0,12,15,false,true,true,0.948,0.052
105,21,84,52.5,21,84,925,801,124,1,0,0.5,0,88,2,1,0.454545,1,0,14,16,false,true,true,0.99,0.01
367,275,92,16.681818,13.095238,92,1606,1544,62,0,0,0,0,-16,22,21,-2.8125,0,0,2,2,false,true,true,1,0
27,37,-10,13.5,18.5,-10,1156,1184,-28,0,0,0,0,82,2,2,0.341463,0,0,15,13,false,true,true,0.676,0.324
316,344,-28,22.571429,24.571429,-28,1539,1537,2,0,1,0,0.071429,0,14,14,0,0,0,12,7,false,true,false,0.021,0.979
292,145,147,29.2,16.111111,147,1482,1554,-72,1,0,0.1,0,33,10,9,1.090909,0,0,10,8,false,true,true,1,0
390,230,160,24.375,14.375,160,954,1078,-124,1,1,0.0625,0.0625,-9,16,16,-4.222222,0,0,7,12,false,true,true,1,0
155,45,110,38.75,15,110,1824,1793,31,1,0,0.25,0,75,4,3,0.373333,1,0,19,12,false,true,true,0.995,0.005
361,261,100,20.055556,15.352941,100,844,821,23,0,0,0,0,4,18,17,10.5,0,1,8,6,false,true,true,1,0
232,236,-4,15.466667,15.733333,-4,361,493,-132,1,0,0.066667,0,-11,15,15,-3.727273,0,0,10,20,false,true,true,0.719,0.281
226,179,47,20.545455,17.9,47,804,988,-184,1,0,0.090909,0,27,11,10,1.222222,1,0,6,8,false,true,true,0.775,0.225
8,31,-23,8,31,-23,908,859,49,0,0,0,0,91,1,1,0.428571,0,0,20,8,false,true,true,0.666,0.334
197,117,80,39.4,23.4,80,1983,2020,-37,1,0,0.2,0,60,5,5,0.433333,0,1,15,9,false,true,true,0.866,0.134
55,35,20,18.333333,11.666667,20,527,503,24,0,0,0,0,82,3,3,0.5,2,0,18,10,false,true,true,0.987,0.013
224,224,0,22.4,22.4,0,1127,1075,52,1,1,0.1,0.1,26,10,10,1.192308,0,1,7,9,false,true,false,0.498,0.502
183,180,3,16.636364,18,3,334,446,-112,0,0,0,0,22,11,10,1.818182,0,1,13,6,false,true,false,0.171,0.829
52,34,18,13,11.333333,18,719,614,105,0,0,0,0,77,4,3,0.558442,0,2,12,10,false,true,true,0.593,0.407
52,53,-1,13,17.666667,-1,1128,889,239,0,1,0,0.333333,75,4,3,0.626667,1,0,8,7,false,true,true,0.961,0.039
397,347,50,23.352941,21.6875,50,1093,1090,3,1,2,0.058824,0.125,-10,17,16,-3.4,0,0,3,4,false,true,true,1,0
166,125,41,16.6,13.888889,41,363,668,-305,0,0,0,0,47,10,9,0.914894,0,0,8,13,false,true,true,0.823,0.177
209,228,-19,29.857143,32.571429,-19,2219,2029,190,0,0,0,0,34,7,7,0.764706,0,1,27,10,false,true,true,0.932,0.068
18,8,10,18,8,10,272,288,-16,0,0,0,0,93,1,1,0.55914,1,0,7,10,false,true,true,0.58,0.42
192,156,36,21.333333,17.333333,36,691,473,218,0,0,0,0,35,9,9,1.028571,0,0,13,16,false,true,true,0.912,0.088
190,81,109,31.666667,16.2,109,1408,1454,-46,1,0,0.166667,0,62,6,5,0.516129,0,0,10,11,false,true,true,0.968,0.032
227,170,57,18.916667,15.454545,57,786,788,-2,0,0,0,0,13,12,11,2.615385,1,1,9,12,false,true,true,0.981,0.019
137,126,11,22.833333,21,11,902,866,36,0,0,0,0,51,6,6,0.627451,0,0,10,15,false,true,true,0.681,0.319
296,248,48,22.769231,19.076923,48,941,926,15,1,0,0.076923,0,16,13,13,2.375,1,0,19,13,false,true,true,0.999,0.001
218,134,84,36.333333,26.8,84,1571,1554,17,2,1,0.333333,0.2,50,6,5,0.66,0,0,7,8,false,true,true,0.969,0.031
245,184,61,18.846154,14.153846,61,566,542,24,0,0,0,0,17,13,13,2.411765,0,1,26,6,false,true,true,0.986,0.014
183,99,84,45.75,24.75,84,1397,1361,36,1,0,0.25,0,64,4,4,0.453125,0,0,10,12,false,true,true,0.893,0.107
372,308,64,23.25,20.533333,64,901,1159,-258,2,0,0.125,0,-12,16,15,-2.916667,0,0,14,8,false,true,true,1,0
340,195,145,21.25,12.1875,145,786,757,29,1,0,0.0625,0,-2,16,16,-19.5,0,0,16,14,false,true,true,1,0
174,201,-27,14.5,16.75,-27,916,876,40,0,0,0,0,9,12,12,3.777778,1,0,24,18,false,true,true,0.52,0.48
35,35,0,11.666667,17.5,0,95,360,-265,0,1,0,0.5,75,3,2,0.533333,0,0,21,17,false,true,true,0.66,0.34
154,98,56,17.111111,12.25,56,801,807,-6,0,0,0,0,39,9,8,0.897436,0,0,16,9,false,true,true,0.935,0.065
38,58,-20,12.666667,19.333333,-20,1027,856,171,1,0,0.333333,0,72,3,3,0.458333,0,1,10,8,false,true,true,0.677,0.323
308,257,51,20.533333,17.133333,51,904,783,121,0,0,0,0,7,15,15,6,0,0,10,8,false,true,true,0.998,0.002
201,209,-8,15.461538,17.416667,-8,719,614,105,0,1,0,0.083333,15,13,12,2.866667,0,0,23,11,false,true,true,0.6,0.4
297,155,142,24.75,14.090909,142,303,342,-39,0,0,0,0,23,12,11,1.652174,0,0,14,12,false,true,true,1,0
57,20,37,28.5,20,37,1513,1479,34,0,0,0,0,88,2,1,0.386364,1,0,16,9,false,true,true,0.929,0.071
56,37,19,18.666667,18.5,19,2219,2029,190,0,0,0,0,82,3,2,0.317073,1,0,9,9,false,true,true,0.735,0.265
14,9,5,14,9,5,306,169,137,0,0,0,0,93,1,1,0.365591,0,0,22,19,false,true,true,0.712,0.288
334,229,105,23.857143,17.615385,105,596,595,1,1,0,0.071429,0,8,14,13,5,0,0,7,22,false,true,true,1,0
144,101,43,20.571429,14.428571,43,786,788,-2,0,0,0,0,43,7,7,0.790698,0,0,11,16,false,true,true,0.915,0.085
221,243,-22,17,18.692308,-22,1176,1127,49,0,0,0,0,9,13,13,4.111111,0,0,21,15,false,true,false,0.202,0.798
346,308,38,28.833333,25.666667,38,1454,1531,-77,1,1,0.083333,0.083333,2,12,12,15,0,0,11,8,false,true,true,1,0
98,33,65,24.5,11,65,1270,1348,-78,0,0,0,0,78,4,3,0.487179,1,0,13,17,false,true,true,0.87,0.13
175,149,26,25,21.285714,26,1034,1040,-6,0,0,0,0,50,7,7,0.7,0,0,14,18,false,true,true,0.754,0.246
181,206,-25,15.083333,17.166667,-25,262,306,-44,0,0,0,0,27,12,12,1.703704,0,0,12,17,false,true,false,0.179,0.821
127,139,-12,14.111111,17.375,-12,450,412,38,0,0,0,0,39,9,8,0.974359,0,0,11,10,false,true,false,0.409,0.591
242,105,137,40.333333,21,137,1880,1777,103,1,0,0.166667,0,51,6,5,0.54902,0,1,11,19,false,true,true,1,0
85,41,44,21.25,13.666667,44,904,783,121,0,0,0,0,75,4,3,0.56,1,0,11,23,false,true,true,0.912,0.088
274,228,46,22.833333,19,46,1075,1152,-77,0,1,0,0.083333,16,12,12,2.5,0,0,11,15,false,true,true,0.949,0.051
16,36,-20,16,36,-20,1023,1110,-87,0,0,0,0,90,1,1,0.333333,0,1,10,15,false,true,false,0.037,0.963
322,231,91,21.466667,15.4,91,580,620,-40,1,0,0.066667,0,5,15,15,8.6,0,0,11,14,false,true,true,1,0
331,312,19,23.642857,22.285714,19,971,1180,-209,1,1,0.071429,0.071429,0,14,14,0,0,0,15,4,false,true,true,0.849,0.151
294,226,68,19.6,15.066667,68,746,796,-50,0,1,0,0.066667,5,15,15,9.6,0,1,16,14,false,true,true,0.984,0.016
341,245,96,28.416667,22.272727,96,1803,1552,251,1,2,0.083333,0.181818,8,12,11,3.5,0,0,7,26,false,true,true,1,0
358,332,26,25.571429,23.714286,26,907,752,155,0,1,0,0.071429,2,14,14,16.5,0,0,7,14,false,true,true,1,0
145,123,22,20.714286,17.571429,22,904,783,121,0,0,0,0,58,7,7,0.724138,0,0,14,20,false,true,true,0.519,0.481
52,82,-30,10.4,16.4,-30,1037,950,87,0,0,0,0,68,5,5,0.455882,1,0,8,11,false,true,false,0.276,0.724
203,192,11,16.916667,17.454545,11,704,691,13,0,0,0,0,26,12,11,1.461538,1,0,9,7,false,true,true,0.863,0.137
158,122,36,19.75,17.428571,36,1397,1422,-25,1,0,0.125,0,57,8,7,0.631579,0,2,7,8,false,true,false,0.426,0.574
125,102,23,17.857143,17,23,947,909,38,0,0,0,0,60,7,6,0.766667,1,0,9,32,false,true,true,0.513,0.487
278,235,43,18.533333,16.785714,43,1221,1438,-217,0,0,0,0,19,15,14,2.368421,0,1,20,7,false,true,true,0.875,0.125
368,279,89,21.647059,17.4375,89,1305,1218,87,1,0,0.058824,0,-22,17,16,-1.727273,0,0,2,5,false,true,true,1,0
313,212,101,26.083333,19.272727,101,1394,1118,276,0,1,0,0.090909,17,12,11,2.176471,0,0,10,13,false,true,true,1,0
410,333,77,31.538462,27.75,77,1826,1656,170,2,0,0.153846,0,-4,13,12,-6.75,0,0,4,1,false,true,true,1,0
67,121,-54,16.75,30.25,-54,719,785,-66,0,1,0,0.25,70,4,4,0.514286,0,0,9,7,false,true,false,0.212,0.788
264,174,90,26.4,17.4,90,1014,948,66,1,0,0.1,0,32,10,10,1.03125,0,0,8,20,false,true,true,1,0
301,270,31,21.5,20.769231,31,315,294,21,0,1,0,0.076923,-5,14,13,-7,0,0,14,10,false,true,true,0.934,0.066
348,265,83,19.333333,15.588235,83,691,473,218,0,0,0,0,-19,18,17,-1.894737,1,0,0,1,false,true,true,1,0
211,170,41,19.181818,15.454545,41,786,788,-2,0,0,0,0,17,11,11,2,1,1,7,12,false,true,true,0.952,0.048
196,191,5,21.777778,21.222222,5,1304,1040,264,1,0,0.111111,0,37,9,9,0.891892,0,0,18,17,false,true,false,0.286,0.714
18,17,1,9,17,1,1156,1114,42,0,0,0,0,87,2,1,0.367816,1,0,6,9,false,true,true,0.677,0.323
174,164,10,15.818182,14.909091,10,540,518,22,0,0,0,0,29,11,11,1.37931,0,0,10,14,false,true,true,0.819,0.181
41,38,3,13.666667,19,3,1128,889,239,0,1,0,0.5,81,3,2,0.580247,1,0,7,7,false,true,true,0.968,0.032
156,101,55,19.5,14.428571,55,786,788,-2,0,0,0,0,40,8,7,0.85,0,0,11,16,false,true,true,0.927,0.073
87,46,41,17.4,11.5,41,1253,1166,87,0,0,0,0,71,5,4,0.605634,1,0,9,21,false,true,true,0.712,0.288
22,29,-7,7.333333,14.5,-7,1100,1008,92,0,0,0,0,88,3,2,0.409091,0,0,18,9,false,true,true,0.559,0.441
395,348,47,32.916667,31.636364,47,2219,2106,113,2,0,0.166667,0,-6,12,11,-4.5,0,0,8,10,false,true,true,1,0
95,107,-12,19,21.4,-12,1189,1266,-77,0,0,0,0,67,5,5,0.507463,1,0,17,10,false,true,true,0.642,0.358
40,0,40,40,0,40,866,949,-83,0,0,0,0,95,1,0,0.421053,0,0,13,0,false,true,false,0.353,0.647
99,98,1,19.8,24.5,1,758,952,-194,0,0,0,0,61,5,4,0.655738,0,1,14,6,false,true,false,0.229,0.771
435,288,147,16.111111,10.666667,147,1176,1076,100,0,0,0,0,-29,27,27,-2.034483,0,0,3,3,false,true,true,1,0
347,261,86,24.785714,18.642857,86,1034,1040,-6,1,0,0.071429,0,3,14,14,11.666667,1,0,7,10,false,true,true,1,0
41,118,-77,13.666667,39.333333,-77,1762,1538,224,0,1,0,0.333333,76,3,3,0.447368,0,0,14,10,false,true,true,0.997,0.003
53,38,15,17.666667,19,15,1297,1606,-309,0,0,0,0,83,3,2,0.361446,1,0,13,20,false,true,false,0.251,0.749
167,178,-11,15.181818,17.8,-11,272,238,34,0,0,0,0,30,11,10,1.333333,0,0,10,11,false,true,false,0.13,0.87
382,326,56,18.190476,16.3,56,580,620,-40,1,0,0.047619,0,-28,21,20,-1.535714,0,0,1,1,false,true,true,1,0
302,271,31,30.2,27.1,31,1075,1009,66,2,0,0.2,0,22,10,10,1.454545,0,0,19,9,false,true,true,0.864,0.136
86,68,18,21.5,17,18,1245,1232,13,1,0,0.25,0,65,4,4,0.446154,0,0,18,9,false,true,true,0.695,0.305
324,310,14,17.052632,16.315789,14,942,976,-34,0,0,0,0,-23,19,19,-1.73913,0,0,1,5,false,true,true,1,0
93,51,42,31,17,42,838,786,52,0,0,0,0,79,3,3,0.405063,0,0,8,7,false,true,true,0.836,0.164
29,44,-15,14.5,22,-15,1501,1622,-121,0,0,0,0,86,2,2,0.360465,1,0,18,25,false,true,true,0.596,0.404
162,136,26,27,22.666667,26,948,933,15,1,0,0.166667,0,58,6,6,0.655172,0,0,7,14,false,true,true,0.86,0.14
379,368,11,23.6875,23,11,907,752,155,0,1,0,0.0625,-10,16,16,-3.3,0,0,3,4,false,true,true,1,0
39,34,5,19.5,34,5,907,752,155,0,0,0,0,92,2,1,0.358696,0,0,9,12,false,true,true,0.554,0.446
213,152,61,23.666667,16.888889,61,1022,1095,-73,0,0,0,0,34,9,9,0.970588,0,1,16,11,false,true,true,0.933,0.067
101,159,-58,14.428571,26.5,-58,1154,1062,92,0,0,0,0,58,7,6,0.603448,0,0,9,16,false,true,false,0.186,0.814
233,227,6,17.923077,17.461538,6,859,786,73,0,0,0,0,12,13,13,3.166667,0,0,18,10,false,true,true,0.679,0.321
184,157,27,30.666667,26.166667,27,1710,1636,74,1,1,0.166667,0.166667,53,6,6,0.679245,1,0,20,11,false,true,true,0.986,0.014
86,80,6,21.5,20,6,1691,1692,-1,0,0,0,0,66,4,4,0.454545,0,0,13,7,false,true,true,0.677,0.323
43,42,1,14.333333,21,1,825,907,-82,0,0,0,0,81,3,2,0.493827,2,0,12,7,false,true,true,0.931,0.069
261,264,-3,14.5,14.666667,-3,480,518,-38,0,0,0,0,-5,18,18,-9.2,1,0,6,16,false,true,true,0.722,0.278
10,17,-7,10,17,-7,658,817,-159,0,0,0,0,95,1,1,0.4,0,0,21,7,false,true,false,0.251,0.749
218,180,38,14.533333,12,38,584,565,19,0,0,0,0,3,15,15,15.333333,0,0,20,17,false,true,true,0.934,0.066
107,54,53,21.4,13.5,53,613,461,152,0,0,0,0,67,5,4,0.552239,0,1,7,15,false,true,true,0.845,0.155
101,91,10,20.2,22.75,10,2219,2029,190,0,0,0,0,64,5,4,0.40625,1,0,12,9,false,true,true,0.578,0.422
68,50,18,17,12.5,18,1047,1094,-47,0,0,0,0,73,4,4,0.493151,0,1,11,18,false,true,false,0.295,0.705
170,124,46,18.888889,15.5,46,847,952,-105,0,0,0,0,53,9,8,0.679245,0,1,10,17,false,true,false,0.496,0.504
313,227,86,22.357143,16.214286,86,371,336,35,2,0,0.142857,0,-13,14,14,-2.923077,0,0,7,16,false,true,true,1,0
311,297,14,25.916667,24.75,14,1439,1397,42,1,2,0.083333,0.166667,3,12,12,11.333333,0,0,20,23,false,true,true,0.896,0.104
180,128,52,20,14.222222,52,566,542,24,0,0,0,0,38,9,9,1.078947,0,1,19,8,false,true,true,0.944,0.056
258,211,47,23.454545,21.1,47,1489,1445,44,0,0,0,0,25,11,10,1.28,1,0,8,16,false,true,true,0.926,0.074
331,311,20,19.470588,19.4375,20,1115,1078,37,0,1,0,0.0625,-12,17,16,-2.833333,1,0,3,5,false,true,true,0.967,0.033
278,195,83,19.857143,15,83,576,532,44,0,0,0,0,16,14,13,2.875,0,0,9,7,false,true,true,0.984,0.016
275,226,49,22.916667,20.545455,49,948,933,15,1,0,0.083333,0,28,12,11,1.357143,0,0,9,15,false,true,true,0.896,0.104
185,91,94,37,18.2,94,1054,917,137,0,0,0,0,57,5,5,0.614035,0,0,7,9,false,true,true,0.946,0.054
212,204,8,17.666667,17,8,448,598,-150,0,0,0,0,14,12,12,2.571429,0,0,19,13,false,true,true,0.77,0.23
52,44,8,26,22,8,1050,1144,-94,0,0,0,0,83,2,2,0.457831,0,0,7,8,false,true,true,0.59,0.41
170,94,76,28.333333,18.8,76,630,786,-156,1,0,0.166667,0,57,6,5,0.614035,0,0,23,14,false,true,true,0.838,0.162
135,49,86,33.75,16.333333,86,742,696,46,0,0,0,0,70,4,3,0.457143,0,1,16,11,false,true,true,0.849,0.151
208,176,32,20.8,17.6,32,820,822,-2,0,0,0,0,32,10,10,1.21875,0,0,14,9,false,true,true,0.962,0.038
256,208,48,15.058824,13,48,871,999,-128,0,0,0,0,4,17,16,12,0,0,10,9,false,true,true,0.748,0.252
385,285,100,18.333333,13.571429,100,844,821,23,0,0,0,0,-12,21,21,-3.5,0,0,3,4,true,true,true,1,0
255,175,80,23.181818,15.909091,80,1004,653,351,0,0,0,0,17,11,11,2.058824,0,1,11,24,false,true,true,0.965,0.035
23,10,13,11.5,10,13,1270,1348,-78,0,0,0,0,93,2,1,0.408602,0,0,14,12,false,true,false,0.294,0.706
209,225,-16,19,20.454545,-16,947,810,137,0,1,0,0.090909,28,11,11,1.5,0,0,18,14,false,true,false,0.38,0.62
277,266,11,25.181818,24.181818,11,1331,1399,-68,0,0,0,0,15,11,11,2.333333,0,0,16,9,false,true,false,0.425,0.575
27,29,-2,13.5,14.5,-2,1572,1550,22,0,0,0,0,87,2,2,0.448276,0,0,8,10,false,true,true,0.662,0.338
297,221,76,27,22.1,76,1305,1218,87,1,0,0.090909,0,21,11,10,1.809524,0,0,17,8,false,true,true,0.997,0.003
16,20,-4,16,20,-4,1513,1479,34,0,0,0,0,91,1,1,0.373626,0,0,25,9,false,true,true,0.678,0.322
303,262,41,30.3,26.2,41,1659,1782,-123,1,0,0.1,0,13,10,10,2.230769,0,1,14,16,false,true,true,0.993,0.007
216,123,93,24,15.375,93,859,811,48,0,0,0,0,40,9,8,0.9,0,1,17,7,false,true,true,0.971,0.029
188,185,3,15.666667,15.416667,3,540,518,22,0,0,0,0,22,12,12,1.818182,0,0,11,11,false,true,true,0.756,0.244
332,208,124,19.529412,13,124,1281,1339,-58,0,0,0,0,5,17,16,8.2,0,0,15,8,false,true,true,1,0
153,123,30,19.125,17.571429,30,904,783,121,0,0,0,0,55,8,7,0.763636,0,0,18,20,false,true,false,0.432,0.568
122,194,-72,17.428571,27.714286,-72,947,810,137,0,1,0,0.142857,48,7,7,0.875,0,0,29,10,false,true,false,0.193,0.807
165,77,88,41.25,19.25,88,1510,1583,-73,1,0,0.25,0,63,4,4,0.507937,0,1,21,6,false,true,true,0.849,0.151
64,12,52,32,6,52,1115,1078,37,0,0,0,0,85,2,2,0.4,0,0,22,15,false,true,true,0.843,0.157
33,51,-18,11,17,-18,831,830,1,0,0,0,0,80,3,3,0.4625,0,0,11,14,false,true,true,0.536,0.464
87,74,13,21.75,18.5,13,1167,1216,-49,0,0,0,0,73,4,4,0.561644,1,0,13,26,false,true,true,0.644,0.356
264,182,82,24,16.545455,82,1014,1303,-289,1,0,0.090909,0,21,11,11,1.809524,0,0,19,11,false,true,true,0.871,0.129
285,243,42,17.8125,16.2,42,468,542,-74,0,0,0,0,-1,16,15,-39,0,0,16,8,false,true,true,0.975,0.025
81,61,20,20.25,20.333333,20,758,952,-194,0,0,0,0,69,4,3,0.57971,0,1,10,14,false,true,false,0.25,0.75
154,197,-43,25.666667,32.833333,-43,1489,1558,-69,0,1,0,0.166667,57,6,6,0.491228,0,0,13,8,false,true,false,0.202,0.798
449,307,142,28.0625,20.466667,142,1519,1782,-263,2,0,0.125,0,-9,16,15,-3.666667,0,0,2,2,false,true,true,1,0
97,16,81,48.5,16,81,1216,1230,-14,1,0,0.5,0,86,2,1,0.372093,0,0,23,10,false,true,true,0.83,0.17
255,244,11,19.615385,18.769231,11,349,315,34,0,0,0,0,-3,13,13,-11.333333,0,0,17,15,false,true,true,0.882,0.118
275,269,6,22.916667,22.416667,6,976,965,11,1,0,0.083333,0,6,12,12,5.333333,1,0,11,12,false,true,true,0.882,0.118
171,161,10,28.5,26.833333,10,1004,840,164,1,0,0.166667,0,51,6,6,0.588235,1,0,8,13,false,true,true,0.782,0.218
74,8,66,37,8,66,1075,1152,-77,0,0,0,0,85,2,1,0.470588,0,1,16,19,false,true,false,0.479,0.521
199,146,53,18.090909,13.272727,53,299,315,-16,0,0,0,0,29,11,11,1.448276,0,0,7,11,false,true,true,0.883,0.117
424,231,193,24.941176,14.4375,193,1482,1554,-72,1,0,0.058824,0,-13,17,16,-2.769231,0,1,3,8,false,true,true,1,0
262,245,17,18.714286,18.846154,17,947,810,137,0,1,0,0.076923,11,14,13,3.818182,1,0,10,15,false,true,true,0.683,0.317
57,37,20,19,12.333333,20,939,913,26,0,0,0,0,83,3,3,0.481928,0,0,12,7,false,true,true,0.733,0.267
371,258,113,19.526316,13.578947,113,596,595,1,1,0,0.052632,0,-19,19,19,-2.105263,0,0,1,11,false,true,true,1,0
22,0,22,22,0,22,1431,802,629,0,0,0,0,94,1,0,0.340426,0,0,24,0,false,true,true,1,0
90,27,63,30,13.5,63,1586,1782,-196,0,0,0,0,81,3,2,0.493827,0,0,19,8,false,true,true,0.658,0.342
164,197,-33,18.222222,24.625,-33,1181,1149,32,0,1,0,0.125,47,9,8,0.957447,0,0,19,22,false,true,false,0.199,0.801
287,242,45,22.076923,18.615385,45,901,1159,-258,2,0,0.153846,0,10,13,13,3.5,1,0,16,7,false,true,false,0.456,0.544
101,66,35,14.428571,11,35,880,952,-72,0,0,0,0,58,7,6,0.706897,0,0,10,18,false,true,false,0.358,0.642
217,241,-24,19.727273,21.909091,-24,771,754,17,0,0,0,0,24,11,11,1.333333,0,1,11,16,false,true,false,0.008,0.992
272,144,128,19.428571,11.076923,128,595,543,52,0,0,0,0,19,14,13,2.473684,0,0,12,14,false,true,true,1,0
326,279,47,16.3,14.684211,47,468,542,-74,0,0,0,0,-19,20,19,-2.052632,0,0,2,1,true,true,true,1,0
69,58,11,17.25,19.333333,11,892,788,104,0,0,0,0,77,4,3,0.558442,1,0,13,22,false,true,true,0.628,0.372
321,316,5,18.882353,18.588235,5,885,719,166,0,0,0,0,-12,17,17,-3.166667,0,0,6,8,false,true,true,0.983,0.017
198,164,34,22,18.222222,34,1388,1477,-89,1,0,0.111111,0,36,9,9,1.333333,0,0,13,11,false,true,true,0.852,0.148
373,288,85,28.692308,22.153846,85,1245,1241,4,2,1,0.153846,0.076923,-14,13,13,-2.071429,0,0,6,2,false,true,true,1,0
313,226,87,14.227273,10.272727,87,416,222,194,0,0,0,0,-25,22,22,-2.2,0,0,12,11,false,true,true,1,0
22,0,22,22,0,22,1556,1591,-35,0,0,0,0,95,1,0,0.378947,0,0,24,0,false,true,true,0.679,0.321
122,77,45,40.666667,25.666667,45,1210,1252,-42,1,0,0.333333,0,77,3,3,0.415584,0,0,9,11,false,true,true,0.742,0.258
29,34,-5,9.666667,17,-5,448,598,-150,0,0,0,0,86,3,2,0.418605,0,0,8,8,false,true,false,0.251,0.749
454,307,147,26.705882,18.058824,147,1270,1322,-52,1,0,0.058824,0,-16,17,17,-2.375,0,0,3,4,false,true,true,1,0
272,196,76,24.727273,19.6,76,1388,1506,-118,2,1,0.181818,0.1,30,11,10,1.133333,0,0,11,25,false,true,true,0.997,0.003
338,164,174,16.9,8.631579,174,859,719,140,0,1,0,0.052632,-22,20,19,-2.409091,0,1,24,11,false,true,true,1,0
67,111,-44,16.75,27.75,-44,613,611,2,0,0,0,0,69,4,4,0.550725,0,0,12,13,false,true,false,0.199,0.801
258,150,108,32.25,18.75,108,971,621,350,2,0,0.25,0,36,8,8,0.888889,0,0,17,13,false,true,true,0.999,0.001
36,50,-14,18,25,-14,1406,1454,-48,0,0,0,0,82,2,2,0.414634,0,0,16,16,false,true,true,0.658,0.342
114,57,57,38,19,57,1220,1261,-41,1,0,0.333333,0,79,3,3,0.56962,0,0,11,11,false,true,true,0.822,0.178
51,50,1,10.2,12.5,1,904,857,47,0,0,0,0,69,5,4,0.594203,0,1,32,15,false,true,true,0.642,0.358
159,94,65,26.5,15.666667,65,904,668,236,0,0,0,0,56,6,6,0.607143,0,0,11,12,false,true,true,0.949,0.051
12,0,12,12,0,12,939,913,26,0,0,0,0,97,1,0,0.412371,0,0,16,0,false,true,true,0.674,0.326
265,275,-10,18.928571,19.642857,-10,901,889,12,0,1,0,0.071429,11,14,14,3.909091,0,0,23,8,false,true,true,0.751,0.249
178,104,74,29.666667,17.333333,74,769,527,242,1,0,0.166667,0,51,6,6,0.705882,0,0,13,8,false,true,true,0.97,0.03
288,287,1,18,17.9375,1,859,786,73,0,0,0,0,-8,16,16,-4.75,0,0,11,11,false,true,true,0.704,0.296
285,204,81,15,11.333333,81,498,43,455,0,0,0,0,-18,19,18,-2.055556,0,0,4,3,true,true,true,1,0
305,292,13,25.416667,24.333333,13,1154,1062,92,2,0,0.166667,0,15,12,12,2.333333,0,0,19,9,false,true,true,0.941,0.059
109,168,-59,18.166667,28,-59,594,605,-11,0,0,0,0,62,6,6,0.596774,1,0,11,10,false,true,false,0.003,0.997
274,196,78,15.222222,11.529412,78,584,565,19,0,0,0,0,-11,18,17,-4.181818,0,0,20,15,false,true,true,1,0
335,307,28,18.611111,17.055556,28,921,1072,-151,1,0,0.055556,0,-12,18,18,-3.166667,0,0,2,4,false,true,true,1,0
277,243,34,23.083333,22.090909,34,758,796,-38,0,0,0,0,18,12,11,2.111111,0,0,11,10,false,true,true,0.887,0.113
12,16,-4,12,16,-4,1077,1094,-17,0,0,0,0,91,1,1,0.461538,0,0,12,21,false,true,true,0.632,0.368
53,45,8,17.666667,15,8,1047,1094,-47,0,0,0,0,79,3,3,0.455696,0,1,7,18,false,true,false,0.256,0.744
263,170,93,18.785714,12.142857,93,1586,1782,-196,0,0,0,0,10,14,14,4,1,0,12,17,false,true,true,1,0
22,10,12,22,10,12,1210,1253,-43,0,0,0,0,90,1,1,0.388889,0,0,17,9,false,true,true,0.68,0.32
203,198,5,33.833333,33,5,1454,1531,-77,1,1,0.166667,0.166667,48,6,6,0.625,0,0,11,7,false,true,true,0.684,0.316
160,108,52,26.666667,18,52,1210,1253,-43,0,1,0,0.166667,51,6,6,0.686275,0,1,12,9,false,true,true,0.848,0.152
245,184,61,17.5,13.142857,61,272,288,-16,0,0,0,0,26,14,14,2,0,0,8,15,false,true,true,0.876,0.124
83,68,15,16.6,13.6,15,856,897,-41,0,0,0,0,65,5,5,0.538462,1,0,11,7,false,true,true,0.74,0.26
252,224,28,18,17.230769,28,885,719,166,0,0,0,0,10,14,13,3.8,0,0,10,13,false,true,true,0.762,0.238
118,87,31,16.857143,14.5,31,739,480,259,1,0,0.142857,0,56,7,6,0.642857,0,0,31,10,false,true,true,0.965,0.035
252,249,3,21,20.75,3,901,889,12,0,1,0,0.083333,24,12,12,1.791667,0,0,14,8,false,true,true,0.764,0.236
224,156,68,20.363636,15.6,68,1159,1051,108,0,0,0,0,33,11,10,1.212121,0,0,7,12,false,true,true,0.926,0.074
148,70,78,37,23.333333,78,820,783,37,0,0,0,0,75,4,3,0.44,0,0,9,9,false,true,true,0.879,0.121
348,262,86,21.75,16.375,86,527,581,-54,0,0,0,0,-9,16,16,-4.666667,0,0,7,14,false,true,true,1,0
63,74,-11,12.6,14.8,-11,448,598,-150,0,0,0,0,66,5,5,0.545455,0,0,11,11,false,true,false,0.252,0.748
187,209,-22,18.7,23.222222,-22,947,810,137,0,1,0,0.111111,37,10,9,1.135135,0,0,22,13,false,true,false,0.206,0.794
273,157,116,30.333333,17.444444,116,1482,1394,88,2,0,0.222222,0,37,9,9,0.972973,0,0,8,10,false,true,true,1,0
360,279,81,22.5,18.6,81,1127,1075,52,1,1,0.0625,0.066667,-10,16,15,-3.1,0,1,6,2,true,true,true,1,0
255,203,52,36.428571,29,52,1645,1777,-132,2,0,0.285714,0,32,7,7,0.78125,0,0,12,9,false,true,true,0.923,0.077
127,71,56,21.166667,11.833333,56,1482,1554,-72,0,0,0,0,64,6,6,0.5625,1,0,6,19,false,true,true,0.909,0.091
277,249,28,25.181818,24.9,28,1331,1399,-68,0,0,0,0,19,11,10,1.842105,0,0,16,12,false,true,false,0.405,0.595
105,114,-9,17.5,19,-9,316,306,10,0,2,0,0.333333,59,6,6,0.644068,0,1,8,13,false,true,true,0.999,0.001
127,115,12,15.875,16.428571,12,699,448,251,0,0,0,0,55,8,7,0.727273,0,1,12,12,false,true,false,0.265,0.735
223,177,46,24.777778,22.125,46,902,866,36,0,0,0,0,30,9,8,1.066667,0,0,8,11,false,true,true,0.876,0.124
236,150,86,29.5,18.75,86,1156,1114,42,1,0,0.125,0,32,8,8,1,0,1,16,23,false,true,true,0.892,0.108
355,307,48,25.357143,21.928571,48,1554,1622,-68,2,0,0.142857,0,-10,14,14,-3.1,0,0,7,4,false,true,true,1,0
50,33,17,25,16.5,17,1530,1550,-20,0,0,0,0,85,2,2,0.4,0,0,19,8,false,true,true,0.683,0.317
162,154,8,27,30.8,8,1434,1493,-59,1,0,0.166667,0,48,6,5,0.770833,1,0,8,17,false,true,true,0.635,0.365
73,65,8,24.333333,21.666667,8,1501,1622,-121,0,0,0,0,79,3,3,0.392405,1,0,10,28,false,true,true,0.695,0.305
329,213,116,15.666667,10.65,116,1428,1302,126,0,0,0,0,-17,21,20,-3.117647,0,1,14,13,false,true,true,1,0
281,223,58,20.071429,17.153846,58,1221,1258,-37,1,0,0.071429,0,18,14,13,2.166667,0,0,10,14,false,true,true,0.978,0.022
232,231,1,19.333333,21,1,1530,1550,-20,0,1,0,0.090909,19,12,11,1.789474,1,0,18,10,false,true,false,0.352,0.648
42,20,22,21,20,22,719,651,68,0,0,0,0,92,2,1,0.48913,1,0,24,13,false,true,true,0.784,0.216
74,0,74,74,0,74,1270,1322,-52,1,0,1,0,93,1,0,0.408602,0,0,16,0,false,true,false,0.315,0.685
286,207,79,17.875,12.9375,79,691,675,16,0,0,0,0,-3,16,16,-12.666667,0,0,11,16,false,true,true,1,0
152,136,16,21.714286,22.666667,16,771,754,17,0,0,0,0,49,7,6,0.653061,0,0,12,21,false,true,false,0.498,0.502
190,89,101,23.75,12.714286,101,1586,1782,-196,0,0,0,0,50,8,7,0.8,1,0,10,7,false,true,true,0.968,0.032
12,22,-10,12,22,-10,1148,1164,-16,0,0,0,0,91,1,1,0.274725,0,0,17,12,false,true,true,0.676,0.324
287,205,82,19.133333,13.666667,82,1295,1477,-182,2,0,0.133333,0,12,15,15,3.833333,1,0,15,13,false,true,true,1,0
262,263,-1,26.2,26.3,-1,1885,1846,39,1,1,0.1,0.1,18,10,10,1.611111,1,0,25,7,false,true,true,0.951,0.049
36,8,28,18,8,28,859,719,140,0,0,0,0,88,2,1,0.602273,0,0,12,10,false,true,true,0.701,0.299
293,244,49,22.538462,20.333333,49,809,868,-59,1,0,0.076923,0,12,13,12,2.666667,1,0,9,7,false,true,true,0.92,0.08
357,286,71,16.227273,13.619048,71,416,374,42,0,0,0,0,-21,22,21,-2.190476,0,0,1,2,false,true,true,1,0
187,176,11,17,17.6,11,695,523,172,0,0,0,0,21,11,10,1.761905,0,0,21,20,false,true,false,0.468,0.532
133,166,-33,12.090909,15.090909,-33,480,518,-38,0,0,0,0,38,11,11,1.210526,0,1,19,7,false,true,false,0.052,0.948
20,26,-6,20,26,-6,1406,1454,-48,0,0,0,0,91,1,1,0.373626,0,0,14,14,false,true,true,0.677,0.323
384,253,131,27.428571,19.461538,131,1489,1445,44,1,0,0.071429,0,3,14,13,10.666667,0,0,7,10,false,true,true,1,0
8,24,-16,8,24,-16,926,854,72,0,0,0,0,92,1,1,0.369565,0,0,9,20,false,true,false,0.278,0.722
201,228,-27,15.461538,17.538462,-27,719,614,105,0,1,0,0.076923,12,13,13,3.583333,0,0,23,8,false,true,false,0.488,0.512
297,289,8,22.846154,22.230769,8,992,1100,-108,2,0,0.153846,0,9,13,13,3.777778,0,0,17,16,false,true,false,0.281,0.719
308,288,20,20.533333,20.571429,20,1115,1078,37,0,1,0,0.071429,2,15,14,17,1,0,6,10,false,true,true,0.812,0.188
257,240,17,16.0625,16,17,262,306,-44,0,0,0,0,1,16,15,46,0,0,7,13,false,true,false,0.27,0.73
146,130,16,29.2,32.5,16,1782,1512,270,1,1,0.2,0.25,64,5,4,0.65625,0,0,13,7,false,true,true,1,0
178,133,45,19.777778,16.625,45,1164,1201,-37,0,0,0,0,39,9,8,1.076923,0,1,18,8,false,true,true,0.847,0.153
40,0,40,20,0,40,1762,1582,180,0,0,0,0,94,2,1,0.340426,0,1,15,8,false,true,true,0.753,0.247
286,268,18,17.875,16.75,18,864,808,56,1,0,0.0625,0,-20,16,16,-1.7,0,0,10,5,false,true,true,0.97,0.03
343,360,-17,22.866667,24,-17,809,868,-59,2,1,0.133333,0.066667,-12,15,15,-2.666667,1,0,0,4,false,true,true,0.866,0.134
57,30,27,28.5,15,27,1210,1253,-43,0,0,0,0,84,2,2,0.416667,0,0,7,11,false,true,true,0.704,0.296
73,88,-15,14.6,22,-15,95,360,-265,0,1,0,0.25,62,5,4,0.645161,0,0,9,9,false,true,false,0.329,0.671
358,264,94,18.842105,14.666667,94,711,876,-165,0,0,0,0,-12,19,18,-3.583333,0,0,3,3,false,true,true,1,0
339,315,24,21.1875,21,24,1493,1513,-20,1,0,0.0625,0,-3,16,15,-11,0,1,5,4,false,true,true,0.933,0.067
162,137,25,23.142857,22.833333,25,1266,1144,122,0,0,0,0,52,7,6,0.653846,1,0,9,11,false,true,true,0.851,0.149
84,59,25,21,14.75,25,834,758,76,0,0,0,0,72,4,4,0.5,0,1,11,9,false,true,true,0.813,0.187
178,81,97,35.6,16.2,97,539,500,39,0,0,0,0,53,5,5,0.754717,0,0,9,19,false,true,true,0.971,0.029
48,55,-7,16,27.5,-7,1177,1214,-37,0,0,0,0,81,3,2,0.432099,0,0,17,9,false,true,true,0.672,0.328
70,37,33,17.5,12.333333,33,1089,1063,26,0,0,0,0,80,4,3,0.475,1,0,12,21,false,true,true,0.738,0.262
319,284,35,29,25.818182,35,1659,1782,-123,1,0,0.090909,0,7,11,11,4.142857,0,1,14,11,false,true,true,0.991,0.009
361,349,12,17.190476,16.619048,12,1181,1149,32,0,1,0,0.047619,-22,21,21,-2.045455,0,0,4,1,false,true,true,1,0
14,16,-2,7,16,-2,416,374,42,0,0,0,0,93,2,1,0.494624,0,0,11,9,false,true,false,0.333,0.667
222,173,49,22.2,17.3,49,691,675,16,0,0,0,0,29,10,10,1.275862,0,1,14,13,false,true,true,0.958,0.042
85,96,-11,21.25,32,-11,1305,1218,87,0,0,0,0,71,4,3,0.535211,1,0,9,7,false,true,true,0.883,0.117
420,287,133,28,19.133333,133,1826,1803,23,1,0,0.066667,0,-10,15,15,-3,1,0,2,2,true,true,true,1,0
354,283,71,20.823529,17.6875,71,941,926,15,1,0,0.058824,0,-7,17,16,-5.428571,0,0,8,8,false,true,true,1,0
257,212,45,17.133333,15.142857,45,916,876,40,0,0,0,0,-7,15,14,-4.857143,1,0,6,21,false,true,true,0.998,0.002
236,184,52,21.454545,16.727273,52,1170,1156,14,1,0,0.090909,0,25,11,11,1.52,1,0,8,11,false,true,true,0.971,0.029
361,279,82,22.5625,18.6,82,1036,1181,-145,0,0,0,0,3,16,15,11.333333,1,0,5,11,false,true,true,1,0
152,89,63,25.333333,17.8,63,1093,1090,3,1,0,0.166667,0,64,6,5,0.53125,0,0,11,7,false,true,true,0.912,0.088
409,237,172,34.083333,19.75,172,1550,1624,-74,2,0,0.166667,0,15,12,12,2,1,0,8,8,false,true,true,1,0
267,155,112,24.272727,14.090909,112,303,342,-39,0,0,0,0,28,11,11,1.357143,0,0,18,12,false,true,true,0.994,0.006
184,220,-36,18.4,24.444444,-36,594,605,-11,0,0,0,0,34,10,9,1.088235,0,0,9,7,false,true,false,0.039,0.961
163,110,53,20.375,15.714286,53,527,503,24,0,0,0,0,59,8,7,0.694915,0,0,12,16,false,true,true,0.85,0.15
368,248,120,26.285714,17.714286,120,695,671,24,0,0,0,0,2,14,14,16.5,0,1,7,13,false,true,true,1,0
161,179,-18,16.1,17.9,-18,527,514,13,0,0,0,0,30,10,10,1.3,0,0,7,13,false,true,false,0.132,0.868
254,271,-17,23.090909,24.636364,-17,1431,802,629,0,0,0,0,16,11,11,2,0,1,14,6,false,true,true,0.998,0.002
248,221,27,19.076923,17,27,468,542,-74,0,0,0,0,14,13,13,2.785714,1,0,13,13,false,true,true,0.821,0.179
409,284,125,14.607143,10.142857,125,1413,1422,-9,0,0,0,0,-32,28,28,-1.78125,0,0,3,1,false,true,true,1,0
297,283,14,16.5,15.722222,14,1583,1422,161,1,0,0.055556,0,9,18,18,5.666667,0,0,11,17,false,true,true,1,0
39,33,6,13,11,6,658,817,-159,0,0,0,0,87,3,3,0.436782,0,0,21,10,false,true,false,0.259,0.741
127,79,48,21.166667,15.8,48,272,288,-16,0,0,0,0,62,6,5,0.83871,1,0,13,20,false,true,true,0.713,0.287
200,177,23,15.384615,13.615385,23,698,742,-44,0,0,0,0,30,13,13,1.366667,1,0,6,11,false,true,true,0.727,0.273
90,35,55,45,17.5,55,791,885,-94,1,0,0.5,0,81,2,2,0.469136,0,0,13,16,false,true,true,0.546,0.454
113,102,11,18.833333,17,11,1029,1075,-46,0,0,0,0,60,6,6,0.8,1,0,6,11,false,true,true,0.692,0.308
294,266,28,13.363636,12.090909,28,947,909,38,0,0,0,0,-37,22,22,-1.243243,0,0,1,7,false,true,true,1,0
255,186,69,17,12.4,69,1037,950,87,1,0,0.066667,0,11,15,15,2.818182,0,0,8,18,false,true,true,1,0
9,22,-13,4.5,11,-13,1014,1303,-289,0,0,0,0,87,2,2,0.436782,1,1,14,8,false,true,false,0.251,0.749
101,167,-66,14.428571,23.857143,-66,1154,1062,92,0,0,0,0,55,7,7,0.636364,0,0,9,24,false,true,false,0.167,0.833
126,146,-20,15.75,18.25,-20,1583,1422,161,0,0,0,0,55,8,8,0.927273,1,0,14,9,false,true,true,0.543,0.457
177,103,74,29.5,20.6,74,1256,1232,24,1,0,0.166667,0,58,6,5,0.517241,0,1,16,12,false,true,true,0.848,0.152
12,14,-2,12,14,-2,1073,1177,-104,0,0,0,0,93,1,1,0.344086,0,1,13,25,false,true,false,0.244,0.756
328,308,20,16.4,15.4,20,628,658,-30,0,0,0,0,-16,20,20,-2.875,0,0,6,8,false,true,true,1,0
372,327,45,20.666667,18.166667,45,1452,1469,-17,1,1,0.055556,0.055556,-25,18,18,-1.52,0,0,1,1,false,true,true,1,0
252,220,32,19.384615,18.333333,32,1266,1247,19,0,0,0,0,16,13,12,2,1,0,11,25,false,true,true,0.769,0.231
211,218,-7,23.444444,24.222222,-7,1142,1176,-34,1,0,0.111111,0,32,9,9,1.125,1,0,20,11,false,true,true,0.903,0.097
364,179,185,14,6.884615,185,859,719,140,0,1,0,0.038462,-36,26,26,-1.472222,0,1,11,9,false,true,true,1,0
268,270,-2,22.333333,24.545455,-2,974,995,-21,0,1,0,0.090909,14,12,11,2.357143,1,0,16,14,false,true,true,0.599,0.401
236,271,-35,15.733333,18.066667,-35,1075,989,86,0,0,0,0,14,15,15,2.785714,1,0,6,12,false,true,false,0.383,0.617
257,232,25,25.7,23.2,25,1394,1424,-30,0,1,0,0.1,31,10,10,1.032258,1,0,6,15,false,true,true,0.807,0.193
336,307,29,19.764706,18.058824,29,1094,1030,64,0,0,0,0,-17,17,17,-2.117647,0,0,2,2,false,true,true,1,0
339,257,82,19.941176,16.0625,82,505,95,410,0,1,0,0.0625,2,17,16,22,0,0,7,13,false,true,true,1,0
309,217,92,30.9,24.111111,92,1349,1302,47,0,0,0,0,24,10,9,1.208333,0,0,11,11,false,true,true,1,0
119,51,68,29.75,17,68,769,527,242,1,0,0.25,0,67,4,3,0.537313,0,0,29,7,false,true,true,0.966,0.034
128,151,-23,16,21.571429,-23,856,897,-41,0,0,0,0,43,8,7,0.813953,1,0,6,14,false,true,false,0.183,0.817
407,381,26,27.133333,27.214286,26,1890,2020,-130,1,2,0.066667,0.142857,-16,15,14,-1.8125,0,0,2,1,true,true,true,1,0
176,131,45,25.142857,18.714286,45,1245,1232,13,1,0,0.142857,0,39,7,7,0.74359,1,0,14,12,false,true,true,0.955,0.045
106,108,-2,21.2,27,-2,995,912,83,1,0,0.2,0,75,5,4,0.586667,1,0,11,7,false,true,false,0.214,0.786
284,138,146,40.571429,23,146,1489,1405,84,2,0,0.285714,0,52,7,6,0.538462,0,0,13,8,false,true,true,1,0
309,255,54,20.6,17,54,1551,1550,1,0,0,0,0,-3,15,15,-14,0,1,15,9,false,true,true,0.984,0.016
315,276,39,24.230769,21.230769,39,1331,1399,-68,0,0,0,0,3,13,13,11.666667,0,0,9,11,false,true,true,1,0
28,0,28,28,0,28,1115,1078,37,0,0,0,0,94,1,0,0.361702,0,0,26,0,false,true,true,0.694,0.306
148,121,27,21.142857,20.166667,27,784,758,26,0,0,0,0,48,7,6,0.729167,0,0,13,9,false,true,true,0.714,0.286
112,146,-34,12.444444,18.25,-34,576,494,82,0,0,0,0,46,9,8,0.956522,1,0,15,12,false,true,false,0.258,0.742
325,299,26,19.117647,18.6875,26,1027,856,171,1,1,0.058824,0.0625,-23,17,16,-1.434783,0,0,2,3,true,true,true,0.998,0.002
338,264,74,28.166667,24,74,1394,1424,-30,1,1,0.083333,0.090909,17,12,11,1.882353,1,0,6,11,false,true,true,1,0
110,151,-41,22,37.75,-41,1075,1009,66,0,0,0,0,64,5,4,0.5,0,0,10,17,false,true,false,0.147,0.853
317,257,60,21.133333,18.357143,60,866,949,-83,0,0,0,0,2,15,14,20,1,0,7,13,false,true,true,1,0
189,144,45,15.75,13.090909,45,777,830,-53,0,0,0,0,32,12,11,1.28125,0,0,14,12,false,true,true,0.835,0.165
313,259,54,15.65,12.95,54,698,742,-44,1,0,0.05,0,-15,20,20,-2.733333,0,0,1,3,false,true,true,1,0
248,219,29,22.545455,21.9,29,1047,1094,-47,1,1,0.090909,0.1,28,11,10,1.285714,0,0,21,11,false,true,true,0.968,0.032
332,252,80,18.444444,14,80,695,523,172,0,0,0,0,-17,18,18,-2.176471,0,0,1,7,false,true,true,1,0
271,209,62,27.1,20.9,62,1550,1466,84,1,0,0.1,0,28,10,10,1.321429,0,0,14,10,false,true,true,0.983,0.017
72,58,14,24,29,14,1109,1065,44,0,0,0,0,85,3,2,0.388235,0,0,21,10,false,true,true,0.678,0.322
57,39,18,19,13,18,1045,1009,36,0,0,0,0,82,3,3,0.463415,0,0,10,14,false,true,true,0.702,0.298
190,181,9,15.833333,15.083333,9,500,567,-67,0,0,0,0,34,12,12,1.294118,0,1,9,24,false,true,false,0.074,0.926
0,70,-70,0,70,-70,1030,1144,-114,0,1,0,1,93,1,1,0.376344,0,0,8,12,false,true,false,0.063,0.937
48,34,14,16,11.333333,14,808,812,-4,0,0,0,0,79,3,3,0.468354,0,1,9,7,false,true,false,0.449,0.551
306,304,2,34,38,2,2219,2029,190,0,0,0,0,19,9,8,1.368421,0,0,15,14,false,true,true,1,0
136,188,-52,15.111111,20.888889,-52,1100,1008,92,0,0,0,0,44,9,9,0.818182,2,0,11,17,false,true,true,0.772,0.228
143,199,-56,13,18.090909,-56,1075,989,86,0,0,0,0,37,11,11,1.054054,0,0,23,17,false,true,false,0.157,0.843
93,101,-8,11.625,12.625,-8,658,817,-159,0,0,0,0,55,8,8,0.690909,0,0,32,14,false,true,false,0.3,0.7
377,254,123,22.176471,15.875,123,1394,1230,164,0,1,0,0.0625,-12,17,16,-3.166667,0,1,12,17,false,true,true,1,0
381,268,113,31.75,22.333333,113,1507,1554,-47,1,2,0.083333,0.166667,2,12,12,14.5,0,0,15,13,false,true,true,1,0
302,193,109,27.454545,19.3,109,1030,998,32,1,0,0.090909,0,20,11,10,1.9,0,0,11,10,false,true,true,1,0
314,246,68,28.545455,22.363636,68,1550,1466,84,1,0,0.090909,0,19,11,11,1.947368,0,0,7,10,false,true,true,1,0
297,230,67,37.125,32.857143,67,1770,1689,81,0,1,0,0.142857,28,8,7,0.928571,0,0,10,27,false,true,true,1,0
16,13,3,16,13,3,993,897,96,0,0,0,0,93,1,1,0.505376,1,0,7,8,false,true,true,0.68,0.32
278,221,57,30.888889,27.625,57,1659,1782,-123,1,0,0.111111,0,23,9,8,1.26087,0,1,10,12,false,true,true,0.855,0.145
137,133,4,22.833333,26.6,4,1670,1770,-100,1,1,0.166667,0.2,59,6,5,0.542373,0,0,19,10,false,true,true,0.678,0.322
72,71,1,18,17.75,1,1735,1770,-35,0,0,0,0,64,4,4,0.4375,0,0,9,9,false,true,true,0.672,0.328
210,216,-6,16.153846,16.615385,-6,613,549,64,0,0,0,0,15,13,13,2.933333,1,0,11,12,false,true,true,0.616,0.384
223,150,73,37.166667,25,73,1645,1777,-132,2,0,0.333333,0,42,6,6,0.595238,0,0,7,18,false,true,true,0.977,0.023
279,251,28,16.411765,15.6875,28,801,807,-6,0,0,0,0,-14,17,16,-2.5,0,0,2,2,false,true,true,0.805,0.195
253,212,41,15.8125,13.25,41,698,742,-44,1,0,0.0625,0,10,16,16,4.1,0,0,7,15,false,true,true,0.832,0.168
133,144,-11,16.625,20.571429,-11,916,876,40,0,0,0,0,42,8,7,0.809524,1,0,14,9,false,true,true,0.586,0.414
234,168,66,26,21,66,1109,1065,44,0,0,0,0,30,9,8,1.1,0,0,18,12,false,true,true,0.952,0.048
292,245,47,15.368421,13.611111,47,613,502,111,0,0,0,0,-19,19,18,-2.578947,0,0,6,28,false,true,true,1,0
320,224,96,29.090909,20.363636,96,1167,1216,-49,1,0,0.090909,0,21,11,11,1.952381,0,0,7,8,false,true,true,1,0
72,92,-20,10.285714,15.333333,-20,580,620,-40,0,0,0,0,64,7,6,0.671875,1,0,16,13,false,true,false,0.305,0.695
50,8,42,25,8,42,1530,1550,-20,0,0,0,0,88,2,1,0.386364,0,0,19,8,false,true,true,0.704,0.296
339,194,145,30.818182,19.4,145,1101,1078,23,1,0,0.090909,0,23,11,10,1.434783,0,1,10,10,false,true,true,1,0
436,271,165,33.538462,22.583333,165,1571,1554,17,2,1,0.153846,0.083333,0,13,12,0,1,0,8,9,false,true,true,1,0
324,293,31,23.142857,22.538462,31,974,995,-21,0,1,0,0.076923,4,14,13,8.25,0,0,13,10,false,true,true,0.834,0.166
259,270,-11,17.266667,18,-11,658,817,-159,0,0,0,0,10,15,15,3.8,1,0,8,10,false,true,false,0.21,0.79
293,282,11,15.421053,14.842105,11,262,306,-44,1,0,0.052632,0,-29,19,19,-1.586207,0,0,5,6,false,true,true,0.942,0.058
33,86,-53,16.5,43,-53,1885,1793,92,0,0,0,0,85,2,2,0.317647,0,0,19,12,false,true,false,0.212,0.788
152,170,-18,25.333333,28.333333,-18,1659,1782,-123,1,0,0.166667,0,48,6,6,0.604167,1,0,11,9,false,true,true,0.796,0.204
48,46,2,16,23,2,613,611,2,0,0,0,0,82,3,2,0.463415,0,1,10,13,false,true,false,0.16,0.84
186,74,112,26.571429,12.333333,112,1014,1303,-289,1,0,0.142857,0,52,7,6,0.730769,0,1,17,7,false,true,true,0.62,0.38
22,0,22,22,0,22,1210,1253,-43,0,0,0,0,95,1,0,0.368421,0,0,17,0,false,true,true,0.672,0.328
267,163,104,24.272727,16.3,104,518,533,-15,1,0,0.090909,0,22,11,10,1.590909,0,0,17,10,false,true,true,0.981,0.019
100,117,-17,33.333333,39,-17,1434,1493,-59,1,0,0.333333,0,66,3,3,0.560606,0,0,22,11,false,true,true,0.667,0.333
369,374,-5,21.705882,22,-5,1320,1339,-19,2,1,0.117647,0.058824,-16,17,17,-2.4375,0,0,5,2,false,true,true,0.8,0.2
246,180,66,15.375,11.25,66,947,909,38,0,0,0,0,-6,16,16,-7.666667,0,0,8,32,false,true,true,1,0
26,30,-4,13,15,-4,1548,1493,55,0,0,0,0,83,2,2,0.493976,1,0,8,14,false,true,true,0.779,0.221
326,238,88,16.3,11.9,88,913,871,42,0,0,0,0,-19,20,20,-2.263158,0,0,3,2,false,true,true,1,0
249,169,80,20.75,15.363636,80,576,532,44,0,0,0,0,25,12,11,1.84,0,0,16,7,false,true,true,0.971,0.029
134,62,72,19.142857,8.857143,72,1176,1076,100,0,0,0,0,64,7,7,0.921875,0,1,12,15,false,true,true,0.849,0.151
426,312,114,26.625,19.5,114,1396,1454,-58,2,0,0.125,0,-10,16,16,-3.3,0,0,1,1,false,true,true,1,0
340,246,94,20,14.470588,94,1181,1069,112,0,0,0,0,-15,17,17,-2.466667,0,0,3,3,false,true,true,1,0
175,131,44,21.875,18.714286,44,901,1159,-258,2,0,0.25,0,47,8,7,0.744681,0,0,13,17,false,true,true,0.76,0.24
119,127,-8,13.222222,14.111111,-8,416,374,42,0,0,0,0,52,9,9,0.884615,1,0,9,14,false,true,false,0.474,0.526
416,283,133,23.111111,16.647059,133,1221,1266,-45,1,0,0.055556,0,-24,18,17,-1.458333,0,0,13,5,true,true,true,1,0
284,233,51,23.666667,19.416667,51,1489,1445,44,0,0,0,0,17,12,12,1.882353,1,0,6,7,false,true,true,0.999,0.001
348,265,83,19.333333,14.722222,83,691,473,218,0,0,0,0,-19,18,18,-1.894737,1,0,0,1,true,true,true,1,0
267,112,155,22.25,10.181818,155,993,897,96,1,0,0.083333,0,20,12,11,2.35,0,0,14,19,false,true,true,1,0
293,262,31,18.3125,16.375,31,885,719,166,0,0,0,0,-4,16,16,-9.5,0,0,16,15,false,true,true,0.973,0.027
196,154,42,24.5,22,42,1089,1063,26,1,0,0.125,0,50,8,7,0.76,0,0,18,13,false,true,true,0.954,0.046
357,221,136,17.85,11.05,136,896,818,78,0,1,0,0.05,-14,20,20,-3.142857,1,0,11,7,false,true,true,1,0
37,29,8,12.333333,14.5,8,1127,1075,52,0,0,0,0,85,3,2,0.364706,0,0,7,15,false,true,true,0.606,0.394
290,161,129,20.714286,12.384615,129,925,801,124,1,0,0.071429,0,17,14,13,2.352941,1,0,9,19,false,true,true,1,0
115,57,58,23,14.25,58,786,788,-2,0,0,0,0,63,5,4,0.539683,0,0,12,19,false,true,true,0.869,0.131
227,180,47,18.916667,16.363636,47,859,786,73,0,0,0,0,22,12,11,1.727273,0,0,20,12,false,true,true,0.955,0.045
152,96,56,25.333333,16,56,1093,1090,3,1,0,0.166667,0,61,6,6,0.557377,0,0,11,7,false,true,true,0.947,0.053
254,172,82,25.4,17.2,82,371,336,35,2,0,0.2,0,9,10,10,4.222222,0,0,12,15,false,true,true,0.992,0.008
170,95,75,34,19,75,1270,1322,-52,1,0,0.2,0,64,5,5,0.59375,0,0,19,20,false,true,true,0.967,0.033
367,363,4,20.388889,20.166667,4,1096,1009,87,2,0,0.111111,0,-7,18,18,-6.285714,0,0,12,9,false,true,true,0.505,0.495
375,229,146,23.4375,15.266667,146,742,696,46,0,0,0,0,-18,16,15,-1.777778,0,0,6,2,false,true,true,1,0
142,119,23,23.666667,23.8,23,518,448,70,0,0,0,0,62,6,5,0.548387,0,0,13,12,false,true,true,0.753,0.247
148,142,6,16.444444,15.777778,6,1181,1069,112,0,0,0,0,41,9,9,0.902439,1,0,22,8,false,true,true,0.742,0.258
502,299,203,45.636364,27.181818,203,991,996,-5,3,0,0.272727,0,11,11,11,2.727273,0,0,9,8,false,true,true,1,0
131,94,37,21.833333,15.666667,37,1513,1479,34,0,0,0,0,59,6,6,0.576271,1,0,10,13,false,true,true,0.881,0.119
176,130,46,22,18.571429,46,1556,1591,-35,0,0,0,0,49,8,7,0.734694,1,1,6,15,false,true,true,0.913,0.087
297,226,71,21.214286,16.142857,71,719,651,68,0,1,0,0.071429,18,14,14,2.5,1,0,6,10,false,true,true,0.999,0.001
239,234,5,17.071429,18,5,95,360,-265,0,1,0,0.076923,4,14,13,10,1,0,6,10,false,true,true,0.709,0.291
37,33,4,18.5,16.5,4,885,719,166,0,0,0,0,87,2,2,0.436782,0,1,26,9,false,true,true,0.698,0.302
197,113,84,28.142857,16.142857,84,1216,1230,-14,1,0,0.142857,0,51,7,7,0.627451,1,0,15,9,false,true,true,0.971,0.029
228,115,113,28.5,16.428571,113,1826,1803,23,1,0,0.125,0,44,8,7,0.681818,1,0,7,16,false,true,true,1,0
46,50,-4,23,25,-4,758,952,-194,0,0,0,0,80,2,2,0.5,0,1,11,10,false,true,false,0.234,0.766
244,186,58,22.181818,18.6,58,1493,1513,-20,1,0,0.090909,0,27,11,10,1.222222,0,2,15,14,false,true,true,0.915,0.085
258,147,111,28.666667,16.333333,111,742,696,46,0,0,0,0,33,9,9,0.969697,0,0,12,17,false,true,true,1,0
463,438,25,33.071429,33.692308,25,1885,1793,92,0,0,0,0,-9,14,13,-3,0,0,3,2,true,true,true,1,0
230,199,31,32.857143,33.166667,31,1333,1331,2,1,0,0.142857,0,41,7,6,0.731707,0,0,11,8,false,true,true,0.686,0.314
37,23,14,18.5,11.5,14,1045,1009,36,0,0,0,0,88,2,2,0.431818,0,0,12,15,false,true,true,0.687,0.313
75,109,-34,18.75,27.25,-34,1096,1009,87,0,0,0,0,79,4,4,0.556962,1,0,18,10,false,true,true,0.688,0.312
371,344,27,26.5,26.461538,27,1125,1227,-102,2,1,0.142857,0.076923,-12,14,13,-2.5,0,0,1,6,false,true,true,1,0
71,52,19,17.75,17.333333,19,1394,1118,276,0,0,0,0,72,4,3,0.513889,1,0,9,10,false,true,true,0.831,0.169
386,301,85,22.705882,18.8125,85,977,976,1,2,0,0.117647,0,-14,17,16,-2.428571,0,0,4,4,false,true,true,1,0
156,162,-6,19.5,23.142857,-6,1077,1094,-17,0,0,0,0,50,8,7,0.84,0,0,15,13,false,true,false,0.177,0.823
392,271,121,23.058824,15.941176,121,778,758,20,0,1,0,0.058824,-18,17,17,-2.166667,0,0,3,3,false,true,true,1,0
44,79,-35,11,19.75,-35,1142,1176,-34,0,0,0,0,71,4,4,0.507042,0,0,14,7,false,true,true,0.595,0.405
405,380,25,18.409091,17.272727,25,1096,1009,87,2,0,0.090909,0,-23,22,22,-1.913043,0,0,1,1,true,true,true,0.905,0.095
294,203,91,17.294118,11.941176,91,913,871,42,0,0,0,0,-4,17,17,-10.75,0,1,12,15,false,true,true,1,0
51,52,-1,10.2,13,-1,523,480,43,0,0,0,0,72,5,4,0.458333,0,0,20,10,false,true,true,0.625,0.375
240,207,33,14.117647,12.9375,33,611,584,27,0,0,0,0,6,17,16,7.333333,0,0,9,14,false,true,false,0.456,0.544
23,14,9,11.5,14,9,1176,1076,100,0,0,0,0,93,2,1,0.634409,1,0,10,10,false,true,true,0.683,0.317
257,264,-7,21.416667,24,-7,1096,1009,87,1,0,0.083333,0,33,12,11,1.333333,0,0,7,12,false,true,false,0.117,0.883
128,102,26,32,25.5,26,1793,1897,-104,1,0,0.25,0,72,4,4,0.416667,0,0,7,17,false,true,true,0.587,0.413
107,105,2,21.4,26.25,2,1305,1218,87,0,0,0,0,65,5,4,0.584615,1,1,11,6,false,true,true,0.911,0.089
328,256,72,21.866667,18.285714,72,306,169,137,0,0,0,0,-15,15,14,-2.266667,0,0,4,12,false,true,true,1,0
84,10,74,42,10,74,1220,1261,-41,1,0,0.5,0,89,2,1,0.505618,0,0,10,19,false,true,false,0.394,0.606
37,36,1,9.25,12,1,904,857,47,0,0,0,0,75,4,3,0.546667,0,1,33,16,false,true,true,0.652,0.348
353,298,55,20.764706,17.529412,55,892,819,73,0,1,0,0.058824,-14,17,17,-2.428571,0,0,4,2,true,true,true,1,0
330,214,116,25.384615,16.461538,116,1482,1394,88,2,0,0.153846,0,10,13,13,3.6,0,0,10,8,false,true,true,1,0
315,316,-1,19.6875,19.75,-1,1431,802,629,0,0,0,0,-16,16,16,-2,0,0,2,3,true,true,true,1,0
10,40,-30,3.333333,13.333333,-30,791,774,17,0,0,0,0,88,3,3,0.465909,0,0,11,14,false,true,false,0.071,0.929
182,91,91,45.5,22.75,91,1684,1320,364,1,0,0.25,0,62,4,4,0.483871,0,0,12,12,false,true,true,1,0
275,198,77,27.5,22,77,1556,1591,-35,1,0,0.1,0,29,10,9,1.241379,0,0,12,9,false,true,true,0.987,0.013
377,338,39,25.133333,24.142857,39,1762,1616,146,2,0,0.133333,0,-13,15,14,-2.307692,1,0,2,4,false,true,true,1,0
20,18,2,10,18,2,628,658,-30,0,0,0,0,88,2,1,0.522727,0,0,32,9,false,true,true,0.542,0.458
96,72,24,16,14.4,24,361,493,-132,0,0,0,0,59,6,5,0.694915,0,1,18,25,false,true,false,0.205,0.795
36,18,18,18,9,18,1516,1397,119,0,0,0,0,84,2,2,0.392857,0,1,12,7,false,true,true,0.709,0.291
288,207,81,24,18.818182,81,825,907,-82,1,0,0.083333,0,21,12,11,1.904762,0,0,16,14,false,true,true,0.988,0.012
24,7,17,12,7,17,468,542,-74,0,0,0,0,91,2,1,0.428571,0,0,21,10,false,true,false,0.256,0.744
244,139,105,22.181818,13.9,105,1033,1037,-4,0,1,0,0.1,32,11,10,1.40625,0,0,22,10,false,true,true,0.971,0.029
167,118,49,23.857143,16.857143,49,1127,1075,52,1,0,0.142857,0,49,7,7,0.632653,0,1,13,18,false,true,true,0.847,0.153
314,183,131,28.545455,18.3,131,996,1063,-67,1,1,0.090909,0.1,16,11,10,2,1,0,11,15,false,true,true,1,0
330,284,46,30,28.4,46,1762,1616,146,2,0,0.181818,0,13,11,10,2.307692,1,0,7,8,false,true,true,1,0
323,301,22,16.15,15.842105,22,908,859,49,0,0,0,0,-20,20,19,-1.95,0,0,1,2,true,true,true,1,0
292,258,34,16.222222,15.176471,34,904,857,47,0,0,0,0,-9,18,17,-4.555556,0,0,17,5,false,true,true,0.961,0.039
303,245,58,27.545455,24.5,58,1397,1195,202,1,0,0.090909,0,24,11,10,1.458333,0,1,10,6,false,true,true,0.831,0.169
102,117,-15,20.4,23.4,-15,1266,1144,122,0,0,0,0,59,5,5,0.576271,1,0,15,12,false,true,true,0.796,0.204
227,258,-31,20.636364,23.454545,-31,1305,1242,63,1,1,0.090909,0.090909,25,11,11,1.36,1,0,6,10,false,true,false,0.337,0.663
168,131,37,12.923077,10.076923,37,310,359,-49,0,0,0,0,11,13,13,4.454545,0,0,7,18,false,true,true,0.895,0.105
170,138,32,21.25,17.25,32,691,473,218,0,0,0,0,41,8,8,0.878049,0,0,16,7,false,true,true,0.94,0.06
363,254,109,30.25,21.166667,109,1826,1803,23,1,0,0.083333,0,7,12,12,4.285714,1,0,13,11,false,true,true,1,0
117,168,-51,14.625,24,-51,316,306,10,0,2,0,0.285714,52,8,7,0.730769,0,0,23,10,false,true,true,0.999,0.001
403,284,119,23.705882,17.75,119,1069,917,152,1,1,0.058824,0.0625,-16,17,16,-2.125,0,0,2,1,false,true,true,1,0
210,72,138,42,14.4,138,918,619,299,2,0,0.4,0,62,5,5,0.564516,1,0,6,16,false,true,true,1,0
12,71,-59,12,71,-59,1076,1176,-100,0,1,0,1,88,1,1,0.363636,0,0,8,18,false,true,false,0.199,0.801
276,256,20,18.4,18.285714,20,947,810,137,0,1,0,0.071429,5,15,14,8.4,1,0,8,13,false,true,true,0.702,0.298
171,140,31,19,15.555556,31,804,683,121,0,0,0,0,42,9,9,1.071429,0,1,27,10,false,true,true,0.949,0.051
202,114,88,40.4,22.8,88,1684,1320,364,1,0,0.2,0,56,5,5,0.535714,0,1,11,6,false,true,true,0.92,0.08
66,42,24,16.5,14,24,527,514,13,0,0,0,0,80,4,3,0.4875,0,0,10,12,false,true,false,0.338,0.662
418,233,185,38,23.3,185,1571,1554,17,2,1,0.181818,0.1,11,11,10,3,1,0,13,12,false,true,true,1,0
157,65,92,31.4,16.25,92,1216,1230,-14,1,0,0.2,0,63,5,4,0.507937,0,0,17,11,false,true,true,0.959,0.041
178,87,91,19.777778,10.875,91,954,1078,-124,0,1,0,0.125,41,9,8,0.926829,1,0,10,21,false,true,true,0.97,0.03
310,256,54,15.5,13.473684,54,299,315,-16,0,0,0,0,-32,20,19,-1.3125,0,0,2,5,false,true,true,1,0
316,290,26,19.75,19.333333,26,561,526,35,0,0,0,0,-16,16,15,-2.1875,0,0,8,10,false,true,true,0.978,0.022
115,58,57,28.75,14.5,57,916,837,79,0,0,0,0,77,4,4,0.519481,0,1,11,16,false,true,true,0.847,0.153
221,143,78,31.571429,23.833333,78,1142,1095,47,1,0,0.142857,0,48,7,6,0.729167,0,1,16,16,false,true,true,0.787,0.213
113,71,42,18.833333,14.2,42,847,952,-105,0,0,0,0,69,6,5,0.521739,0,0,10,25,false,true,false,0.417,0.583
289,233,56,28.9,25.888889,56,1397,1195,202,1,0,0.1,0,30,10,9,1.166667,0,1,9,9,false,true,true,0.76,0.24
315,213,102,35,26.625,102,1507,1554,-47,1,2,0.111111,0.25,23,9,8,1.26087,0,0,14,11,false,true,true,1,0
334,272,62,20.875,18.133333,62,306,169,137,0,0,0,0,-22,16,15,-1.545455,0,0,1,7,false,true,true,1,0
336,206,130,21,12.875,130,1586,1782,-196,0,0,0,0,-3,16,16,-13.333333,1,0,13,16,false,true,true,1,0
256,243,13,15.058824,15.1875,13,361,493,-132,1,0,0.058824,0,-20,17,16,-2.05,0,0,6,18,false,true,true,0.767,0.233
187,143,44,26.714286,20.428571,44,901,889,12,0,1,0,0.142857,58,7,7,0.741379,0,0,15,8,false,true,true,0.969,0.031
129,54,75,25.8,13.5,75,1093,1100,-7,1,0,0.2,0,78,5,4,0.410256,0,1,10,9,false,true,false,0.477,0.523
418,263,155,29.857143,20.230769,155,1216,1230,-14,1,0,0.071429,0,4,14,13,8,0,0,7,20,false,true,true,1,0
343,211,132,15.590909,10.047619,132,1069,1040,29,0,0,0,0,-35,22,21,-1.257143,0,0,1,1,false,true,true,1,0
45,6,39,22.5,6,39,777,830,-53,0,0,0,0,87,2,1,0.471264,0,0,14,10,false,true,false,0.425,0.575
44,38,6,22,19,6,1176,1127,49,0,0,0,0,85,2,2,0.435294,0,0,16,11,false,true,true,0.68,0.32
38,49,-11,19,24.5,-11,971,906,65,0,0,0,0,86,2,2,0.372093,0,1,11,13,false,true,true,0.638,0.362
183,150,33,30.5,30,33,1770,1689,81,0,0,0,0,52,6,5,0.5,0,1,8,8,false,true,true,0.538,0.462
339,280,59,19.941176,16.470588,59,1406,1454,-48,0,2,0,0.117647,-11,17,17,-3.090909,0,0,2,11,true,true,true,1,0
347,220,127,18.263158,12.222222,127,871,867,4,0,0,0,0,-15,19,18,-2.866667,0,0,7,9,false,true,true,1,0
311,247,64,18.294118,14.529412,64,1091,1078,13,0,0,0,0,-1,17,17,-43,0,0,10,8,false,true,true,1,0
313,279,34,15.65,14.684211,34,808,639,169,0,0,0,0,-22,20,19,-1.863636,0,0,3,1,false,true,true,0.999,0.001
163,81,82,20.375,10.125,82,993,897,96,1,0,0.125,0,42,8,8,1.119048,0,0,13,16,false,true,true,0.97,0.03
249,181,68,27.666667,20.111111,68,1501,1622,-121,1,0,0.111111,0,35,9,9,0.885714,0,0,7,9,false,true,true,0.964,0.036
337,221,116,24.071429,15.785714,116,742,696,46,0,0,0,0,-5,14,14,-6.4,0,0,14,4,false,true,true,1,0
335,364,-29,27.916667,33.090909,-29,1897,1793,104,2,3,0.166667,0.272727,23,12,11,1.391304,0,0,17,15,false,true,true,0.985,0.015
307,221,86,27.909091,22.1,86,977,976,1,1,0,0.090909,0,26,11,10,1.307692,1,0,18,8,false,true,true,1,0
247,216,31,17.642857,15.428571,31,704,691,13,0,0,0,0,8,14,14,4.75,1,0,7,7,false,true,true,0.967,0.033
95,83,12,23.75,20.75,12,942,976,-34,0,0,0,0,71,4,4,0.56338,1,1,9,16,false,true,false,0.257,0.743
163,59,104,32.6,11.8,104,1014,1303,-289,1,0,0.2,0,62,5,5,0.612903,0,1,18,7,false,true,true,0.528,0.472
115,52,63,28.75,17.333333,63,916,837,79,0,0,0,0,79,4,3,0.506329,0,1,11,9,false,true,true,0.846,0.154
341,283,58,31,25.727273,58,1793,1897,-104,2,0,0.181818,0,11,11,11,2.727273,0,0,14,10,false,true,true,1,0
248,213,35,24.8,23.666667,35,1153,1065,88,0,1,0,0.111111,15,10,9,1.866667,1,0,9,17,false,true,true,0.725,0.275
277,218,59,27.7,24.222222,59,965,1013,-48,1,0,0.1,0,24,10,9,1.375,0,1,10,12,false,true,false,0.13,0.87
42,60,-18,14,20,-18,272,238,34,0,0,0,0,77,3,3,0.519481,1,0,6,19,false,true,false,0.369,0.631
38,18,20,19,18,20,1333,1331,2,0,0,0,0,86,2,1,0.348837,1,1,12,22,false,true,true,0.92,0.08
29,32,-3,14.5,16,-3,892,768,124,0,0,0,0,89,2,2,0.483146,0,0,17,17,false,true,true,0.645,0.355
341,334,7,17.947368,18.555556,7,885,719,166,0,0,0,0,-21,19,18,-1.809524,0,0,3,3,false,true,true,0.991,0.009
32,48,-16,16,24,-16,671,725,-54,0,0,0,0,84,2,2,0.440476,1,0,8,11,false,true,false,0.346,0.654
141,101,40,28.2,20.2,40,907,752,155,0,0,0,0,68,5,5,0.485294,0,0,12,12,false,true,true,0.85,0.15
217,174,43,24.111111,21.75,43,1210,1252,-42,1,0,0.111111,0,39,9,8,0.820513,0,0,14,18,false,true,true,0.931,0.069
264,247,17,16.5,15.4375,17,904,857,47,0,0,0,0,-1,16,16,-41,1,0,17,9,false,true,true,0.952,0.048
148,123,25,14.8,12.3,25,1016,1037,-21,0,0,0,0,42,10,10,1.142857,0,0,8,24,false,true,false,0.2,0.8
304,288,16,21.714286,20.571429,16,1115,1078,37,0,1,0,0.071429,4,14,14,8.5,1,0,6,10,false,true,true,0.841,0.159
239,196,43,14.9375,13.066667,43,871,999,-128,0,0,0,0,10,16,15,4.8,0,0,10,12,false,true,true,0.606,0.394
291,286,5,20.785714,20.428571,5,594,605,-11,0,0,0,0,0,14,14,0,0,0,13,9,false,true,true,0.675,0.325
258,223,35,23.454545,20.272727,35,1489,1445,44,0,0,0,0,22,11,11,1.454545,1,0,8,7,false,true,true,0.965,0.035
6,0,6,6,0,6,1550,1546,4,0,0,0,0,97,1,0,0.309278,0,0,21,0,false,true,true,0.678,0.322
333,190,143,23.785714,14.615385,143,1482,1554,-72,1,0,0.071429,0,8,14,13,4.5,0,0,10,12,false,true,true,1,0
339,217,122,26.076923,16.692308,122,939,907,32,1,0,0.076923,0,18,13,13,2.222222,0,0,11,7,false,true,true,1,0
374,327,47,19.684211,17.210526,47,1452,1469,-17,1,1,0.052632,0.052632,-27,19,19,-1.407407,0,0,1,1,true,true,true,1,0
325,247,78,23.214286,17.642857,78,901,1159,-258,2,0,0.142857,0,5,14,14,7,1,0,9,8,false,true,true,1,0
372,287,85,21.882353,16.882353,85,1731,1691,40,1,0,0.058824,0,-15,17,17,-2.266667,0,0,2,12,true,true,true,1,0
363,312,51,18.15,15.6,51,904,783,121,0,0,0,0,-28,20,20,-1.5,1,0,1,3,false,true,true,1,0
48,19,29,24,19,29,1302,1082,220,0,0,0,0,86,2,1,0.348837,0,0,16,9,false,true,true,0.69,0.31
53,34,19,13.25,11.333333,19,1265,1045,220,0,0,0,0,72,4,3,0.583333,0,1,17,20,false,true,false,0.226,0.774
317,249,68,26.416667,22.636364,68,1210,1253,-43,0,1,0,0.090909,7,12,11,4.857143,0,0,17,18,false,true,true,1,0
310,258,52,15.5,12.9,52,299,315,-16,0,0,0,0,-34,20,20,-1.235294,0,0,2,4,false,true,true,1,0
312,323,-11,22.285714,23.071429,-11,1076,1176,-100,0,1,0,0.071429,-1,14,14,-32,0,0,10,6,false,true,false,0.347,0.653
271,221,50,27.1,22.1,50,1305,1218,87,1,0,0.1,0,24,10,10,1.583333,0,0,24,8,false,true,true,0.97,0.03
68,60,8,22.666667,20,8,1331,1399,-68,0,0,0,0,75,3,3,0.466667,1,0,11,13,false,true,true,0.797,0.203
223,207,16,20.272727,18.818182,16,1266,1247,19,0,0,0,0,26,11,11,1.230769,1,0,12,8,false,true,true,0.842,0.158
137,94,43,27.4,18.8,43,1045,1009,36,1,0,0.2,0,65,5,5,0.584615,0,0,14,15,false,true,true,0.929,0.071
430,356,74,28.666667,23.733333,74,1684,1320,364,1,0,0.066667,0,-15,15,15,-2,0,0,4,6,true,true,true,1,0
231,237,-6,23.1,23.7,-6,1142,1176,-34,1,0,0.1,0,28,10,10,1.285714,1,0,19,9,false,true,true,0.897,0.103
219,168,51,24.333333,21,51,596,595,1,1,0,0.111111,0,40,9,8,1,0,0,15,12,false,true,true,0.911,0.089
341,271,70,20.058824,16.9375,70,1045,1009,36,1,0,0.058824,0,-7,17,16,-5.428571,0,0,4,10,false,true,true,1,0
108,101,7,21.6,20.2,7,872,818,54,0,1,0,0.2,63,5,5,0.650794,0,0,7,10,false,true,true,0.702,0.298
356,327,29,20.941176,19.235294,29,1710,1636,74,1,1,0.058824,0.058824,-16,17,17,-2.25,0,0,1,2,false,true,true,1,0
363,344,19,27.923077,26.461538,19,1454,1531,-77,1,1,0.076923,0.076923,-5,13,13,-6,0,0,8,5,false,true,true,1,0
93,54,39,23.25,18,39,1530,1550,-20,0,0,0,0,75,4,3,0.453333,0,0,17,7,false,true,true,0.701,0.299
330,286,44,18.333333,16.823529,44,866,949,-83,0,0,0,0,-11,18,17,-3.636364,1,0,3,7,false,true,true,1,0
247,188,59,24.7,18.8,59,596,595,1,1,0,0.1,0,30,10,10,1.333333,0,0,10,15,false,true,true,0.938,0.062
297,267,30,21.214286,19.071429,30,1161,1166,-5,1,0,0.071429,0,-2,14,14,-17.5,0,1,8,16,false,true,true,0.965,0.035
323,302,21,19,18.875,21,1127,1176,-49,0,0,0,0,-7,17,16,-6,0,0,4,6,false,true,true,0.924,0.076
216,187,29,24,23.375,29,1153,1065,88,0,1,0,0.125,24,9,8,1.166667,0,0,15,22,false,true,false,0.374,0.626
228,143,85,25.333333,15.888889,85,1691,1692,-1,0,0,0,0,32,9,9,0.9375,0,0,19,9,false,true,true,0.874,0.126
294,261,33,19.6,18.642857,33,1176,1127,49,0,0,0,0,0,15,14,0,0,0,11,9,false,true,true,0.75,0.25
274,219,55,27.4,21.9,55,1210,1253,-43,0,1,0,0.1,18,10,10,1.888889,0,0,10,22,false,true,true,0.993,0.007
279,240,39,16.411765,14.117647,39,346,231,115,0,0,0,0,-28,17,17,-1.464286,0,1,20,5,false,true,true,0.985,0.015
436,279,157,31.142857,19.928571,157,1550,1624,-74,2,0,0.142857,0,2,14,14,15,1,0,4,3,false,true,true,1,0
308,285,23,14,13.571429,23,262,306,-44,1,0,0.045455,0,-38,22,21,-1.210526,0,0,1,4,false,true,true,1,0
159,154,5,17.666667,19.25,5,361,493,-132,0,0,0,0,36,9,8,1.138889,0,0,15,23,false,true,true,0.581,0.419
193,187,6,24.125,23.375,6,1153,1065,88,0,1,0,0.125,27,8,8,1.037037,0,0,14,22,false,true,false,0.235,0.765
40,18,22,13.333333,9,22,1265,1045,220,0,0,0,0,78,3,2,0.538462,0,1,20,21,false,true,false,0.304,0.696
147,57,90,49,19,90,1396,1454,-58,1,0,0.333333,0,76,3,3,0.434211,0,0,11,10,false,true,true,0.867,0.133
71,45,26,23.666667,22.5,26,784,758,26,0,0,0,0,83,3,2,0.421687,0,0,14,8,false,true,true,0.69,0.31
267,303,-36,15.705882,17.823529,-36,999,1011,-12,0,0,0,0,-10,17,17,-4.6,1,0,11,7,false,true,true,0.556,0.444
255,271,-16,15.9375,18.066667,-16,1075,989,86,0,0,0,0,12,16,15,3.25,1,0,10,12,false,true,true,0.565,0.435
361,369,-8,21.235294,23.0625,-8,1762,1538,224,1,2,0.058824,0.125,-16,17,16,-2.125,0,0,1,2,false,true,true,0.999,0.001
280,273,7,13.333333,13.65,7,361,493,-132,1,0,0.047619,0,-38,21,20,-1.078947,0,0,1,1,true,true,true,0.946,0.054
160,91,69,26.666667,18.2,69,778,758,20,0,0,0,0,59,6,5,0.661017,0,0,19,7,false,true,true,0.95,0.05
159,102,57,22.714286,14.571429,57,1211,1173,38,0,0,0,0,56,7,7,0.625,0,1,18,9,false,true,true,0.855,0.145
272,239,33,20.923077,18.384615,33,784,758,26,0,0,0,0,7,13,13,5,0,0,10,18,false,true,true,0.891,0.109
12,25,-13,12,25,-13,613,569,44,0,0,0,0,90,1,1,0.433333,0,0,8,20,false,true,true,0.636,0.364
105,114,-9,13.125,16.285714,-9,416,374,42,0,0,0,0,60,8,7,0.766667,1,0,12,10,false,true,true,0.581,0.419
398,339,59,28.428571,24.214286,59,1793,1897,-104,2,0,0.142857,0,-7,14,14,-4.285714,0,0,3,10,false,true,true,1,0
47,81,-34,9.4,16.2,-34,218,86,132,0,0,0,0,63,5,5,0.634921,0,0,19,10,false,true,true,0.62,0.38
288,200,88,32,22.222222,88,1334,1477,-143,1,1,0.111111,0.111111,26,9,9,1.153846,0,0,13,16,false,true,true,1,0
336,314,22,17.684211,17.444444,22,758,796,-38,0,0,0,0,-23,19,18,-1.652174,0,0,1,1,false,true,true,0.999,0.001
57,28,29,19,14,29,1266,1247,19,0,0,0,0,85,3,2,0.376471,0,0,8,10,false,true,true,0.685,0.315
101,116,-15,16.833333,23.2,-15,613,549,64,0,0,0,0,58,6,5,0.758621,0,0,18,13,false,true,false,0.458,0.542
180,165,15,11.25,10.3125,15,416,222,194,0,0,0,0,9,16,16,6.111111,0,0,8,25,false,true,true,0.797,0.203
183,198,-15,15.25,16.5,-15,576,494,82,0,0,0,0,28,12,12,1.571429,0,0,9,10,false,true,false,0.327,0.673
246,171,75,20.5,14.25,75,1091,1078,13,0,0,0,0,32,12,12,1.34375,0,0,10,8,false,true,true,0.971,0.029
255,190,65,25.5,19,65,1731,1691,40,1,0,0.1,0,23,10,10,1.478261,0,0,9,11,false,true,true,0.958,0.042
332,193,139,33.2,19.3,139,1439,1353,86,1,0,0.1,0,25,10,10,1.2,0,0,7,22,false,true,true,1,0
318,279,39,19.875,18.6,39,1270,1348,-78,0,0,0,0,1,16,15,38,0,0,9,16,false,true,true,1,0
366,272,94,26.142857,20.923077,94,1093,1197,-104,3,0,0.214286,0,3,14,13,10.333333,0,1,8,13,false,true,true,1,0
28,0,28,14,0,28,1710,1636,74,0,0,0,0,95,2,1,0.378947,0,1,19,9,false,true,true,0.689,0.311
260,156,104,20,12,104,421,306,115,0,1,0,0.076923,6,13,13,7.333333,0,0,24,10,false,true,true,1,0
329,304,25,20.5625,20.266667,25,869,820,49,0,1,0,0.066667,-11,16,15,-3.363636,0,0,8,6,false,true,true,0.852,0.148
151,159,-8,21.571429,22.714286,-8,518,448,70,0,0,0,0,52,7,7,0.653846,0,0,15,9,false,true,true,0.675,0.325
260,189,71,21.666667,15.75,71,1159,1031,128,1,0,0.083333,0,12,12,12,3.25,0,0,7,14,false,true,true,1,0
42,28,14,21,14,14,1266,1247,19,0,0,0,0,88,2,2,0.363636,0,0,8,10,false,true,true,0.684,0.316
359,265,94,17.95,13.947368,94,925,801,124,1,0,0.05,0,-21,20,19,-1.904762,0,0,2,4,false,true,true,1,0
238,181,57,21.636364,18.1,57,941,926,15,1,0,0.090909,0,31,11,10,1.225806,1,0,18,10,false,true,true,0.969,0.031
159,130,29,22.714286,18.571429,29,1556,1591,-35,0,0,0,0,52,7,7,0.692308,1,1,9,15,false,true,true,0.925,0.075
87,49,38,29,24.5,38,1388,1506,-118,1,0,0.333333,0,81,3,2,0.419753,0,0,9,18,false,true,false,0.258,0.742
78,53,25,15.6,13.25,25,346,231,115,0,0,0,0,64,5,4,0.640625,0,0,9,14,false,true,true,0.76,0.24
278,243,35,27.8,24.3,35,1762,1582,180,2,2,0.2,0.2,21,10,10,1.52381,0,0,7,18,false,true,true,0.999,0.001
45,87,-42,11.25,21.75,-42,611,584,27,0,0,0,0,74,4,4,0.594595,0,0,19,7,false,true,true,0.551,0.449
214,151,63,42.8,30.2,63,991,996,-5,1,0,0.2,0,60,5,5,0.5,1,0,8,9,false,true,true,0.911,0.089
413,315,98,22.944444,17.5,98,1550,1466,84,1,0,0.055556,0,-22,18,18,-1.681818,0,0,1,1,false,true,true,1,0
350,263,87,26.923077,20.230769,87,996,1063,-67,1,1,0.076923,0.076923,3,13,13,10.666667,1,0,9,9,false,true,true,1,0
171,167,4,21.375,20.875,4,1305,1242,63,1,0,0.125,0,48,8,8,0.708333,0,1,11,7,false,true,true,0.717,0.283
338,293,45,24.142857,20.928571,45,1388,1506,-118,2,1,0.142857,0.071429,6,14,14,5.666667,0,0,10,14,false,true,true,1,0
74,42,32,24.666667,14,32,1101,1078,23,0,0,0,0,81,3,3,0.407407,0,1,13,9,false,true,true,0.811,0.189
409,278,131,24.058824,16.352941,131,1211,1173,38,0,0,0,0,-17,17,17,-2.058824,0,0,5,3,false,true,true,1,0
322,253,69,12.384615,9.730769,69,416,222,194,0,0,0,0,-40,26,26,-1.375,0,0,7,2,false,true,true,1,0
406,341,65,25.375,22.733333,65,1408,1454,-46,1,0,0.0625,0,-6,16,15,-5.333333,0,0,2,5,false,true,true,1,0
182,184,-2,15.166667,16.727273,-2,1214,1176,38,0,0,0,0,32,12,11,1.125,0,0,14,12,false,true,false,0.202,0.798
360,202,158,17.142857,10.1,158,1176,1076,100,0,0,0,0,10,21,20,5.9,0,0,10,16,false,true,true,1,0
151,161,-10,15.1,17.888889,-10,1176,1127,49,0,0,0,0,35,10,9,1.057143,0,0,14,23,false,true,false,0.201,0.799
134,100,34,19.142857,16.666667,34,1037,950,87,1,0,0.142857,0,55,7,6,0.563636,0,0,12,17,false,true,true,0.831,0.169
192,123,69,24,15.375,69,859,811,48,0,0,0,0,44,8,8,0.818182,0,1,21,7,false,true,true,0.954,0.046
114,167,-53,19,27.833333,-53,947,810,137,0,1,0,0.166667,55,6,6,0.763636,0,0,19,14,false,true,false,0.2,0.8
316,251,65,19.75,15.6875,65,746,796,-50,0,1,0,0.0625,0,16,16,0,0,0,15,8,false,true,true,0.996,0.004
73,67,6,24.333333,22.333333,6,1355,1210,145,0,0,0,0,76,3,3,0.394737,1,0,8,13,false,true,true,0.923,0.077
56,63,-7,14,15.75,-7,971,761,210,0,0,0,0,71,4,4,0.422535,0,1,14,11,false,true,false,0.297,0.703
177,135,42,17.7,13.5,42,299,315,-16,0,0,0,0,34,10,10,1.235294,0,0,12,11,false,true,true,0.897,0.103
347,313,34,28.916667,26.083333,34,1153,1065,88,0,1,0,0.083333,-9,12,12,-3.111111,0,0,12,13,false,true,true,1,0
174,92,82,29,18.4,82,866,949,-83,0,0,0,0,60,6,5,0.666667,0,1,16,9,false,true,true,0.567,0.433
119,72,47,23.8,14.4,47,916,837,79,0,0,0,0,70,5,5,0.571429,0,1,13,13,false,true,true,0.847,0.153
102,51,51,17,10.2,51,584,565,19,0,0,0,0,64,6,5,0.71875,0,0,13,22,false,true,true,0.934,0.066
278,182,96,27.8,18.2,96,1075,1027,48,2,0,0.2,0,28,10,10,1.321429,0,1,9,6,false,true,true,0.934,0.066
108,78,30,21.6,19.5,30,1110,1039,71,0,0,0,0,70,5,4,0.514286,0,0,17,11,false,true,true,0.702,0.298
8,0,8,8,0,8,1100,1008,92,0,0,0,0,96,1,0,0.375,0,0,21,0,false,true,true,0.679,0.321
240,166,74,21.818182,16.6,74,576,532,44,0,0,0,0,29,11,10,1.586207,0,0,13,7,false,true,true,0.97,0.03
132,91,41,18.857143,15.166667,41,698,742,-44,0,0,0,0,65,7,6,0.630769,0,0,7,11,false,true,true,0.524,0.476
330,244,86,16.5,12.842105,86,576,532,44,0,0,0,0,-21,20,19,-2.190476,1,0,8,17,false,true,true,1,0
244,215,29,17.428571,15.357143,29,864,808,56,1,0,0.071429,0,-5,14,14,-6.8,0,1,13,19,false,true,true,0.881,0.119
315,256,59,22.5,18.285714,59,1036,1181,-145,0,0,0,0,11,14,14,3.090909,1,0,17,12,false,true,true,1,0
327,251,76,23.357143,19.307692,76,613,569,44,0,0,0,0,6,14,13,6.5,1,0,9,12,false,true,true,1,0
393,291,102,28.071429,20.785714,102,1051,1030,21,0,0,0,0,-6,14,14,-5,0,0,4,4,false,true,true,1,0
219,204,15,21.9,20.4,15,315,294,21,0,1,0,0.1,20,10,10,1.75,0,0,15,18,false,true,true,0.954,0.046
279,260,19,23.25,21.666667,19,1127,1075,52,1,1,0.083333,0.083333,13,12,12,2.384615,0,1,11,6,false,true,true,0.701,0.299
12,13,-1,12,13,-1,1159,1031,128,0,0,0,0,94,1,1,0.414894,1,0,13,14,false,true,true,0.709,0.291
314,262,52,20.933333,18.714286,52,1094,1030,64,0,0,0,0,-2,15,14,-18,0,0,7,16,false,true,true,1,0
319,233,86,18.764706,13.705882,86,1048,1000,48,0,0,0,0,-4,17,17,-10,0,1,8,7,false,true,true,1,0
131,82,49,21.833333,16.4,49,1513,1479,34,0,0,0,0,62,6,5,0.548387,1,0,10,10,false,true,true,0.883,0.117
383,219,164,22.529412,13.6875,164,1295,1477,-182,3,0,0.176471,0,-1,17,16,-46,0,0,21,21,false,true,true,1,0
171,221,-50,15.545455,22.1,-50,999,1011,-12,0,0,0,0,29,11,10,1.586207,0,0,13,11,false,true,false,0.062,0.938
121,80,41,24.2,20,41,1127,1176,-49,0,0,0,0,66,5,4,0.636364,0,0,11,13,false,true,true,0.716,0.284
239,205,34,26.555556,22.777778,34,1394,1424,-30,0,1,0,0.111111,37,9,9,0.864865,1,0,8,20,false,true,true,0.903,0.097
18,0,18,18,0,18,1344,1209,135,0,0,0,0,97,1,0,0.350515,1,0,8,0,false,true,true,0.773,0.227
346,193,153,31.454545,19.3,153,1431,825,606,1,1,0.090909,0.1,19,11,10,1.789474,0,0,8,16,false,true,true,1,0
131,74,57,21.833333,14.8,57,838,786,52,0,0,0,0,60,6,5,0.533333,0,0,9,7,false,true,true,0.85,0.15
148,131,17,29.6,32.75,17,1428,1606,-178,1,0,0.2,0,60,5,4,0.533333,1,0,12,12,false,true,false,0.196,0.804
383,381,2,21.277778,21.166667,2,1320,1339,-19,2,1,0.111111,0.055556,-22,18,18,-1.772727,0,0,2,1,false,true,true,0.98,0.02
180,221,-41,13.846154,18.416667,-41,1075,989,86,0,0,0,0,27,13,12,1.444444,0,0,20,17,false,true,false,0.119,0.881
160,116,44,22.857143,16.571429,44,885,719,166,0,0,0,0,55,7,7,0.690909,0,1,14,9,false,true,true,0.847,0.153
412,323,89,24.235294,19,89,1075,1027,48,2,1,0.117647,0.058824,-20,17,17,-1.85,0,0,4,4,false,true,true,1,0
311,213,98,17.277778,12.529412,98,272,288,-16,0,0,0,0,6,18,17,8.666667,0,0,13,14,false,true,true,1,0
219,209,10,16.846154,17.416667,10,808,812,-4,0,0,0,0,15,13,12,2.466667,1,0,15,10,false,true,true,0.786,0.214
78,44,34,15.6,11,34,859,719,140,0,1,0,0.25,63,5,4,0.84127,0,2,18,5,false,true,true,0.95,0.05
276,309,-33,21.230769,23.769231,-33,1076,1176,-100,0,1,0,0.076923,4,13,13,8,0,0,18,8,false,true,false,0.159,0.841
403,273,130,22.388889,16.058824,130,1110,1039,71,0,0,0,0,-22,18,17,-1.636364,0,0,2,5,false,true,true,1,0
285,265,20,21.923077,20.384615,20,1304,1040,264,1,0,0.076923,0,12,13,13,2.75,0,0,10,8,false,true,true,0.794,0.206
318,149,169,24.461538,12.416667,169,554,342,212,0,0,0,0,9,13,12,4,1,0,13,19,false,true,true,1,0
223,230,-7,18.583333,19.166667,-7,942,976,-34,0,0,0,0,16,12,12,2.5,0,0,11,7,false,true,false,0.253,0.747
93,49,44,31,24.5,44,1890,2020,-130,0,0,0,0,81,3,2,0.358025,0,0,15,19,false,true,true,0.681,0.319
126,128,-2,15.75,18.285714,-2,1583,1422,161,0,0,0,0,58,8,7,0.87931,1,0,14,7,false,true,true,0.542,0.458
178,133,45,17.8,14.777778,45,1164,1201,-37,0,0,0,0,39,10,9,1.076923,0,1,18,15,false,true,true,0.716,0.284
67,117,-50,13.4,23.4,-50,1554,1622,-68,1,0,0.2,0,62,5,5,0.5,0,1,9,7,false,true,false,0.252,0.748
315,245,70,21,16.333333,70,539,500,39,0,0,0,0,-7,15,15,-5.714286,0,0,8,13,false,true,true,1,0
341,269,72,20.058824,16.8125,72,939,913,26,0,1,0,0.0625,-8,17,16,-5,1,0,4,10,false,true,true,1,0
229,239,-10,15.266667,17.071429,-10,719,614,105,0,1,0,0.071429,4,15,14,10.75,0,0,19,11,false,true,true,0.729,0.271
349,283,66,13.96,11.791667,66,272,288,-16,0,0,0,0,-28,25,24,-1.857143,0,0,1,1,false,true,true,1,0
296,304,-8,26.909091,27.636364,-8,1297,1606,-309,1,1,0.090909,0.090909,15,11,11,2,0,0,10,8,false,true,false,0.494,0.506
83,86,-3,11.857143,12.285714,-3,658,817,-159,0,0,0,0,63,7,7,0.603175,0,0,33,12,false,true,false,0.302,0.698
195,176,19,21.666667,22,19,1530,1550,-20,0,1,0,0.125,34,9,8,1,0,0,9,13,false,true,false,0.224,0.776
262,219,43,18.714286,15.642857,43,844,821,23,0,0,0,0,26,14,14,1.615385,0,0,16,8,false,true,true,0.76,0.24
60,20,40,20,10,40,1428,1302,126,0,0,0,0,82,3,2,0.646341,0,0,7,16,false,true,true,0.707,0.293
361,283,78,20.055556,16.647059,78,1364,1093,271,0,1,0,0.058824,-13,18,17,-2.923077,0,0,5,3,false,true,true,1,0
104,37,67,34.666667,18.5,67,1334,1256,78,1,0,0.333333,0,80,3,2,0.3875,0,0,18,9,false,true,true,0.826,0.174
12,0,12,12,0,12,719,785,-66,0,0,0,0,97,1,0,0.371134,0,0,19,0,false,true,false,0.253,0.747
264,197,67,24,19.7,67,892,819,73,0,1,0,0.1,24,11,10,1.416667,0,0,7,11,false,true,true,0.964,0.036
281,274,7,17.5625,18.266667,7,947,810,137,0,1,0,0.066667,-1,16,15,-42,1,0,10,13,false,true,true,0.585,0.415
233,180,53,29.125,22.5,53,1142,1095,47,1,0,0.125,0,37,8,8,0.945946,0,1,16,18,false,true,true,0.815,0.185
85,166,-81,14.166667,27.666667,-81,1897,1793,104,0,1,0,0.166667,67,6,6,0.477612,0,0,8,8,false,true,true,0.996,0.004
170,162,8,18.888889,18,8,527,503,24,0,0,0,0,50,9,9,0.82,0,0,14,10,false,true,true,0.699,0.301
104,65,39,20.8,16.25,39,1364,1093,271,0,0,0,0,71,5,4,0.535211,0,1,11,6,false,true,true,0.709,0.291
133,127,6,22.166667,25.4,6,1161,1166,-5,1,0,0.166667,0,57,6,5,0.614035,0,1,8,17,false,true,false,0.049,0.951
14,22,-8,14,22,-8,1023,1070,-47,0,0,0,0,93,1,1,0.344086,1,0,15,10,false,true,true,0.672,0.328
140,132,8,20,18.857143,8,518,533,-15,1,0,0.142857,0,48,7,7,0.729167,0,0,23,7,false,true,true,0.874,0.126
196,232,-36,19.6,23.2,-36,1277,1166,111,0,1,0,0.1,28,10,10,1.285714,0,0,10,8,false,true,false,0.036,0.964
367,355,12,20.388889,20.882353,12,1096,1009,87,2,0,0.111111,0,-5,18,17,-8.8,0,0,12,12,false,true,false,0.225,0.775
227,230,-3,17.461538,19.166667,-3,721,689,32,0,0,0,0,-1,13,12,-34,0,0,26,7,false,true,false,0.392,0.608
354,336,18,19.666667,19.764706,18,847,952,-105,0,0,0,0,-12,18,17,-3,0,1,2,2,false,true,true,0.782,0.218
95,59,36,19,14.75,36,1277,1166,111,0,0,0,0,69,5,4,0.521739,0,2,8,8,false,true,true,0.795,0.205
35,6,29,17.5,6,29,527,581,-54,0,0,0,0,90,2,1,0.466667,1,0,14,7,false,true,false,0.47,0.53
249,251,-2,17.785714,19.307692,-2,491,398,93,0,0,0,0,12,14,13,3,0,0,7,15,false,true,true,0.544,0.456
90,70,20,15,11.666667,20,595,543,52,0,0,0,0,62,6,6,0.758065,0,0,14,15,false,true,true,0.849,0.151
18,2,16,18,2,16,1305,1390,-85,0,0,0,0,93,1,1,0.387097,0,0,29,8,false,true,true,0.631,0.369
365,241,124,26.071429,18.538462,124,1305,1390,-85,0,1,0,0.076923,1,14,13,36,0,1,10,18,false,true,true,1,0
85,59,26,21.25,19.666667,26,1297,1606,-309,0,0,0,0,77,4,3,0.38961,1,0,10,21,false,true,false,0.253,0.747
279,286,-7,19.928571,20.428571,-7,758,952,-194,0,0,0,0,-2,14,14,-20,0,0,7,7,false,true,false,0.32,0.68
256,235,21,21.333333,19.583333,21,1094,1030,64,0,0,0,0,14,12,12,2.571429,0,0,11,11,false,true,true,0.574,0.426
42,64,-22,14,21.333333,-22,1154,1062,92,0,0,0,0,81,3,3,0.432099,0,0,11,27,false,true,false,0.201,0.799
331,212,119,33.1,23.555556,119,1489,1405,84,2,0,0.2,0,26,10,9,1.076923,0,0,8,17,false,true,true,1,0
189,71,118,21,8.875,118,1067,95,972,0,0,0,0,52,9,8,0.653846,0,0,14,10,false,true,true,1,0
165,78,87,33,15.6,87,1334,1256,78,1,0,0.2,0,64,5,5,0.484375,0,0,13,8,false,true,true,0.956,0.044
30,39,-9,30,39,-9,1331,1399,-68,0,0,0,0,87,1,1,0.402299,0,0,14,10,false,true,true,0.678,0.322
331,221,110,27.583333,18.416667,110,695,671,24,0,0,0,0,12,12,12,2.75,0,0,7,14,false,true,true,1,0
217,194,23,19.727273,19.4,23,1452,1469,-17,0,1,0,0.1,28,11,10,1.357143,1,0,8,22,false,true,true,0.588,0.412
360,258,102,32.727273,23.454545,102,1396,1454,-58,2,0,0.181818,0,16,11,11,2.0625,0,0,7,12,false,true,true,1,0
140,58,82,23.333333,11.6,82,993,897,96,1,0,0.166667,0,56,6,5,0.839286,0,0,9,16,false,true,true,0.968,0.032
24,0,24,24,0,24,1413,1422,-9,0,0,0,0,95,1,0,0.6,0,0,15,0,false,true,true,0.681,0.319
26,49,-23,26,49,-23,1890,2020,-130,0,0,0,0,91,1,1,0.318681,0,0,15,12,false,true,true,0.631,0.369
341,313,28,18.944444,17.388889,28,613,611,2,0,0,0,0,-26,18,18,-1.461538,0,0,2,1,false,true,true,1,0
397,281,116,19.85,14.789474,116,778,758,20,0,1,0,0.052632,-26,20,19,-1.5,0,0,1,1,true,true,true,1,0
236,238,-2,18.153846,18.307692,-2,1547,1439,108,1,0,0.076923,0,13,13,13,2.846154,0,0,20,16,false,true,false,0.295,0.705
442,333,109,34,25.615385,109,1489,1405,84,3,0,0.230769,0,-5,13,13,-5.6,0,0,5,2,false,true,true,1,0
213,164,49,21.3,18.222222,49,1388,1477,-89,1,0,0.1,0,33,10,9,1.454545,0,0,14,11,false,true,true,0.885,0.115
203,159,44,18.454545,15.9,44,864,808,56,1,0,0.090909,0,21,11,10,1.619048,0,1,7,6,false,true,true,0.848,0.152
90,69,21,18,13.8,21,527,514,13,0,0,0,0,64,5,5,0.609375,0,0,10,12,false,true,true,0.786,0.214
208,154,54,20.8,17.111111,54,830,907,-77,1,0,0.1,0,33,10,9,1.181818,0,0,16,18,false,true,true,0.843,0.157
290,192,98,22.307692,14.769231,98,954,1078,-124,0,1,0,0.076923,12,13,13,3.166667,1,0,6,15,false,true,true,1,0
308,249,59,20.533333,17.785714,59,904,783,121,0,0,0,0,11,15,14,3.818182,0,0,10,8,false,true,true,0.989,0.011
158,131,27,19.75,16.375,27,971,658,313,0,0,0,0,44,8,8,0.818182,0,0,12,22,false,true,false,0.47,0.53
150,58,92,21.428571,8.285714,92,1413,1422,-9,0,0,0,0,56,7,7,1.017857,2,0,13,19,false,true,true,0.995,0.005
14,10,4,14,10,4,671,725,-54,0,0,0,0,91,1,1,0.406593,0,0,10,18,false,true,false,0.253,0.747
66,83,-17,22,27.666667,-17,1419,1488,-69,0,0,0,0,71,3,3,0.394366,0,0,9,7,false,true,true,0.676,0.324
375,272,103,22.058824,17,103,1030,998,32,1,0,0.058824,0,-14,17,16,-2.714286,1,0,1,4,false,true,true,1,0
318,272,46,17.666667,15.111111,46,1077,1094,-17,0,0,0,0,-8,18,18,-5.25,1,1,6,7,false,true,true,1,0
220,183,37,13.75,11.4375,37,584,565,19,0,0,0,0,-2,16,16,-23,0,0,20,18,false,true,true,0.96,0.04
350,283,67,19.444444,15.722222,67,505,95,410,0,1,0,0.055556,-7,18,18,-6.285714,0,0,7,12,false,true,true,1,0
337,291,46,16.85,14.55,46,866,949,-83,0,0,0,0,-20,20,20,-2,1,0,1,4,true,true,true,1,0
405,380,25,18.409091,18.095238,25,1096,1009,87,2,0,0.090909,0,-23,22,21,-1.913043,0,0,1,1,false,true,true,0.895,0.105
211,91,120,35.166667,18.2,120,1510,1583,-73,1,0,0.166667,0,53,6,5,0.603774,0,1,14,15,false,true,true,0.854,0.146
379,322,57,19.947368,16.947368,57,539,500,39,0,0,0,0,-27,19,19,-1.481481,0,0,4,1,false,true,true,1,0
14,0,14,14,0,14,739,480,259,0,0,0,0,94,1,0,0.382979,0,0,14,0,false,true,true,0.689,0.311
119,96,23,19.833333,19.2,23,613,461,152,0,0,0,0,61,6,5,0.606557,0,1,8,11,false,true,true,0.709,0.291
187,197,-10,20.777778,24.625,-10,942,976,-34,0,0,0,0,37,9,8,1.081081,0,0,13,7,false,true,false,0.339,0.661
68,45,23,17,15,23,1047,1094,-47,0,0,0,0,76,4,3,0.473684,0,1,11,18,false,true,false,0.259,0.741
65,87,-22,13,21.75,-22,611,584,27,0,0,0,0,72,5,4,0.611111,0,0,16,7,false,true,false,0.496,0.504
225,139,86,18.75,11.583333,86,1176,1076,100,0,0,0,0,47,12,12,1.255319,0,0,12,11,false,true,true,0.963,0.037
210,226,-16,15,17.384615,-16,576,494,82,0,0,0,0,20,14,13,2.2,0,0,12,9,false,true,false,0.202,0.798
107,126,-19,21.4,25.2,-19,1355,1210,145,0,0,0,0,64,5,5,0.46875,1,0,20,18,false,true,true,0.616,0.384
57,51,6,14.25,17,6,1156,1184,-28,0,0,0,0,70,4,3,0.4,1,0,13,19,false,true,true,0.674,0.326
234,173,61,29.25,24.714286,61,1397,1195,202,1,0,0.125,0,43,8,7,0.813953,0,0,20,13,false,true,true,0.955,0.045
185,131,54,30.833333,21.833333,54,1237,1277,-40,0,0,0,0,50,6,6,0.58,0,1,7,13,false,true,true,0.843,0.157
221,141,80,27.625,17.625,80,880,952,-72,0,0,0,0,46,8,8,0.76087,0,0,22,19,false,true,true,0.949,0.051
141,98,43,23.5,16.333333,43,1211,1173,38,0,0,0,0,63,6,6,0.555556,0,1,15,6,false,true,true,0.846,0.154
121,81,40,20.166667,13.5,40,1651,1691,-40,0,0,0,0,64,6,6,0.53125,1,0,9,11,false,true,true,0.831,0.169
332,272,60,23.714286,20.923077,60,834,758,76,0,1,0,0.076923,2,14,13,18,0,0,9,9,false,true,true,0.999,0.001
96,102,-6,24,25.5,-6,1334,1270,64,1,0,0.25,0,71,4,4,0.521127,0,0,18,9,false,true,true,0.678,0.322
188,133,55,17.090909,13.3,55,1221,1438,-217,0,0,0,0,38,11,10,1.184211,0,2,14,23,false,true,true,0.886,0.114
359,355,4,21.117647,20.882353,4,1096,1009,87,2,0,0.117647,0,-1,17,17,-44,0,0,12,12,false,true,true,0.68,0.32
175,179,-4,15.909091,17.9,-4,527,514,13,0,0,0,0,26,11,10,1.5,0,0,12,13,false,true,false,0.207,0.793
62,24,38,20.666667,12,38,1551,1550,1,0,0,0,0,86,3,2,0.488372,0,0,20,25,false,true,true,0.68,0.32
354,345,9,17.7,17.25,9,901,889,12,0,1,0,0.05,-28,20,20,-1.535714,0,0,4,1,false,true,true,0.999,0.001
367,350,17,19.315789,19.444444,17,1265,1045,220,0,1,0,0.055556,-26,19,18,-1.615385,0,0,2,5,false,true,true,1,0
108,54,54,15.428571,9,54,1428,1302,126,0,0,0,0,57,7,6,0.929825,0,1,19,15,false,true,true,0.822,0.178
350,237,113,26.923077,19.75,113,996,1063,-67,1,1,0.076923,0.083333,6,13,12,5.333333,1,0,9,16,false,true,true,1,0
384,234,150,21.333333,13.764706,150,303,342,-39,0,0,0,0,-15,18,17,-2.533333,0,0,1,4,false,true,true,1,0
108,135,-27,18,27,-27,1530,1550,-20,0,1,0,0.2,54,6,5,0.62963,0,1,19,12,false,true,false,0.2,0.8
230,146,84,25.555556,18.25,84,1045,1009,36,1,0,0.111111,0,40,9,8,0.95,0,0,9,19,false,true,true,0.974,0.026
20,84,-64,10,84,-64,1782,1512,270,0,1,0,1,86,2,1,0.488372,1,0,9,16,false,true,true,0.804,0.196
345,321,24,19.166667,17.833333,24,825,907,-82,1,0,0.055556,0,-15,18,18,-2.666667,0,0,3,10,false,true,true,1,0
374,318,56,23.375,21.2,56,630,786,-156,1,0,0.0625,0,-4,16,15,-8.75,0,0,6,4,false,true,true,1,0
78,120,-42,9.75,17.142857,-42,480,518,-38,0,0,0,0,61,8,7,0.754098,0,1,14,6,false,true,false,0.019,0.981
36,26,10,18,26,10,1406,1454,-48,0,0,0,0,86,2,1,0.395349,0,0,16,14,false,true,true,0.677,0.323
253,220,33,19.461538,18.333333,33,1078,1130,-52,0,1,0,0.083333,15,13,12,2.6,0,0,12,24,false,true,true,0.785,0.215
38,35,3,19,17.5,3,1127,1134,-7,0,0,0,0,84,2,2,0.357143,0,0,14,15,false,true,true,0.678,0.322
313,279,34,24.076923,23.25,34,1355,1210,145,1,0,0.076923,0,13,13,12,2.307692,1,0,6,11,false,true,true,1,0
287,200,87,17.9375,13.333333,87,1164,1201,-37,0,0,0,0,5,16,15,8.4,0,2,16,9,false,true,true,0.92,0.08
333,268,65,23.785714,20.615385,65,904,668,236,0,0,0,0,-12,14,13,-2.833333,0,0,7,8,false,true,true,1,0
24,12,12,12,12,12,1159,1051,108,0,0,0,0,89,2,1,0.449438,0,0,17,11,false,true,true,0.676,0.324
313,280,33,20.866667,20,33,290,416,-126,0,0,0,0,-3,15,14,-11.333333,0,0,7,9,false,true,true,0.89,0.11
380,301,79,18.095238,14.333333,79,527,581,-54,0,0,0,0,-35,21,21,-1.2,0,0,1,4,true,true,true,1,0
10,15,-5,5,15,-5,1651,1691,-40,0,0,0,0,94,2,1,0.361702,0,0,24,16,false,true,false,0.413,0.587
200,221,-21,13.333333,15.785714,-21,699,448,251,0,0,0,0,15,15,14,2.666667,0,0,16,13,false,true,false,0.248,0.752
62,67,-5,20.666667,22.333333,-5,711,876,-165,0,0,0,0,77,3,3,0.558442,0,0,7,12,false,true,false,0.251,0.749
288,171,117,22.153846,14.25,117,539,500,39,0,0,0,0,11,13,12,3.636364,0,0,13,10,false,true,true,1,0
91,35,56,22.75,8.75,56,872,818,54,0,0,0,0,73,4,4,0.561644,0,1,11,6,false,true,true,0.848,0.152
327,207,120,21.8,13.8,120,303,342,-39,0,0,0,0,6,15,15,6.333333,0,1,9,6,false,true,true,1,0
360,293,67,24,20.928571,67,1388,1506,-118,2,1,0.133333,0.071429,3,15,14,11.333333,0,0,4,14,false,true,true,1,0
130,150,-20,21.666667,25,-20,1826,1656,170,0,0,0,0,51,6,6,0.529412,0,0,7,17,false,true,false,0.145,0.855
282,178,104,28.2,19.777778,104,986,856,130,1,0,0.1,0,22,10,9,1.409091,0,0,13,10,false,true,true,1,0
336,302,34,16.8,15.894737,34,363,668,-305,0,0,0,0,-15,20,19,-2.866667,0,1,7,2,false,true,true,0.633,0.367
108,142,-34,15.428571,20.285714,-34,1304,1040,264,0,0,0,0,53,7,7,0.622642,1,0,9,24,false,true,false,0.027,0.973
4,0,4,4,0,4,831,830,1,0,0,0,0,98,1,0,0.377551,0,0,7,0,false,true,false,0.34,0.66
262,292,-30,20.153846,22.461538,-30,971,761,210,0,0,0,0,6,13,13,5,0,0,9,14,false,true,false,0.017,0.983
28,4,24,14,2,24,1033,1037,-4,0,0,0,0,87,2,2,0.517241,0,0,10,7,false,true,true,0.735,0.265
314,240,74,22.428571,17.142857,74,1731,1691,40,1,0,0.071429,0,-2,14,14,-17,0,0,12,26,false,true,true,1,0
249,208,41,19.153846,17.333333,41,1388,1477,-89,1,0,0.076923,0,19,13,12,2.526316,1,0,10,18,false,true,true,0.845,0.155
231,179,52,28.875,25.571429,52,992,1100,-108,2,0,0.25,0,39,8,7,0.871795,0,0,10,7,false,true,true,0.658,0.342
85,129,-44,17,25.8,-44,613,611,2,0,0,0,0,62,5,5,0.612903,0,0,7,21,false,true,false,0.041,0.959
65,112,-47,10.833333,18.666667,-47,450,412,38,0,0,0,0,58,6,6,0.655172,1,0,8,13,false,true,false,0.202,0.798
18,13,5,9,13,5,698,742,-44,0,0,0,0,94,2,1,0.43617,0,1,23,11,false,true,false,0.252,0.748
77,38,39,38.5,19,39,1302,1349,-47,0,0,0,0,81,2,2,0.345679,0,0,15,8,false,true,true,0.769,0.231
210,72,138,42,18,138,918,619,299,2,0,0.4,0,62,5,4,0.564516,1,0,6,11,false,true,true,0.99,0.01
166,97,69,33.2,24.25,69,1210,1252,-42,1,0,0.2,0,67,5,4,0.477612,0,0,11,23,false,true,true,0.92,0.08
295,248,47,21.071429,17.714286,47,1364,1093,271,0,1,0,0.071429,5,14,14,7.6,0,0,20,7,false,true,true,1,0
141,97,44,23.5,16.166667,44,941,926,15,1,0,0.166667,0,61,6,6,0.622951,0,0,14,14,false,true,true,0.963,0.037
322,290,32,26.833333,26.363636,32,1102,1245,-143,2,0,0.166667,0,-10,12,11,-2.8,0,0,7,12,false,true,true,1,0
198,209,-11,15.230769,16.076923,-11,916,876,40,0,0,0,0,3,13,13,11.333333,2,0,17,18,false,true,true,0.906,0.094
284,278,6,20.285714,19.857143,6,561,526,35,0,0,0,0,-5,14,14,-7,0,0,13,8,false,true,true,0.745,0.255
10,15,-5,10,15,-5,1651,1691,-40,0,0,0,0,94,1,1,0.361702,0,0,31,16,false,true,true,0.673,0.327
353,309,44,44.125,38.625,44,1983,2020,-37,2,1,0.25,0.125,25,8,8,1.04,0,0,12,29,false,true,true,1,0
319,289,30,14.5,13.136364,30,804,683,121,0,0,0,0,-28,22,22,-1.607143,0,1,12,2,false,true,true,0.995,0.005
373,328,45,23.3125,20.5,45,880,952,-72,0,0,0,0,-9,16,16,-3.888889,0,0,3,2,false,true,true,1,0
99,44,55,24.75,14.666667,55,1572,1550,22,1,0,0.25,0,77,4,3,0.506494,0,0,18,10,false,true,true,0.796,0.204
302,234,68,18.875,15.6,68,363,668,-305,0,0,0,0,5,16,15,8.6,0,1,12,15,false,true,true,0.899,0.101
306,281,25,15.3,14.05,25,95,360,-265,0,1,0,0.05,-29,20,20,-1.37931,0,0,2,1,true,true,true,0.955,0.045
139,200,-61,17.375,25,-61,971,761,210,0,0,0,0,40,8,8,0.75,0,0,9,15,false,true,false,0.031,0.969
388,322,66,21.555556,17.888889,66,892,788,104,3,0,0.166667,0,-16,18,18,-2.6875,0,0,6,4,false,true,true,1,0
169,206,-37,15.363636,18.727273,-37,262,306,-44,0,0,0,0,31,11,11,1.483871,0,0,9,11,false,true,false,0.079,0.921
271,264,7,16.9375,16.5,7,334,446,-112,0,0,0,0,-12,16,16,-3.333333,1,1,9,10,false,true,false,0.297,0.703
162,152,10,23.142857,25.333333,10,1355,1210,145,0,0,0,0,55,7,6,0.545455,1,0,15,12,false,true,true,0.655,0.345
47,22,25,23.5,11,25,699,448,251,0,0,0,0,89,2,2,0.449438,0,0,11,16,false,true,true,0.797,0.203
294,204,90,21,15.692308,90,746,796,-50,0,1,0,0.076923,10,14,13,4.8,0,1,14,8,false,true,true,0.982,0.018
83,80,3,20.75,20,3,630,786,-156,0,0,0,0,67,4,4,0.522388,0,0,9,14,false,true,false,0.252,0.748
37,69,-32,7.4,17.25,-32,1214,1176,38,0,0,0,0,70,5,4,0.514286,1,0,21,8,false,true,false,0.396,0.604
316,302,14,19.75,18.875,14,1127,1176,-49,0,0,0,0,-4,16,16,-10.5,0,0,9,6,false,true,true,0.772,0.228
248,209,39,19.076923,17.416667,39,1127,1176,-49,0,0,0,0,20,13,12,2.1,0,1,21,15,false,true,true,0.635,0.365
255,264,-9,23.181818,24,-9,1096,1009,87,1,0,0.090909,0,35,11,11,1.257143,0,0,7,12,false,true,false,0.344,0.656
222,217,5,15.857143,15.5,5,450,412,38,0,0,0,0,3,14,14,12.666667,0,0,10,9,false,true,true,0.859,0.141
214,193,21,26.75,24.125,21,1297,1606,-309,1,0,0.125,0,38,8,8,0.789474,0,0,9,9,false,true,false,0.28,0.72
184,93,91,26.285714,13.285714,91,554,342,212,0,0,0,0,49,7,7,0.734694,0,0,9,19,false,true,true,0.97,0.03
126,49,77,25.2,12.25,77,1014,948,66,0,0,0,0,70,5,4,0.471429,0,1,15,17,false,true,true,0.848,0.152
246,122,124,22.363636,11.090909,124,925,801,124,1,0,0.090909,0,34,11,11,1.176471,1,0,9,28,false,true,true,1,0
225,164,61,18.75,13.666667,61,1281,1339,-58,0,0,0,0,33,12,12,1.242424,0,0,20,7,false,true,true,0.968,0.032
379,353,26,23.6875,23.533333,26,907,752,155,0,1,0,0.066667,-7,16,15,-4.714286,0,0,3,4,false,true,true,1,0
165,146,19,16.5,16.222222,19,1583,1422,161,0,0,0,0,50,10,9,1.02,1,0,16,10,false,true,true,0.501,0.499
59,38,21,14.75,9.5,21,880,952,-72,0,0,0,0,77,4,4,0.532468,0,0,14,10,false,true,false,0.344,0.656
77,44,33,25.666667,22,33,691,473,218,0,0,0,0,80,3,2,0.45,0,0,7,11,false,true,true,0.733,0.267
394,254,140,28.142857,18.142857,140,1270,1322,-52,1,0,0.071429,0,4,14,14,9.5,0,0,11,16,false,true,true,1,0
212,153,59,19.272727,13.909091,59,1037,950,87,1,0,0.090909,0,28,11,11,1.107143,0,0,8,12,false,true,true,0.97,0.03
274,249,25,16.117647,14.647059,25,371,435,-64,0,0,0,0,-11,17,17,-4,0,0,6,5,false,true,true,0.835,0.165
157,145,12,15.7,14.5,12,272,288,-16,0,0,0,0,48,10,10,1.083333,0,1,24,13,false,true,true,0.68,0.32
248,137,111,24.8,15.222222,111,904,668,236,0,0,0,0,23,10,9,1.478261,0,1,14,9,false,true,true,0.954,0.046
143,150,-7,20.428571,21.428571,-7,1161,1166,-5,1,0,0.142857,0,47,7,7,0.744681,0,1,11,13,false,true,false,0.426,0.574
257,185,72,25.7,18.5,72,1029,1227,-198,1,0,0.1,0,21,10,10,1.52381,1,0,7,14,false,true,true,0.994,0.006
296,291,5,29.6,29.1,5,1148,1164,-16,1,2,0.1,0.2,12,10,10,2.083333,0,0,16,7,false,true,true,0.965,0.035
169,109,60,24.142857,15.571429,60,1022,1095,-73,0,0,0,0,54,7,7,0.611111,0,0,11,11,false,true,true,0.924,0.076
375,297,78,18.75,15.631579,78,527,581,-54,0,0,0,0,-31,20,19,-1.354839,0,0,1,5,false,true,true,1,0
212,99,113,26.5,12.375,113,1159,1031,128,1,0,0.125,0,40,8,8,0.975,1,0,15,14,false,true,true,0.976,0.024
351,283,68,27,21.769231,68,1245,1232,13,1,0,0.076923,0,-16,13,13,-1.8125,0,0,3,2,false,true,true,1,0
337,245,92,37.444444,27.222222,92,1824,1793,31,1,0,0.111111,0,31,9,9,0.903226,1,0,6,11,false,true,true,1,0
386,290,96,21.444444,16.111111,96,769,527,242,1,0,0.055556,0,-25,18,18,-1.44,0,0,2,2,true,true,true,1,0
165,144,21,16.5,14.4,21,777,830,-53,0,0,0,0,36,10,10,1.138889,0,0,14,11,false,true,true,0.774,0.226
351,254,97,27,19.538462,97,1691,1692,-1,0,0,0,0,7,13,13,4.285714,1,0,7,8,false,true,true,1,0
293,241,52,18.3125,16.066667,52,808,639,169,0,0,0,0,0,16,15,0,0,1,10,8,false,true,true,0.91,0.09
322,294,28,20.125,19.6,28,1710,1636,74,1,1,0.0625,0.066667,0,16,15,0,1,0,10,14,false,true,true,1,0
231,197,34,21,19.7,34,809,868,-59,1,0,0.090909,0,26,11,10,1.230769,0,0,9,20,false,true,true,0.806,0.194
36,18,18,18,18,18,1164,1201,-37,0,0,0,0,87,2,1,0.482759,0,1,17,13,false,true,true,0.553,0.447
131,78,53,32.75,19.5,53,1270,1322,-52,1,0,0.25,0,73,4,4,0.520548,1,0,18,12,false,true,true,0.973,0.027
21,94,-73,10.5,47,-73,1762,1538,224,0,1,0,0.5,83,2,2,0.409639,0,0,13,17,false,true,true,0.997,0.003
234,186,48,26,20.666667,48,1109,1065,44,0,0,0,0,25,9,9,1.32,0,0,18,12,false,true,true,0.945,0.055
387,360,27,27.642857,25.714286,27,1489,1555,-66,1,0,0.071429,0,-11,14,14,-2.636364,0,0,5,10,false,true,true,1,0
194,186,8,17.636364,18.6,8,671,725,-54,0,0,0,0,25,11,10,1.48,1,0,7,12,false,true,true,0.725,0.275
280,270,10,17.5,18,10,658,817,-159,0,0,0,0,7,16,15,5.428571,1,0,7,10,false,true,false,0.284,0.716
234,173,61,16.714286,12.357143,61,1069,1040,29,0,0,0,0,7,14,14,6.285714,0,2,7,5,false,true,true,0.985,0.015
240,154,86,21.818182,14,86,1253,1166,87,1,0,0.090909,0,34,11,11,1.264706,0,0,7,18,false,true,true,0.996,0.004
315,292,23,17.5,16.222222,23,725,771,-46,0,1,0,0.055556,-10,18,18,-4.6,1,0,10,10,false,true,true,0.966,0.034
157,94,63,17.444444,11.75,63,1050,1144,-94,0,0,0,0,51,9,8,0.745098,0,0,25,8,false,true,true,0.855,0.145
109,93,16,18.166667,18.6,16,1216,1228,-12,0,0,0,0,63,6,5,0.52381,0,0,14,8,false,true,true,0.677,0.323
263,172,91,16.4375,11.466667,91,1128,889,239,0,1,0,0.066667,10,16,15,4.7,0,0,19,19,false,true,true,1,0
328,298,30,16.4,15.684211,30,628,658,-30,0,0,0,0,-13,20,19,-3.538462,0,0,6,10,false,true,true,1,0
264,184,80,29.333333,20.444444,80,1030,998,32,1,0,0.111111,0,31,9,9,1.225806,0,0,16,13,false,true,true,0.988,0.012
30,48,-18,15,24,-18,1304,1040,264,0,0,0,0,83,2,2,0.39759,0,0,13,16,false,true,false,0.21,0.79
206,155,51,25.75,19.375,51,1334,1256,78,1,0,0.125,0,42,8,8,0.738095,0,0,9,7,false,true,true,0.91,0.09
136,125,11,17,15.625,11,758,750,8,0,0,0,0,41,8,8,0.902439,0,1,11,11,false,true,true,0.74,0.26
130,188,-58,18.571429,26.857143,-58,594,605,-11,0,0,0,0,55,7,7,0.672727,1,0,8,9,false,true,false,0.003,0.997
355,274,81,23.666667,19.571429,81,804,988,-184,2,0,0.133333,0,-8,15,14,-4.125,0,0,7,4,false,true,true,1,0
71,79,-8,14.2,19.75,-8,596,595,1,0,0,0,0,71,5,4,0.56338,1,0,9,14,false,true,false,0.349,0.651
387,271,116,27.642857,20.846154,116,1489,1555,-66,1,0,0.071429,0,-3,14,13,-9.666667,0,0,5,10,false,true,true,1,0
250,147,103,27.777778,16.333333,103,1651,1691,-40,1,0,0.111111,0,41,9,9,0.829268,0,0,17,11,false,true,true,0.986,0.014
102,83,19,25.5,27.666667,19,1419,1488,-69,0,0,0,0,66,4,3,0.424242,0,0,14,7,false,true,true,0.678,0.322
254,227,27,14.111111,12.611111,27,611,584,27,0,0,0,0,-4,18,18,-11,0,0,7,14,false,true,true,0.74,0.26
355,224,131,22.1875,14,131,554,342,212,0,0,0,0,-15,16,16,-2.4,0,0,2,4,false,true,true,1,0
409,316,93,22.722222,18.588235,93,1050,1144,-94,0,1,0,0.058824,-21,18,17,-1.809524,0,0,1,3,false,true,true,1,0
55,29,26,18.333333,9.666667,26,1516,1397,119,0,0,0,0,79,3,3,0.417722,0,1,22,10,false,true,true,0.778,0.222
298,240,58,21.285714,18.461538,58,791,774,17,1,0,0.071429,0,19,14,13,2.157895,0,0,16,14,false,true,true,0.968,0.032
351,325,26,17.55,17.105263,26,1181,1149,32,0,1,0,0.052632,-15,20,19,-3,0,0,8,6,false,true,true,1,0
241,198,43,17.214286,15.230769,43,363,668,-305,0,0,0,0,16,14,13,2.6875,0,1,21,12,false,true,true,0.718,0.282
224,243,-19,14.933333,17.357143,-19,500,567,-67,0,0,0,0,18,15,14,2.444444,0,1,9,8,false,true,false,0.03,0.97
269,268,1,26.9,29.777778,1,1256,1232,24,1,0,0.1,0,24,10,9,1.25,0,0,15,14,false,true,false,0.271,0.729
119,94,25,19.833333,15.666667,25,1048,1000,48,0,0,0,0,60,6,6,0.666667,0,1,7,7,false,true,true,0.816,0.184
30,18,12,30,18,12,1826,1656,170,0,0,0,0,90,1,1,0.3,0,0,11,14,false,true,true,0.757,0.243
85,131,-46,14.166667,26.2,-46,1897,1793,104,0,1,0,0.2,70,6,5,0.457143,0,0,8,14,false,true,true,0.996,0.004
358,275,83,22.375,17.1875,83,613,569,44,0,0,0,0,-9,16,16,-4.333333,0,0,3,4,false,true,true,1,0
34,33,1,17,16.5,1,1170,1156,14,0,0,0,0,87,2,2,0.436782,1,0,13,18,false,true,true,0.702,0.298
117,84,33,23.4,21,33,1237,1277,-40,0,0,0,0,64,5,4,0.453125,0,0,16,20,false,true,true,0.683,0.317
96,79,17,19.2,19.75,17,1211,1173,38,0,0,0,0,72,5,4,0.486111,0,1,14,6,false,true,true,0.678,0.322
297,243,54,22.846154,20.25,54,1493,1513,-20,1,0,0.076923,0,15,13,12,2.2,0,2,8,8,false,true,true,0.549,0.451
204,153,51,29.142857,21.857143,51,1731,1691,40,1,0,0.142857,0,44,7,7,0.772727,0,0,11,9,false,true,true,0.843,0.157
351,255,96,20.647059,15.9375,96,1055,1050,5,0,0,0,0,-9,17,16,-3.777778,1,0,2,1,false,true,true,1,0
202,144,58,20.2,16,58,1091,1078,13,0,0,0,0,43,10,9,1,0,0,16,8,false,true,true,0.946,0.054
75,51,24,15,10.2,24,584,565,19,0,0,0,0,67,5,5,0.686567,0,0,16,22,false,true,true,0.818,0.182
334,252,82,22.266667,18,82,941,926,15,1,0,0.066667,0,6,15,14,6.333333,0,0,12,12,false,true,true,1,0
257,271,-14,19.769231,22.583333,-14,1096,1009,87,1,0,0.076923,0,31,13,12,1.419355,0,0,8,12,false,true,false,0.064,0.936
74,53,21,18.5,13.25,21,1551,1550,1,0,0,0,0,74,4,4,0.567568,0,1,19,24,false,true,true,0.552,0.448
219,171,48,15.642857,12.214286,48,777,830,-53,0,0,0,0,16,14,14,2.5625,0,0,23,9,false,true,true,0.965,0.035
27,39,-12,13.5,19.5,-12,1040,925,115,0,0,0,0,85,2,2,0.505882,0,0,16,8,false,true,true,0.67,0.33
316,300,16,15.8,15,16,1583,1422,161,1,0,0.05,0,-2,20,20,-25.5,0,0,7,15,false,true,true,1,0
8,11,-3,4,11,-3,539,632,-93,0,0,0,0,93,2,1,0.494624,0,1,14,16,false,true,false,0.25,0.75
318,262,56,13.826087,11.909091,56,584,565,19,0,0,0,0,-38,23,22,-1.210526,0,0,1,2,false,true,true,1,0
208,235,-27,11.555556,13.055556,-27,1030,1045,-15,0,0,0,0,1,18,18,46,1,0,8,9,false,true,false,0.325,0.675
297,279,18,29.7,27.9,18,1237,1277,-40,0,0,0,0,17,10,10,1.705882,1,0,6,13,false,true,true,1,0
30,0,30,30,0,30,620,513,107,0,0,0,0,95,1,0,0.473684,0,0,9,0,false,true,true,0.728,0.272
68,60,8,22.666667,30,8,1331,1399,-68,0,0,0,0,75,3,2,0.466667,1,0,11,7,false,true,true,0.886,0.114
386,301,85,22.705882,17.705882,85,977,976,1,2,0,0.117647,0,-14,17,17,-2.428571,0,0,4,4,true,true,true,1,0
137,98,39,17.125,12.25,39,801,807,-6,0,0,0,0,43,8,8,0.813953,0,0,9,9,false,true,true,0.876,0.124
95,68,27,15.833333,13.6,27,856,897,-41,0,0,0,0,61,6,5,0.57377,1,0,11,7,false,true,true,0.753,0.247
337,275,62,22.466667,18.333333,62,1065,1030,35,0,1,0,0.066667,-8,15,15,-4.25,0,0,6,5,false,true,true,1,0
325,213,112,32.5,23.666667,112,1245,1241,4,1,1,0.1,0.111111,23,10,9,1.26087,0,0,13,10,false,true,true,1,0
10,24,-14,10,24,-14,1551,1550,1,0,0,0,0,92,1,1,0.456522,0,0,22,22,false,true,false,0.262,0.738
338,314,24,17.789474,17.444444,24,1270,1348,-78,0,0,0,0,-17,19,18,-2.235294,0,0,2,4,false,true,true,1,0
148,121,27,24.666667,20.166667,27,1302,1082,220,0,0,0,0,47,6,6,0.638298,0,0,17,9,false,true,true,0.768,0.232
334,300,34,18.555556,17.647059,34,1181,1149,32,0,1,0,0.058824,-3,18,17,-15,0,0,15,7,false,true,true,0.898,0.102
289,209,80,26.272727,19,80,1014,948,66,1,0,0.090909,0,23,11,11,1.434783,0,0,18,18,false,true,true,1,0
37,43,-6,12.333333,14.333333,-6,1127,1075,52,0,0,0,0,82,3,3,0.378049,0,0,7,14,false,true,true,0.582,0.418
115,108,7,23,21.6,7,1297,1606,-309,0,0,0,0,66,5,5,0.454545,1,0,7,22,false,true,false,0.256,0.744
132,140,-8,14.666667,17.5,-8,611,584,27,0,0,0,0,50,9,8,0.88,0,0,7,7,false,true,false,0.086,0.914
233,233,0,19.416667,19.416667,0,349,315,34,0,0,0,0,3,12,12,11.333333,0,1,19,14,false,true,false,0.466,0.534
294,290,4,22.615385,24.166667,4,1344,1325,19,1,0,0.076923,0,5,13,12,6.2,0,0,15,7,false,true,false,0.284,0.716
178,115,63,19.777778,14.375,63,871,867,4,0,0,0,0,45,9,8,0.955556,0,0,11,15,false,true,true,0.966,0.034
342,194,148,16.285714,9.238095,148,993,897,96,1,0,0.047619,0,-21,21,21,-2.238095,0,0,5,25,false,true,true,1,0
385,253,132,25.666667,18.071429,132,1211,1173,38,0,0,0,0,4,15,14,8.75,0,0,7,7,false,true,true,1,0
281,194,87,25.545455,19.4,87,1216,1217,-1,1,0,0.090909,0,22,11,10,1.545455,0,0,9,19,false,true,true,1,0
0,0,0,0,0,0,1897,1793,104,0,0,0,0,100,1,0,0.32,0,0,8,0,false,true,true,0.733,0.267
40,0,40,40,0,40,742,696,46,0,0,0,0,94,1,0,0.340426,0,0,20,0,false,true,true,0.784,0.216
224,170,54,20.363636,17,54,916,837,79,0,0,0,0,35,11,10,1.142857,0,0,9,14,false,true,true,0.91,0.09
155,81,74,31,16.2,74,1439,1294,145,1,0,0.2,0,62,5,5,0.580645,0,0,9,14,false,true,true,0.882,0.118
157,53,104,39.25,17.666667,104,1489,1405,84,1,0,0.25,0,75,4,3,0.373333,1,0,14,14,false,true,true,0.995,0.005
108,146,-38,15.428571,24.333333,-38,719,785,-66,0,1,0,0.166667,53,7,6,0.679245,0,0,17,16,false,true,false,0.061,0.939
74,57,17,18.5,14.25,17,1489,1445,44,0,0,0,0,70,4,4,0.457143,0,0,19,10,false,true,true,0.694,0.306
336,321,15,28,29.181818,15,1256,1232,24,1,0,0.083333,0,11,12,11,2.727273,0,0,7,15,false,true,true,1,0
172,176,-4,19.111111,22,-4,995,912,83,1,0,0.111111,0,50,9,8,0.88,1,0,8,8,false,true,true,0.746,0.254
16,0,16,16,0,16,1659,1782,-123,0,0,0,0,97,1,0,0.298969,0,0,9,0,false,true,false,0.461,0.539
265,253,12,26.5,25.3,12,1554,1716,-162,1,1,0.1,0.1,21,10,10,1.666667,0,0,16,11,false,true,true,0.837,0.163
143,119,24,23.833333,23.8,24,844,821,23,0,0,0,0,69,6,5,0.608696,0,0,12,9,false,true,true,0.651,0.349
408,339,69,27.2,22.6,69,1793,1897,-104,2,0,0.133333,0,-11,15,15,-2.727273,0,0,3,10,true,true,true,1,0
154,163,-9,15.4,16.3,-9,523,480,43,1,0,0.1,0,29,10,10,1.137931,0,0,12,14,false,true,true,0.91,0.09
45,41,4,22.5,20.5,4,820,783,37,0,0,0,0,88,2,2,0.375,0,0,10,14,false,true,true,0.677,0.323
59,31,28,29.5,15.5,28,1295,1281,14,0,0,0,0,84,2,2,0.452381,0,0,17,11,false,true,true,0.719,0.281
304,243,61,20.266667,16.2,61,1270,1315,-45,0,0,0,0,-3,15,15,-12,0,0,5,31,false,true,true,1,0
27,20,7,13.5,20,7,1265,1237,28,0,0,0,0,86,2,1,0.348837,0,0,10,18,false,true,true,0.616,0.384
328,286,42,27.333333,23.833333,42,1885,1846,39,1,1,0.083333,0.083333,4,12,12,7.25,1,0,12,8,false,true,true,1,0
208,123,85,29.714286,20.5,85,1109,1065,44,0,0,0,0,50,7,6,0.66,0,0,10,11,false,true,true,0.945,0.055
274,233,41,15.222222,12.944444,41,584,565,19,0,0,0,0,-14,18,18,-3.285714,0,0,20,8,false,true,true,0.993,0.007
262,205,57,18.714286,15.769231,57,334,446,-112,0,0,0,0,1,14,13,40,0,1,8,16,false,true,false,0.35,0.65
110,78,32,22,19.5,32,1069,917,152,0,0,0,0,68,5,4,0.5,0,1,11,7,false,true,true,0.756,0.244
10,16,-6,10,16,-6,1221,1438,-217,0,0,0,0,94,1,1,0.478723,0,0,17,14,false,true,false,0.251,0.749
288,226,62,26.181818,20.545455,62,1034,1040,-6,1,0,0.090909,0,19,11,11,1.842105,1,0,8,16,false,true,true,1,0
34,20,14,17,20,14,1245,1232,13,1,0,0.5,0,81,2,1,0.358025,0,0,10,11,false,true,true,0.678,0.322
396,346,50,26.4,23.066667,50,1454,1531,-77,1,1,0.066667,0.066667,-13,15,15,-2.307692,0,0,3,4,true,true,true,1,0
99,54,45,24.75,13.5,45,1586,1782,-196,0,0,0,0,71,4,4,0.56338,0,0,17,16,false,true,false,0.437,0.563
274,202,72,22.833333,16.833333,72,1022,1095,-73,0,0,0,0,12,12,12,2.75,0,1,11,8,false,true,true,0.986,0.014
69,79,-10,17.25,19.75,-10,1261,1349,-88,0,0,0,0,71,4,4,0.183099,0,0,13,19,false,true,false,0.326,0.674
260,229,31,21.666667,20.818182,31,1115,1078,37,0,1,0,0.090909,19,12,11,1.789474,1,0,11,9,false,true,true,0.77,0.23
191,216,-25,15.916667,19.636364,-25,1077,1094,-17,0,0,0,0,29,12,11,1.448276,0,0,10,9,false,true,false,0.051,0.949
128,114,14,21.333333,19,14,505,95,410,0,1,0,0.166667,69,6,6,0.637681,0,0,14,8,false,true,true,1,0
181,138,43,45.25,34.5,43,1348,1331,17,1,0,0.25,0,59,4,4,0.40678,0,0,9,13,false,true,true,0.734,0.266
407,374,33,29.071429,28.769231,33,1890,2020,-130,1,2,0.071429,0.153846,-13,14,13,-2.230769,0,0,2,1,false,true,true,1,0
230,223,7,32.857143,31.857143,7,1333,1331,2,1,0,0.142857,0,36,7,7,0.833333,0,0,11,13,false,true,true,0.678,0.322
68,60,8,13.6,15,8,613,502,111,0,0,0,0,67,5,4,0.731343,0,0,16,16,false,true,true,0.653,0.347
129,65,64,25.8,13,64,1093,1100,-7,1,0,0.2,0,75,5,5,0.426667,0,1,10,6,false,true,false,0.495,0.505
220,182,38,20,16.545455,38,1227,1060,167,0,1,0,0.090909,28,11,11,1.428571,0,0,11,16,false,true,true,0.851,0.149
159,130,29,19.875,18.571429,29,808,639,169,0,0,0,0,41,8,7,1,1,0,24,7,false,true,true,0.928,0.072
136,163,-27,22.666667,32.6,-27,1305,1218,87,0,0,0,0,54,6,5,0.703704,1,0,8,9,false,true,true,0.596,0.404
272,284,-12,15.111111,15.777778,-12,628,658,-30,0,0,0,0,-4,18,18,-11.5,0,0,11,12,false,true,false,0.025,0.975
146,119,27,18.25,17,27,695,523,172,0,0,0,0,43,8,7,0.860465,0,1,12,7,false,true,true,0.792,0.208
193,190,3,21.444444,21.111111,3,1406,1454,-48,0,1,0,0.111111,31,9,9,1.096774,1,1,11,15,false,true,false,0.381,0.619
292,262,30,26.545455,23.818182,30,1428,1606,-178,1,0,0.090909,0,15,11,11,2.133333,1,0,15,10,false,true,true,0.905,0.095
412,307,105,27.466667,20.466667,105,1396,1454,-58,2,0,0.133333,0,-5,15,15,-6.6,0,0,4,1,false,true,true,1,0
322,255,67,20.125,17,67,1551,1550,1,0,0,0,0,-6,16,15,-7,0,1,12,9,false,true,true,1,0
175,141,34,14.583333,12.818182,34,1030,1045,-15,0,0,0,0,38,12,11,1.210526,0,0,9,16,false,true,false,0.186,0.814
249,147,102,35.571429,24.5,102,1320,1339,-19,2,1,0.285714,0.166667,47,7,6,0.829787,0,1,7,19,false,true,true,0.875,0.125
241,224,17,16.066667,16,17,628,658,-30,0,0,0,0,15,15,14,3.066667,0,0,14,12,false,true,false,0.354,0.646
351,307,44,21.9375,20.466667,44,1022,1095,-73,0,1,0,0.066667,-14,16,15,-2.357143,0,0,2,4,false,true,true,1,0
392,375,17,23.058824,23.4375,17,1397,1195,202,1,0,0.058824,0,-14,17,16,-2.5,0,0,3,2,false,true,true,1,0
55,62,-7,18.333333,20.666667,-7,500,567,-67,0,0,0,0,82,3,3,0.536585,0,0,11,7,false,true,false,0.252,0.748
258,214,44,28.666667,23.777778,44,1093,1100,-7,2,2,0.222222,0.222222,38,9,9,0.842105,0,0,8,12,false,true,true,0.994,0.006
148,90,58,21.142857,15,58,561,526,35,0,0,0,0,47,7,6,0.744681,0,0,13,12,false,true,true,0.962,0.038
176,118,58,22,16.857143,58,1127,1075,52,1,0,0.125,0,45,8,7,0.688889,0,1,15,18,false,true,true,0.847,0.153
289,240,49,16.055556,14.117647,49,346,231,115,0,0,0,0,-30,18,17,-1.366667,0,1,18,5,false,true,true,0.979,0.021
84,34,50,16.8,8.5,50,1428,1302,126,0,0,0,0,71,5,4,0.746479,0,1,10,15,false,true,true,0.819,0.181
294,238,56,17.294118,14.875,56,1583,1422,161,1,0,0.058824,0,18,17,16,2.833333,0,0,7,15,false,true,true,1,0
262,217,45,21.833333,18.083333,45,691,675,16,0,0,0,0,18,12,12,2.055556,0,1,25,6,false,true,true,0.986,0.014
369,307,62,24.6,21.928571,62,1554,1622,-68,2,0,0.133333,0,-15,15,14,-2.066667,0,0,3,4,false,true,true,1,0
14,0,14,14,0,14,902,866,36,0,0,0,0,94,1,0,0.340426,0,0,7,0,false,true,true,0.678,0.322
16,0,16,16,0,16,1048,1000,48,0,0,0,0,97,1,0,0.412371,0,0,17,0,false,true,true,0.68,0.32
95,136,-41,13.571429,19.428571,-41,576,494,82,0,0,0,0,57,7,7,0.77193,0,0,7,16,false,true,false,0.105,0.895
369,285,84,18.45,15,84,613,569,44,0,0,0,0,-21,20,19,-1.857143,0,0,1,1,true,true,true,1,0
102,111,-9,17,18.5,-9,999,1011,-12,0,0,0,0,59,6,6,0.779661,0,0,12,21,false,true,false,0.186,0.814
18,20,-2,18,20,-2,892,788,104,0,0,0,0,93,1,1,0.462366,1,0,10,12,false,true,true,0.686,0.314
270,227,43,27,25.222222,43,1142,1095,47,1,0,0.1,0,26,10,9,1.346154,0,0,16,13,false,true,true,0.965,0.035
304,152,152,27.636364,15.2,152,1144,1014,130,0,0,0,0,28,11,10,1.285714,0,1,18,9,false,true,true,1,0
280,228,52,35,28.5,52,1302,1349,-47,0,1,0,0.125,30,8,8,0.933333,0,0,13,16,false,true,true,0.988,0.012
188,114,74,26.857143,19,74,1110,1039,71,0,0,0,0,52,7,6,0.692308,0,0,17,7,false,true,true,0.893,0.107
30,36,-6,10,12,-6,450,412,38,0,0,0,0,81,3,3,0.469136,0,1,7,6,false,true,false,0.269,0.731
332,238,94,25.538462,18.307692,94,769,527,242,1,0,0.076923,0,1,13,13,36,0,0,11,15,false,true,true,1,0
50,29,21,25,14.5,21,1216,1217,-1,0,0,0,0,84,2,2,0.404762,0,0,17,24,false,true,true,0.686,0.314
338,288,50,15.363636,13.714286,50,1091,1078,13,0,0,0,0,-20,22,21,-2.15,1,0,4,2,true,true,true,1,0
315,287,28,19.6875,17.9375,28,1210,1253,-43,0,1,0,0.0625,-12,16,16,-2.916667,1,0,4,3,false,true,true,0.98,0.02
13,16,-3,6.5,16,-3,523,480,43,0,0,0,0,93,2,1,0.354839,0,0,18,10,false,true,false,0.5,0.5
173,156,17,28.833333,26,17,1489,1555,-66,1,0,0.166667,0,51,6,6,0.568627,0,0,11,13,false,true,true,0.683,0.317
77,52,25,19.25,13,25,1439,1413,26,0,0,0,0,75,4,4,0.48,0,0,22,8,false,true,true,0.741,0.259
360,331,29,16.363636,15.045455,29,1388,1477,-89,1,0,0.045455,0,-31,22,22,-1.548387,0,0,2,4,false,true,true,1,0
73,60,13,14.6,15,13,416,222,194,0,0,0,0,68,5,4,0.808824,1,0,9,7,false,true,true,0.885,0.115
69,78,-9,23,26,-9,1406,1454,-48,0,1,0,0.333333,71,3,3,0.478873,1,0,13,18,false,true,true,0.727,0.273
212,147,65,21.2,14.7,65,739,480,259,1,0,0.1,0,34,10,10,1.058824,0,1,12,7,false,true,true,0.856,0.144
295,232,63,22.692308,19.333333,63,825,907,-82,1,0,0.076923,0,17,13,12,2.352941,0,0,16,15,false,true,true,0.98,0.02
173,129,44,19.222222,16.125,44,527,581,-54,0,0,0,0,42,9,8,1,1,0,20,15,false,true,true,0.798,0.202
381,239,142,17.318182,11.380952,142,896,818,78,0,1,0,0.047619,-25,22,21,-1.76,1,0,5,5,false,true,true,1,0
350,254,96,19.444444,14.941176,96,719,651,68,0,1,0,0.058824,-3,18,17,-15,0,0,10,11,false,true,true,1,0
179,175,4,16.272727,15.909091,4,523,480,43,1,0,0.090909,0,21,11,11,1.571429,0,0,13,12,false,true,true,0.965,0.035
39,31,8,19.5,15.5,8,1047,1094,-47,0,0,0,0,87,2,2,0.413793,0,0,8,17,false,true,false,0.417,0.583
313,285,28,19.5625,17.8125,28,1161,1166,-5,1,0,0.0625,0,-15,16,16,-2.333333,0,1,5,9,false,true,true,0.998,0.002
403,346,57,19.190476,16.47619,57,892,788,104,3,0,0.142857,0,-24,21,21,-1.791667,0,0,1,1,false,true,true,1,0
274,209,65,18.266667,13.933333,65,415,518,-103,0,0,0,0,1,15,15,38,0,0,8,21,false,true,true,1,0
335,249,86,19.705882,14.647059,86,518,533,-15,1,0,0.058824,0,-20,17,17,-1.75,0,0,3,1,false,true,true,1,0
134,181,-47,19.142857,25.857143,-47,869,820,49,0,1,0,0.142857,56,7,7,0.660714,0,0,13,8,false,true,false,0.201,0.799
121,138,-17,15.125,17.25,-17,908,859,49,0,0,0,0,48,8,8,0.8125,1,1,12,8,false,true,false,0.395,0.605
191,69,122,31.833333,13.8,122,1216,1217,-1,1,0,0.166667,0,56,6,5,0.607143,0,0,10,28,false,true,true,0.981,0.019
94,9,85,23.5,3,85,1067,95,972,0,0,0,0,79,4,3,0.43038,0,0,21,14,false,true,true,1,0
286,188,98,17.875,12.533333,98,691,675,16,0,0,0,0,0,16,15,0,0,0,11,16,false,true,true,1,0
12,0,12,12,0,12,1016,1037,-21,0,0,0,0,97,1,0,0.494845,0,0,13,0,false,true,true,0.565,0.435
69,69,0,17.25,17.25,0,1065,1030,35,0,0,0,0,74,4,4,0.459459,0,1,20,9,false,true,true,0.679,0.321
378,281,97,21,16.529412,97,801,925,-124,1,0,0.055556,0,-20,18,17,-1.75,0,0,4,1,true,true,true,1,0
118,115,3,23.6,23,3,1302,1234,68,0,0,0,0,62,5,5,0.5,1,0,13,17,false,true,true,0.893,0.107
175,189,-14,15.909091,17.181818,-14,527,514,13,0,0,0,0,23,11,11,1.695652,0,1,12,11,false,true,false,0.056,0.944
25,22,3,12.5,22,3,1885,1846,39,0,1,0,1,84,2,1,0.345238,1,0,9,16,false,true,false,0.217,0.783
14,22,-8,14,22,-8,778,758,20,0,0,0,0,92,1,1,0.423913,0,0,7,15,false,true,true,0.664,0.336
289,250,39,22.230769,20.833333,39,1244,1361,-117,2,1,0.153846,0.083333,23,13,12,1.652174,0,0,18,13,false,true,true,0.841,0.159
249,148,101,31.125,18.5,101,1270,1322,-52,1,0,0.125,0,45,8,8,0.844444,1,0,11,23,false,true,true,1,0
344,285,59,22.933333,20.357143,59,1014,1303,-289,1,0,0.066667,0,-5,15,14,-7.6,0,0,6,18,false,true,true,1,0
33,39,-6,11,19.5,-6,691,675,16,0,0,0,0,82,3,2,0.463415,1,0,13,11,false,true,true,0.669,0.331
28,8,20,14,8,20,1110,1039,71,0,0,0,0,91,2,1,0.395604,1,0,24,8,false,true,true,0.722,0.278
232,249,-17,25.777778,27.666667,-17,1102,1245,-143,1,0,0.111111,0,16,9,9,1.75,0,0,14,8,false,true,true,0.545,0.455
60,22,38,20,11,38,1014,1303,-289,0,0,0,0,84,3,2,0.452381,1,1,7,8,false,true,false,0.252,0.748
317,217,100,28.818182,21.7,100,630,786,-156,1,0,0.090909,0,23,11,10,1.521739,0,0,11,15,false,true,true,1,0
77,38,39,25.666667,19,39,880,952,-72,0,0,0,0,81,3,2,0.432099,0,1,21,9,false,true,false,0.352,0.648
113,128,-15,16.142857,21.333333,-15,1583,1422,161,0,0,0,0,61,7,6,0.836066,1,0,16,7,false,true,true,0.6,0.4
66,68,-2,16.5,17,-2,421,306,115,0,1,0,0.25,61,4,4,0.721311,0,0,14,13,false,true,true,0.828,0.172
352,293,59,22,19.533333,59,1434,1493,-59,1,0,0.0625,0,-8,16,15,-4.625,0,0,6,3,false,true,true,1,0
394,301,93,23.176471,18.8125,93,995,912,83,2,0,0.117647,0,-2,17,16,-22,0,0,7,16,false,true,true,1,0
128,105,23,21.333333,21,23,711,876,-165,0,0,0,0,60,6,5,0.716667,0,0,16,13,false,true,false,0.261,0.739
326,283,43,19.176471,17.6875,43,921,1072,-151,1,0,0.058824,0,-4,17,16,-9.5,0,0,6,8,false,true,true,1,0
270,190,80,24.545455,17.272727,80,847,952,-105,0,0,0,0,33,11,11,1.090909,0,0,7,13,false,true,true,0.965,0.035
210,133,77,17.5,12.090909,77,346,231,115,0,0,0,0,9,12,11,4.555556,0,0,10,9,false,true,true,0.97,0.03
255,152,103,23.181818,15.2,103,1004,653,351,0,0,0,0,20,11,10,1.75,0,0,11,19,false,true,true,1,0
146,67,79,20.857143,9.571429,79,993,897,96,1,0,0.142857,0,48,7,7,0.979167,0,0,14,16,false,true,true,0.97,0.03
52,22,30,13,7.333333,30,1016,1037,-21,0,0,0,0,80,4,3,0.6,0,0,11,17,false,true,false,0.466,0.534
318,285,33,18.705882,17.8125,33,1161,1166,-5,1,0,0.058824,0,-17,17,16,-2.058824,0,1,1,9,false,true,true,1,0
256,249,7,17.066667,16.6,7,864,808,56,1,0,0.066667,0,-12,15,15,-2.833333,0,1,15,12,false,true,true,0.832,0.168
105,83,22,21,20.75,22,613,569,44,0,0,0,0,65,5,4,0.6,2,0,7,13,false,true,true,0.956,0.044
18,0,18,18,0,18,1762,1538,224,0,0,0,0,96,1,0,0.354167,0,0,9,0,false,true,true,1,0
179,66,113,35.8,13.2,113,925,801,124,1,0,0.2,0,68,5,5,0.588235,1,0,9,9,false,true,true,0.971,0.029
66,78,-12,22,26,-12,820,822,-2,0,0,0,0,78,3,3,0.5,1,0,19,8,false,true,true,0.711,0.289
209,155,54,19,14.090909,54,954,1078,-124,0,1,0,0.090909,27,11,11,1.407407,1,0,15,15,false,true,true,0.969,0.031
50,2,48,25,2,48,1305,1390,-85,0,0,0,0,89,2,1,0.404494,0,0,26,8,false,true,true,0.739,0.261
11,12,-1,5.5,12,-1,1397,1422,-25,0,0,0,0,94,2,1,0.382979,0,0,9,14,false,true,false,0.484,0.516
388,293,95,17.636364,13.318182,95,539,632,-93,0,0,0,0,-27,22,22,-1.703704,0,0,1,4,false,true,true,1,0
261,147,114,26.1,16.333333,114,1651,1691,-40,1,0,0.1,0,37,10,9,0.918919,0,0,10,11,false,true,true,1,0
332,324,8,18.444444,18,8,1127,1176,-49,0,0,0,0,-15,18,18,-2.8,0,0,3,2,false,true,true,0.993,0.007
321,230,91,21.4,15.333333,91,371,336,35,2,0,0.133333,0,-18,15,15,-2.111111,0,0,5,15,false,true,true,1,0
302,263,39,15.1,13.842105,39,826,771,55,0,0,0,0,-10,20,19,-4.5,0,0,11,7,false,true,true,0.999,0.001
173,146,27,19.222222,16.222222,27,527,581,-54,0,0,0,0,39,9,9,1.076923,1,0,20,16,false,true,true,0.773,0.227
191,79,112,15.916667,7.181818,112,1428,1302,126,0,0,0,0,33,12,11,1.606061,0,1,15,18,false,true,true,0.979,0.021
109,79,30,21.8,19.75,30,1216,1228,-12,0,0,0,0,67,5,4,0.492537,0,0,14,8,false,true,true,0.691,0.309
366,295,71,24.4,19.666667,71,1109,1065,44,0,0,0,0,-22,15,15,-1.5,0,0,5,1,false,true,true,1,0
328,320,8,23.428571,22.857143,8,1142,1176,-34,1,0,0.071429,0,4,14,14,9,1,0,16,10,false,true,true,0.982,0.018
283,286,-3,16.647059,16.823529,-3,725,771,-46,0,1,0,0.058824,-5,17,17,-9.2,1,0,13,9,false,true,false,0.485,0.515
330,310,20,15.714286,14.761905,20,1583,1422,161,1,0,0.047619,0,-8,21,21,-6.375,0,0,16,11,false,true,true,1,0
292,179,113,20.857143,12.785714,113,786,757,29,1,0,0.071429,0,9,14,14,4.333333,0,0,9,15,false,true,true,1,0
68,69,-1,13.6,13.8,-1,613,502,111,0,0,0,0,64,5,5,0.765625,0,0,16,19,false,true,true,0.615,0.385
154,133,21,19.25,19,21,871,999,-128,0,0,0,0,46,8,7,1.043478,0,0,7,7,false,true,false,0.265,0.735
310,128,182,44.285714,18.285714,182,1550,1624,-74,1,0,0.142857,0,49,7,7,0.612245,0,1,9,18,false,true,true,1,0
266,166,100,22.166667,15.090909,100,1551,1550,1,0,0,0,0,19,12,11,2.210526,0,1,16,19,false,true,true,0.998,0.002
335,223,112,30.454545,22.3,112,1334,1477,-143,2,1,0.181818,0.1,13,11,10,2.307692,0,0,13,10,false,true,true,1,0
305,274,31,20.333333,19.571429,31,786,847,-61,0,0,0,0,0,15,14,0,0,0,4,10,false,true,true,0.73,0.27
332,215,117,13.833333,9.347826,117,1428,1302,126,0,0,0,0,-22,24,23,-2.409091,0,1,13,12,false,true,true,1,0
132,133,-1,22,26.6,-1,1102,1245,-143,0,0,0,0,50,6,5,0.56,0,0,9,8,false,true,true,0.512,0.488
327,293,34,20.4375,18.3125,34,825,907,-82,1,0,0.0625,0,-3,16,16,-13.333333,0,0,10,15,false,true,true,1,0
167,134,33,20.875,16.75,33,1127,1176,-49,0,0,0,0,42,8,8,1,0,0,12,12,false,true,true,0.821,0.179
172,152,20,24.571429,21.714286,20,948,933,15,1,0,0.142857,0,52,7,7,0.730769,0,0,7,11,false,true,true,0.85,0.15
178,131,47,19.777778,14.555556,47,871,867,4,0,0,0,0,42,9,9,1.02381,0,0,11,12,false,true,true,0.964,0.036
285,204,81,15.833333,11.333333,81,498,43,455,0,0,0,0,-18,18,18,-2.055556,0,0,4,3,false,true,true,1,0
122,129,-7,24.4,32.25,-7,1489,1558,-69,0,1,0,0.25,65,5,4,0.430769,0,0,19,11,false,true,false,0.271,0.729
171,80,91,28.5,16,91,801,925,-124,1,0,0.166667,0,53,6,5,0.660377,0,0,13,10,false,true,true,0.893,0.107
43,65,-22,14.333333,21.666667,-22,1011,921,90,0,0,0,0,78,3,3,0.628205,0,0,11,15,false,true,false,0.287,0.713
367,323,44,30.583333,29.363636,44,1302,1349,-47,0,1,0,0.090909,7,12,11,4,0,1,10,14,false,true,true,1,0
314,286,28,20.933333,19.066667,28,1094,1030,64,0,0,0,0,-5,15,15,-7.2,0,0,7,5,false,true,true,0.972,0.028
286,210,76,19.066667,14,76,576,532,44,0,0,0,0,6,15,15,7.666667,0,0,9,10,false,true,true,1,0
12,22,-10,12,22,-10,711,876,-165,0,0,0,0,92,1,1,0.467391,0,0,12,11,false,true,false,0.251,0.749
205,198,7,18.636364,19.8,7,491,398,93,0,0,0,0,28,11,10,1.285714,0,0,7,20,false,true,true,0.562,0.438
174,78,96,43.5,19.5,96,1396,1454,-58,1,0,0.25,0,68,4,4,0.485294,1,0,12,10,false,true,true,0.995,0.005
203,178,25,11.277778,10.470588,25,416,222,194,0,0,0,0,0,18,17,0,0,0,14,25,false,true,true,0.824,0.176
183,180,3,16.636364,16.363636,3,334,446,-112,0,0,0,0,22,11,11,1.818182,0,1,13,7,false,true,false,0.481,0.519
45,32,13,15,16,13,1550,1546,4,0,0,0,0,83,3,2,0.361446,0,0,19,17,false,true,true,0.64,0.36
315,278,37,22.5,21.384615,37,1100,1008,92,1,0,0.071429,0,6,14,13,6,0,0,10,9,false,true,true,0.995,0.005
372,333,39,31,27.75,39,1826,1656,170,2,0,0.166667,0,-2,12,12,-13.5,0,0,15,1,false,true,true,1,0
12,0,12,12,0,12,1073,1177,-104,0,0,0,0,96,1,0,0.333333,0,0,13,0,false,true,false,0.255,0.745
121,109,12,11,9.909091,12,310,359,-49,0,0,0,0,24,11,11,2.041667,0,0,9,18,false,true,true,0.819,0.181
368,359,9,23,22.4375,9,1539,1537,2,0,1,0,0.0625,-11,16,16,-2.909091,0,0,6,2,true,true,true,0.998,0.002
259,206,53,21.583333,18.727273,53,901,1159,-258,2,0,0.166667,0,19,12,11,1.842105,1,0,7,10,false,true,false,0.287,0.713
21,29,-8,10.5,14.5,-8,1127,1075,52,0,0,0,0,89,2,2,0.348315,0,0,9,15,false,true,true,0.59,0.41
10,0,10,10,0,10,1221,1438,-217,0,0,0,0,97,1,0,0.463918,0,0,17,0,false,true,false,0.251,0.749
337,249,88,25.923077,19.153846,88,1510,1583,-73,1,0,0.076923,0,5,13,13,6.4,0,0,7,13,false,true,true,1,0
238,183,55,19.833333,16.636364,55,1221,1258,-37,1,0,0.083333,0,28,12,11,1.392857,0,0,14,9,false,true,true,0.963,0.037
22,0,22,22,0,22,838,786,52,0,0,0,0,95,1,0,0.336842,0,0,19,0,false,true,true,0.688,0.312
386,290,96,24.125,18.125,96,1305,1390,-85,0,1,0,0.0625,-16,16,16,-2.25,0,2,9,5,false,true,true,1,0
256,149,107,25.6,16.555556,107,1550,1546,4,0,0,0,0,37,10,9,0.810811,1,0,25,12,false,true,true,0.998,0.002
301,273,28,23.153846,21,28,1710,1636,74,1,1,0.076923,0.076923,12,13,13,3,1,0,9,9,false,true,true,0.945,0.055
109,12,97,54.5,12,97,1396,1454,-58,1,0,0.5,0,86,2,1,0.383721,0,0,16,10,false,true,true,0.844,0.156
280,278,2,14,13.9,2,540,518,22,0,0,0,0,-25,20,20,-1.6,0,0,1,1,true,true,true,0.548,0.452
332,296,36,25.538462,22.769231,36,630,786,-156,1,0,0.076923,0,9,13,13,3.888889,0,0,10,8,false,true,true,0.995,0.005
278,269,9,18.533333,17.933333,9,95,378,-283,0,0,0,0,-9,15,15,-3.888889,0,0,6,6,false,true,true,0.795,0.205
25,55,-30,12.5,27.5,-30,1177,1214,-37,0,0,0,0,85,2,2,0.411765,0,0,8,9,false,true,true,0.604,0.396
14,0,14,14,0,14,971,658,313,0,0,0,0,97,1,0,0.371134,0,0,11,0,false,true,true,0.7,0.3
30,45,-15,15,22.5,-15,1434,1493,-59,0,0,0,0,81,2,2,0.45679,0,0,8,8,false,true,true,0.675,0.325
349,250,99,34.9,25,99,1824,1793,31,1,0,0.1,0,23,10,10,1.217391,1,0,8,10,false,true,true,1,0
312,192,120,31.2,19.2,120,1270,1322,-52,1,0,0.1,0,33,10,10,1.151515,0,0,8,18,false,true,true,1,0
33,37,-4,16.5,18.5,-4,948,933,15,0,0,0,0,87,2,2,0.436782,1,1,15,14,false,true,true,0.671,0.329
123,122,1,17.571429,17.428571,1,831,830,1,0,0,0,0,54,7,7,0.685185,0,0,24,9,false,true,true,0.69,0.31
20,0,20,20,0,20,1454,1531,-77,0,0,0,0,97,1,0,0.309278,1,0,9,0,false,true,true,0.698,0.302
279,214,65,19.928571,16.461538,65,711,876,-165,0,0,0,0,9,14,13,4.777778,0,1,12,12,false,true,true,0.924,0.076
138,66,72,27.6,16.5,72,1295,1281,14,0,0,0,0,71,5,4,0.535211,0,0,16,10,false,true,true,0.847,0.153
180,172,8,22.5,21.5,8,809,868,-59,1,0,0.125,0,40,8,8,0.8,0,0,8,17,false,true,true,0.594,0.406
182,118,64,22.75,16.857143,64,1014,948,66,0,0,0,0,54,8,7,0.611111,0,0,7,16,false,true,true,0.945,0.055
26,21,5,13,21,5,95,360,-265,0,0,0,0,88,2,1,0.454545,0,0,7,16,false,true,false,0.21,0.79
135,78,57,16.875,11.142857,57,1128,889,239,0,1,0,0.142857,51,8,7,0.921569,0,0,25,9,false,true,true,1,0
61,43,18,15.25,14.333333,18,95,378,-283,0,0,0,0,74,4,3,0.472973,0,0,7,7,false,true,false,0.28,0.72
162,89,73,27,17.8,73,901,1159,-258,2,0,0.333333,0,59,6,5,0.59322,0,0,11,17,false,true,true,0.826,0.174
199,160,39,18.090909,16,39,801,807,-6,0,0,0,0,23,11,10,1.521739,1,0,11,21,false,true,true,0.924,0.076
321,219,102,20.0625,13.6875,102,1295,1477,-182,2,0,0.125,0,6,16,16,7.666667,1,0,6,21,false,true,true,1,0
80,45,35,20,15,35,786,788,-2,0,0,0,0,70,4,3,0.485714,0,0,18,21,false,true,true,0.709,0.291
268,227,41,38.285714,37.833333,41,1885,1793,92,0,0,0,0,39,7,6,0.692308,0,0,13,8,false,true,true,0.925,0.075
141,135,6,28.2,33.75,6,1434,1493,-59,1,0,0.2,0,54,5,4,0.685185,0,0,18,11,false,true,true,0.678,0.322
48,63,-15,16,21,-15,999,1011,-12,0,0,0,0,76,3,3,0.605263,0,0,11,21,false,true,false,0.49,0.51
313,254,59,15.65,13.368421,59,698,742,-44,1,0,0.05,0,-12,20,19,-3.416667,0,0,1,3,false,true,true,1,0
362,279,83,25.857143,19.928571,83,1203,1221,-18,2,0,0.142857,0,8,14,14,4.375,0,0,7,16,false,true,true,1,0
66,47,19,22,23.5,19,1305,1218,87,0,0,0,0,78,3,2,0.487179,0,0,11,10,false,true,true,0.677,0.323
14,0,14,14,0,14,1434,1493,-59,0,0,0,0,96,1,0,0.385417,0,0,11,0,false,true,true,0.663,0.337
194,161,33,17.636364,16.1,33,613,502,111,0,0,0,0,30,11,10,1.633333,0,0,7,24,false,true,true,0.765,0.235
379,392,-13,29.153846,32.666667,-13,1897,1793,104,2,3,0.153846,0.25,15,13,12,2.133333,0,0,9,15,false,true,true,0.911,0.089
46,16,30,46,16,30,1348,1331,17,0,0,0,0,89,1,1,0.269663,0,0,16,9,false,true,true,0.723,0.277
222,72,150,37,14.4,150,918,619,299,2,0,0.333333,0,57,6,5,0.614035,1,0,16,16,false,true,true,0.999,0.001
253,187,66,19.461538,14.384615,66,1181,1069,112,0,0,0,0,16,13,13,2.3125,1,0,9,12,false,true,true,0.991,0.009
218,193,25,18.166667,16.083333,25,334,446,-112,0,0,0,0,16,12,12,2.5,0,1,9,7,false,true,true,0.824,0.176
278,249,29,21.384615,20.75,29,1115,1078,37,0,1,0,0.083333,14,13,12,2.428571,1,0,11,19,false,true,true,0.703,0.297
120,146,-26,20,29.2,-26,1501,1473,28,0,0,0,0,55,6,5,0.654545,0,0,20,23,false,true,false,0.201,0.799
213,164,49,19.363636,14.909091,49,1181,1069,112,0,0,0,0,30,11,11,1.233333,1,0,6,8,false,true,true,0.966,0.034
12,0,12,12,0,12,1069,1040,29,0,0,0,0,97,1,0,0.453608,0,0,14,0,false,true,true,0.678,0.322
72,111,-39,12,22.2,-39,1156,1184,-28,0,0,0,0,60,6,5,0.466667,1,0,16,13,false,true,false,0.221,0.779
342,328,14,18,18.222222,14,901,889,12,0,1,0,0.055556,-17,19,18,-2.529412,0,0,5,6,false,true,true,0.971,0.029
351,298,53,17.55,14.9,53,1548,1493,55,1,0,0.05,0,-28,20,20,-1.464286,0,0,1,3,false,true,true,1,0
257,253,4,32.125,31.625,4,1333,1331,2,1,0,0.125,0,28,8,8,1.071429,0,0,10,7,false,true,true,0.68,0.32
53,51,2,13.25,17,2,831,830,1,0,0,0,0,77,4,3,0.480519,0,0,18,14,false,true,true,0.611,0.389
356,153,203,32.363636,15.3,203,1054,917,137,2,0,0.181818,0,12,11,10,2.916667,0,0,15,18,false,true,true,1,0
0,0,0,0,0,0,1397,1422,-25,0,0,0,0,100,1,0,0.36,0,0,8,0,false,true,true,0.62,0.38
281,197,84,23.416667,16.416667,84,580,620,-40,1,0,0.083333,0,23,12,12,1.869565,0,0,12,16,false,true,true,1,0
265,137,128,26.5,13.7,128,801,925,-124,1,0,0.1,0,27,10,10,1.296296,1,0,12,16,false,true,true,1,0
72,31,41,18,7.75,41,595,543,52,0,0,0,0,78,4,4,0.602564,0,0,12,15,false,true,true,0.911,0.089
365,269,96,24.333333,17.933333,96,801,925,-124,1,0,0.066667,0,-8,15,15,-4.375,0,0,6,4,false,true,true,1,0
294,275,19,18.375,17.1875,19,1159,1051,108,0,0,0,0,-2,16,16,-20,1,0,6,13,false,true,true,0.998,0.002
125,110,15,15.625,15.714286,15,1029,1075,-46,0,0,0,0,53,8,7,0.90566,1,0,17,9,false,true,true,0.74,0.26
148,99,49,14.8,11,49,1016,1037,-21,0,0,0,0,45,10,9,1.066667,0,0,8,24,false,true,false,0.472,0.528
200,152,48,18.181818,15.2,48,620,513,107,0,0,0,0,31,11,10,1.451613,0,0,10,14,false,true,true,0.953,0.047
367,312,55,17.47619,14.857143,55,904,783,121,0,0,0,0,-31,21,21,-1.354839,1,0,1,3,true,true,true,1,0
236,179,57,19.666667,14.916667,57,620,658,-38,0,0,0,0,20,12,12,1.8,0,0,23,7,false,true,true,0.972,0.028
14,0,14,14,0,14,1181,1069,112,0,0,0,0,97,1,0,0.381443,1,0,8,0,false,true,true,0.682,0.318
136,109,27,11.333333,9.909091,27,310,359,-49,0,0,0,0,21,12,11,2.333333,0,0,16,18,false,true,true,0.845,0.155
33,12,21,16.5,12,21,1069,917,152,0,0,0,0,88,2,1,0.386364,0,0,12,17,false,true,true,0.672,0.328
85,57,28,28.333333,19,28,1295,1281,14,0,0,0,0,78,3,3,0.487179,0,0,25,12,false,true,true,0.728,0.272
318,287,31,19.875,17.9375,31,1270,1348,-78,0,0,0,0,-3,16,16,-12.666667,0,0,9,16,false,true,true,1,0
342,337,5,16.285714,16.85,5,1164,1201,-37,0,0,0,0,-33,21,20,-1.272727,0,0,2,1,false,true,true,1,0
149,139,10,29.8,27.8,10,1004,840,164,1,0,0.2,0,58,5,5,0.517241,1,0,13,9,false,true,true,0.872,0.128
165,119,46,16.5,13.222222,46,698,742,-44,0,0,0,0,53,10,9,0.773585,0,0,7,16,false,true,true,0.81,0.19
368,275,93,19.368421,15.277778,93,844,821,23,0,0,0,0,-1,19,18,-42,0,1,6,9,false,true,true,1,0
34,9,25,17,9,25,1170,1156,14,0,0,0,0,92,2,1,0.413043,1,0,13,22,false,true,true,0.682,0.318
294,194,100,17.294118,12.125,100,913,871,42,0,0,0,0,-1,17,16,-43,0,1,12,17,false,true,true,1,0
166,216,-50,23.714286,30.857143,-50,1885,1846,39,1,1,0.142857,0.142857,34,7,7,0.852941,1,0,17,9,false,true,false,0.211,0.789
109,113,-4,18.166667,18.833333,-4,1216,1228,-12,0,0,0,0,60,6,6,0.55,0,0,14,10,false,true,true,0.635,0.365
388,381,7,20.421053,21.166667,7,1320,1339,-19,2,1,0.105263,0.055556,-25,19,18,-1.56,0,0,1,1,false,true,true,0.944,0.056
260,242,18,20,18.615385,18,1210,1253,-43,0,1,0,0.076923,7,13,13,5,1,0,10,18,false,true,true,0.731,0.269
336,306,30,15.272727,14.571429,30,363,668,-305,0,0,0,0,-19,22,21,-2.263158,0,0,7,1,true,true,true,1,0
279,236,43,21.461538,18.153846,43,1364,1093,271,0,1,0,0.076923,11,13,13,3.454545,0,0,20,7,false,true,true,1,0
28,14,14,14,14,14,613,502,111,0,0,0,0,87,2,1,0.563218,0,0,10,13,false,true,true,0.68,0.32
183,139,44,20.333333,17.375,44,1305,1390,-85,0,0,0,0,41,9,8,0.878049,0,0,8,20,false,true,true,0.599,0.401
323,267,56,14.681818,12.714286,56,1016,1037,-21,0,0,0,0,-19,22,21,-2.526316,0,0,4,12,false,true,true,1,0
41,30,11,20.5,15,11,620,513,107,0,0,0,0,84,2,2,0.535714,0,0,8,20,false,true,true,0.689,0.311
302,244,58,16.777778,14.352941,58,804,683,121,0,0,0,0,-4,18,17,-11.25,0,1,16,14,false,true,true,0.976,0.024
46,18,28,46,18,28,1054,917,137,0,0,0,0,90,1,1,0.388889,1,0,14,15,false,true,true,0.93,0.07
315,278,37,15,13.9,37,1030,1045,-15,1,0,0.047619,0,-18,21,20,-2.555556,0,0,5,9,false,true,true,1,0
217,197,20,19.727273,17.909091,20,1452,1469,-17,0,1,0,0.090909,25,11,11,1.52,1,0,8,23,false,true,true,0.65,0.35
297,244,53,27,22.181818,53,1302,1234,68,1,1,0.090909,0.090909,19,11,11,1.631579,0,0,10,12,false,true,true,0.992,0.008
248,193,55,15.5,12.866667,55,892,768,124,0,0,0,0,15,16,15,2.866667,0,0,10,12,false,true,true,0.814,0.186
394,330,64,21.888889,19.411765,64,901,1159,-258,2,0,0.111111,0,-18,18,17,-1.944444,0,0,10,4,true,true,true,1,0
381,314,67,21.166667,17.444444,67,1482,1394,88,2,0,0.111111,0,-18,18,18,-2,0,0,2,2,true,true,true,1,0
60,30,30,20,10,30,1428,1302,126,0,0,0,0,80,3,3,0.6625,0,1,7,15,false,true,true,0.778,0.222
283,188,95,20.214286,14.461538,95,1606,1544,62,0,0,0,0,25,14,13,1.8,0,1,16,9,false,true,true,0.965,0.035
302,189,113,37.75,23.625,113,1880,1777,103,1,0,0.125,0,33,8,8,0.848485,0,1,13,10,false,true,true,1,0
146,96,50,18.25,13.714286,50,1030,1045,-15,0,0,0,0,55,8,7,0.836364,0,0,12,15,false,true,true,0.846,0.154
256,155,101,25.6,15.5,101,539,500,39,0,0,0,0,22,10,10,1.818182,0,0,11,10,false,true,true,0.988,0.012
93,93,0,31,31,0,991,996,-5,0,0,0,0,78,3,3,0.384615,0,0,7,9,false,true,true,0.678,0.322
187,152,35,18.7,15.2,35,620,513,107,0,0,0,0,34,10,10,1.323529,0,0,9,14,false,true,true,0.959,0.041
374,233,141,26.714286,17.923077,141,1211,1173,38,0,0,0,0,10,14,13,3.5,0,0,7,10,false,true,true,1,0
343,348,-5,22.866667,24.857143,-5,809,868,-59,2,1,0.133333,0.071429,-8,15,14,-4,1,0,0,7,false,true,true,0.827,0.173
131,94,37,18.714286,13.428571,37,1050,1144,-94,0,0,0,0,56,7,7,0.678571,0,0,16,8,false,true,true,0.707,0.293
115,102,13,19.166667,17,13,947,909,38,0,0,0,0,63,6,6,0.730159,1,0,9,32,false,true,true,0.577,0.423
49,16,33,12.25,5.333333,33,1394,1230,164,0,0,0,0,75,4,3,0.506667,0,0,15,7,false,true,true,0.735,0.265
307,243,64,15.35,12.789474,64,1016,1037,-21,0,0,0,0,-6,20,19,-8,0,0,7,16,false,true,true,1,0
70,46,24,17.5,15.333333,24,628,658,-30,0,0,0,0,76,4,3,0.605263,0,0,27,14,false,true,false,0.42,0.58
215,120,95,21.5,12,95,786,757,29,1,0,0.1,0,35,10,10,1.114286,0,0,10,17,false,true,true,0.972,0.028
110,63,47,22,15.75,47,916,876,40,0,0,0,0,65,5,4,0.523077,1,0,9,10,false,true,true,0.865,0.135
413,331,82,18.772727,15.761905,82,995,912,83,2,0,0.090909,0,-20,22,21,-2.2,0,0,2,10,false,true,true,1,0
473,259,214,26.277778,15.235294,214,918,619,299,2,0,0.111111,0,-19,18,17,-1.842105,0,0,3,1,true,true,true,1,0
111,44,67,37,14.666667,67,942,1003,-61,0,0,0,0,77,3,3,0.584416,0,0,9,7,false,true,true,0.848,0.152
190,162,28,14.615385,12.461538,28,1128,889,239,0,1,0,0.076923,27,13,13,1.740741,0,0,28,18,false,true,true,1,0
97,31,66,48.5,31,66,1793,1897,-104,1,0,0.5,0,86,2,1,0.348837,0,0,14,12,false,true,true,0.687,0.313
197,187,10,17.909091,17,10,725,771,-46,0,1,0,0.090909,31,11,11,1.483871,1,0,6,18,false,true,true,0.534,0.466
192,162,30,16,13.5,30,691,675,16,0,0,0,0,20,12,12,1.9,0,0,13,21,false,true,true,0.873,0.127
245,166,79,35,23.714286,79,1245,1241,4,1,1,0.142857,0.142857,44,7,7,0.659091,0,0,17,12,false,true,true,0.971,0.029
206,131,75,17.166667,11.909091,75,1069,1040,29,0,0,0,0,20,12,11,2.2,0,2,7,8,false,true,true,0.987,0.013
262,243,19,16.375,15.1875,19,808,812,-4,0,0,0,0,-6,16,16,-6.166667,1,0,11,8,false,true,true,0.909,0.091
236,152,84,26.222222,16.888889,84,539,500,39,0,0,0,0,27,9,9,1.481481,0,0,13,10,false,true,true,0.971,0.029
313,275,38,24.076923,22.916667,38,971,1180,-209,1,1,0.076923,0.083333,9,13,12,3.555556,0,0,20,8,false,true,true,0.841,0.159
361,243,118,30.083333,20.25,118,1519,1782,-263,2,0,0.166667,0,13,12,12,2.538462,0,0,24,17,false,true,true,1,0
270,244,26,24.545455,22.181818,26,1710,1636,74,1,1,0.090909,0.090909,22,11,11,1.636364,1,0,15,14,false,true,true,0.921,0.079
300,284,16,25,25.818182,16,1636,1576,60,0,2,0,0.181818,11,12,11,3.090909,0,0,11,18,false,true,true,0.96,0.04
0,0,0,0,0,0,1295,1477,-182,0,0,0,0,100,1,0,0.46,0,0,9,0,false,true,false,0.251,0.749
337,296,41,16.85,14.8,41,1077,1094,-17,0,0,0,0,-21,20,20,-2,1,0,2,1,false,true,true,1,0
270,219,51,24.545455,19.909091,51,1295,1281,14,0,0,0,0,31,11,11,1.225806,0,1,10,8,false,true,true,0.961,0.039
112,109,3,22.4,21.8,3,1040,925,115,0,0,0,0,64,5,5,0.671875,1,0,11,10,false,true,true,0.761,0.239
284,298,-14,16.705882,17.529412,-14,1388,1477,-89,1,0,0.058824,0,-4,17,17,-12,1,0,7,18,false,true,true,0.811,0.189
301,272,29,18.8125,18.133333,29,349,315,34,0,0,0,0,-20,16,15,-1.7,0,0,1,7,false,true,true,0.97,0.03
332,320,12,23.714286,22.857143,12,1344,1325,19,1,0,0.071429,0,-7,14,14,-4.428571,0,0,6,3,false,true,true,0.996,0.004
105,67,38,21,16.75,38,272,288,-16,0,0,0,0,69,5,4,0.753623,1,0,9,13,false,true,true,0.688,0.312
180,163,17,18,18.111111,17,1221,1258,-37,1,0,0.1,0,39,10,9,1,0,0,26,9,false,true,true,0.724,0.276
223,103,120,31.857143,17.166667,120,1408,1454,-46,1,0,0.142857,0,54,7,6,0.592593,0,0,9,11,false,true,true,0.975,0.025
36,22,14,12,11,14,1093,1090,3,0,0,0,0,86,3,2,0.395349,1,0,14,13,false,true,true,0.674,0.326
240,186,54,18.461538,14.307692,54,523,480,43,1,0,0.076923,0,5,13,13,6.6,0,1,23,12,false,true,true,0.987,0.013
184,128,56,23,18.285714,56,977,976,1,0,0,0,0,51,8,7,0.666667,0,0,16,9,false,true,true,0.918,0.082
283,225,58,20.214286,17.307692,58,719,785,-66,0,1,0,0.076923,11,14,13,3.272727,0,0,17,12,false,true,true,0.962,0.038
204,178,26,18.545455,16.181818,26,904,783,121,0,0,0,0,32,11,11,1.3125,0,0,16,19,false,true,true,0.782,0.218
37,9,28,18.5,9,28,584,565,19,0,0,0,0,90,2,1,0.511111,0,1,15,20,false,true,false,0.279,0.721
305,262,43,23.461538,20.153846,43,995,912,83,2,0,0.153846,0,21,13,13,2.095238,0,0,11,10,false,true,true,0.998,0.002
369,312,57,24.6,20.8,57,1554,1622,-68,2,0,0.133333,0,-19,15,15,-1.631579,0,0,3,4,false,true,true,1,0
158,135,23,22.571429,19.285714,23,844,821,23,0,0,0,0,63,7,7,0.666667,0,0,17,7,false,true,true,0.825,0.175
59,53,6,14.75,13.25,6,786,847,-61,0,0,0,0,75,4,4,0.453333,0,1,10,6,false,true,false,0.273,0.727
20,14,6,20,14,6,1428,1302,126,0,0,0,0,92,1,1,0.576087,0,0,15,16,false,true,true,0.671,0.329
169,134,35,21.125,19.142857,35,711,876,-165,0,0,0,0,46,8,7,0.934783,0,0,10,9,false,true,false,0.382,0.618
396,328,68,39.6,32.8,68,1770,1689,81,0,1,0,0.1,7,10,10,3.714286,0,0,13,18,false,true,true,1,0
315,286,29,15,13.619048,29,1030,1045,-15,1,0,0.047619,0,-21,21,21,-2.190476,0,0,5,5,false,true,true,1,0
192,135,57,24,19.285714,57,1142,1176,-34,1,0,0.125,0,42,8,7,0.857143,0,0,17,15,false,true,true,0.962,0.038
333,237,96,20.8125,15.8,96,1170,1156,14,1,0,0.0625,0,-9,16,15,-4.222222,0,0,7,11,false,true,true,1,0
325,251,74,19.117647,14.764706,74,1606,1544,62,0,0,0,0,1,17,17,45,0,0,21,10,false,true,true,1,0
93,118,-25,23.25,39.333333,-25,1431,825,606,0,1,0,0.333333,68,4,3,0.5,1,0,6,14,false,true,true,1,0
228,111,117,25.333333,12.333333,117,554,342,212,0,0,0,0,35,9,9,1.028571,0,0,10,16,false,true,true,0.988,0.012
257,288,-31,17.133333,19.2,-31,491,398,93,0,0,0,0,2,15,15,18,0,0,7,12,false,true,false,0.326,0.674
159,112,47,15.9,12.444444,47,218,86,132,0,0,0,0,32,10,9,1.25,0,0,26,16,false,true,true,0.97,0.03
125,66,59,25,13.2,59,1022,1095,-73,0,0,0,0,68,5,5,0.485294,0,0,17,7,false,true,true,0.854,0.146
300,278,22,20,18.533333,22,784,758,26,0,0,0,0,-7,15,15,-5,1,0,6,6,false,true,true,0.97,0.03
387,263,124,21.5,15.470588,124,1394,1230,164,0,1,0,0.058824,-18,18,17,-2.111111,0,1,7,12,false,true,true,1,0
189,163,26,31.5,27.166667,26,416,282,134,1,0,0.166667,0,56,6,6,0.607143,0,0,9,12,false,true,true,0.637,0.363
208,170,38,20.8,17,38,916,837,79,0,0,0,0,38,10,10,1.052632,0,0,14,14,false,true,true,0.94,0.06
45,73,-28,11.25,24.333333,-28,611,584,27,0,0,0,0,77,4,3,0.571429,0,0,19,9,false,true,true,0.525,0.475
351,266,85,35.1,29.555556,85,1880,1777,103,1,1,0.1,0.111111,21,10,9,1.333333,0,1,17,11,false,true,true,1,0
170,109,61,21.25,15.571429,61,921,1072,-151,1,0,0.125,0,51,8,7,0.745098,0,0,9,12,false,true,true,0.832,0.168
238,147,91,21.636364,14.7,91,561,526,35,0,0,0,0,16,11,10,2.1875,0,0,7,13,false,true,true,0.974,0.026
183,60,123,45.75,20,123,1349,1302,47,0,0,0,0,70,4,3,0.414286,0,0,14,8,false,true,true,0.88,0.12
311,293,18,20.733333,20.928571,18,926,854,72,0,0,0,0,3,15,14,11.333333,1,0,8,7,false,true,true,0.815,0.185
256,184,72,19.692308,15.333333,72,1227,1060,167,0,1,0,0.083333,18,13,12,2.222222,0,0,12,16,false,true,true,0.87,0.13
192,197,-5,19.2,19.7,-5,518,448,70,0,0,0,0,31,10,10,1.096774,0,0,11,8,false,true,true,0.64,0.36
282,181,101,31.333333,20.111111,101,630,786,-156,1,0,0.111111,0,32,9,9,1.09375,0,0,7,22,false,true,true,1,0
225,215,10,16.071429,16.538462,10,272,238,34,0,0,0,0,6,14,13,6.666667,0,0,22,7,false,true,true,0.946,0.054
97,23,74,48.5,23,74,992,1100,-108,1,0,0.5,0,86,2,1,0.395349,1,0,7,12,false,true,true,0.73,0.27
281,277,4,17.5625,17.3125,4,947,810,137,0,1,0,0.0625,-3,16,16,-14,1,0,10,13,false,true,true,0.636,0.364
356,153,203,32.363636,13.909091,203,1054,917,137,2,0,0.181818,0,12,11,11,2.916667,0,0,15,11,false,true,true,1,0
14,0,14,14,0,14,1302,1349,-47,0,0,0,0,96,1,0,0.291667,0,0,10,0,false,true,true,0.651,0.349
211,234,-23,23.444444,26,-23,1331,1399,-68,0,0,0,0,30,9,9,1.166667,0,0,26,8,false,true,false,0.306,0.694
202,150,52,28.857143,25,52,1826,1656,170,1,0,0.142857,0,44,7,6,0.613636,1,0,8,17,false,true,true,0.948,0.052
282,262,20,13.428571,12.47619,20,611,584,27,0,0,0,0,-21,21,21,-2.095238,0,0,1,3,false,true,true,0.984,0.016
244,210,34,18.769231,17.5,34,1334,1270,64,1,0,0.076923,0,26,13,12,1.423077,1,0,16,13,false,true,true,0.868,0.132
42,13,29,21,13,29,1096,1009,87,0,0,0,0,94,2,1,0.468085,1,0,25,13,false,true,true,0.915,0.085
171,99,72,28.5,19.8,72,1270,1315,-45,0,0,0,0,58,6,5,0.62069,0,0,7,10,false,true,true,0.845,0.155
321,296,25,20.0625,19.733333,25,1244,1361,-117,2,1,0.125,0.066667,8,16,15,4.75,0,0,11,18,false,true,true,0.985,0.015
353,270,83,25.214286,20.769231,83,1109,1065,44,0,0,0,0,-11,14,13,-3,0,0,6,6,false,true,true,1,0
430,356,74,28.666667,25.428571,74,1684,1320,364,1,0,0.066667,0,-15,15,14,-2,0,0,4,6,false,true,true,1,0
140,113,27,20,18.833333,27,518,533,-15,1,0,0.142857,0,52,7,6,0.673077,0,0,23,7,false,true,true,0.883,0.117
145,193,-48,16.111111,21.444444,-48,721,689,32,0,0,0,0,25,9,9,1.36,0,0,21,12,false,true,false,0.207,0.793
297,229,68,29.7,25.444444,68,1237,1277,-40,0,0,0,0,21,10,9,1.380952,1,0,6,14,false,true,true,1,0
97,143,-46,19.4,28.6,-46,1125,1227,-102,0,0,0,0,56,5,5,0.535714,1,0,6,18,false,true,false,0.097,0.903
16,0,16,16,0,16,880,952,-72,0,0,0,0,96,1,0,0.364583,0,0,24,0,false,true,false,0.274,0.726
0,0,0,0,0,0,1197,1127,70,0,0,0,0,100,1,0,0.3,0,0,7,0,false,true,true,0.677,0.323
252,197,55,16.8,14.071429,55,299,315,-16,0,0,0,0,-1,15,14,-42,0,0,10,20,false,true,true,0.911,0.089
20,0,20,20,0,20,820,783,37,0,0,0,0,97,1,0,0.340206,0,0,10,0,false,true,true,0.676,0.324
211,187,24,21.1,18.7,24,1161,1166,-5,1,0,0.1,0,25,10,10,1.4,0,1,10,8,false,true,true,0.84,0.16
173,136,37,19.222222,15.111111,37,786,788,-2,0,0,0,0,31,9,9,1.096774,1,0,11,15,false,true,true,0.954,0.046
196,171,25,21.777778,19,25,613,569,44,0,0,0,0,34,9,9,1.147059,2,0,12,7,false,true,true,0.984,0.016
341,293,48,22.733333,20.928571,48,1177,1214,-37,0,0,0,0,-4,15,14,-8.75,0,1,6,5,false,true,true,0.998,0.002
129,44,85,32.25,14.666667,85,942,1003,-61,0,0,0,0,73,4,3,0.616438,0,0,7,7,false,true,true,0.854,0.146
256,239,17,16,14.9375,17,371,435,-64,0,0,0,0,-5,16,16,-8.8,0,0,10,6,false,true,true,0.814,0.186
332,215,117,14.434783,9.772727,117,1428,1302,126,0,0,0,0,-22,23,22,-2.409091,0,1,13,12,false,true,true,1,0
276,181,95,30.666667,20.111111,95,1334,1256,78,2,0,0.222222,0,33,9,9,0.939394,0,0,13,11,false,true,true,1,0
263,162,101,18.785714,12.461538,101,1586,1782,-196,0,0,0,0,12,14,13,3.333333,1,0,12,14,false,true,true,1,0
279,321,-42,19.928571,24.692308,-42,1501,1473,28,0,0,0,0,4,14,13,9,0,0,8,7,false,true,false,0.003,0.997
237,185,52,14.8125,11.5625,52,1016,1037,-21,0,0,0,0,12,16,16,4,1,0,8,23,false,true,true,0.995,0.005
254,271,-17,25.4,27.1,-17,1102,1245,-143,1,0,0.1,0,6,10,10,4.666667,0,0,13,9,false,true,true,0.631,0.369
75,41,34,15,10.25,34,584,565,19,0,0,0,0,70,5,4,0.657143,0,0,16,22,false,true,true,0.663,0.337
90,101,-11,18,20.2,-11,1142,1176,-34,0,0,0,0,63,5,5,0.571429,1,0,11,7,false,true,true,0.679,0.321
128,197,-69,21.333333,32.833333,-69,1075,1009,66,0,0,0,0,53,6,6,0.603774,0,0,7,9,false,true,false,0.196,0.804
276,222,54,23,20.181818,54,1210,1252,-42,1,0,0.083333,0,18,12,11,1.777778,0,0,7,16,false,true,true,0.996,0.004
234,286,-52,21.272727,26,-52,907,752,155,0,1,0,0.090909,23,11,11,1.434783,0,0,10,18,false,true,false,0.003,0.997
420,294,126,24.705882,17.294118,126,1189,1266,-77,1,0,0.058824,0,-19,17,17,-1.789474,0,0,1,1,true,true,true,1,0
395,377,18,32.916667,31.416667,18,2219,2106,113,2,0,0.166667,0,-11,12,12,-2.454545,0,0,8,3,false,true,true,1,0
250,129,121,27.777778,16.125,121,1651,1691,-40,1,0,0.111111,0,44,9,8,0.772727,0,0,17,9,false,true,true,0.983,0.017
104,37,67,34.666667,18.5,67,1216,1230,-14,1,0,0.333333,0,79,3,2,0.405063,0,0,20,10,false,true,true,0.824,0.176
193,116,77,27.571429,16.571429,77,746,796,-50,0,1,0,0.142857,40,7,7,1.2,0,0,7,17,false,true,true,0.97,0.03
145,151,-6,20.714286,21.571429,-6,838,786,52,0,1,0,0.142857,48,7,7,0.666667,1,0,9,13,false,true,true,0.812,0.188
273,224,49,21,18.666667,49,786,847,-61,0,0,0,0,16,13,12,2.125,0,0,7,13,false,true,true,0.829,0.171
168,186,-18,18.666667,20.666667,-18,491,398,93,0,0,0,0,38,9,9,0.947368,0,0,16,20,false,true,false,0.403,0.597
179,158,21,14.916667,14.363636,21,539,632,-93,0,0,0,0,33,12,11,1.393939,0,0,10,7,false,true,true,0.754,0.246
271,241,30,18.066667,17.214286,30,334,446,-112,0,0,0,0,-4,15,14,-10,0,1,8,12,false,true,true,0.759,0.241
70,73,-3,17.5,18.25,-3,725,771,-46,0,1,0,0.25,67,4,4,0.686567,0,1,23,17,false,true,true,0.643,0.357
152,177,-25,21.714286,25.285714,-25,771,754,17,0,0,0,0,46,7,7,0.695652,0,0,12,19,false,true,false,0.186,0.814
347,287,60,28.916667,26.090909,60,1875,1793,82,2,1,0.166667,0.090909,13,12,11,2.307692,0,0,11,11,false,true,true,1,0
414,277,137,19.714286,13.85,137,942,1003,-61,0,0,0,0,-32,21,20,-1.40625,1,0,0,3,false,true,true,1,0
391,288,103,27.928571,20.571429,103,1334,1256,78,2,0,0.142857,0,-4,14,14,-7.75,0,0,4,2,false,true,true,1,0
216,86,130,30.857143,14.333333,130,1144,1014,130,0,0,0,0,53,7,6,0.679245,0,1,15,9,false,true,true,0.939,0.061
341,314,27,28.416667,28.545455,27,1265,1237,28,1,0,0.083333,0,7,12,11,4.285714,0,1,7,18,false,true,true,0.995,0.005
192,138,54,21.333333,17.25,54,691,473,218,0,0,0,0,39,9,8,0.923077,0,0,13,7,false,true,true,0.964,0.036
324,176,148,19.058824,11,148,421,306,115,0,1,0,0.0625,-7,17,16,-6.285714,0,0,12,9,false,true,true,1,0
358,367,-9,21.058824,21.588235,-9,1439,1413,26,0,1,0,0.058824,-12,17,17,-3,0,0,3,2,false,true,false,0.084,0.916
75,114,-39,15,22.8,-39,316,306,10,0,2,0,0.4,64,5,5,0.59375,0,1,11,13,false,true,true,0.997,0.003
77,52,25,15.4,10.4,25,880,952,-72,0,0,0,0,71,5,5,0.577465,0,0,12,18,false,true,false,0.355,0.645
0,0,0,0,0,0,901,1159,-258,0,0,0,0,100,1,0,0.35,0,0,10,0,false,true,false,0.251,0.749
174,170,4,17.4,18.888889,4,719,785,-66,0,1,0,0.111111,34,10,9,1.058824,0,0,23,16,false,true,true,0.611,0.389
308,229,79,30.8,25.444444,79,1428,1452,-24,1,1,0.1,0.111111,27,10,9,1.148148,0,0,11,12,false,true,true,1,0
141,89,52,23.5,17.8,52,1211,1173,38,0,0,0,0,65,6,5,0.538462,0,1,15,6,false,true,true,0.839,0.161
89,69,20,22.25,17.25,20,1210,1253,-43,0,0,0,0,70,4,4,0.5,0,0,10,12,false,true,true,0.694,0.306
369,303,66,23.0625,18.9375,66,1482,1394,88,2,0,0.125,0,-10,16,16,-3.6,0,0,5,3,false,true,true,1,0
334,307,27,25.692308,23.615385,27,1554,1716,-162,1,1,0.076923,0.076923,1,13,13,35,0,0,12,10,false,true,true,1,0
225,220,5,28.125,31.428571,5,1256,1232,24,1,0,0.125,0,40,8,7,0.75,0,0,13,20,false,true,false,0.237,0.763
238,224,14,21.636364,20.363636,14,1344,1209,135,1,1,0.090909,0.090909,17,11,11,2,0,0,9,18,false,true,true,0.712,0.288
343,331,12,22.866667,23.642857,12,1501,1473,28,1,0,0.066667,0,-5,15,14,-7.2,0,0,6,7,false,true,true,0.999,0.001
41,91,-50,20.5,45.5,-50,1571,1554,17,0,1,0,0.5,83,2,2,0.39759,0,0,10,10,false,true,false,0.2,0.8
74,49,25,18.5,12.25,25,1670,1770,-100,1,0,0.25,0,72,4,4,0.444444,0,0,28,10,false,true,true,0.695,0.305
238,204,34,21.636364,18.545455,34,691,675,16,0,0,0,0,23,11,11,1.608696,0,1,24,9,false,true,true,0.984,0.016
267,129,138,24.272727,11.727273,138,942,1003,-61,0,0,0,0,25,11,11,1.8,1,1,21,15,false,true,true,1,0
94,70,24,23.5,23.333333,24,363,668,-305,0,0,0,0,78,4,3,0.551282,1,0,6,12,false,true,false,0.127,0.873
310,247,63,23.846154,19,63,902,866,36,0,0,0,0,-6,13,13,-5.333333,1,0,13,15,false,true,true,1,0
69,30,39,23,15,39,1055,1050,5,0,0,0,0,81,3,2,0.419753,0,0,20,10,false,true,true,0.726,0.274
289,237,52,17,14.8125,52,299,315,-16,0,0,0,0,-15,17,16,-2.8,0,0,10,19,false,true,true,1,0
149,100,49,24.833333,20,49,1334,1477,-143,0,0,0,0,59,6,5,0.508475,0,2,15,18,false,true,true,0.875,0.125
37,23,14,18.5,23,14,885,719,166,0,0,0,0,90,2,1,0.422222,0,1,26,9,false,true,true,0.684,0.316
293,257,36,20.928571,19.769231,36,290,416,-126,0,0,0,0,4,14,13,8.5,0,0,7,10,false,true,true,0.839,0.161
250,247,3,19.230769,20.583333,3,1782,1512,270,1,1,0.076923,0.083333,18,13,12,2.333333,0,0,15,12,false,true,true,0.999,0.001
103,135,-32,20.6,27,-32,1530,1550,-20,0,1,0,0.2,59,5,5,0.576271,0,1,14,12,false,true,false,0.2,0.8
59,96,-37,29.5,48,-37,1394,1424,-30,0,1,0,0.5,81,2,2,0.395062,0,0,13,8,false,true,false,0.218,0.782
391,329,62,27.928571,23.5,62,1333,1331,2,1,0,0.071429,0,-16,14,14,-1.875,0,0,3,7,false,true,true,1,0
409,266,143,27.266667,19,143,986,856,130,1,0,0.066667,0,-15,15,14,-2.066667,0,0,3,2,false,true,true,1,0
196,149,47,24.5,18.625,47,844,821,23,0,0,0,0,55,8,8,0.763636,1,0,18,12,false,true,true,0.966,0.034
234,258,-24,19.5,21.5,-24,594,605,-11,0,0,0,0,14,12,12,2.642857,1,0,15,8,false,true,true,0.569,0.431
366,303,63,22.875,18.9375,63,416,282,134,1,0,0.0625,0,-16,16,16,-2.125,0,0,3,4,false,true,true,1,0
366,347,19,16.636364,16.52381,19,901,889,12,0,1,0,0.047619,-32,22,21,-1.34375,0,0,2,1,true,true,true,1,0
81,65,16,16.2,16.25,16,361,493,-132,0,0,0,0,65,5,4,0.630769,0,1,17,9,false,true,false,0.255,0.745
151,65,86,15.1,7.222222,86,1428,1302,126,0,0,0,0,44,10,9,1.204545,0,1,15,16,false,true,true,0.838,0.162
253,146,107,31.625,20.857143,107,1349,1302,47,0,0,0,0,41,8,7,0.707317,0,0,9,13,false,true,true,1,0
324,281,43,17.052632,14.789474,43,699,448,251,0,0,0,0,-14,19,19,-2.857143,0,0,2,7,false,true,true,1,0
285,247,38,25.909091,22.454545,38,992,1100,-108,2,0,0.181818,0,21,11,11,1.619048,0,0,14,19,false,true,true,0.825,0.175
349,237,112,23.266667,16.928571,112,1110,1039,71,0,0,0,0,-4,15,14,-9,0,0,17,7,false,true,true,1,0
187,178,9,20.777778,22.25,9,1040,925,115,0,0,0,0,34,9,8,1.264706,0,0,15,7,false,true,false,0.312,0.688
73,44,29,14.6,8.8,29,801,807,-6,0,0,0,0,64,5,5,0.546875,0,1,13,15,false,true,true,0.688,0.312
27,27,0,13.5,27,0,1043,1055,-12,0,0,0,0,90,2,1,0.411111,0,0,8,7,false,true,true,0.675,0.325
301,204,97,21.5,15.692308,97,1551,1550,1,0,0,0,0,7,14,13,6,0,1,12,19,false,true,true,1,0
88,70,18,14.666667,11.666667,18,346,231,115,0,0,0,0,53,6,6,0.773585,0,0,10,13,false,true,true,0.882,0.118
195,100,95,32.5,16.666667,95,1054,917,137,0,0,0,0,51,6,6,0.686275,0,0,7,8,false,true,true,0.963,0.037
317,267,50,26.416667,22.25,50,1210,1253,-43,0,1,0,0.083333,4,12,12,8.5,0,0,17,19,false,true,true,1,0
202,117,85,22.444444,13,85,1586,1782,-196,0,0,0,0,40,9,9,1,1,0,9,12,false,true,true,0.965,0.035
284,231,53,28.4,23.1,53,1355,1210,145,1,0,0.1,0,27,10,10,1.111111,1,0,6,15,false,true,true,1,0
317,293,24,18.647059,17.235294,24,784,758,26,0,0,0,0,-18,17,17,-1.944444,1,0,1,2,false,true,true,1,0
55,65,-10,18.333333,21.666667,-10,907,752,155,0,0,0,0,83,3,3,0.39759,0,0,17,9,false,true,true,0.642,0.358
194,171,23,24.25,21.375,23,1127,1134,-7,0,0,0,0,38,8,8,0.789474,0,1,9,6,false,true,true,0.778,0.222
44,43,1,14.666667,14.333333,1,1651,1691,-40,0,0,0,0,85,3,3,0.4,0,0,18,22,false,true,false,0.391,0.609
292,234,58,22.461538,18,58,1004,653,351,0,0,0,0,1,13,13,35,0,0,13,17,false,true,true,1,0
225,177,48,17.307692,13.615385,48,272,288,-16,0,0,0,0,33,13,13,1.575758,0,0,9,16,false,true,true,0.818,0.182
221,186,35,17,14.307692,35,758,750,8,0,0,0,0,13,13,13,2.846154,0,1,17,8,false,true,true,0.983,0.017
65,72,-7,21.666667,24,-7,871,999,-128,0,0,0,0,78,3,3,0.615385,0,0,7,10,false,true,false,0.252,0.748
410,379,31,24.117647,22.294118,31,1266,1144,122,0,0,0,0,-21,17,17,-1.619048,0,0,4,4,true,true,true,1,0
28,19,9,14,19,9,1388,1477,-89,0,0,0,0,87,2,1,0.551724,1,0,6,12,false,true,true,0.674,0.326
114,115,-1,22.8,28.75,-1,315,294,21,0,1,0,0.25,65,5,4,0.538462,0,0,9,22,false,true,true,0.625,0.375
288,174,114,48,34.8,114,1348,1331,17,2,0,0.333333,0,45,6,5,0.533333,0,0,12,10,false,true,true,1,0
194,193,1,13.857143,13.785714,1,1030,1045,-15,0,0,0,0,20,14,14,2.3,0,0,8,9,false,true,false,0.163,0.837
12,40,-28,6,20,-28,844,821,23,0,0,0,0,90,2,2,0.466667,0,0,25,10,false,true,true,0.642,0.358
343,256,87,24.5,18.285714,87,1073,1177,-104,1,0,0.071429,0,-4,14,14,-8,0,0,6,5,false,true,true,1,0
215,228,-13,15.357143,17.538462,-13,719,614,105,0,1,0,0.076923,9,14,13,4.777778,0,0,21,8,false,true,true,0.54,0.46
20,101,-81,10,50.5,-81,1782,1512,270,0,1,0,0.5,84,2,2,0.5,1,0,9,7,false,true,true,0.868,0.132
36,14,22,36,14,22,609,620,-11,0,0,0,0,93,1,1,0.397849,0,0,17,12,false,true,true,0.627,0.373
46,63,-17,9.2,15.75,-17,1221,1258,-37,0,0,0,0,75,5,4,0.52,0,0,8,19,false,true,false,0.044,0.956
76,33,43,15.2,8.25,43,1176,1076,100,0,0,0,0,78,5,4,0.75641,0,0,18,7,false,true,true,0.824,0.176
222,121,101,27.75,17.285714,101,539,500,39,0,0,0,0,37,8,7,1.081081,0,0,12,10,false,true,true,0.97,0.03
438,351,87,23.052632,19.5,87,791,885,-94,1,1,0.052632,0.055556,-28,19,18,-1.357143,0,0,1,1,false,true,true,1,0
82,109,-27,10.25,15.571429,-27,826,771,55,0,0,0,0,59,8,7,0.762712,0,0,14,12,false,true,false,0.115,0.885
347,278,69,15.086957,12.086957,69,272,288,-16,0,0,0,0,-24,23,23,-2.166667,0,0,2,2,false,true,true,1,0
133,53,80,44.333333,17.666667,80,1489,1405,84,1,0,0.333333,0,78,3,3,0.358974,1,0,10,14,false,true,true,0.994,0.006
204,234,-30,20.4,23.4,-30,971,761,210,0,0,0,0,25,10,10,1.2,0,0,11,13,false,true,false,0.172,0.828
182,189,-7,22.75,27,-7,1439,1397,42,0,2,0,0.285714,39,8,7,0.871795,0,0,7,10,false,true,false,0.124,0.876
200,209,-9,14.285714,14.928571,-9,480,518,-38,0,0,0,0,19,14,14,2.421053,1,1,9,7,false,true,false,0.054,0.946
269,263,6,26.9,26.3,6,1439,1397,42,1,2,0.1,0.2,14,10,10,2.428571,0,0,14,13,false,true,true,0.778,0.222
268,177,91,22.333333,16.090909,91,1439,1413,26,0,0,0,0,29,12,11,1.241379,1,0,12,9,false,true,true,0.997,0.003
389,271,118,20.473684,14.263158,118,942,1003,-61,0,0,0,0,-22,19,19,-2.045455,1,0,11,5,false,true,true,1,0
44,34,10,14.666667,17,10,1073,1177,-104,0,0,0,0,85,3,2,0.376471,0,1,13,22,false,true,false,0.239,0.761
84,62,22,28,20.666667,22,1556,1591,-35,0,0,0,0,80,3,3,0.45,0,0,23,13,false,true,true,0.688,0.312
50,20,30,16.666667,10,30,719,651,68,0,0,0,0,89,3,2,0.505618,1,0,23,13,false,true,true,0.905,0.095
236,168,68,19.666667,15.272727,68,620,658,-38,0,0,0,0,24,12,11,1.5,0,0,23,7,false,true,true,0.97,0.03
356,307,49,19.777778,17.055556,49,1090,1244,-154,0,0,0,0,-22,18,18,-1.681818,0,0,2,1,false,true,true,1,0
369,272,97,21.705882,16,97,704,691,13,1,0,0.058824,0,-14,17,17,-2.714286,0,0,5,3,false,true,true,1,0
222,173,49,22.2,19.222222,49,901,889,12,0,1,0,0.111111,39,10,9,1.102564,0,0,19,9,false,true,true,0.969,0.031
12,0,12,12,0,12,527,514,13,0,0,0,0,97,1,0,0.402062,0,0,17,0,false,true,false,0.326,0.674
291,259,32,29.1,28.777778,32,2219,2106,113,1,0,0.1,0,15,10,9,1.8,1,0,7,16,false,true,true,1,0
185,126,59,30.833333,25.2,59,1344,1325,19,1,0,0.166667,0,55,6,5,0.563636,0,0,8,15,false,true,true,0.833,0.167
131,154,-23,18.714286,22,-23,995,912,83,1,0,0.142857,0,58,7,7,0.758621,1,0,16,10,false,true,true,0.815,0.185
116,111,5,19.333333,18.5,5,901,889,12,0,1,0,0.166667,64,6,6,0.671875,1,0,21,12,false,true,true,0.929,0.071
326,181,145,19.176471,10.647059,145,896,818,78,0,1,0,0.058824,6,17,17,7.333333,1,0,10,11,false,true,true,1,0
426,307,119,26.625,20.466667,119,1396,1454,-58,2,0,0.125,0,-8,16,15,-4.125,0,0,1,1,false,true,true,1,0
323,131,192,35.888889,14.555556,192,1513,1482,31,1,0,0.111111,0,26,9,9,1.269231,0,0,10,19,false,true,true,1,0
146,125,21,12.166667,11.363636,21,892,768,124,0,0,0,0,39,12,11,1.102564,0,0,11,16,false,true,false,0.437,0.563
227,174,53,28.375,24.857143,53,1710,1636,74,1,1,0.125,0.142857,45,8,7,0.8,1,0,11,13,false,true,true,0.992,0.008
321,271,50,21.4,19.357143,50,1244,1361,-117,2,1,0.133333,0.071429,11,15,14,3.454545,0,0,11,14,false,true,true,1,0
366,353,13,21.529412,22.0625,13,1501,1473,28,1,0,0.058824,0,-18,17,16,-2,0,0,1,2,false,true,true,1,0
348,346,2,23.2,23.066667,2,1297,1606,-309,1,1,0.066667,0.066667,-11,15,15,-2.727273,0,0,3,4,true,true,true,0.999,0.001
267,123,144,24.272727,12.3,144,942,1003,-61,0,0,0,0,27,11,10,1.666667,1,1,21,15,false,true,true,1,0
320,306,14,16.842105,16.105263,14,947,810,137,0,1,0,0.052632,-19,19,19,-2.210526,0,0,6,8,false,true,true,0.919,0.081
280,266,14,15.555556,14.777778,14,699,448,251,0,0,0,0,-7,18,18,-5.714286,0,0,15,10,false,true,true,0.917,0.083
290,259,31,26.363636,23.545455,31,1189,1266,-77,1,0,0.090909,0,18,11,11,1.888889,1,0,6,7,false,true,true,0.979,0.021
216,203,13,24,22.555556,13,1793,1897,-104,1,0,0.111111,0,34,9,9,0.882353,0,1,8,6,false,true,true,0.571,0.429
277,241,36,18.466667,16.066667,36,808,639,169,0,0,0,0,3,15,15,13.666667,0,1,11,8,false,true,true,0.895,0.105
29,34,-5,14.5,17,-5,448,598,-150,0,0,0,0,86,2,2,0.418605,0,0,7,8,false,true,false,0.251,0.749
239,235,4,18.384615,18.076923,4,904,783,121,0,0,0,0,22,13,13,1.909091,0,0,13,10,false,true,true,0.669,0.331
317,261,56,15.095238,13.05,56,1016,1037,-21,0,0,0,0,-13,21,20,-3.692308,0,0,6,15,false,true,true,1,0
134,71,63,26.8,17.75,63,554,342,212,0,0,0,0,66,5,4,0.545455,0,1,12,6,false,true,true,0.848,0.152
129,147,-18,16.125,21,-18,95,360,-265,0,1,0,0.142857,41,8,7,0.97561,0,0,12,10,false,true,true,0.533,0.467
134,92,42,19.142857,15.333333,42,786,976,-190,0,0,0,0,65,7,6,0.492308,0,0,10,10,false,true,false,0.441,0.559
107,66,41,53.5,33,41,1493,1513,-20,1,0,0.5,0,80,2,2,0.4125,0,1,14,6,false,true,true,0.658,0.342
283,204,79,21.769231,15.692308,79,1551,1550,1,0,0,0,0,10,13,13,4.2,0,1,13,19,false,true,true,1,0
14,0,14,14,0,14,1023,1070,-47,0,0,0,0,96,1,0,0.333333,1,0,15,0,false,true,true,0.578,0.422
14,0,14,14,0,14,1265,1237,28,0,0,0,0,96,1,0,0.3125,0,0,12,0,false,true,true,0.679,0.321
135,67,68,27,13.4,68,871,867,4,0,0,0,0,65,5,5,0.661538,0,0,8,9,false,true,true,0.911,0.089
284,155,129,35.5,19.375,129,1684,1320,364,1,0,0.125,0,30,8,8,1,0,1,9,15,false,true,true,1,0
291,281,10,18.1875,17.5625,10,942,976,-34,0,0,0,0,-8,16,16,-5,0,0,11,9,false,true,true,0.745,0.255
360,378,-18,22.5,25.2,-18,834,844,-10,1,2,0.0625,0.133333,-16,16,15,-2.25,0,0,2,9,false,true,false,0,1
297,170,127,33,21.25,127,1167,1216,-49,1,0,0.111111,0,34,9,8,1.205882,0,0,9,14,false,true,true,1,0
341,259,82,18.944444,14.388889,82,830,907,-77,1,0,0.055556,0,-13,18,18,-3,0,1,14,1,false,true,true,1,0
107,98,9,17.833333,16.333333,9,1091,1078,13,0,0,0,0,63,6,6,0.68254,0,0,13,11,false,true,true,0.684,0.316
23,0,23,11.5,0,23,505,95,410,0,0,0,0,95,2,1,0.463158,0,0,17,0,false,true,true,0.988,0.012
321,234,87,20.0625,15.6,87,505,95,410,0,1,0,0.066667,9,16,15,4.888889,0,0,9,16,false,true,true,1,0
49,12,37,24.5,12,37,1078,1130,-52,0,0,0,0,88,2,1,0.443182,0,1,17,12,false,true,false,0.355,0.645
332,252,80,19.529412,15.75,80,695,523,172,0,0,0,0,-17,17,16,-2.176471,0,0,1,7,false,true,true,1,0
297,170,127,24.75,14.166667,127,303,342,-39,0,0,0,0,20,12,12,1.9,0,0,14,12,false,true,true,1,0
285,288,-3,13.571429,13.714286,-3,1029,1075,-46,0,0,0,0,-15,21,21,-3.2,1,0,5,4,false,true,true,0.927,0.073
153,141,12,25.5,23.5,12,892,819,73,0,1,0,0.166667,54,6,6,0.62963,0,0,14,7,false,true,true,0.783,0.217
238,199,39,21.636364,18.090909,39,941,926,15,1,0,0.090909,0,28,11,11,1.357143,1,0,18,10,false,true,true,0.968,0.032
111,60,51,22.2,15,51,1051,1030,21,0,0,0,0,63,5,4,0.47619,0,0,11,11,false,true,true,0.813,0.187
315,293,22,22.5,20.928571,22,1177,1214,-37,0,0,0,0,0,14,14,0,0,1,18,5,false,true,true,0.915,0.085
93,90,3,23.25,22.5,3,1501,1622,-121,0,0,0,0,71,4,4,0.43662,1,0,10,21,false,true,true,0.816,0.184
179,64,115,35.8,16,115,925,801,124,1,0,0.2,0,70,5,4,0.571429,1,0,9,9,false,true,true,0.971,0.029
233,194,39,19.416667,16.166667,39,609,620,-11,0,0,0,0,17,12,12,2.176471,0,0,8,9,false,true,true,0.969,0.031
343,191,152,16.333333,9.095238,152,421,306,115,0,1,0,0.047619,-18,21,21,-2.444444,0,0,8,5,false,true,true,1,0
350,267,83,19.444444,15.705882,83,505,95,410,0,1,0,0.058824,-3,18,17,-14.666667,0,0,7,16,false,true,true,1,0
199,179,20,28.428571,29.833333,20,1256,1232,24,1,0,0.142857,0,48,7,6,0.625,0,0,16,19,false,true,true,0.675,0.325
120,59,61,30,19.666667,61,1880,1777,103,1,0,0.25,0,72,4,3,0.388889,0,1,11,6,false,true,true,0.825,0.175
161,177,-16,12.384615,13.615385,-16,611,584,27,0,0,0,0,27,13,13,1.62963,0,0,10,18,false,true,false,0.124,0.876
132,150,-18,14.666667,16.666667,-18,611,584,27,0,0,0,0,46,9,9,0.956522,0,0,7,7,false,true,false,0.122,0.878
344,261,83,20.235294,15.352941,83,844,821,23,0,0,0,0,6,17,17,7,0,1,7,6,false,true,true,1,0
288,261,27,16,15.352941,27,808,812,-4,0,0,0,0,-16,18,17,-2.3125,1,0,6,1,false,true,true,0.945,0.055
76,21,55,76,21,55,925,801,124,1,0,1,0,91,1,1,0.43956,1,0,15,16,false,true,true,0.955,0.045
120,114,6,20,19,6,1388,1506,-118,1,1,0.166667,0.166667,61,6,6,0.557377,1,0,8,20,false,true,true,0.779,0.221
111,43,68,22.2,10.75,68,1482,1554,-72,0,0,0,0,74,5,4,0.486486,1,0,9,20,false,true,true,0.853,0.147
157,114,43,17.444444,12.666667,43,1281,1339,-58,0,0,0,0,51,9,9,0.803922,1,1,14,9,false,true,true,0.814,0.186
91,38,53,15.166667,7.6,53,1428,1302,126,0,0,0,0,61,6,5,0.868852,0,1,12,18,false,true,true,0.801,0.199
376,308,68,19.789474,16.210526,68,880,952,-72,0,0,0,0,-24,19,19,-1.708333,0,0,2,1,false,true,true,1,0
350,314,36,23.333333,20.933333,36,834,758,76,0,1,0,0.066667,-8,15,15,-4.5,0,0,10,9,false,true,true,1,0
123,101,22,20.5,20.2,22,859,786,73,0,0,0,0,63,6,5,0.603175,0,0,23,7,false,true,true,0.704,0.296
251,192,59,20.916667,17.454545,59,1394,1230,164,0,1,0,0.090909,19,12,11,2,0,1,9,20,false,true,false,0.375,0.625
339,237,102,28.25,19.75,102,996,1063,-67,1,1,0.083333,0.083333,8,12,12,4,1,0,18,16,false,true,true,1,0
262,219,43,21.833333,19.909091,43,1069,917,152,0,1,0,0.090909,23,12,11,1.478261,0,0,10,9,false,true,true,0.792,0.208
143,140,3,13,12.727273,3,416,374,42,0,0,0,0,44,11,11,1.045455,1,0,18,10,false,true,true,0.687,0.313
30,0,30,30,0,30,1331,1399,-68,0,0,0,0,95,1,0,0.368421,0,0,14,0,false,true,true,0.674,0.326
558,193,365,34.875,12.866667,365,1431,825,606,2,1,0.125,0.066667,-5,16,15,-6.8,0,0,2,16,false,true,true,1,0
107,89,18,26.75,22.25,18,809,868,-59,1,0,0.25,0,67,4,4,0.477612,0,0,14,13,false,true,false,0.321,0.679
316,318,-2,22.571429,24.461538,-2,1539,1537,2,0,1,0,0.076923,4,14,13,8,0,0,12,12,false,true,false,0.138,0.862
342,161,181,16.285714,8.05,181,993,897,96,1,0,0.047619,0,-19,21,20,-2.473684,0,1,5,25,false,true,true,1,0
325,308,17,21.666667,20.533333,17,1304,1040,264,1,0,0.066667,0,-3,15,15,-11,0,1,4,2,false,true,false,0.196,0.804
302,307,-5,20.133333,20.466667,-5,594,605,-11,0,0,0,0,-7,15,15,-5.285714,0,0,10,3,false,true,true,0.602,0.398
297,218,79,21.214286,16.769231,79,1394,1230,164,0,1,0,0.076923,6,14,13,6.333333,0,0,20,20,false,true,true,1,0
406,402,4,29,28.714286,4,1428,1452,-24,1,2,0.071429,0.142857,-9,14,14,-3.444444,0,0,2,2,false,true,true,1,0
319,296,23,19.9375,19.733333,23,1334,1270,64,1,0,0.0625,0,4,16,15,9.25,0,0,10,7,false,true,true,0.978,0.022
279,290,-11,23.25,24.166667,-11,1344,1325,19,1,0,0.083333,0,9,12,12,3.444444,0,0,18,7,false,true,false,0.311,0.689
268,214,54,20.615385,17.833333,54,1040,925,115,0,0,0,0,8,13,12,5.375,1,0,11,10,false,true,true,0.969,0.031
111,59,52,15.857143,9.833333,52,801,807,-6,0,0,0,0,55,7,6,0.636364,0,0,10,23,false,true,true,0.901,0.099
126,117,9,12.6,11.7,9,892,768,124,0,0,0,0,47,10,10,0.914894,0,0,7,15,false,true,false,0.363,0.637
114,105,9,19,17.5,9,363,668,-305,0,0,0,0,70,6,6,0.614286,1,0,6,11,false,true,false,0.428,0.572
174,135,39,19.333333,16.875,39,1090,1244,-154,0,0,0,0,40,9,8,0.925,0,0,9,16,false,true,false,0.33,0.67
274,239,35,16.117647,14.9375,35,371,435,-64,0,0,0,0,-7,17,16,-6.285714,0,0,6,6,false,true,true,0.805,0.195
336,280,56,21,18.666667,56,1406,1454,-48,0,2,0,0.133333,-8,16,15,-4.25,0,0,2,11,false,true,true,1,0
330,211,119,17.368421,11.722222,119,218,86,132,0,0,0,0,-27,19,18,-1.481481,0,0,2,6,false,true,true,1,0
321,221,100,24.692308,18.416667,100,1220,1261,-41,2,0,0.153846,0,24,13,12,1.875,1,0,12,11,false,true,true,1,0
302,252,50,25.166667,21,50,834,758,76,0,1,0,0.083333,12,12,12,3,0,0,11,16,false,true,true,0.971,0.029
213,184,29,26.625,23,29,1394,1424,-30,0,1,0,0.125,44,8,8,0.727273,0,0,12,19,false,true,false,0.493,0.507
277,213,64,21.307692,17.75,64,719,651,68,0,1,0,0.083333,26,13,12,1.730769,0,0,10,11,false,true,true,0.88,0.12
59,62,-3,29.5,31,-3,991,996,-5,0,0,0,0,83,2,2,0.361446,0,0,11,10,false,true,true,0.678,0.322
49,12,37,24.5,12,37,739,480,259,0,0,0,0,87,2,1,0.413793,0,0,11,17,false,true,true,0.756,0.244
374,351,23,24.933333,25.071429,23,1670,1770,-100,1,1,0.066667,0.071429,-17,15,14,-1.882353,0,1,4,6,false,true,true,0.999,0.001
319,219,100,26.583333,18.25,100,1075,1027,48,2,0,0.166667,0,12,12,12,3.083333,0,1,26,9,false,true,true,1,0
274,243,31,19.571429,18.692308,31,1266,1247,19,0,0,0,0,7,14,13,4.571429,2,0,7,16,false,true,true,0.998,0.002
277,187,90,19.785714,14.384615,90,1181,1069,112,0,0,0,0,12,14,13,3.083333,1,0,6,12,false,true,true,1,0
131,67,64,65.5,33.5,64,1633,1580,53,1,0,0.5,0,82,2,2,0.341463,0,0,17,13,false,true,true,0.949,0.051
43,95,-52,10.75,23.75,-52,844,821,23,0,0,0,0,78,4,4,0.538462,0,0,23,8,false,true,false,0.199,0.801
213,160,53,26.625,22.857143,53,1394,1424,-30,0,1,0,0.142857,47,8,7,0.680851,0,0,12,19,false,true,true,0.799,0.201
61,60,1,30.5,30,1,1153,1065,88,0,1,0,0.5,80,2,2,0.35,0,0,15,17,false,true,false,0.477,0.523
233,120,113,33.285714,20,113,630,786,-156,1,0,0.142857,0,51,7,6,0.686275,0,0,16,16,false,true,true,0.853,0.147
113,79,34,22.6,15.8,34,1572,1550,22,1,0,0.2,0,66,5,5,0.590909,0,0,18,11,false,true,true,0.797,0.203
70,57,13,17.5,19,13,926,854,72,0,0,0,0,77,4,3,0.441558,0,0,15,16,false,true,true,0.657,0.343
42,74,-32,21,37,-32,1636,1576,60,0,1,0,0.5,78,2,2,0.435897,0,0,10,13,false,true,false,0.237,0.763
137,55,82,27.4,13.75,82,1045,1009,36,1,0,0.2,0,69,5,4,0.550725,0,0,14,18,false,true,true,0.969,0.031
286,218,68,22,18.166667,68,786,976,-190,0,0,0,0,12,13,12,2.666667,0,0,18,10,false,true,true,0.898,0.102
360,336,24,20,19.764706,24,1177,1214,-37,0,0,0,0,-22,18,17,-1.590909,0,0,1,2,true,true,true,1,0
24,16,8,12,16,8,971,761,210,0,0,0,0,87,2,1,0.344828,0,1,7,9,false,true,true,0.581,0.419
384,339,45,27.428571,24.214286,45,1153,1065,88,0,1,0,0.071429,-20,14,14,-1.4,0,0,7,4,true,true,true,1,0
233,232,1,23.3,23.2,1,1344,1325,19,1,0,0.1,0,21,10,10,1.47619,0,0,10,17,false,true,false,0.33,0.67
61,51,10,15.25,12.75,10,95,378,-283,0,0,0,0,70,4,4,0.5,0,0,7,16,false,true,false,0.479,0.521
57,41,16,19,20.5,16,630,786,-156,0,0,0,0,78,3,2,0.448718,0,0,14,7,false,true,false,0.252,0.748
61,52,9,20.333333,17.333333,9,916,837,79,0,0,0,0,81,3,3,0.493827,0,1,14,9,false,true,true,0.703,0.297
116,46,70,38.666667,15.333333,70,1513,1482,31,1,0,0.333333,0,72,3,3,0.458333,0,0,10,23,false,true,true,0.843,0.157
230,146,84,32.857143,20.857143,84,1349,1302,47,0,0,0,0,43,7,7,0.674419,0,0,10,13,false,true,true,0.958,0.042
73,53,20,24.333333,26.5,20,1355,1210,145,0,0,0,0,79,3,2,0.379747,1,0,8,12,false,true,true,0.926,0.074
82,102,-20,16.4,20.4,-20,1027,856,171,1,0,0.2,0,55,5,5,0.6,0,1,13,6,false,true,true,0.677,0.323
203,142,61,22.555556,17.75,61,1516,1397,119,0,1,0,0.125,34,9,8,0.970588,0,0,18,10,false,true,true,0.891,0.109
168,259,-91,21,32.375,-91,1419,1488,-69,0,1,0,0.125,30,8,8,0.933333,1,0,15,9,false,true,false,0.063,0.937
87,90,-3,17.4,18,-3,262,306,-44,0,0,0,0,75,5,5,0.613333,0,0,23,11,false,true,false,0.497,0.503
244,243,1,12.842105,13.5,1,1029,1075,-46,0,0,0,0,0,19,18,0,2,0,9,12,false,true,true,0.756,0.244
10,18,-8,10,18,-8,1216,1217,-1,0,0,0,0,91,1,1,0.373626,0,0,23,11,false,true,true,0.677,0.323
195,168,27,24.375,21,27,596,595,1,1,0,0.125,0,44,8,8,0.909091,0,0,19,12,false,true,true,0.893,0.107
164,139,25,18.222222,17.375,25,416,306,110,0,0,0,0,45,9,8,0.933333,0,0,8,10,false,true,true,0.935,0.065
304,226,78,30.4,25.111111,78,1735,1770,-35,2,1,0.2,0.111111,20,10,9,1.4,0,1,15,14,false,true,true,0.972,0.028
326,329,-3,21.733333,21.933333,-3,1439,1413,26,0,1,0,0.066667,-1,15,15,-36,1,0,11,13,false,true,true,0.778,0.222
393,373,20,19.65,19.631579,20,1096,1009,87,2,0,0.1,0,-16,20,19,-2.75,0,0,3,6,false,true,true,0.518,0.482
384,251,133,27.428571,19.307692,133,1167,1216,-49,1,0,0.071429,0,12,14,13,3.416667,0,0,8,11,false,true,true,1,0
147,83,64,18.375,10.375,64,595,543,52,0,0,0,0,53,8,8,0.886792,1,0,6,17,false,true,true,0.97,0.03
144,100,44,24,20,44,1127,1176,-49,0,0,0,0,59,6,5,0.711864,0,0,12,16,false,true,true,0.736,0.264
97,107,-10,16.166667,17.833333,-10,611,584,27,0,0,0,0,66,6,6,0.666667,1,0,11,14,false,true,true,0.702,0.298
100,166,-66,14.285714,27.666667,-66,1897,1793,104,0,1,0,0.166667,65,7,6,0.492308,0,0,11,8,false,true,true,0.996,0.004
18,0,18,18,0,18,847,952,-105,0,0,0,0,97,1,0,0.371134,0,0,18,0,false,true,false,0.253,0.747
75,149,-74,15,29.8,-74,947,810,137,0,1,0,0.2,63,5,5,0.666667,0,1,16,13,false,true,false,0.044,0.956
105,75,30,21,18.75,30,1388,1506,-118,1,1,0.2,0.25,67,5,4,0.507463,1,0,9,27,false,true,true,0.88,0.12
409,278,131,15.730769,11.12,131,1413,1422,-9,0,0,0,0,-28,26,25,-2.035714,0,0,3,2,false,true,true,1,0
223,93,130,22.3,10.333333,130,993,897,96,1,0,0.1,0,31,10,9,1.516129,0,0,12,16,false,true,true,0.986,0.014
319,210,109,39.875,30,109,1824,1793,31,1,0,0.125,0,41,8,7,0.682927,1,0,7,14,false,true,true,1,0
274,200,74,17.125,13.333333,74,539,632,-93,0,0,0,0,12,16,15,3.833333,0,0,11,11,false,true,true,0.982,0.018
319,197,122,19.9375,13.133333,122,925,801,124,1,0,0.0625,0,4,16,15,10,0,0,16,7,false,true,true,1,0
226,126,100,37.666667,21,100,1684,1320,364,1,0,0.166667,0,47,6,6,0.638298,0,1,8,6,false,true,true,0.875,0.125
269,177,92,33.625,25.285714,92,1203,1221,-18,2,0,0.25,0,45,8,7,0.777778,0,0,13,9,false,true,true,0.986,0.014
370,277,93,24.666667,19.785714,93,977,976,1,1,0,0.066667,0,1,15,14,34,1,0,10,9,false,true,true,1,0
291,209,82,26.454545,20.9,82,880,952,-72,0,0,0,0,26,11,10,1.346154,0,0,19,7,false,true,true,0.977,0.023
150,108,42,25,18,42,939,907,32,0,0,0,0,62,6,6,0.645161,1,0,17,7,false,true,true,0.961,0.039
269,229,40,17.933333,16.357143,40,609,620,-11,0,0,0,0,0,15,14,0,0,1,7,8,false,true,true,0.859,0.141
191,167,24,17.363636,16.7,24,1583,1422,161,0,0,0,0,44,11,10,1.159091,1,0,7,7,false,true,false,0.299,0.701
53,49,4,13.25,12.25,4,1265,1045,220,0,0,0,0,68,4,4,0.617647,0,1,17,17,false,true,false,0.235,0.765
370,349,21,16.818182,16.619048,21,1181,1149,32,0,1,0,0.047619,-27,22,21,-1.666667,0,0,3,1,false,true,true,1,0
48,0,48,24,0,48,901,889,12,0,0,0,0,93,2,1,0.462366,0,0,9,11,false,true,true,0.716,0.284
104,57,47,14.857143,9.5,47,584,565,19,0,0,0,0,58,7,6,0.793103,0,0,15,22,false,true,true,0.943,0.057
14,26,-12,14,26,-12,1355,1210,145,0,0,0,0,93,1,1,0.322581,0,0,18,12,false,true,false,0.43,0.57
214,255,-41,16.461538,19.615385,-41,316,306,10,0,2,0,0.153846,11,13,13,3.454545,0,0,14,22,false,true,true,0.988,0.012
46,52,-6,15.333333,17.333333,-6,361,493,-132,0,0,0,0,75,3,3,0.546667,0,1,19,7,false,true,false,0.246,0.754
149,96,53,21.285714,16,53,830,907,-77,1,0,0.142857,0,54,7,6,0.722222,0,0,16,14,false,true,true,0.833,0.167
267,258,9,19.071429,18.428571,9,1547,1439,108,1,0,0.071429,0,6,14,14,6.166667,0,0,19,13,false,true,true,0.556,0.444
277,184,93,25.181818,16.727273,93,1216,1230,-14,1,0,0.090909,0,29,11,11,1.103448,0,0,10,17,false,true,true,1,0
16,0,16,16,0,16,613,502,111,0,0,0,0,96,1,0,0.510417,0,0,9,0,false,true,true,0.685,0.315
276,155,121,30.666667,19.375,121,1334,1256,78,2,0,0.222222,0,35,9,8,0.885714,0,0,13,7,false,true,true,1,0
201,180,21,22.333333,20,21,1078,1130,-52,0,1,0,0.111111,38,9,9,1.026316,0,1,12,18,false,true,false,0.343,0.657
231,182,49,23.1,18.2,49,1036,1181,-145,0,0,0,0,36,10,10,0.944444,0,0,16,8,false,true,true,0.83,0.17
357,287,70,18.789474,15.944444,70,1045,1009,36,1,0,0.052632,0,-17,19,18,-2.235294,0,0,2,3,false,true,true,1,0
282,224,58,21.692308,18.666667,58,791,774,17,1,0,0.076923,0,25,13,12,1.64,0,0,13,10,false,true,true,0.882,0.118
12,11,1,12,11,1,527,514,13,0,0,0,0,94,1,1,0.414894,0,0,17,7,false,true,false,0.486,0.514
204,156,48,20.4,17.333333,48,691,473,218,0,0,0,0,33,10,9,1.090909,0,0,15,16,false,true,true,0.878,0.122
230,197,33,23,19.7,33,926,854,72,0,0,0,0,33,10,10,1.030303,0,1,10,10,false,true,true,0.769,0.231
191,155,36,15.916667,12.916667,36,584,565,19,0,0,0,0,25,12,12,1.84,0,0,8,14,false,true,true,0.956,0.044
82,47,35,20.5,15.666667,35,526,370,156,0,0,0,0,75,4,3,0.466667,0,0,15,18,false,true,true,0.802,0.198
289,142,147,22.230769,10.923077,147,942,1003,-61,0,0,0,0,14,13,13,3.214286,1,1,19,15,false,true,true,1,0
260,249,11,21.666667,20.75,11,1115,1078,37,0,1,0,0.083333,17,12,12,2,1,0,11,19,false,true,true,0.644,0.356
385,313,72,24.0625,19.5625,72,1762,1582,180,2,3,0.125,0.1875,-10,16,16,-3.2,0,0,1,24,true,true,true,1,0
175,124,51,15.909091,12.4,51,1128,889,239,0,1,0,0.1,34,11,10,1.382353,0,0,25,20,false,true,true,1,0
244,204,40,22.181818,18.545455,40,784,758,26,0,0,0,0,18,11,11,1.944444,0,0,10,9,false,true,true,0.969,0.031
93,84,9,13.285714,14,9,416,222,194,0,0,0,0,54,7,6,1.018519,1,0,9,7,false,true,true,0.907,0.093
233,182,51,21.181818,18.2,51,844,821,23,0,0,0,0,42,11,10,1,0,0,23,7,false,true,true,0.961,0.039
581,360,221,38.733333,25.714286,221,991,996,-5,3,0,0.2,0,-14,15,14,-2.142857,0,0,6,7,false,true,true,1,0
271,190,81,33.875,23.75,81,1245,1241,4,1,1,0.125,0.125,36,8,8,0.805556,0,0,14,11,false,true,true,0.979,0.021
133,82,51,19,13.666667,51,786,847,-61,0,0,0,0,57,7,6,0.596491,0,0,8,14,false,true,true,0.617,0.383
149,134,15,16.555556,16.75,15,540,518,22,0,0,0,0,45,9,8,0.888889,0,0,11,12,false,true,true,0.592,0.408
226,183,43,13.294118,11.4375,43,584,565,19,0,0,0,0,-4,17,16,-11.5,0,0,29,18,false,true,true,0.983,0.017
217,240,-23,19.727273,21.818182,-23,869,820,49,0,1,0,0.090909,28,11,11,1.321429,0,1,11,6,false,true,false,0.218,0.782
179,107,72,25.571429,17.833333,72,1221,1266,-45,0,0,0,0,48,7,6,0.729167,1,0,8,16,false,true,true,0.958,0.042
400,323,77,26.666667,21.533333,77,1075,1027,48,2,1,0.133333,0.066667,-13,15,15,-2.846154,0,0,6,4,false,true,true,1,0
51,32,19,17,10.666667,19,310,359,-49,0,0,0,0,81,3,3,0.604938,0,0,7,13,false,true,false,0.36,0.64
350,270,80,21.875,18,80,1004,653,351,0,0,0,0,-17,16,15,-2.058824,0,0,3,2,false,true,true,1,0
358,351,7,22.375,21.9375,7,1554,1716,-162,1,1,0.0625,0.0625,-16,16,16,-2.1875,0,0,4,2,false,true,true,0.999,0.001
336,275,61,18.666667,16.176471,61,739,480,259,1,0,0.055556,0,-17,18,17,-2.117647,0,2,11,2,false,true,true,0.79,0.21
348,259,89,21.75,17.266667,89,1216,1217,-1,1,0,0.0625,0,-8,16,15,-4.25,0,0,4,5,false,true,true,1,0
301,266,35,13.086957,11.565217,35,947,909,38,0,0,0,0,-42,23,23,-1.095238,0,0,1,7,true,true,true,1,0
398,321,77,28.428571,24.692308,77,1793,1897,-104,2,0,0.142857,0,-4,14,13,-7.5,0,0,3,13,false,true,true,1,0
321,314,7,24.692308,24.153846,7,1023,1110,-87,1,1,0.076923,0.076923,-6,13,13,-5,1,0,9,4,false,true,true,0.948,0.052
133,113,20,22.166667,18.833333,20,1075,1152,-77,0,0,0,0,61,6,6,0.655738,0,1,16,7,false,true,false,0.346,0.654
354,321,33,27.230769,26.75,33,1148,1164,-16,1,2,0.076923,0.166667,-4,13,12,-6.25,0,0,3,2,true,true,true,0.998,0.002
419,215,204,29.928571,16.538462,204,820,783,37,1,0,0.071429,0,2,14,13,16.5,0,0,7,10,false,true,true,1,0
378,334,44,37.8,33.4,44,1885,1793,92,0,0,0,0,16,10,10,1.6875,1,0,8,13,false,true,true,1,0
58,20,38,29,20,38,1428,1452,-24,0,0,0,0,90,2,1,0.344444,0,0,17,10,false,true,true,0.69,0.31
159,59,100,19.875,8.428571,100,1067,95,972,0,0,0,0,60,8,7,0.566667,0,0,13,7,false,true,true,1,0
115,69,46,23,17.25,46,1210,1253,-43,0,0,0,0,66,5,4,0.530303,0,0,21,12,false,true,true,0.763,0.237
289,226,63,24.083333,20.545455,63,995,912,83,2,0,0.166667,0,30,12,11,1.466667,0,0,11,13,false,true,true,0.989,0.011
157,137,20,26.166667,27.4,20,1394,1424,-30,0,1,0,0.2,60,6,5,0.533333,0,0,12,10,false,true,true,0.551,0.449
369,256,113,21.705882,16,113,704,691,13,1,0,0.058824,0,-12,17,16,-3.166667,0,0,5,5,false,true,true,1,0
164,221,-57,16.4,22.1,-57,999,1011,-12,0,0,0,0,33,10,10,1.393939,0,0,15,11,false,true,false,0.07,0.93
365,224,141,20.277778,12.444444,141,554,342,212,0,0,0,0,-19,18,18,-1.894737,0,0,1,4,true,true,true,1,0
307,226,81,27.909091,20.545455,81,977,976,1,1,0,0.090909,0,22,11,11,1.545455,1,0,18,7,false,true,true,1,0
158,99,59,26.333333,16.5,59,1065,1030,35,0,0,0,0,60,6,6,0.566667,0,0,15,10,false,true,true,0.891,0.109
316,269,47,21.066667,17.933333,47,791,774,17,1,0,0.066667,0,9,15,15,4.555556,0,0,13,7,false,true,true,0.998,0.002
107,56,51,21.4,11.2,51,804,683,121,0,0,0,0,64,5,5,0.703125,0,1,20,8,false,true,true,0.848,0.152
171,132,39,17.1,13.2,39,1030,1045,-15,0,0,0,0,42,10,10,1.095238,0,0,7,23,false,true,true,0.577,0.423
342,236,106,26.307692,18.153846,106,1030,998,32,1,0,0.076923,0,5,13,13,7.6,0,0,17,18,false,true,true,1,0
59,61,-2,14.75,20.333333,-2,954,1078,-124,0,0,0,0,74,4,3,0.513514,1,0,27,11,false,true,false,0.28,0.72
360,289,71,25.714286,20.642857,71,880,952,-72,0,0,0,0,2,14,14,17.5,0,0,7,8,false,true,true,1,0
69,57,12,13.8,14.25,12,1128,889,239,0,1,0,0.25,69,5,4,0.681159,1,0,12,7,false,true,true,0.999,0.001
276,298,-22,25.090909,29.8,-22,1030,1144,-114,0,2,0,0.2,26,11,10,1.346154,0,0,15,9,false,true,false,0.257,0.743
253,235,18,25.3,26.111111,18,1096,1009,87,1,0,0.1,0,42,10,9,1.047619,0,0,7,14,false,true,false,0.448,0.552
146,99,47,20.857143,14.142857,47,609,620,-11,0,0,0,0,52,7,7,0.711538,0,0,15,10,false,true,true,0.966,0.034
53,25,28,13.25,8.333333,28,1519,1782,-263,0,0,0,0,82,4,3,0.402439,0,1,15,10,false,true,false,0.256,0.744
262,115,147,26.2,12.777778,147,1295,1477,-182,2,0,0.2,0,38,10,9,1.210526,0,0,22,10,false,true,true,0.995,0.005
176,168,8,14.666667,15.272727,8,658,817,-159,0,0,0,0,32,12,11,1.1875,0,0,19,15,false,true,false,0.464,0.536
222,163,59,18.5,14.818182,59,831,830,1,0,0,0,0,24,12,11,1.541667,1,0,22,10,false,true,true,0.974,0.026
329,215,114,14.954545,9.772727,114,1428,1302,126,0,0,0,0,-19,22,22,-2.789474,0,1,14,12,false,true,true,1,0
36,24,12,18,12,12,1551,1550,1,0,0,0,0,89,2,2,0.47191,0,0,19,25,false,true,true,0.638,0.362
355,222,133,20.882353,13.875,133,303,342,-39,0,0,0,0,-6,17,16,-6.333333,0,0,8,7,false,true,true,1,0
272,154,118,22.666667,12.833333,118,1295,1477,-182,2,0,0.166667,0,25,12,12,1.84,0,0,19,13,false,true,true,1,0
409,394,15,31.461538,30.307692,15,2219,2106,113,2,0,0.153846,0,-17,13,13,-1.588235,0,0,7,3,false,true,true,0.999,0.001
156,121,35,19.5,17.285714,35,859,786,73,0,0,0,0,49,8,7,0.77551,0,0,23,8,false,true,true,0.836,0.164
351,318,33,35.1,31.8,33,1880,1777,103,1,1,0.1,0.1,16,10,10,1.75,0,0,17,8,false,true,true,1,0
162,106,56,27,17.666667,56,901,1159,-258,2,0,0.333333,0,56,6,6,0.625,0,0,11,19,false,true,true,0.824,0.176
382,270,112,19.1,13.5,112,746,796,-50,0,1,0,0.05,-20,20,20,-2.4,0,0,2,3,false,true,true,1,0
124,56,68,20.666667,11.2,68,1551,1550,1,0,0,0,0,63,6,5,0.666667,0,1,14,24,false,true,true,0.839,0.161
391,272,119,24.4375,17,119,1211,1173,38,0,0,0,0,-8,16,16,-4.375,0,0,12,3,false,true,true,1,0
381,307,74,20.052632,17.055556,74,1089,1063,26,1,0,0.052632,0,-19,19,18,-2,0,0,1,6,false,true,true,1,0
88,81,7,22,27,7,594,605,-11,0,0,0,0,78,4,3,0.474359,0,0,7,11,false,true,false,0.296,0.704
134,134,0,22.333333,26.8,0,1177,1214,-37,0,0,0,0,63,6,5,0.555556,0,0,19,8,false,true,true,0.646,0.354
107,65,42,21.4,13,42,1055,1050,5,0,0,0,0,68,5,5,0.5,0,0,10,8,false,true,true,0.84,0.16
299,259,40,24.916667,23.545455,40,1320,1339,-19,2,1,0.166667,0.090909,17,12,11,2.294118,0,0,19,13,false,true,true,0.973,0.027
329,161,168,16.45,8.473684,168,993,897,96,1,0,0.05,0,-16,20,19,-2.9375,0,1,15,25,false,true,true,1,0
353,281,72,25.214286,21.615385,72,856,897,-41,0,1,0,0.076923,-4,14,13,-8.75,0,0,11,12,false,true,true,1,0
194,157,37,21.555556,19.625,37,1452,1469,-17,0,1,0,0.125,40,9,8,0.95,1,1,6,12,false,true,true,0.599,0.401
360,319,41,27.692308,24.538462,41,1408,1454,-46,1,0,0.076923,0,6,13,13,5.333333,0,0,16,9,false,true,true,1,0
211,104,107,23.444444,11.555556,107,719,651,68,0,0,0,0,53,9,9,0.849057,0,0,13,8,false,true,true,0.97,0.03
301,156,145,18.8125,9.75,145,1176,1076,100,0,0,0,0,28,16,16,2.107143,0,0,12,15,false,true,true,1,0
109,144,-35,21.8,36,-35,1023,1110,-87,0,1,0,0.25,57,5,4,0.526316,0,0,12,12,false,true,false,0.214,0.786
358,266,92,17.9,14,92,711,876,-165,0,0,0,0,-14,20,19,-3.071429,0,0,3,2,false,true,true,1,0
339,297,42,21.1875,18.5625,42,795,830,-35,1,1,0.0625,0.0625,-8,16,16,-5.25,0,0,11,11,false,true,true,1,0
199,181,18,22.111111,20.111111,18,941,926,15,1,0,0.111111,0,37,9,9,1.027027,1,0,9,7,false,true,true,0.932,0.068
371,254,117,19.526316,14.111111,117,1413,1422,-9,0,0,0,0,-8,19,18,-7.125,0,0,9,7,false,true,true,1,0
73,74,-1,24.333333,24.666667,-1,965,1013,-48,0,0,0,0,77,3,3,0.428571,1,0,6,15,false,true,true,0.648,0.352
233,213,20,17.923077,17.75,20,719,785,-66,0,1,0,0.083333,18,13,12,2,0,0,21,11,false,true,true,0.833,0.167
141,129,12,47,64.5,12,1370,1431,-61,1,1,0.333333,0.5,73,3,2,0.315068,0,0,17,11,false,true,true,0.678,0.322
239,253,-14,19.916667,21.083333,-14,971,906,65,0,0,0,0,11,12,12,2.909091,1,0,7,12,false,true,true,0.568,0.432
29,18,11,14.5,9,11,834,758,76,0,0,0,0,83,2,2,0.433735,0,1,14,11,false,true,true,0.708,0.292
52,45,7,17.333333,15,7,540,518,22,0,0,0,0,82,3,3,0.487805,0,1,14,17,false,true,false,0.272,0.728
177,112,65,35.4,28,65,1142,1095,47,1,0,0.2,0,59,5,4,0.59322,0,0,12,19,false,true,true,0.918,0.082
183,82,101,45.75,27.333333,101,1397,1361,36,1,0,0.25,0,70,4,3,0.414286,0,0,10,7,false,true,true,0.873,0.127
218,157,61,24.222222,19.625,61,901,889,12,0,1,0,0.125,46,9,8,0.934783,0,0,15,7,false,true,true,0.97,0.03
325,311,14,21.666667,20.733333,14,1344,1209,135,1,1,0.066667,0.066667,-11,15,15,-3.090909,0,0,7,3,false,true,true,0.702,0.298
153,123,30,30.6,24.6,30,1489,1555,-66,1,0,0.2,0,57,5,5,0.508772,0,0,12,18,false,true,true,0.699,0.301
224,221,3,14,13.8125,3,1029,1075,-46,0,0,0,0,12,16,16,4,2,0,7,12,false,true,false,0.468,0.532
332,215,117,14.434783,9.347826,117,1428,1302,126,0,0,0,0,-22,23,23,-2.409091,0,1,13,12,false,true,true,1,0
396,310,86,23.294118,18.235294,86,1305,1390,-85,0,1,0,0.058824,-24,17,17,-1.5,0,2,3,4,false,true,true,1,0
136,173,-37,17,21.625,-37,1100,1008,92,0,0,0,0,48,8,8,0.75,2,0,5,14,false,true,true,0.799,0.201
219,138,81,27.375,19.714286,81,1388,1506,-118,2,1,0.25,0.142857,47,8,7,0.723404,0,0,13,16,false,true,true,0.961,0.039
105,68,37,21,13.6,37,1550,1546,4,0,0,0,0,67,5,5,0.447761,0,0,14,18,false,true,true,0.78,0.22
272,259,13,16,16.1875,13,500,567,-67,0,0,0,0,7,17,16,6.285714,0,0,7,12,false,true,false,0.409,0.591
175,160,15,13.461538,12.307692,15,416,374,42,0,0,0,0,35,13,13,1.314286,0,1,11,13,false,true,true,0.506,0.494
297,226,71,21.214286,17.384615,71,719,651,68,0,1,0,0.076923,18,14,13,2.5,1,0,6,10,false,true,true,0.992,0.008
249,228,21,24.9,25.333333,21,1670,1770,-100,1,1,0.1,0.111111,32,10,9,1,0,0,10,15,false,true,false,0.406,0.594
351,305,46,27,25.416667,46,1762,1616,146,2,0,0.153846,0,-1,13,12,-30,1,0,11,11,false,true,true,1,0
250,197,53,22.727273,17.909091,53,719,651,68,0,1,0,0.090909,36,11,11,1.25,0,0,10,9,false,true,true,0.962,0.038
401,164,237,30.846154,12.615385,237,1054,917,137,2,0,0.153846,0,0,13,13,0,0,0,13,9,false,true,true,1,0
395,375,20,30.384615,31.25,20,1935,2020,-85,0,1,0,0.083333,-1,13,12,-31,0,0,7,11,false,true,true,1,0
33,0,33,16.5,0,33,1885,1793,92,0,0,0,0,93,2,1,0.290323,0,1,19,7,false,true,true,0.697,0.303
109,154,-45,18.166667,30.8,-45,594,605,-11,0,0,0,0,65,6,5,0.569231,1,0,11,7,false,true,false,0.006,0.994
197,130,67,24.625,18.571429,67,1221,1266,-45,0,0,0,0,41,8,7,0.853659,1,0,6,10,false,true,true,0.953,0.047
207,157,50,17.25,14.272727,50,913,871,42,0,0,0,0,28,12,11,1.535714,0,0,14,18,false,true,true,0.869,0.131
119,51,68,39.666667,25.5,68,996,1063,-67,1,1,0.333333,0.5,72,3,2,0.444444,0,0,12,10,false,true,true,0.949,0.051
135,173,-38,15,19.222222,-38,1043,1055,-12,0,0,0,0,41,9,9,0.902439,1,0,19,9,false,true,false,0.231,0.769
294,205,89,21,15.769231,89,1270,1315,-45,0,0,0,0,7,14,13,5.142857,0,0,9,30,false,true,true,1,0
38,22,16,38,22,16,1075,989,86,0,0,0,0,92,1,1,0.423913,0,0,8,7,false,true,true,0.69,0.31
337,291,46,18.722222,17.117647,46,658,817,-159,0,0,0,0,-7,18,17,-5.428571,0,0,2,6,false,true,true,1,0
321,287,34,22.928571,20.5,34,976,965,11,1,0,0.071429,0,-8,14,14,-4,1,0,7,5,false,true,true,1,0
91,119,-28,18.2,23.8,-28,844,821,23,0,0,0,0,72,5,5,0.583333,0,0,17,9,false,true,false,0.364,0.636
340,251,89,26.153846,19.307692,89,1167,1216,-49,1,0,0.076923,0,15,13,13,2.733333,0,0,16,11,false,true,true,1,0
41,72,-31,13.666667,24,-31,1221,1266,-45,0,0,0,0,77,3,3,0.454545,0,0,19,7,false,true,true,0.664,0.336
190,149,41,17.272727,14.9,41,527,581,-54,0,0,0,0,28,11,10,1.5,1,0,18,16,false,true,true,0.844,0.156
99,44,55,16.5,8.8,55,1030,1045,-15,0,0,0,0,69,6,5,0.666667,0,0,10,10,false,true,true,0.837,0.163
305,292,13,20.333333,19.466667,13,786,847,-61,0,0,0,0,-2,15,15,-17,0,0,4,8,false,true,false,0.349,0.651
406,302,104,23.882353,18.875,104,1550,1466,84,1,0,0.058824,0,-15,17,16,-2.466667,0,0,3,3,false,true,true,1,0
325,299,26,20.3125,18.6875,26,1027,856,171,1,1,0.0625,0.0625,-23,16,16,-1.434783,0,0,2,3,false,true,true,0.987,0.013
42,72,-30,10.5,24,-30,480,518,-38,0,0,0,0,81,4,3,0.567901,0,0,8,9,false,true,false,0.2,0.8
70,87,-17,17.5,21.75,-17,926,854,72,0,0,0,0,75,4,4,0.453333,0,0,15,10,false,true,true,0.602,0.398
47,34,13,15.666667,17,13,786,847,-61,0,0,0,0,84,3,2,0.404762,0,1,13,8,false,true,false,0.254,0.746
175,87,88,25,14.5,88,786,757,29,1,0,0.142857,0,56,7,6,0.696429,0,0,7,12,false,true,true,0.97,0.03
155,104,51,25.833333,20.8,51,1548,1493,55,1,0,0.166667,0,56,6,5,0.732143,0,0,13,16,false,true,true,0.797,0.203
349,214,135,34.9,23.777778,135,1396,1454,-58,2,0,0.2,0,27,10,9,1.222222,0,0,7,12,false,true,true,1,0
349,340,9,19.388889,20,9,1100,1008,92,1,0,0.055556,0,-21,18,17,-1.714286,0,0,1,1,false,true,true,1,0
311,286,25,22.214286,20.428571,25,758,796,-38,0,0,0,0,2,14,14,19,0,0,7,10,false,true,true,0.979,0.021
378,338,40,19.894737,18.777778,40,1014,1303,-289,1,0,0.052632,0,-27,19,18,-1.407407,0,0,1,4,false,true,true,1,0
16,0,16,16,0,16,505,95,410,0,0,0,0,97,1,1,0.453608,0,0,7,0,false,true,true,0.873,0.127
12,0,12,12,0,12,801,807,-6,0,0,0,0,97,1,0,0.360825,0,0,11,0,false,true,false,0.411,0.589
266,134,132,22.166667,11.166667,132,925,801,124,1,0,0.083333,0,27,12,12,1.481481,1,0,9,25,false,true,true,1,0
184,172,12,18.4,17.2,12,786,847,-61,0,0,0,0,37,10,10,0.918919,1,0,9,10,false,true,true,0.692,0.308
99,82,17,19.8,16.4,17,1513,1479,34,0,0,0,0,65,5,5,0.523077,1,0,19,10,false,true,true,0.92,0.08
187,132,55,23.375,16.5,55,1022,1095,-73,0,0,0,0,44,8,8,0.75,0,0,16,12,false,true,true,0.955,0.045
335,240,95,20.9375,16,95,711,876,-165,0,0,0,0,-2,16,15,-21.5,0,1,9,8,false,true,true,1,0
267,187,80,29.666667,23.375,80,2219,2106,113,1,0,0.111111,0,28,9,8,0.964286,0,0,9,10,false,true,true,0.999,0.001
170,171,-1,21.25,21.375,-1,834,758,76,0,1,0,0.125,43,8,8,0.837209,0,1,16,17,false,true,false,0.289,0.711
249,174,75,19.153846,13.384615,75,871,867,4,0,0,0,0,17,13,13,2.529412,0,1,12,16,false,true,true,0.984,0.016
100,45,55,33.333333,22.5,55,1434,1493,-59,1,0,0.333333,0,74,3,2,0.5,0,0,22,8,false,true,true,0.719,0.281
174,156,18,15.818182,15.6,18,540,518,22,0,0,0,0,33,11,10,1.212121,0,0,10,13,false,true,true,0.635,0.365
231,202,29,38.5,33.666667,29,1633,1580,53,2,0,0.333333,0,47,6,6,0.595745,0,0,9,15,false,true,true,0.646,0.354
279,216,63,19.928571,16.615385,63,505,95,410,0,1,0,0.076923,22,14,13,2,0,0,8,9,false,true,true,1,0
192,135,57,24,19.285714,57,1295,1281,14,0,0,0,0,55,8,7,0.690909,0,0,12,13,false,true,true,0.842,0.158
82,51,31,16.4,12.75,31,95,378,-283,0,0,0,0,66,5,4,0.530303,0,0,17,16,false,true,true,0.692,0.308
228,266,-38,22.8,29.555556,-38,1897,1793,104,1,2,0.1,0.222222,44,10,9,0.727273,0,1,15,9,false,true,false,0.015,0.985
90,84,6,18,16.8,6,1089,1063,26,0,0,0,0,72,5,5,0.527778,1,0,9,19,false,true,true,0.66,0.34
127,112,15,21.166667,22.4,15,926,854,72,0,0,0,0,68,6,5,0.5,0,0,18,10,false,true,true,0.654,0.346
354,271,83,29.5,22.583333,83,1093,1100,-7,3,3,0.25,0.25,11,12,12,2.909091,0,1,11,11,false,true,true,1,0
231,182,49,15.4,12.133333,49,698,742,-44,1,0,0.066667,0,17,15,15,2.411765,0,0,8,23,false,true,true,0.801,0.199
370,320,50,24.666667,22.857143,50,1142,1176,-34,1,0,0.066667,0,1,15,14,36,1,0,4,10,false,true,true,1,0
24,0,24,24,0,24,1684,1320,364,0,0,0,0,95,1,0,0.315789,1,0,7,0,false,true,true,0.952,0.048
334,176,158,18.555556,10.352941,158,421,306,115,0,1,0,0.058824,-9,18,17,-4.888889,0,0,11,9,false,true,true,1,0
317,238,79,13.782609,10.347826,79,416,222,194,0,0,0,0,-31,23,23,-1.774194,0,0,11,10,false,true,true,1,0
153,118,35,21.857143,19.666667,35,1547,1439,108,1,0,0.142857,0,57,7,6,0.649123,0,0,15,18,false,true,true,0.731,0.269
255,206,49,23.181818,18.727273,49,866,949,-83,0,0,0,0,23,11,11,1.73913,1,0,6,14,false,true,true,0.946,0.054
350,330,20,23.333333,22,20,1023,1110,-87,1,1,0.066667,0.066667,-18,15,15,-1.666667,0,0,3,1,true,true,true,1,0
334,263,71,16.7,13.842105,71,416,374,42,0,0,0,0,-11,20,19,-4.181818,0,0,6,7,false,true,true,1,0
14,21,-7,14,21,-7,1489,1555,-66,0,0,0,0,90,1,1,0.322222,1,0,9,20,false,true,true,0.774,0.226
12,0,12,12,0,12,711,876,-165,0,0,0,0,95,1,0,0.452632,0,0,12,0,false,true,false,0.251,0.749
233,193,40,25.888889,24.125,40,1519,1782,-263,1,0,0.111111,0,38,9,8,0.868421,0,0,12,7,false,true,false,0.303,0.697
243,139,104,14.294118,8.6875,104,310,359,-49,0,0,0,0,-7,17,16,-7,0,0,9,17,false,true,true,1,0
151,149,2,21.571429,24.833333,2,518,448,70,0,0,0,0,56,7,6,0.607143,0,0,15,8,false,true,true,0.656,0.344
252,180,72,25.2,20,72,1093,1090,3,1,1,0.1,0.111111,35,10,9,0.971429,0,1,16,11,false,true,true,0.849,0.151
387,275,112,25.8,19.642857,112,1550,1466,84,1,0,0.066667,0,-3,15,14,-12.333333,0,0,10,11,false,true,true,1,0
204,172,32,17,15.636364,32,527,581,-54,0,0,0,0,21,12,11,2,0,0,17,17,false,true,true,0.814,0.186
273,239,34,21,18.384615,34,786,847,-61,0,0,0,0,14,13,13,2.428571,0,0,7,14,false,true,true,0.717,0.283
57,59,-2,19,19.666667,-2,630,786,-156,0,0,0,0,75,3,3,0.466667,0,1,14,6,false,true,false,0.252,0.748
329,275,54,21.933333,19.642857,54,847,952,-105,0,0,0,0,8,15,14,4.5,0,0,9,7,false,true,true,0.999,0.001
274,156,118,19.571429,12,118,421,306,115,0,1,0,0.076923,2,14,13,22,0,0,21,10,false,true,true,1,0
194,189,5,16.166667,17.181818,5,527,514,13,0,0,0,0,20,12,11,1.95,0,1,8,11,false,true,false,0.055,0.945
241,177,64,16.066667,11.8,64,1069,1040,29,0,0,0,0,0,15,15,0,0,2,7,5,false,true,true,0.984,0.016
339,193,146,18.833333,11.352941,146,871,867,4,0,0,0,0,-6,18,17,-7.166667,0,1,10,16,false,true,true,1,0
110,70,40,15.714286,11.666667,40,346,231,115,0,0,0,0,50,7,6,0.82,0,0,9,13,false,true,true,0.948,0.052
157,101,56,39.25,33.666667,56,1770,1689,81,0,0,0,0,66,4,3,0.393939,0,1,16,12,false,true,true,0.95,0.05
403,338,65,20.15,17.789474,65,892,788,104,3,0,0.15,0,-20,20,19,-2.15,0,0,1,2,false,true,true,1,0
317,259,58,22.642857,19.923077,58,1075,1152,-77,0,1,0,0.076923,7,14,13,5.714286,0,0,14,14,false,true,true,0.988,0.012
23,17,6,7.666667,8.5,6,1397,1422,-25,0,0,0,0,88,3,2,0.409091,0,1,7,13,false,true,false,0.192,0.808
370,342,28,23.125,22.8,28,1305,1242,63,2,1,0.125,0.066667,-11,16,15,-3.090909,0,0,2,4,false,true,true,1,0
267,234,33,19.071429,18,33,1127,1176,-49,0,0,0,0,12,14,13,3.5,0,0,19,15,false,true,true,0.691,0.309
62,49,13,20.666667,16.333333,13,349,315,34,0,0,0,0,76,3,3,0.447368,1,0,6,13,false,true,true,0.911,0.089
286,191,95,26,19.1,95,613,569,44,0,0,0,0,24,11,10,1.625,1,0,12,10,false,true,true,1,0
283,248,35,20.214286,17.714286,35,921,1072,-151,1,0,0.071429,0,13,14,14,2.923077,0,1,12,10,false,true,true,0.709,0.291
241,189,52,18.538462,15.75,52,916,837,79,0,0,0,0,26,13,12,1.538462,1,0,15,11,false,true,true,0.952,0.048
70,56,14,23.333333,28,14,1203,1221,-18,0,0,0,0,84,3,2,0.416667,1,0,10,14,false,true,true,0.874,0.126
286,277,9,14.3,13.85,9,871,999,-128,0,0,0,0,-20,20,20,-2.4,0,0,10,8,false,true,true,0.903,0.097
357,301,56,18.789474,16.722222,56,1547,1439,108,1,0,0.052632,0,-19,19,18,-1.947368,0,0,4,3,true,true,true,1,0
350,333,17,25,23.785714,17,1554,1716,-162,1,1,0.071429,0.071429,-5,14,14,-7,0,0,9,4,false,true,true,0.998,0.002
281,196,85,23.416667,17.818182,85,596,595,1,1,0,0.083333,0,21,12,11,1.904762,0,0,7,12,false,true,true,0.999,0.001
28,62,-34,9.333333,20.666667,-34,941,926,15,0,0,0,0,78,3,3,0.487179,1,0,6,8,false,true,true,0.655,0.345
92,65,27,15.333333,13,27,498,43,455,0,0,0,0,64,6,5,0.578125,1,0,10,12,false,true,true,0.954,0.046
128,160,-32,16,20,-32,719,785,-66,0,1,0,0.125,45,8,8,0.8,0,0,10,18,false,true,false,0.048,0.952
124,85,39,24.8,17,39,1439,1397,42,0,1,0,0.2,62,5,5,0.548387,0,0,11,14,false,true,true,0.834,0.166
115,42,73,38.333333,21,73,908,1070,-162,1,0,0.333333,0,79,3,2,0.379747,1,0,9,8,false,true,true,0.702,0.298
119,104,15,23.8,26,15,1431,802,629,0,0,0,0,62,5,4,0.516129,0,0,14,12,false,true,true,0.998,0.002
360,309,51,27.692308,25.75,51,1793,1897,-104,2,0,0.153846,0,4,13,12,7.5,0,0,12,8,false,true,true,1,0
152,137,15,16.888889,17.125,15,500,567,-67,0,0,0,0,49,9,8,0.897959,0,0,9,24,false,true,false,0.274,0.726
228,199,29,20.727273,19.9,29,901,889,12,0,1,0,0.1,32,11,10,1.34375,0,0,16,9,false,true,true,0.872,0.128
245,122,123,27.222222,13.555556,123,1211,1173,38,0,0,0,0,42,9,9,0.833333,0,1,14,9,false,true,true,0.987,0.013
277,167,110,18.466667,11.133333,110,595,543,52,0,0,0,0,9,15,15,5.222222,0,1,14,11,false,true,true,1,0
197,172,25,28.142857,28.666667,25,1428,1452,-24,0,0,0,0,55,7,6,0.563636,0,1,12,12,false,true,false,0.386,0.614
297,224,73,18.5625,14,73,576,532,44,0,0,0,0,-1,16,16,-46,0,0,9,10,false,true,true,1,0
321,181,140,32.1,20.111111,140,1501,1622,-121,2,0,0.2,0,28,10,9,1.107143,0,0,14,9,false,true,true,1,0
192,106,86,24,15.142857,86,859,811,48,0,0,0,0,46,8,7,0.782609,0,1,21,10,false,true,true,0.951,0.049
164,79,85,32.8,19.75,85,746,796,-50,0,1,0,0.25,56,5,4,0.857143,0,0,10,11,false,true,true,0.97,0.03
187,225,-38,18.7,22.5,-38,947,810,137,0,1,0,0.1,32,10,10,1.3125,0,0,22,13,false,true,false,0.203,0.797
99,146,-47,19.8,29.2,-47,1501,1473,28,0,0,0,0,58,5,5,0.62069,0,0,19,23,false,true,false,0.201,0.799
200,221,-21,14.285714,17,-21,699,448,251,0,0,0,0,15,14,13,2.666667,0,0,16,11,false,true,false,0.204,0.796
212,189,23,23.555556,23.625,23,1431,802,629,0,0,0,0,32,9,8,1,0,0,9,14,false,true,true,0.998,0.002
170,78,92,34,19.5,92,1270,1322,-52,1,0,0.2,0,69,5,4,0.550725,0,0,19,12,false,true,true,0.965,0.035
246,224,22,18.923077,17.230769,22,885,719,166,0,0,0,0,14,13,13,2.714286,0,0,7,13,false,true,true,0.778,0.222
105,97,8,21,19.4,8,941,926,15,1,0,0.2,0,63,5,5,0.603175,0,0,20,7,false,true,true,0.701,0.299
261,204,57,20.076923,17,57,1548,1493,55,1,0,0.076923,0,14,13,12,2.928571,0,0,7,27,false,true,true,1,0
218,138,80,36.333333,23,80,1489,1405,84,1,0,0.166667,0,59,6,6,0.474576,1,0,10,8,false,true,true,0.995,0.005
276,299,-23,21.230769,24.916667,-23,1076,1176,-100,0,1,0,0.083333,8,13,12,4,0,0,18,10,false,true,false,0.139,0.861
61,50,11,20.333333,25,11,758,952,-194,0,0,0,0,77,3,2,0.519481,0,1,12,10,false,true,false,0.221,0.779
136,101,35,22.666667,20.2,35,1397,1195,202,0,0,0,0,57,6,5,0.614035,0,0,7,17,false,true,false,0.251,0.749
12,21,-9,12,21,-9,801,807,-6,0,0,0,0,93,1,1,0.376344,0,0,11,20,false,true,false,0.422,0.578
234,137,97,33.428571,22.833333,97,1762,1582,180,2,1,0.285714,0.166667,51,7,6,0.627451,0,0,7,12,false,true,true,0.972,0.028
310,309,1,20.666667,22.071429,1,1431,802,629,0,0,0,0,-11,15,14,-2.909091,0,0,2,4,false,true,true,0.999,0.001
107,53,54,26.75,17.666667,54,809,868,-59,1,0,0.25,0,73,4,3,0.438356,0,0,14,9,false,true,true,0.635,0.365
374,365,9,24.933333,24.333333,9,1670,1770,-100,1,1,0.066667,0.066667,-22,15,15,-1.454545,0,0,4,2,false,true,true,1,0
110,100,10,15.714286,16.666667,10,859,822,37,0,0,0,0,52,7,6,0.730769,0,0,20,7,false,true,true,0.683,0.317
186,146,40,23.25,18.25,40,1045,1009,36,1,0,0.125,0,44,8,8,0.863636,0,0,9,19,false,true,true,0.967,0.033
358,221,137,23.866667,15.785714,137,742,696,46,0,0,0,0,-11,15,14,-2.909091,0,0,6,4,false,true,true,1,0
22,0,22,22,0,22,1983,2020,-37,0,0,0,0,94,1,0,0.276596,0,0,8,0,false,true,true,0.678,0.322
85,136,-51,14.166667,27.2,-51,1077,1094,-17,0,0,0,0,62,6,5,0.677419,0,0,27,14,false,true,false,0.149,0.851
116,160,-44,29,40,-44,1265,1237,28,0,0,0,0,61,4,4,0.491803,0,0,13,8,false,true,false,0.26,0.74
14,0,14,14,0,14,971,761,210,0,0,0,0,96,1,0,0.3125,0,0,9,0,false,true,true,0.682,0.318
451,273,178,30.066667,19.5,178,1501,1622,-121,2,0,0.133333,0,-6,15,14,-5.166667,0,0,12,5,false,true,true,1,0
264,148,116,24,14.8,116,1014,1303,-289,1,0,0.090909,0,23,11,10,1.652174,0,1,19,13,false,true,true,0.947,0.053
294,264,30,17.294118,16.5,30,859,822,37,0,0,0,0,-7,17,16,-5.428571,2,0,7,8,false,true,true,1,0
209,158,51,26.125,19.75,51,1029,1227,-198,1,0,0.125,0,36,8,8,0.888889,1,0,15,17,false,true,true,0.792,0.208
217,234,-17,19.727273,23.4,-17,771,754,17,0,0,0,0,27,11,10,1.185185,0,1,11,16,false,true,false,0.003,0.997
168,84,84,28,16.8,84,1089,1063,26,1,0,0.166667,0,65,6,5,0.584615,0,0,20,19,false,true,true,0.97,0.03
313,259,54,14.904762,12.95,54,698,742,-44,1,0,0.047619,0,-15,21,20,-2.733333,0,0,1,3,true,true,true,1,0
94,70,24,18.8,17.5,24,1181,1149,32,0,0,0,0,76,5,4,0.592105,0,0,10,14,false,true,true,0.652,0.348
236,130,106,29.5,18.571429,106,1156,1114,42,1,0,0.125,0,36,8,7,0.888889,0,1,16,23,false,true,true,0.904,0.096
304,284,20,16,15.777778,20,628,658,-30,0,0,0,0,-6,19,18,-7.666667,0,0,8,12,false,true,true,0.952,0.048
344,267,77,26.461538,22.25,77,1210,1253,-43,0,1,0,0.083333,0,13,12,0,0,0,17,19,false,true,true,1,0
204,166,38,20.4,16.6,38,576,532,44,0,0,0,0,33,10,10,1.393939,0,0,15,7,false,true,true,0.97,0.03
92,71,21,23,17.75,21,1094,1030,64,0,0,0,0,72,4,4,0.5,0,0,9,8,false,true,true,0.723,0.277
402,318,84,40.2,31.8,84,1983,2020,-37,2,1,0.2,0.1,15,10,10,1.733333,0,0,11,13,false,true,true,1,0
119,101,18,19.833333,20.2,18,784,758,26,0,0,0,0,59,6,5,0.59322,0,0,7,10,false,true,true,0.682,0.318
188,233,-45,23.5,29.125,-45,1885,1846,39,1,1,0.125,0.125,29,8,8,1,1,0,18,8,false,true,false,0.268,0.732
359,231,128,22.4375,15.4,128,704,691,13,1,0,0.0625,0,-6,16,15,-6.333333,0,0,10,13,false,true,true,1,0
112,166,-54,22.4,33.2,-54,834,844,-10,0,1,0,0.2,58,5,5,0.62069,0,0,9,10,false,true,false,0.203,0.797
204,246,-42,20.4,27.333333,-42,1076,1176,-100,0,1,0,0.111111,30,10,9,1.066667,0,1,26,9,false,true,false,0.038,0.962
192,179,13,19.2,19.888889,13,518,448,70,0,0,0,0,35,10,9,0.971429,0,0,11,9,false,true,true,0.767,0.233
283,216,67,17.6875,14.4,67,758,750,8,0,0,0,0,-4,16,15,-9.25,0,1,15,7,false,true,true,0.985,0.015
72,63,9,14.4,15.75,9,971,761,210,0,0,0,0,67,5,4,0.447761,0,1,14,11,false,true,false,0.307,0.693
295,300,-5,19.666667,20,-5,1266,1247,19,0,0,0,0,-3,15,15,-10.666667,2,0,3,7,false,true,true,0.973,0.027
322,244,78,13.416667,10.166667,78,416,222,194,0,0,0,0,-35,24,24,-1.571429,0,0,7,5,false,true,true,1,0
215,205,10,14.333333,13.666667,10,1583,1422,161,0,0,0,0,31,15,15,1.645161,2,0,6,21,false,true,true,0.882,0.118
336,296,40,17.684211,16.444444,40,363,668,-305,0,0,0,0,-12,19,18,-3.583333,0,1,7,3,false,true,true,0.709,0.291
50,23,27,16.666667,11.5,27,960,1070,-110,0,0,0,0,81,3,2,0.432099,0,0,7,14,false,true,false,0.257,0.743
398,285,113,33.166667,23.75,113,1645,1777,-132,2,0,0.166667,0,-9,12,12,-2.777778,0,0,3,1,false,true,true,1,0
288,327,-39,22.153846,25.153846,-39,1127,1134,-7,0,1,0,0.076923,2,13,13,15,0,0,10,11,false,true,false,0.024,0.976
357,192,165,25.5,14.769231,165,954,1078,-124,1,1,0.071429,0.076923,5,14,13,7.6,0,0,11,15,false,true,true,1,0
331,156,175,36.777778,17.333333,175,820,783,37,1,0,0.111111,0,31,9,9,1.064516,0,0,14,12,false,true,true,1,0
359,305,54,27.615385,25.416667,54,1875,1793,82,2,1,0.153846,0.083333,6,13,12,5,0,0,9,13,false,true,true,1,0
129,43,86,32.25,10.75,86,976,965,11,0,0,0,0,69,4,4,0.463768,0,0,16,23,false,true,true,0.966,0.034
50,54,-4,12.5,13.5,-4,847,952,-105,0,0,0,0,78,4,4,0.461538,0,0,21,15,false,true,false,0.252,0.748
297,268,29,22.846154,22.333333,29,992,1100,-108,2,0,0.153846,0,11,13,12,3.090909,0,0,17,25,false,true,true,0.978,0.022
358,211,147,21.058824,12.411765,147,786,757,29,1,0,0.058824,0,-8,17,17,-4.875,0,0,25,14,false,true,true,1,0
380,282,98,25.333333,20.142857,98,1397,1361,36,1,0,0.066667,0,-10,15,14,-2.9,0,0,1,1,true,true,true,1,0
313,270,43,22.357143,20.769231,43,1344,1209,135,1,1,0.071429,0.076923,-2,14,13,-17,0,0,10,13,false,true,true,0.991,0.009
229,207,22,28.625,25.875,22,1428,1452,-24,0,1,0,0.125,42,8,8,0.738095,0,0,9,11,false,true,false,0.467,0.533
162,123,39,27,24.6,39,948,933,15,1,0,0.166667,0,62,6,5,0.612903,0,0,7,8,false,true,true,0.799,0.201
323,263,60,17,13.842105,60,1091,1078,13,0,0,0,0,-12,19,19,-3.583333,1,0,8,7,false,true,true,1,0
153,180,-27,15.3,18,-27,719,614,105,0,1,0,0.1,33,10,10,1.30303,0,0,18,11,false,true,false,0.241,0.759
123,84,39,24.6,16.8,39,526,370,156,0,0,0,0,65,5,5,0.538462,0,0,16,23,false,true,true,0.967,0.033
342,186,156,20.117647,11.625,156,1067,95,972,1,0,0.058824,0,-13,17,16,-2.615385,1,0,2,11,false,true,true,1,0
426,250,176,28.4,17.857143,176,971,621,350,2,0,0.133333,0,-17,15,14,-1.882353,0,0,1,16,false,true,true,1,0
162,70,92,40.5,23.333333,92,971,1180,-209,1,0,0.25,0,73,4,3,0.438356,0,0,7,7,false,true,true,0.801,0.199
50,62,-12,12.5,15.5,-12,1037,950,87,0,0,0,0,73,4,4,0.424658,1,0,8,11,false,true,true,0.652,0.348
199,100,99,28.428571,16.666667,99,1803,1552,251,1,0,0.142857,0,53,7,6,0.528302,1,1,12,6,false,true,true,0.972,0.028
59,31,28,19.666667,15.5,28,695,523,172,0,0,0,0,78,3,2,0.474359,0,1,14,6,false,true,true,0.757,0.243
140,73,67,20,12.166667,67,1277,1166,111,0,0,0,0,58,7,6,0.62069,0,2,7,8,false,true,true,0.96,0.04
261,212,49,16.3125,14.133333,49,416,306,110,0,0,0,0,7,16,15,6,1,0,8,9,false,true,true,0.959,0.041
367,271,96,24.466667,19.357143,96,1050,1144,-94,0,1,0,0.071429,-3,15,14,-12.666667,0,1,14,18,false,true,true,1,0
358,313,45,27.538462,24.076923,45,1762,1582,180,2,3,0.153846,0.230769,-2,13,13,-16,0,0,3,24,false,true,true,1,0
107,45,62,21.4,11.25,62,1055,1050,5,0,0,0,0,71,5,4,0.478873,0,0,10,7,false,true,true,0.845,0.155
31,38,-7,15.5,19,-7,1051,1030,21,0,0,0,0,85,2,2,0.352941,0,0,11,8,false,true,true,0.678,0.322
264,207,57,22,18.818182,57,820,822,-2,0,0,0,0,20,12,11,1.95,0,0,23,7,false,true,true,0.971,0.029
15,33,-18,7.5,16.5,-18,299,315,-16,0,0,0,0,88,2,2,0.477273,0,0,7,17,false,true,false,0.248,0.752
6,41,-35,3,20.5,-35,901,1159,-258,0,0,0,0,90,2,2,0.388889,0,0,10,12,false,true,false,0.249,0.751
111,68,43,22.2,13.6,43,771,754,17,0,0,0,0,65,5,5,0.492308,0,0,12,7,false,true,true,0.854,0.146
356,265,91,29.666667,22.083333,91,1245,1241,4,2,1,0.166667,0.083333,-3,12,12,-9.666667,0,0,7,8,false,true,true,1,0
378,353,25,25.2,23.533333,25,1075,1009,66,2,0,0.133333,0,-10,15,15,-3.2,0,0,1,2,false,true,true,1,0
101,132,-31,16.833333,22,-31,613,549,64,0,0,0,0,54,6,6,0.814815,0,0,18,18,false,true,false,0.228,0.772
85,74,11,21.25,18.5,11,691,473,218,0,0,0,0,69,4,4,0.521739,0,0,13,10,false,true,true,0.721,0.279
128,167,-39,21.333333,33.4,-39,1431,825,606,0,1,0,0.2,52,6,5,0.653846,1,0,18,15,false,true,true,1,0
356,268,88,19.777778,14.888889,88,527,503,24,0,0,0,0,-10,18,18,-4.1,0,0,6,4,false,true,true,1,0
231,116,115,21,11.6,115,595,543,52,0,0,0,0,36,11,10,1.305556,0,0,9,8,false,true,true,0.971,0.029
318,326,-8,24.461538,25.076923,-8,908,1070,-162,1,0,0.076923,0,2,13,13,15,0,0,8,7,false,true,false,0.363,0.637
325,269,56,16.25,13.45,56,566,542,24,0,0,0,0,-19,20,20,-2.157895,0,0,1,1,false,true,true,1,0
100,79,21,16.666667,15.8,21,371,435,-64,0,0,0,0,55,6,5,0.8,0,0,16,14,false,true,false,0.35,0.65
8,0,8,8,0,8,901,889,12,0,0,0,0,96,1,0,0.447917,0,0,17,0,false,true,true,0.659,0.341
17,12,5,8.5,12,5,1880,1777,103,0,0,0,0,94,2,1,0.297872,0,0,10,14,false,true,false,0.221,0.779
345,254,91,20.294118,14.941176,91,719,651,68,0,1,0,0.058824,0,17,17,0,0,0,10,11,false,true,true,1,0
278,226,52,21.384615,18.833333,52,1439,1294,145,1,0,0.076923,0,15,13,12,2.4,0,0,8,25,false,true,true,1,0
109,49,60,27.25,16.333333,60,904,668,236,0,0,0,0,72,4,3,0.472222,0,0,22,18,false,true,true,0.859,0.141
203,204,-1,18.454545,18.545455,-1,786,976,-190,0,0,0,0,28,11,11,1.142857,0,0,10,10,false,true,false,0.327,0.673
458,247,211,26.941176,15.4375,211,820,783,37,1,1,0.058824,0.0625,-19,17,16,-1.736842,0,0,3,1,true,true,true,1,0
386,278,108,20.315789,15.444444,108,704,691,13,1,0,0.052632,0,-23,19,18,-1.652174,0,0,2,2,false,true,true,1,0
293,292,1,19.533333,19.466667,1,758,952,-194,0,0,0,0,-8,15,15,-5,0,0,7,7,false,true,false,0.48,0.52
121,75,46,40.333333,25,46,1489,1555,-66,1,0,0.333333,0,71,3,3,0.408451,0,0,11,18,false,true,true,0.711,0.289
161,125,36,20.125,15.625,36,1055,1050,5,0,0,0,0,47,8,8,0.723404,0,0,13,18,false,true,true,0.869,0.131
449,279,170,29.933333,19.928571,170,1550,1624,-74,2,0,0.133333,0,-3,15,14,-10,1,0,4,3,false,true,true,1,0
306,252,54,18,15.75,54,450,412,38,0,0,0,0,-15,17,16,-2.533333,0,0,2,9,false,true,true,1,0
12,10,2,12,10,2,939,913,26,0,0,0,0,94,1,1,0.425532,0,0,16,7,false,true,true,0.679,0.321
371,252,119,23.1875,16.8,119,1651,1691,-40,1,0,0.0625,0,-10,16,15,-3.4,1,0,3,8,false,true,true,1,0
84,76,8,16.8,19,8,1606,1544,62,0,0,0,0,77,5,4,0.584416,1,0,11,7,false,true,true,0.88,0.12
244,142,102,40.666667,28.4,102,1203,1221,-18,2,0,0.333333,0,56,6,5,0.625,0,0,12,9,false,true,true,0.972,0.028
192,116,76,27.428571,19.333333,76,795,830,-35,1,1,0.142857,0.166667,47,7,6,0.893617,1,0,17,10,false,true,true,0.971,0.029
28,6,22,28,6,22,777,830,-53,0,0,0,0,91,1,1,0.450549,0,0,15,10,false,true,false,0.407,0.593
230,149,81,25.555556,16.555556,81,1550,1546,4,0,0,0,0,42,9,9,0.714286,1,0,10,12,false,true,true,0.995,0.005
172,124,48,24.571429,17.714286,48,1045,1009,36,1,0,0.142857,0,52,7,7,0.730769,0,1,7,18,false,true,true,0.776,0.224
34,8,26,17,8,26,310,359,-49,0,0,0,0,89,2,1,0.550562,0,0,10,16,false,true,false,0.274,0.726
223,192,31,11.736842,10.105263,31,416,222,194,0,0,0,0,-9,19,19,-6.111111,0,0,14,26,false,true,true,0.974,0.026
379,254,125,27.071429,19.538462,125,1691,1692,-1,0,0,0,0,3,14,13,10,1,0,2,8,false,true,true,1,0
191,190,1,15.916667,17.272727,1,272,238,34,0,0,0,0,21,12,11,1.904762,0,0,19,9,false,true,true,0.821,0.179
405,295,110,27,21.071429,110,1245,1241,4,2,1,0.133333,0.071429,-19,15,14,-1.526316,0,0,1,2,true,true,true,1,0
311,186,125,28.272727,18.6,125,986,856,130,1,0,0.090909,0,13,11,10,2.384615,0,0,18,13,false,true,true,1,0
199,119,80,22.111111,14.875,80,561,526,35,0,0,0,0,31,9,8,1.129032,0,0,13,10,false,true,true,0.97,0.03
373,311,62,20.722222,18.294118,62,1034,1040,-6,1,0,0.055556,0,-17,18,17,-2.058824,0,0,3,3,true,true,true,1,0
12,0,12,12,0,12,1093,1090,3,0,0,0,0,97,1,0,0.350515,0,0,11,0,false,true,true,0.669,0.331
112,106,6,16,17.666667,6,95,378,-283,0,0,0,0,54,7,6,0.648148,0,0,12,8,false,true,false,0.437,0.563
40,18,22,20,18,22,1550,1624,-74,0,0,0,0,88,2,1,0.340909,0,0,31,13,false,true,true,0.678,0.322
208,233,-25,17.333333,19.416667,-25,1547,1439,108,1,0,0.083333,0,20,12,12,1.85,0,0,26,18,false,true,false,0.19,0.81
119,129,-10,14.875,16.125,-10,523,480,43,1,0,0.125,0,44,8,8,0.75,0,0,13,9,false,true,true,0.776,0.224
129,103,26,25.8,25.75,26,1305,1242,63,1,0,0.2,0,67,5,4,0.507463,0,1,10,14,false,true,true,0.595,0.405
360,321,39,24,21.4,39,1439,1397,42,1,2,0.066667,0.133333,-11,15,15,-3.090909,0,0,3,15,false,true,true,1,0
78,70,8,19.5,23.333333,8,1606,1544,62,0,0,0,0,83,4,3,0.542169,1,0,7,9,false,true,true,0.884,0.116
55,39,16,13.75,13,16,856,897,-41,0,0,0,0,74,4,3,0.472973,1,0,11,9,false,true,true,0.657,0.343
200,87,113,25,10.875,113,942,1003,-61,0,0,0,0,40,8,8,1.125,0,1,22,15,false,true,true,0.985,0.015
364,260,104,18.2,13,104,539,632,-93,0,0,0,0,-14,20,20,-3.285714,0,0,7,6,false,true,true,1,0
196,180,16,16.333333,16.363636,16,371,435,-64,0,0,0,0,18,12,11,2.444444,0,0,16,7,false,true,true,0.776,0.224
318,243,75,21.2,17.357143,75,1452,1469,-17,1,1,0.066667,0.071429,-2,15,14,-19,0,0,8,27,false,true,true,1,0
193,254,-61,16.083333,21.166667,-61,1177,1214,-37,0,0,0,0,17,12,12,2.058824,1,1,15,8,false,true,false,0.026,0.974
282,181,101,28.2,20.111111,101,630,786,-156,1,0,0.1,0,32,10,9,1.09375,0,0,11,22,false,true,true,1,0
323,233,90,24.846154,17.923077,90,801,925,-124,1,0,0.076923,0,7,13,13,5,1,0,11,10,false,true,true,1,0
280,222,58,25.454545,22.2,58,1266,1144,122,0,0,0,0,24,11,10,1.416667,1,0,7,17,false,true,true,1,0
183,134,49,20.333333,16.75,49,1127,1176,-49,0,0,0,0,39,9,8,1.076923,0,0,9,12,false,true,true,0.831,0.169
266,198,68,17.733333,14.142857,68,363,668,-305,0,0,0,0,13,15,14,3.307692,0,1,20,11,false,true,true,0.924,0.076
183,143,40,18.3,15.888889,40,1159,1051,108,0,0,0,0,41,10,9,0.97561,0,0,12,10,false,true,true,0.562,0.438
228,178,50,19,16.181818,50,904,783,121,0,0,0,0,30,12,11,1.4,0,0,13,19,false,true,true,0.798,0.202
213,161,52,17.75,14.636364,52,1164,1201,-37,0,0,0,0,27,12,11,1.555556,0,1,18,16,false,true,true,0.881,0.119
217,185,32,14.466667,12.333333,32,1016,1037,-21,0,0,0,0,15,15,15,3.2,1,0,11,23,false,true,true,0.576,0.424
375,279,96,25,19.928571,96,1203,1221,-18,2,0,0.133333,0,3,15,14,11.666667,0,0,15,16,false,true,true,1,0
163,113,50,20.375,16.142857,50,1216,1228,-12,0,0,0,0,53,8,7,0.622642,0,0,16,11,false,true,true,0.834,0.166
268,189,79,19.142857,14.538462,79,1227,1060,167,0,1,0,0.076923,13,14,13,3.076923,0,0,15,16,false,true,true,0.933,0.067
63,68,-5,21,22.666667,-5,1170,1156,14,0,0,0,0,82,3,3,0.463415,1,0,6,15,false,true,true,0.719,0.281
119,92,27,23.8,18.4,27,1547,1439,108,1,0,0.2,0,65,5,5,0.569231,0,0,8,20,false,true,true,0.728,0.272
46,29,17,23,14.5,17,1513,1482,31,0,0,0,0,82,2,2,0.402439,1,0,9,25,false,true,true,0.913,0.087
307,212,95,30.7,21.2,95,1803,1552,251,1,1,0.1,0.1,23,10,10,1.217391,0,0,10,9,false,true,true,1,0
188,162,26,18.8,18,26,527,503,24,0,0,0,0,46,10,9,0.891304,0,0,20,10,false,true,true,0.799,0.201
100,94,6,25,31.333333,6,1075,1152,-77,0,0,0,0,72,4,3,0.555556,0,1,18,7,false,true,false,0.328,0.672
73,61,12,18.25,20.333333,12,908,859,49,0,0,0,0,73,4,3,0.534247,0,0,7,19,false,true,true,0.613,0.387
357,252,105,23.8,16.8,105,1651,1691,-40,1,0,0.066667,0,-7,15,15,-4.857143,1,0,6,8,false,true,true,1,0
269,190,79,17.933333,13.571429,79,1164,1201,-37,0,0,0,0,10,15,14,4.2,0,1,23,10,false,true,true,0.985,0.015
315,305,10,22.5,21.785714,10,1100,1008,92,1,0,0.071429,0,0,14,14,0,0,0,10,10,false,true,true,0.963,0.037
359,296,63,22.4375,19.733333,63,1034,1040,-6,1,0,0.0625,0,-7,16,15,-5,1,0,7,6,false,true,true,1,0
262,174,88,52.4,34.8,88,1348,1331,17,2,0,0.4,0,49,5,5,0.489796,0,0,19,10,false,true,true,1,0
351,334,17,19.5,18.555556,17,869,820,49,0,1,0,0.055556,-25,18,18,-1.48,0,0,1,2,false,true,true,1,0
22,33,-11,11,33,-11,1211,1173,38,0,0,0,0,88,2,1,0.397727,0,0,19,13,false,true,false,0.407,0.593
62,35,27,20.666667,17.5,27,711,876,-165,0,0,0,0,80,3,2,0.5375,0,0,7,23,false,true,false,0.253,0.747
334,287,47,19.647059,16.882353,47,1548,1493,55,1,0,0.058824,0,-11,17,17,-3.727273,0,0,5,7,false,true,true,1,0
162,85,77,23.142857,14.166667,77,576,532,44,0,0,0,0,56,7,6,0.821429,1,0,10,8,false,true,true,0.97,0.03
366,273,93,21.529412,16.058824,93,1216,1217,-1,1,0,0.058824,0,-16,17,17,-2.125,0,0,4,2,true,true,true,1,0
160,171,-11,20,21.375,-11,838,786,52,0,1,0,0.125,42,8,8,0.761905,1,0,10,7,false,true,true,0.841,0.159
189,110,79,21,13.75,79,939,913,26,0,0,0,0,51,9,8,0.784314,0,1,8,9,false,true,true,0.844,0.156
70,0,70,70,0,70,992,1100,-108,1,0,1,0,93,1,0,0.365591,1,0,8,0,false,true,true,0.774,0.226
208,133,75,29.714286,19,75,1109,1065,44,0,0,0,0,45,7,7,0.733333,0,1,10,10,false,true,true,0.854,0.146
413,331,82,18.772727,15.045455,82,995,912,83,2,0,0.090909,0,-20,22,22,-2.2,0,0,2,10,true,true,true,1,0
133,94,39,33.25,23.5,39,1493,1513,-20,1,0,0.25,0,69,4,4,0.478261,0,1,16,6,false,true,true,0.798,0.202
413,329,84,20.65,17.315789,84,995,912,83,2,0,0.1,0,-18,20,19,-2.444444,0,0,2,11,false,true,true,1,0
75,140,-65,15,35,-65,947,810,137,0,1,0,0.25,65,5,4,0.646154,0,1,16,12,false,true,false,0.053,0.947
198,201,-3,15.230769,16.75,-3,916,876,40,0,0,0,0,6,13,12,5.666667,2,0,17,18,false,true,true,0.903,0.097
201,156,45,22.333333,17.333333,45,691,675,16,0,0,0,0,36,9,9,1.027778,0,1,17,13,false,true,true,0.927,0.073
82,129,-47,10.25,16.125,-47,826,771,55,0,0,0,0,57,8,8,0.789474,0,0,14,11,false,true,false,0.088,0.912
16,12,4,8,12,4,561,526,35,0,0,0,0,88,2,1,0.397727,2,0,16,19,false,true,true,0.985,0.015
230,145,85,25.555556,18.125,85,976,965,11,1,0,0.111111,0,33,9,8,0.969697,0,1,12,21,false,true,true,0.85,0.15
15,12,3,7.5,12,3,299,315,-16,0,0,0,0,93,2,1,0.451613,0,1,7,10,false,true,false,0.248,0.752
344,258,86,20.235294,16.125,86,916,837,79,1,0,0.058824,0,-7,17,16,-5.714286,0,0,8,12,false,true,true,1,0
151,152,-1,16.777778,19,-1,628,658,-30,0,0,0,0,44,9,8,1.045455,0,1,19,6,false,true,false,0.228,0.772
77,56,21,19.25,18.666667,21,1277,1166,111,0,0,0,0,74,4,3,0.486486,0,2,11,9,false,true,true,0.647,0.353
378,332,46,25.2,23.714286,46,1075,1009,66,2,0,0.133333,0,-8,15,14,-4,0,0,1,6,false,true,true,1,0
288,265,23,18,17.666667,23,859,786,73,0,0,0,0,-3,16,15,-12.666667,0,0,11,12,false,true,true,0.744,0.256
228,170,58,28.5,24.285714,58,965,1013,-48,1,0,0.125,0,38,8,7,0.868421,0,1,10,11,false,true,false,0.19,0.81
103,88,15,25.75,29.333333,15,1431,802,629,0,0,0,0,68,4,3,0.470588,0,0,9,12,false,true,true,0.997,0.003
153,141,12,10.2,9.4,12,416,222,194,0,0,0,0,17,15,15,3.235294,1,0,10,29,false,true,true,0.82,0.18
345,260,85,19.166667,15.294118,85,1170,1156,14,1,0,0.055556,0,-21,18,17,-1.809524,0,0,1,4,false,true,true,1,0
177,177,0,29.5,35.4,0,2219,2029,190,0,0,0,0,47,6,5,0.553191,0,0,33,8,false,true,true,1,0
148,85,63,29.6,21.25,63,866,949,-83,0,0,0,0,67,5,4,0.597015,0,1,10,9,false,true,false,0.473,0.527
309,226,83,23.769231,18.833333,83,1216,1228,-12,1,0,0.076923,0,19,13,12,1.736842,0,0,13,13,false,true,true,1,0
69,28,41,23,14,41,871,867,4,0,0,0,0,81,3,2,0.530864,1,0,18,12,false,true,true,0.802,0.198
78,90,-12,26,30,-12,1333,1331,2,0,0,0,0,75,3,3,0.4,1,0,18,7,false,true,true,0.929,0.071
323,190,133,24.846154,14.615385,133,1482,1554,-72,1,0,0.076923,0,10,13,13,3.6,0,0,7,12,false,true,true,1,0
82,42,40,20.5,14,40,1216,1217,-1,0,0,0,0,76,4,3,0.447368,0,0,15,25,false,true,true,0.699,0.301
84,55,29,16.8,13.75,29,1159,1051,108,0,0,0,0,73,5,4,0.547945,0,0,18,17,false,true,true,0.657,0.343
182,133,49,20.222222,16.625,49,784,758,26,0,0,0,0,38,9,8,0.921053,0,1,12,9,false,true,true,0.849,0.151
173,92,81,28.833333,18.4,81,971,1180,-209,1,0,0.166667,0,65,6,5,0.492308,0,0,16,10,false,true,true,0.837,0.163
213,178,35,15.214286,12.714286,35,1029,1075,-46,0,0,0,0,24,14,14,2,2,0,6,20,false,true,true,0.696,0.304
322,315,7,20.125,19.6875,7,1710,1636,74,1,1,0.0625,0.0625,-6,16,16,-6,1,0,10,12,false,true,true,0.994,0.006
94,131,-37,23.5,43.666667,-37,834,844,-10,0,1,0,0.333333,68,4,3,0.529412,0,0,11,10,false,true,false,0.205,0.795
277,185,92,19.785714,13.214286,92,1295,1477,-182,2,0,0.142857,0,17,14,14,2.705882,0,0,16,14,false,true,true,1,0
365,212,153,26.071429,15.142857,153,778,758,20,0,1,0,0.071429,-2,14,14,-19.5,0,0,10,11,false,true,true,1,0
135,108,27,27,27,27,1333,1331,2,0,0,0,0,62,5,4,0.483871,1,0,8,14,false,true,true,0.92,0.08
286,320,-34,20.428571,22.857143,-34,971,761,210,0,0,0,0,-2,14,14,-15,0,0,7,11,false,true,false,0.001,0.999
257,240,17,17.133333,16,17,916,876,40,0,0,0,0,-10,15,15,-3.4,1,0,6,9,false,true,true,0.765,0.235
162,166,-4,27,27.666667,-4,1434,1493,-59,1,0,0.166667,0,45,6,6,0.822222,1,0,8,16,false,true,true,0.7,0.3
54,39,15,18,13,15,303,342,-39,0,0,0,0,83,3,3,0.457831,0,0,20,13,false,true,false,0.439,0.561
283,298,-15,21.769231,24.833333,-15,1539,1537,2,0,1,0,0.083333,12,13,12,2.666667,0,0,18,13,false,true,false,0.18,0.82
248,242,6,20.666667,22,6,1100,1008,92,1,0,0.083333,0,22,12,11,1.636364,0,0,18,10,false,true,true,0.512,0.488
171,174,-3,17.1,19.333333,-3,361,493,-132,0,0,0,0,32,10,9,1.28125,0,0,15,20,false,true,false,0.476,0.524
380,230,150,25.333333,15.333333,150,778,758,20,0,1,0,0.066667,-8,15,15,-4.875,0,0,8,10,false,true,true,1,0
265,213,52,26.5,23.666667,52,1297,1606,-309,1,0,0.1,0,29,10,9,1.034483,0,0,10,7,false,true,true,0.746,0.254
190,176,14,15.833333,14.666667,14,1029,1075,-46,0,0,0,0,31,12,12,1.548387,2,0,6,20,false,true,true,0.668,0.332
349,278,71,20.529412,17.375,71,948,933,15,1,0,0.058824,0,4,17,16,9.5,0,0,8,11,false,true,true,1,0
16,27,-11,8,13.5,-11,1507,1554,-47,0,0,0,0,89,2,2,0.325843,0,0,8,16,false,true,false,0.455,0.545
172,183,-11,14.333333,16.636364,-11,699,448,251,0,0,0,0,29,12,11,1.37931,0,0,12,8,false,true,false,0.21,0.79
175,81,94,29.166667,16.2,94,1439,1294,145,1,0,0.166667,0,59,6,5,0.610169,0,0,8,14,false,true,true,0.934,0.066
340,207,133,21.25,13.8,133,303,342,-39,0,0,0,0,3,16,15,12.666667,0,1,10,6,false,true,true,1,0
40,31,9,20,15.5,9,695,523,172,0,0,0,0,82,2,2,0.45122,0,1,11,6,false,true,true,0.721,0.279
96,101,-5,19.2,25.25,-5,1177,1214,-37,0,0,0,0,69,5,4,0.507246,0,0,26,12,false,true,true,0.648,0.352
351,343,8,17.55,17.15,8,1181,1149,32,0,1,0,0.05,-18,20,20,-2.5,0,0,8,3,false,true,true,0.994,0.006
288,141,147,41.142857,23.5,147,1571,1554,17,2,1,0.285714,0.166667,38,7,6,0.868421,0,0,28,8,false,true,true,1,0
414,282,132,18.818182,13.428571,132,942,1003,-61,0,0,0,0,-35,22,21,-1.285714,1,0,0,1,false,true,true,1,0
16,19,-3,16,19,-3,880,952,-72,0,0,0,0,93,1,1,0.376344,0,0,24,7,false,true,false,0.462,0.538
26,0,26,26,0,26,971,906,65,0,0,0,0,96,1,0,0.333333,0,0,10,0,false,true,true,0.691,0.309
364,171,193,33.090909,17.1,193,820,783,37,1,0,0.090909,0,23,11,10,1.434783,0,0,8,14,false,true,true,1,0
129,59,70,25.8,14.75,70,801,925,-124,1,0,0.2,0,61,5,4,0.57377,0,0,10,14,false,true,true,0.82,0.18
218,190,28,21.8,19,28,468,542,-74,0,0,0,0,35,10,10,1.114286,0,0,10,16,false,true,true,0.82,0.18
369,274,95,28.384615,21.076923,95,1004,840,164,1,0,0.076923,0,-5,13,13,-6,0,0,14,5,false,true,true,1,0
249,144,105,22.636364,14.4,105,1397,1422,-25,2,0,0.181818,0,38,11,10,0.947368,0,2,16,19,false,true,false,0.442,0.558
115,89,26,16.428571,14.833333,26,527,514,13,0,0,0,0,52,7,6,0.75,0,1,17,11,false,true,true,0.582,0.418
14,0,14,14,0,14,1530,1550,-20,0,0,0,0,96,1,0,0.354167,0,0,25,0,false,true,true,0.678,0.322
270,250,20,24.545455,22.727273,20,1554,1622,-68,2,0,0.181818,0,15,11,11,2.066667,1,0,10,7,false,true,true,0.943,0.057
421,306,115,35.083333,25.5,115,1489,1405,84,3,0,0.25,0,4,12,12,7,0,0,12,7,false,true,true,1,0
109,133,-24,21.8,26.6,-24,1670,1770,-100,1,1,0.2,0.2,62,5,5,0.516129,0,0,18,10,false,true,true,0.676,0.324
249,130,119,20.75,11.818182,119,595,543,52,0,0,0,0,29,12,11,1.62069,0,0,8,9,false,true,true,0.982,0.018
133,96,37,16.625,13.714286,37,1159,1051,108,0,0,0,0,56,8,7,0.714286,0,0,17,14,false,true,true,0.655,0.345
294,229,65,17.294118,13.470588,65,539,632,-93,0,0,0,0,2,17,17,23,0,0,10,10,false,true,true,1,0
179,169,10,14.916667,14.083333,10,539,632,-93,0,0,0,0,31,12,12,1.483871,0,0,10,7,false,true,true,0.795,0.205
22,13,9,22,13,9,838,786,52,0,0,0,0,91,1,1,0.351648,0,0,19,13,false,true,true,0.684,0.316
50,14,36,50,14,36,1127,1176,-49,0,0,0,0,91,1,1,0.461538,0,0,15,11,false,true,true,0.768,0.232
314,300,14,18.470588,17.647059,14,1181,1149,32,0,1,0,0.058824,1,17,17,45,1,0,13,7,false,true,true,0.872,0.128
348,147,201,38.666667,18.375,201,1550,1624,-74,1,0,0.111111,0,41,9,8,0.731707,0,1,9,15,false,true,true,1,0
120,166,-46,15,23.714286,-46,1897,1793,104,0,1,0,0.142857,63,8,7,0.507937,1,0,7,8,false,true,false,0.03,0.97
121,68,53,24.2,17,53,421,306,115,0,1,0,0.25,57,5,4,0.77193,0,0,10,13,false,true,true,0.972,0.028
159,117,42,22.714286,19.5,42,711,876,-165,0,0,0,0,54,7,6,0.796296,0,0,10,12,false,true,false,0.461,0.539
324,176,148,19.058824,10.352941,148,421,306,115,0,1,0,0.058824,-7,17,17,-6.285714,0,0,12,9,false,true,true,1,0
284,200,84,17.75,12.5,84,218,86,132,0,0,0,0,-11,16,16,-3.636364,0,0,19,7,false,true,true,1,0
175,163,12,21.875,20.375,12,941,926,15,1,0,0.125,0,43,8,8,0.883721,1,0,10,8,false,true,true,0.924,0.076
171,216,-45,13.153846,18,-45,628,658,-30,0,0,0,0,28,13,12,1.642857,0,0,16,11,false,true,false,0.023,0.977
38,42,-4,19,21,-4,826,771,55,0,0,0,0,86,2,2,0.523256,0,0,7,10,false,true,true,0.678,0.322
85,88,-3,17,22,-3,1482,1394,88,0,0,0,0,74,5,4,0.486486,1,0,6,20,false,true,false,0.429,0.571
86,122,-36,17.2,24.4,-36,1304,1040,264,0,0,0,0,66,5,5,0.5,1,0,6,14,false,true,false,0.236,0.764
73,38,35,18.25,9.5,35,1030,1045,-15,0,0,0,0,78,4,4,0.589744,0,0,10,10,false,true,true,0.813,0.187
311,273,38,34.555556,30.333333,38,1302,1349,-47,0,1,0,0.111111,24,9,9,1.166667,0,1,9,9,false,true,true,0.828,0.172
32,22,10,16,11,10,1277,1166,111,0,0,0,0,85,2,2,0.423529,0,0,20,14,false,true,true,0.682,0.318
215,194,21,26.875,27.714286,21,1096,1009,87,1,0,0.125,0,56,8,7,0.785714,0,1,11,12,false,true,false,0.03,0.97
83,82,1,16.6,16.4,1,540,518,22,0,0,0,0,69,5,5,0.57971,0,1,9,13,false,true,false,0.263,0.737
181,184,-3,25.857143,30.666667,-3,1428,1606,-178,1,0,0.142857,0,46,7,6,0.695652,1,0,18,9,false,true,false,0.218,0.782
194,177,17,16.166667,14.75,17,416,306,110,0,0,0,0,29,12,12,1.448276,0,0,14,11,false,true,true,0.865,0.135
455,363,92,41.363636,33,92,1885,1793,92,0,0,0,0,5,11,11,5.4,0,0,7,8,false,true,true,1,0
96,71,25,32,23.666667,25,1036,1181,-145,0,0,0,0,81,3,3,0.419753,0,1,17,6,false,true,false,0.301,0.699
141,102,39,23.5,17,39,885,719,166,0,0,0,0,64,6,6,0.59375,0,1,10,9,false,true,true,0.844,0.156
361,191,170,22.5625,12.733333,170,1033,1037,-4,0,1,0,0.066667,1,16,15,45,0,1,18,12,false,true,true,1,0
429,381,48,25.235294,23.8125,48,1030,1144,-114,0,2,0,0.125,-16,17,16,-2.1875,1,0,1,1,false,true,true,1,0
330,168,162,27.5,14,162,1413,1422,-9,0,0,0,0,21,12,12,2.714286,0,0,7,11,false,true,true,1,0
73,93,-20,24.333333,46.5,-20,1030,1144,-114,0,1,0,0.5,78,3,2,0.448718,0,0,12,14,false,true,false,0.233,0.767
356,350,6,29.666667,29.166667,6,1428,1452,-24,1,2,0.083333,0.166667,6,12,12,5.166667,0,0,9,17,false,true,true,0.999,0.001
375,304,71,26.785714,23.384615,71,1394,1424,-30,1,1,0.071429,0.076923,5,14,13,6.4,1,0,9,17,false,true,true,1,0
12,12,0,12,12,0,561,526,35,0,0,0,0,92,1,1,0.380435,2,0,16,19,false,true,true,0.986,0.014
247,211,36,17.642857,15.071429,36,916,837,79,0,0,0,0,14,14,14,2.857143,1,0,15,13,false,true,true,0.885,0.115
166,100,66,23.714286,14.285714,66,1439,1413,26,0,0,0,0,57,7,7,0.631579,0,0,20,11,false,true,true,0.86,0.14
195,191,4,17.727273,19.1,4,613,549,64,0,0,0,0,29,11,10,1.517241,0,1,14,10,false,true,false,0.13,0.87
262,174,88,21.833333,15.818182,88,526,370,156,0,0,0,0,17,12,11,2.058824,1,0,20,7,false,true,true,0.983,0.017
188,193,-5,12.533333,12.866667,-5,892,768,124,0,0,0,0,19,15,15,2.263158,0,0,13,12,false,true,true,0.568,0.432
232,220,12,25.777778,27.5,12,1102,1245,-143,1,0,0.111111,0,22,9,8,1.272727,0,0,14,12,false,true,false,0.43,0.57
310,202,108,25.833333,16.833333,108,1691,1692,-1,0,0,0,0,16,12,12,1.875,0,1,17,20,false,true,true,1,0
391,284,107,17.772727,12.909091,107,746,796,-50,0,1,0,0.045455,-30,22,22,-1.6,0,0,1,1,false,true,true,1,0
349,280,69,19.388889,16.470588,69,1045,1009,36,1,0,0.055556,0,-13,18,17,-2.923077,0,0,2,6,false,true,true,1,0
188,113,75,26.857143,18.833333,75,1331,1399,-68,0,0,0,0,51,7,6,0.686275,0,0,7,23,false,true,true,0.866,0.134
323,282,41,35.888889,31.333333,41,1890,2020,-130,1,2,0.111111,0.222222,17,9,9,1.705882,0,0,12,16,false,true,true,1,0
162,130,32,27,21.666667,32,907,752,155,0,0,0,0,60,6,6,0.55,0,0,11,12,false,true,true,0.832,0.168
353,305,48,32.090909,30.5,48,1935,2020,-85,0,1,0,0.1,13,11,10,2.384615,0,0,15,17,false,true,true,1,0
248,180,68,14.588235,11.25,68,947,909,38,0,0,0,0,-8,17,16,-5.75,0,0,8,32,false,true,true,1,0
40,40,0,20,20,0,1489,1445,44,0,0,0,0,84,2,2,0.380952,0,0,16,7,false,true,true,0.678,0.322
339,323,16,22.6,23.071429,16,1076,1176,-100,0,1,0,0.071429,-5,15,14,-6.4,0,0,2,6,false,true,true,0.782,0.218
248,298,-50,24.8,29.8,-50,1030,1144,-114,0,2,0,0.2,30,10,10,1.166667,0,0,13,9,false,true,false,0.074,0.926
277,269,8,18.466667,17.933333,8,1159,1051,108,0,0,0,0,4,15,15,10,0,0,10,10,false,true,true,0.637,0.363
40,57,-17,20,28.5,-17,1419,1488,-69,0,0,0,0,82,2,2,0.341463,0,0,8,13,false,true,true,0.661,0.339
51,48,3,10.2,12,3,450,412,38,0,0,0,0,70,5,4,0.542857,0,1,12,16,false,true,false,0.239,0.761
122,171,-49,24.4,34.2,-49,1489,1558,-69,0,1,0,0.2,62,5,5,0.451613,0,0,19,9,false,true,false,0.202,0.798
257,270,-13,18.357143,19.285714,-13,1078,1130,-52,0,1,0,0.071429,6,14,14,6.5,0,0,15,20,false,true,true,0.584,0.416
242,184,58,17.285714,14.153846,58,299,315,-16,0,0,0,0,7,14,13,6,0,0,11,18,false,true,true,0.921,0.079
80,41,39,26.666667,20.5,39,1645,1777,-132,1,0,0.333333,0,73,3,2,0.342466,1,0,18,10,false,true,true,0.836,0.164
148,130,18,16.444444,16.25,18,1181,1069,112,0,0,0,0,45,9,8,0.822222,1,0,22,7,false,true,true,0.728,0.272
18,4,14,18,4,14,1033,1037,-4,0,0,0,0,91,1,1,0.494505,0,0,7,7,false,true,true,0.683,0.317
350,318,32,20.588235,19.875,32,847,952,-105,0,0,0,0,-7,17,16,-5.142857,0,1,2,4,false,true,true,0.965,0.035
148,116,32,16.444444,12.888889,32,346,231,115,0,0,0,0,27,9,9,1.518519,0,0,13,11,false,true,true,0.968,0.032
206,154,52,25.75,22,52,1210,1252,-42,1,0,0.125,0,44,8,7,0.727273,0,0,11,20,false,true,true,0.945,0.055
194,175,19,13.857143,13.461538,19,1030,1045,-15,0,0,0,0,24,14,13,1.916667,0,1,8,10,false,true,false,0.252,0.748
79,49,30,11.285714,8.166667,30,310,359,-49,0,0,0,0,57,7,6,0.859649,1,0,7,21,false,true,true,0.677,0.323
109,63,46,27.25,15.75,46,904,668,236,0,0,0,0,68,4,4,0.5,0,0,22,19,false,true,true,0.867,0.133
219,197,22,21.9,19.7,22,901,1159,-258,2,0,0.2,0,29,10,10,1.206897,0,0,10,7,false,true,true,0.805,0.195
333,290,43,27.75,26.363636,43,1397,1195,202,1,0,0.083333,0,14,12,11,2.5,0,0,10,12,false,true,true,1,0
209,186,23,26.125,23.25,23,1489,1555,-66,1,0,0.125,0,38,8,8,0.763158,1,0,15,14,false,true,true,0.933,0.067
365,228,137,28.076923,19,137,1334,1256,78,2,0,0.153846,0,5,13,12,6.2,0,0,16,17,false,true,true,1,0
82,51,31,27.333333,17,31,704,691,13,0,0,0,0,78,3,3,0.487179,0,0,14,11,false,true,true,0.796,0.204
30,20,10,30,20,10,1266,1144,122,0,0,0,0,88,1,1,0.386364,0,1,12,9,false,true,true,0.686,0.314
286,256,30,14.3,13.473684,30,871,999,-128,0,0,0,0,-17,20,19,-2.823529,0,0,10,17,false,true,true,1,0
117,30,87,29.25,10,87,1004,653,351,0,0,0,0,68,4,3,0.514706,0,0,12,12,false,true,true,0.866,0.134
210,152,58,23.333333,16.888889,58,1439,1294,145,1,0,0.111111,0,37,9,9,0.972973,0,0,14,35,false,true,true,0.898,0.102
203,147,56,15.615385,12.25,56,777,830,-53,0,0,0,0,26,13,12,1.576923,0,0,14,12,false,true,true,0.861,0.139
108,126,-18,21.6,25.2,-18,290,416,-126,0,0,0,0,63,5,5,0.539683,0,0,18,14,false,true,false,0.181,0.819
218,99,119,36.333333,19.8,119,1489,1405,84,1,0,0.166667,0,64,6,5,0.4375,1,0,10,13,false,true,true,0.998,0.002
92,117,-25,15.333333,23.4,-25,1554,1622,-68,1,0,0.166667,0,58,6,5,0.534483,0,1,16,7,false,true,false,0.364,0.636
367,309,58,21.588235,18.176471,58,1210,1253,-43,0,1,0,0.058824,-25,17,17,-1.36,0,0,1,10,true,true,true,1,0
38,23,15,19,11.5,15,272,288,-16,0,0,0,0,85,2,2,0.611765,1,0,9,9,false,true,true,0.678,0.322
260,272,-12,26,27.2,-12,908,1070,-162,1,0,0.1,0,25,10,10,1.2,0,0,13,8,false,true,false,0.245,0.755
45,115,-70,15,38.333333,-70,1782,1512,270,0,1,0,0.333333,78,3,3,0.538462,1,0,7,7,false,true,true,0.674,0.326
318,262,56,13.826087,11.391304,56,584,565,19,0,0,0,0,-38,23,23,-1.210526,0,0,1,2,true,true,true,1,0
211,178,33,17.583333,14.833333,33,363,668,-305,0,0,0,0,27,12,12,1.592593,0,0,7,15,false,true,true,0.836,0.164
352,289,63,23.466667,20.642857,63,1434,1493,-59,1,0,0.066667,0,-6,15,14,-6.166667,0,1,6,3,false,true,true,1,0
276,217,59,19.714286,16.692308,59,1045,1009,36,1,0,0.071429,0,12,14,13,3.166667,1,0,16,16,false,true,true,0.999,0.001
304,230,74,20.266667,16.428571,74,830,907,-77,1,0,0.066667,0,5,15,14,7.8,0,0,18,7,false,true,true,0.994,0.006
186,134,52,26.571429,22.333333,52,306,169,137,0,0,0,0,48,7,6,0.708333,0,0,7,7,false,true,true,0.969,0.031
322,285,37,16.947368,15,37,1077,1094,-17,0,0,0,0,-13,19,19,-3.230769,1,0,6,6,false,true,true,1,0
107,109,-2,21.4,21.8,-2,1516,1397,119,0,1,0,0.2,62,5,5,0.532258,0,0,21,14,false,true,false,0.408,0.592
80,57,23,20,14.25,23,786,788,-2,0,0,0,0,66,4,4,0.515152,0,0,18,19,false,true,true,0.737,0.263
183,139,44,16.636364,13.9,44,947,909,38,0,0,0,0,31,11,10,1.483871,0,0,7,35,false,true,true,0.751,0.249
246,208,38,18.923077,17.333333,38,885,719,166,0,0,0,0,17,13,12,2.235294,0,0,7,12,false,true,true,0.774,0.226
312,259,53,28.363636,23.545455,53,1735,1770,-35,2,1,0.181818,0.090909,10,11,11,2.8,0,1,17,18,false,true,true,0.996,0.004
282,244,38,20.142857,18.769231,38,349,315,34,0,0,0,0,-6,14,13,-5.666667,0,0,8,15,false,true,true,0.953,0.047
311,293,18,22.214286,20.928571,18,1022,1095,-73,0,1,0,0.071429,-5,14,14,-6.6,0,0,12,9,false,true,true,0.822,0.178
34,72,-38,11.333333,24,-38,480,518,-38,0,0,0,0,84,3,3,0.547619,0,0,10,9,false,true,false,0.237,0.763
377,353,24,25.133333,25.214286,24,1397,1195,202,1,0,0.066667,0,-3,15,14,-11.666667,0,0,10,9,false,true,true,1,0
278,238,40,16.352941,14.875,40,272,238,34,0,1,0,0.0625,-17,17,16,-2.352941,0,1,18,9,false,true,true,0.948,0.052
354,247,107,22.125,15.4375,107,596,595,1,1,0,0.0625,0,-7,16,16,-5.714286,0,0,9,19,false,true,true,1,0
18,0,18,18,0,18,1237,1277,-40,0,0,0,0,95,1,0,0.305263,0,0,9,0,false,true,true,0.664,0.336
310,301,9,15.5,15.05,9,500,567,-67,0,0,0,0,-14,20,20,-3.142857,0,0,4,14,false,true,true,0.999,0.001
14,0,14,14,0,14,1029,1075,-46,0,0,0,0,96,1,0,0.5,0,0,20,0,false,true,true,0.518,0.482
272,251,21,17,15.6875,21,801,807,-6,0,0,0,0,-11,16,16,-3.181818,0,0,4,2,false,true,true,0.892,0.108
12,22,-10,12,22,-10,942,976,-34,0,0,0,0,92,1,1,0.434783,0,0,15,15,false,true,true,0.601,0.399
163,145,18,20.375,18.125,18,527,503,24,0,0,0,0,56,8,8,0.732143,0,0,12,13,false,true,true,0.78,0.22
248,188,60,14.588235,11.058824,60,947,909,38,0,0,0,0,-10,17,17,-4.6,0,0,8,34,false,true,true,1,0
18,0,18,18,0,18,892,788,104,0,0,0,0,97,1,0,0.443299,1,0,10,0,false,true,true,0.679,0.321
165,157,8,18.333333,19.625,8,1394,1230,164,0,1,0,0.125,39,9,8,0.974359,0,0,13,18,false,true,true,0.536,0.464
74,36,38,74,36,38,1493,1513,-20,1,0,1,0,89,1,1,0.370787,0,0,24,12,false,true,true,0.926,0.074
241,206,35,24.1,20.6,35,902,866,36,0,0,0,0,18,10,10,1.777778,0,0,21,7,false,true,true,0.96,0.04
210,174,36,15,12.428571,36,584,565,19,0,0,0,0,9,14,14,5.111111,0,0,14,17,false,true,true,0.923,0.077
372,231,141,18.6,12.157895,141,595,543,52,0,0,0,0,-19,20,19,-2.473684,0,0,9,7,false,true,true,1,0
166,156,10,20.75,19.5,10,315,294,21,0,1,0,0.125,34,8,8,1.029412,0,0,12,27,false,true,true,0.856,0.144
119,80,39,19.833333,16,39,1048,1000,48,0,0,0,0,63,6,5,0.634921,0,1,7,9,false,true,true,0.803,0.197
80,61,19,16,15.25,19,699,448,251,0,0,0,0,75,5,4,0.533333,0,0,18,7,false,true,true,0.713,0.287
187,272,-85,18.7,27.2,-85,1501,1473,28,0,0,0,0,26,10,10,1.384615,0,1,25,6,false,true,false,0.001,0.999
243,120,123,30.375,17.142857,123,769,527,242,1,0,0.125,0,39,8,7,0.923077,0,0,15,8,false,true,true,0.977,0.023
248,250,-2,27.555556,27.777778,-2,1428,1606,-178,1,0,0.111111,0,30,9,9,1.066667,1,0,18,9,false,true,true,0.675,0.325
59,50,9,19.666667,16.666667,9,1735,1770,-35,0,0,0,0,71,3,3,0.394366,0,0,7,10,false,true,true,0.678,0.322
177,123,54,16.090909,12.3,54,584,565,19,0,0,0,0,33,11,10,1.393939,0,0,7,9,false,true,true,0.968,0.032
318,263,55,31.8,26.3,55,1454,1531,-77,1,1,0.1,0.1,17,10,10,1.764706,0,0,10,9,false,true,true,1,0
343,295,48,19.055556,16.388889,48,880,952,-72,0,0,0,0,-19,18,18,-2.157895,0,0,3,3,false,true,true,1,0
24,12,12,24,12,12,539,500,39,0,0,0,0,91,1,1,0.43956,0,0,10,29,false,true,false,0.357,0.643
317,259,58,16.684211,14.388889,58,1221,1438,-217,0,0,0,0,-1,19,18,-45,0,1,15,7,false,true,true,0.765,0.235
231,206,25,21,18.727273,25,901,1159,-258,2,0,0.181818,0,22,11,11,1.590909,0,0,14,10,false,true,true,0.821,0.179
251,271,-20,22.818182,24.636364,-20,1539,1537,2,0,1,0,0.090909,22,11,11,1.454545,0,0,11,18,false,true,false,0.172,0.828
416,291,125,27.733333,20.785714,125,1023,1070,-47,2,0,0.133333,0,-9,15,14,-3.555556,0,0,1,12,false,true,true,1,0
54,28,26,27,28,26,290,416,-126,0,0,0,0,86,2,1,0.395349,0,0,11,16,false,true,false,0.184,0.816
85,54,31,17,13.5,31,698,742,-44,0,0,0,0,77,5,4,0.532468,0,0,19,12,false,true,false,0.328,0.672
233,170,63,21.181818,17,63,1394,1230,164,0,1,0,0.1,26,11,10,1.461538,0,1,7,18,false,true,false,0.392,0.608
80,24,56,80,24,56,971,621,350,1,0,1,0,89,1,1,0.359551,0,0,12,10,false,true,true,0.915,0.085
179,133,46,16.272727,13.3,46,363,668,-305,0,0,0,0,39,11,10,1.102564,0,0,10,13,false,true,true,0.834,0.166
102,53,49,17,10.6,49,1069,1040,29,0,0,0,0,61,6,5,0.721311,0,2,16,10,false,true,true,0.957,0.043
324,257,67,20.25,17.133333,67,904,783,121,0,0,0,0,3,16,15,14,1,0,12,8,false,true,true,1,0
48,77,-29,16,25.666667,-29,1177,1214,-37,0,0,0,0,77,3,3,0.454545,0,0,17,15,false,true,false,0.493,0.507
165,127,38,20.625,15.875,38,825,907,-82,1,0,0.125,0,45,8,8,0.888889,0,0,25,8,false,true,true,0.872,0.128
209,230,-21,17.416667,19.166667,-21,721,689,32,0,0,0,0,2,12,12,17,0,0,22,7,false,true,false,0.377,0.623
33,17,16,16.5,17,16,825,907,-82,0,0,0,0,87,2,1,0.45977,1,0,6,10,false,true,false,0.324,0.676
149,63,86,29.8,15.75,86,742,696,46,0,0,0,0,61,5,4,0.52459,0,1,16,11,false,true,true,0.85,0.15
362,378,-16,21.294118,22.235294,-16,834,844,-10,1,2,0.058824,0.117647,-18,17,17,-2,0,0,1,9,false,true,false,0,1
356,189,167,23.733333,13.5,167,1033,1037,-4,0,1,0,0.071429,5,15,14,9,0,1,14,9,false,true,true,1,0
10,11,-1,10,11,-1,1154,1062,92,0,0,0,0,96,1,1,0.364583,0,0,7,18,false,true,true,0.558,0.442
303,258,45,18.9375,16.125,45,1077,1094,-17,0,0,0,0,3,16,16,14,1,1,9,6,false,true,true,0.975,0.025
321,278,43,22.928571,19.857143,43,820,822,-2,0,0,0,0,6,14,14,6.5,0,0,16,7,false,true,true,0.996,0.004
108,56,52,27,14,52,1320,1339,-19,1,0,0.25,0,70,4,4,0.557143,0,0,9,8,false,true,true,0.84,0.16
366,249,117,21.529412,14.647059,117,596,595,1,1,0,0.058824,0,-13,17,17,-3.076923,0,0,5,18,false,true,true,1,0
315,264,51,18.529412,15.529412,51,1077,1094,-17,0,0,0,0,-3,17,17,-14,1,1,6,7,false,true,true,1,0
212,230,-18,15.142857,17.692308,-18,262,306,-44,0,0,0,0,16,14,13,2.875,0,0,10,11,false,true,false,0.166,0.834
132,158,-26,22,26.333333,-26,1431,802,629,0,0,0,0,49,6,6,0.653061,0,0,14,14,false,true,true,0.997,0.003
135,117,18,22.5,23.4,18,1266,1144,122,0,0,0,0,56,6,5,0.607143,1,0,11,12,false,true,true,0.873,0.127
356,307,49,18.736842,17.055556,49,1090,1244,-154,0,0,0,0,-22,19,18,-1.681818,0,0,2,1,true,true,true,1,0
233,243,-10,25.888889,27,-10,791,885,-94,1,1,0.111111,0.111111,32,9,9,1.1875,1,0,19,9,false,true,true,0.789,0.211
360,311,49,24,20.733333,49,1388,1506,-118,2,1,0.133333,0.066667,0,15,15,0,0,0,4,12,false,true,true,1,0
66,41,25,22,20.5,25,609,620,-11,0,0,0,0,80,3,2,0.4625,0,0,18,15,false,true,true,0.627,0.373
54,47,7,18,23.5,7,334,446,-112,0,0,0,0,84,3,2,0.47619,0,0,14,12,false,true,false,0.248,0.752
415,406,9,29.642857,31.230769,9,1897,1793,104,2,3,0.142857,0.230769,9,14,13,3.555556,0,0,10,9,false,true,true,1,0
42,7,35,21,7,35,1556,1591,-35,0,0,0,0,89,2,1,0.404494,0,0,29,16,false,true,true,0.685,0.315
51,57,-6,12.75,19,-6,758,750,8,0,0,0,0,70,4,3,0.528571,1,0,10,11,false,true,true,0.677,0.323
334,314,20,18.555556,17.444444,20,758,796,-38,0,0,0,0,-21,18,18,-1.809524,0,0,1,1,false,true,true,1,0
410,268,142,37.272727,24.363636,142,1824,1793,31,1,0,0.090909,0,12,11,11,2.333333,0,0,10,9,false,true,true,1,0
272,223,49,16,13.117647,49,892,768,124,0,0,0,0,7,17,17,6.142857,0,0,14,13,false,true,true,0.976,0.024
187,141,46,23.375,17.625,46,1489,1445,44,0,0,0,0,41,8,8,0.780488,0,1,14,19,false,true,true,0.71,0.29
323,270,53,17,14.210526,53,450,412,38,0,0,0,0,-27,19,19,-1.407407,0,0,1,3,true,true,true,1,0
314,309,5,14.272727,14.045455,5,576,494,82,0,0,0,0,-29,22,22,-1.517241,0,0,2,3,true,true,true,1,0
46,46,0,23,23,0,554,342,212,0,0,0,0,84,2,2,0.428571,0,0,13,10,false,true,true,0.683,0.317
239,199,40,26.555556,22.111111,40,834,758,76,0,1,0,0.111111,34,9,9,1.058824,0,0,7,12,false,true,true,0.959,0.041
233,218,15,13.705882,13.625,15,826,771,55,0,0,0,0,6,17,16,7.5,0,0,19,10,false,true,true,0.808,0.192
317,327,-10,22.642857,25.153846,-10,1127,1134,-7,0,1,0,0.076923,-1,14,13,-30,0,0,5,11,false,true,false,0.196,0.804
100,53,47,20,13.25,47,1305,1390,-85,0,0,0,0,71,5,4,0.507042,0,0,19,16,false,true,true,0.713,0.287
40,26,14,20,13,14,1439,1397,42,0,0,0,0,86,2,2,0.395349,0,0,17,11,false,true,true,0.683,0.317
375,338,37,20.833333,19.882353,37,1014,1303,-289,1,0,0.055556,0,-25,18,17,-1.52,0,0,1,4,false,true,true,1,0
374,247,127,17.809524,11.761905,127,595,543,52,0,0,0,0,-26,21,21,-1.807692,0,0,8,5,false,true,true,1,0
371,281,90,21.823529,17.5625,90,1065,1030,35,0,1,0,0.0625,-17,17,16,-2,0,0,2,3,false,true,true,1,0
32,22,10,16,22,10,778,758,20,0,0,0,0,87,2,1,0.448276,0,0,13,15,false,true,true,0.676,0.324
543,193,350,36.2,12.866667,350,1431,825,606,2,1,0.133333,0.066667,0,15,15,0,0,0,4,16,false,true,true,1,0
188,165,23,12.533333,11.785714,23,892,768,124,0,0,0,0,22,15,14,1.954545,0,0,13,21,false,true,true,0.774,0.226
107,110,-3,21.4,22,-3,871,999,-128,0,0,0,0,63,5,5,0.761905,1,0,9,7,false,true,false,0.268,0.732
231,168,63,17.769231,12.923077,63,498,43,455,0,0,0,0,11,13,13,3.363636,0,0,10,10,false,true,true,0.976,0.024
361,342,19,24.066667,22.8,19,1305,1242,63,2,1,0.133333,0.066667,-8,15,15,-4.25,0,0,5,4,false,true,true,1,0
105,114,-9,17.5,22.8,-9,316,306,10,0,2,0,0.4,59,6,5,0.644068,0,1,8,13,false,true,true,0.987,0.013
276,186,90,25.090909,18.6,90,1051,1030,21,0,0,0,0,20,11,10,1.5,1,0,8,7,false,true,true,0.999,0.001
354,314,40,22.125,19.625,40,960,1070,-110,1,0,0.0625,0,-10,16,16,-3.5,0,0,4,1,false,true,true,1,0
152,144,8,16.888889,16,8,580,620,-40,0,0,0,0,48,9,9,0.895833,1,1,8,7,false,true,false,0.059,0.941
245,243,2,14.411765,14.294118,2,480,518,-38,0,0,0,0,0,17,17,0,1,0,6,16,false,true,false,0.453,0.547
258,260,-2,15.176471,15.294118,-2,699,448,251,0,0,0,0,-2,17,17,-20,0,0,20,7,false,true,true,0.866,0.134
330,292,38,19.411765,17.176471,38,1270,1348,-78,0,0,0,0,-10,17,17,-3.8,0,0,4,14,false,true,true,1,0
251,177,74,27.888889,19.666667,74,1394,1118,276,0,1,0,0.111111,33,9,9,1.121212,0,0,11,15,false,true,true,1,0
82,62,20,20.5,20.666667,20,290,416,-126,0,0,0,0,74,4,3,0.459459,0,0,13,19,false,true,false,0.323,0.677
125,37,88,25,9.25,88,1144,1014,130,0,0,0,0,68,5,4,0.529412,1,0,16,14,false,true,true,0.983,0.017
147,163,-16,14.7,18.111111,-16,272,238,34,0,0,0,0,38,10,9,1.052632,0,0,14,9,false,true,false,0.116,0.884
215,121,94,23.888889,15.125,94,1216,1230,-14,1,0,0.111111,0,44,9,8,0.727273,1,0,15,9,false,true,true,0.97,0.03
401,203,198,30.846154,15.615385,198,918,619,299,2,0,0.153846,0,6,13,13,5.833333,1,0,19,11,false,true,true,1,0
152,178,-26,21.714286,25.428571,-26,1431,825,606,0,1,0,0.142857,46,7,7,0.73913,1,0,13,13,false,true,true,1,0
85,92,-7,17,23,-7,671,725,-54,0,0,0,0,68,5,4,0.544118,1,0,6,10,false,true,false,0.268,0.732
287,129,158,22.076923,10.75,158,1067,95,972,1,0,0.076923,0,17,13,12,2,1,0,13,10,false,true,true,1,0
109,79,30,21.8,15.8,30,904,783,121,0,0,0,0,66,5,5,0.636364,1,0,11,15,false,true,true,0.921,0.079
73,53,20,14.6,13.25,20,721,689,32,0,0,0,0,63,5,4,0.539683,0,0,14,21,false,true,true,0.682,0.318
318,296,22,21.2,19.733333,22,758,796,-38,0,0,0,0,-4,15,15,-9.5,0,0,4,9,false,true,true,0.979,0.021
374,351,23,22,20.647059,23,1154,1062,92,2,0,0.117647,0,-12,17,17,-2.916667,0,0,2,1,false,true,true,1,0
387,339,48,24.1875,21.1875,48,1203,1221,-18,2,0,0.125,0,-6,16,16,-5.833333,0,0,10,2,false,true,true,1,0
276,238,38,13.8,12.526316,38,947,909,38,0,0,0,0,-24,20,19,-1.916667,0,1,7,27,false,true,true,1,0
141,154,-13,28.2,30.8,-13,1434,1493,-59,1,0,0.2,0,51,5,5,0.72549,0,0,18,17,false,true,true,0.677,0.323
117,113,4,23.4,28.25,4,1636,1576,60,0,1,0,0.25,59,5,4,0.576271,0,1,10,13,false,true,false,0.198,0.802
166,146,20,20.75,20.857143,20,315,294,21,0,1,0,0.142857,37,8,7,0.945946,0,0,12,25,false,true,true,0.866,0.134
253,270,-17,19.461538,20.769231,-17,869,820,49,0,1,0,0.076923,11,13,13,3.363636,0,0,12,18,false,true,true,0.603,0.397
195,209,-14,17.727273,19,-14,613,549,64,0,0,0,0,25,11,11,1.76,0,0,14,10,false,true,false,0.316,0.684
368,291,77,18.4,14.55,77,939,913,26,0,1,0,0.05,-26,20,20,-1.538462,1,0,0,1,true,true,true,1,0
8,15,-7,8,15,-7,941,926,15,0,0,0,0,93,1,1,0.408602,1,0,7,16,false,true,true,0.669,0.331
137,116,21,22.833333,23.2,21,902,866,36,0,0,0,0,56,6,5,0.571429,0,0,10,7,false,true,true,0.685,0.315
328,293,35,16.4,14.65,35,334,446,-112,0,0,0,0,-34,20,20,-1.176471,0,0,2,3,true,true,true,1,0
360,360,0,22.5,22.5,0,809,868,-59,2,1,0.125,0.0625,-17,16,16,-1.882353,1,0,0,4,true,true,true,1,0
363,231,132,22.6875,14.4375,132,1482,1554,-72,1,0,0.0625,0,-8,16,16,-4.5,0,1,17,8,false,true,true,1,0
116,120,-4,19.333333,24,-4,869,820,49,0,1,0,0.2,65,6,5,0.569231,0,0,20,14,false,true,false,0.227,0.773
255,229,26,18.214286,16.357143,26,468,542,-74,0,0,0,0,8,14,14,4.875,1,0,22,10,false,true,true,0.973,0.027
8,15,-7,8,15,-7,1501,1622,-121,0,0,0,0,92,1,1,0.336957,0,0,22,19,false,true,false,0.358,0.642
319,305,14,18.764706,17.941176,14,786,847,-61,0,0,0,0,-11,17,17,-3.090909,0,0,2,4,true,true,true,0.998,0.002
333,286,47,17.526316,15.888889,47,1159,1051,108,0,0,0,0,-17,19,18,-2.352941,0,0,3,8,false,true,true,1,0
38,28,10,19,28,10,1482,1554,-72,0,0,0,0,91,2,1,0.395604,1,0,14,11,false,true,true,0.921,0.079
143,140,3,13,14,3,416,374,42,0,0,0,0,44,11,10,1.045455,1,0,18,10,false,true,true,0.565,0.435
80,46,34,20,15.333333,34,699,448,251,0,0,0,0,79,4,3,0.506329,0,0,7,7,false,true,true,0.792,0.208
59,76,-17,14.75,19,-17,954,1078,-124,0,1,0,0.25,67,4,4,0.567164,1,0,27,10,false,true,true,0.758,0.242
346,325,21,18.210526,17.105263,21,1181,1149,32,0,1,0,0.052632,-12,19,19,-3.75,0,0,12,6,false,true,true,0.998,0.002
179,116,63,29.833333,19.333333,63,795,830,-35,1,1,0.166667,0.166667,51,6,6,0.823529,1,0,16,10,false,true,true,0.971,0.029
68,0,68,68,0,68,1256,1232,24,1,0,1,0,93,1,0,0.322581,0,0,16,0,false,true,true,0.671,0.329
249,158,91,20.75,13.166667,91,1397,1422,-25,2,0,0.166667,0,33,12,12,1.090909,0,2,7,19,false,true,true,0.515,0.485
303,279,24,17.823529,17.4375,24,349,315,34,0,0,0,0,-26,17,16,-1.307692,0,0,1,4,false,true,true,0.944,0.056
138,121,17,17.25,15.125,17,1221,1438,-217,0,0,0,0,48,8,8,0.9375,0,2,10,5,false,true,true,0.87,0.13
408,264,144,20.4,13.894737,144,777,830,-53,1,0,0.05,0,-23,20,19,-1.782609,0,0,4,2,false,true,true,1,0
330,287,43,19.411765,17.9375,43,1270,1348,-78,0,0,0,0,-7,17,16,-5.428571,0,0,4,16,false,true,true,1,0
322,356,-34,32.2,35.6,-34,2219,2029,190,0,0,0,0,7,10,10,3.714286,0,0,12,17,false,true,true,1,0
246,175,71,24.6,19.444444,71,866,949,-83,0,0,0,0,34,10,9,1.176471,1,0,6,16,false,true,true,0.923,0.077
353,265,88,23.533333,17.666667,88,1073,1177,-104,1,0,0.066667,0,-11,15,15,-2.909091,0,0,2,1,false,true,true,1,0
112,126,-14,16,18,-14,95,378,-283,0,0,0,0,52,7,7,0.673077,0,0,12,10,false,true,false,0.451,0.549
35,45,-10,11.666667,15,-10,613,502,111,0,0,0,0,76,3,3,0.644737,0,0,9,19,false,true,true,0.57,0.43
325,269,56,15.47619,13.45,56,566,542,24,0,0,0,0,-19,21,20,-2.157895,0,0,1,1,true,true,true,1,0
292,305,-13,29.2,30.5,-13,1935,2020,-85,0,1,0,0.1,21,10,10,1.47619,1,0,8,17,false,true,true,0.612,0.388
196,172,24,28,24.571429,24,1344,1325,19,1,0,0.142857,0,44,7,7,0.704545,0,0,7,14,false,true,true,0.735,0.265
240,169,71,21.818182,15.363636,71,576,532,44,0,0,0,0,27,11,11,1.703704,0,0,13,7,false,true,true,0.97,0.03
183,175,8,26.142857,25,8,1793,1897,-104,1,0,0.142857,0,46,7,7,0.652174,0,0,12,7,false,true,true,0.679,0.321
301,256,45,23.153846,21.333333,45,758,796,-38,0,0,0,0,14,13,12,2.714286,0,0,9,8,false,true,true,0.931,0.069
230,239,-9,16.428571,17.071429,-9,658,817,-159,0,0,0,0,16,14,14,2.375,0,0,10,14,false,true,false,0.207,0.793
338,284,54,30.727273,25.818182,54,1454,1531,-77,1,1,0.090909,0.090909,12,11,11,2.5,0,0,8,17,false,true,true,1,0
302,176,126,20.133333,11.733333,126,421,306,115,0,1,0,0.066667,-2,15,15,-22,0,0,17,9,false,true,true,1,0
167,106,61,23.857143,17.666667,61,1127,1075,52,1,0,0.142857,0,51,7,6,0.607843,0,1,13,21,false,true,true,0.845,0.155
38,35,3,19,17.5,3,1482,1554,-72,0,0,0,0,88,2,2,0.409091,1,0,14,11,false,true,true,0.891,0.109
22,26,-4,22,26,-4,1181,1149,32,0,0,0,0,92,1,1,0.48913,0,0,7,15,false,true,true,0.674,0.326
0,16,-16,0,16,-16,523,480,43,0,0,0,0,97,1,1,0.340206,0,0,7,10,false,true,false,0.331,0.669
312,257,55,24,19.769231,55,1014,1303,-289,1,0,0.076923,0,6,13,13,6.333333,0,0,10,11,false,true,true,1,0
204,191,13,22.666667,21.222222,13,1782,1512,270,1,1,0.111111,0.111111,42,9,9,1,0,0,11,10,false,true,true,1,0
274,114,160,39.142857,19,160,1093,1197,-104,2,0,0.285714,0,51,7,6,0.607843,0,0,10,20,false,true,true,1,0
65,87,-22,10.833333,17.4,-22,450,412,38,0,0,0,0,62,6,5,0.612903,1,0,8,10,false,true,true,0.594,0.406
47,18,29,23.5,18,29,1394,1118,276,0,0,0,0,86,2,1,0.430233,0,0,10,12,false,true,true,0.709,0.291
303,199,104,30.3,19.9,104,1334,1256,78,2,0,0.2,0,24,10,10,1.291667,0,0,10,12,false,true,true,1,0
451,344,107,34.692308,28.666667,107,1983,2020,-37,2,1,0.153846,0.083333,-1,13,12,-26,0,0,3,12,false,true,true,1,0
174,154,20,15.818182,14,20,859,822,37,0,0,0,0,25,11,11,1.52,0,0,16,21,false,true,true,0.742,0.258
190,230,-40,21.111111,28.75,-40,1076,1176,-100,0,1,0,0.125,37,9,8,0.864865,0,1,26,12,false,true,false,0.039,0.961
47,19,28,23.5,9.5,28,872,818,54,0,0,0,0,84,2,2,0.488095,0,1,11,12,false,true,true,0.796,0.204
33,42,-9,16.5,21,-9,825,907,-82,0,0,0,0,85,2,2,0.470588,1,0,6,7,false,true,false,0.334,0.666
165,159,6,20.625,22.714286,6,518,448,70,0,0,0,0,48,8,7,0.708333,0,0,15,9,false,true,true,0.678,0.322
214,209,5,17.833333,17.416667,5,1127,1176,-49,0,0,0,0,22,12,12,1.909091,0,1,21,15,false,true,false,0.379,0.621
22,0,22,22,0,22,1419,1488,-69,0,0,0,0,95,1,0,0.294737,0,0,12,0,false,true,true,0.669,0.331
72,47,25,24,15.666667,25,1216,1228,-12,0,0,0,0,79,3,3,0.417722,0,0,7,17,false,true,true,0.7,0.3
300,275,25,17.647059,17.1875,25,1159,1051,108,0,0,0,0,-5,17,16,-8,1,0,5,13,false,true,true,1,0
321,270,51,22.928571,19.285714,51,960,1070,-110,1,0,0.071429,0,6,14,14,5.833333,0,1,13,12,false,true,true,0.99,0.01
171,166,5,24.428571,23.714286,5,1334,1477,-143,0,1,0,0.142857,50,7,7,0.6,0,0,12,9,false,true,true,0.66,0.34
236,164,72,19.666667,14.909091,72,1221,1438,-217,0,0,0,0,33,12,11,1.363636,0,1,10,16,false,true,true,0.918,0.082
272,221,51,30.222222,27.625,51,1633,1580,53,2,0,0.222222,0,33,9,8,0.848485,0,0,8,18,false,true,true,0.999,0.001
275,221,54,27.5,22.1,54,1556,1591,-35,1,0,0.1,0,26,10,10,1.384615,0,0,12,10,false,true,true,0.98,0.02
30,24,6,30,24,6,864,808,56,0,0,0,0,89,1,1,0.382022,0,0,7,20,false,true,true,0.679,0.321
262,149,113,37.428571,24.833333,113,1507,1554,-47,1,1,0.142857,0.166667,41,7,6,0.707317,0,0,13,10,false,true,true,0.993,0.007
370,279,91,26.428571,19.928571,91,1556,1591,-35,1,0,0.071429,0,-2,14,14,-18,0,0,7,5,false,true,true,1,0
145,113,32,16.111111,14.125,32,777,830,-53,0,0,0,0,45,9,8,0.911111,0,0,14,17,false,true,true,0.536,0.464
312,230,82,19.5,15.333333,82,830,907,-77,1,0,0.0625,0,2,16,15,19.5,0,1,18,6,false,true,true,0.992,0.008
270,188,82,20.769231,15.666667,82,561,526,35,0,0,0,0,5,13,12,7,0,0,13,11,false,true,true,0.984,0.016
359,299,60,19.944444,16.611111,60,1551,1550,1,0,0,0,0,-22,18,18,-1.909091,0,1,5,3,false,true,true,1,0
337,309,28,16.047619,15.45,28,719,614,105,0,1,0,0.05,-30,21,20,-1.433333,0,0,2,2,false,true,true,0.999,0.001
179,70,109,29.833333,11.666667,109,942,1003,-61,0,0,0,0,55,6,6,0.818182,0,0,20,16,false,true,true,0.97,0.03
177,168,9,25.285714,28,9,1030,1144,-114,0,1,0,0.166667,51,7,6,0.686275,0,1,24,10,false,true,false,0.351,0.649
280,213,67,31.111111,23.666667,67,1148,1164,-16,1,1,0.111111,0.111111,22,9,9,1.136364,0,0,9,9,false,true,true,0.981,0.019
312,166,146,28.363636,15.090909,146,1482,1554,-72,1,0,0.090909,0,22,11,11,1.636364,0,0,7,11,false,true,true,1,0
245,178,67,22.272727,17.8,67,1069,917,152,0,1,0,0.1,29,11,10,1.172414,0,0,12,19,false,true,true,0.807,0.193
24,17,7,24,17,7,1127,1134,-7,0,0,0,0,93,1,1,0.322581,0,0,17,8,false,true,true,0.68,0.32
32,22,10,10.666667,11,10,613,461,152,0,0,0,0,82,3,2,0.45122,1,0,15,20,false,true,true,0.816,0.184
371,347,24,23.1875,21.6875,24,1154,1062,92,2,0,0.125,0,-7,16,16,-5,0,0,3,1,false,true,true,1,0
257,183,74,25.7,20.333333,74,880,952,-72,0,0,0,0,35,10,9,1,0,0,19,12,false,true,true,0.946,0.054
78,65,13,15.6,13,13,346,231,115,0,0,0,0,60,5,5,0.683333,0,0,9,12,false,true,true,0.792,0.208
349,278,71,17.45,14.631579,71,1253,1166,87,1,0,0.05,0,-17,20,19,-2.529412,0,0,3,7,false,true,true,1,0
315,287,28,31.5,28.7,28,1875,1793,82,2,1,0.2,0.1,20,10,10,1.5,0,0,10,9,false,true,true,0.995,0.005
334,291,43,30.363636,26.454545,43,1333,1331,2,1,0,0.090909,0,4,11,11,7.5,0,0,11,12,false,true,true,1,0
335,336,-1,25.769231,25.846154,-1,1297,1606,-309,1,1,0.076923,0.076923,-1,13,13,-30,0,0,7,8,false,true,true,0.661,0.339
134,187,-53,26.8,37.4,-53,1419,1488,-69,0,1,0,0.2,51,5,5,0.54902,0,0,18,13,false,true,false,0.202,0.798
236,179,57,19.666667,14.916667,57,1221,1438,-217,0,0,0,0,30,12,12,1.5,0,1,10,15,false,true,true,0.918,0.082
79,59,20,26.333333,19.666667,20,1302,1082,220,0,0,0,0,74,3,3,0.405405,0,0,10,10,false,true,true,0.704,0.296
67,127,-60,16.75,42.333333,-60,1554,1716,-162,0,1,0,0.333333,70,4,3,0.5,1,1,7,9,false,true,false,0.48,0.52
297,210,87,21.214286,16.153846,87,527,503,24,0,0,0,0,18,14,13,2.277778,0,0,7,8,false,true,true,0.999,0.001
34,36,-2,17,18,-2,272,238,34,0,0,0,0,83,2,2,0.481928,1,0,7,20,false,true,true,0.741,0.259
65,26,39,21.666667,13,39,1181,1149,32,0,0,0,0,85,3,2,0.529412,0,0,10,17,false,true,true,0.708,0.292
130,111,19,21.666667,22.2,19,1826,1656,170,0,0,0,0,56,6,5,0.482143,0,0,7,17,false,true,false,0.262,0.738
66,58,8,33,29,8,1364,1093,271,0,0,0,0,83,2,2,0.457831,0,0,12,9,false,true,true,0.676,0.324
337,302,35,18.722222,16.777778,35,658,817,-159,0,0,0,0,-11,18,18,-3.454545,0,0,2,5,false,true,true,1,0
202,104,98,22.444444,13,98,1586,1782,-196,0,0,0,0,43,9,8,0.930233,1,0,9,7,false,true,true,0.968,0.032
302,283,19,20.133333,20.214286,19,1439,1294,145,1,0,0.066667,0,-2,15,14,-18,1,0,7,26,false,true,true,1,0
247,197,50,17.642857,15.153846,50,416,306,110,0,0,0,0,18,14,13,2.333333,0,0,10,10,false,true,true,0.911,0.089
82,91,-9,20.5,22.75,-9,2219,2029,190,0,0,0,0,67,4,4,0.38806,1,0,11,9,false,true,true,0.5,0.5
20,0,20,20,0,20,1439,1353,86,0,0,0,0,95,1,0,0.315789,1,0,8,0,false,true,true,0.826,0.174
292,256,36,24.333333,23.272727,36,1434,1493,-59,1,0,0.083333,0,11,12,11,3.363636,0,1,13,6,false,true,true,0.869,0.131
299,185,114,27.181818,18.5,114,1029,1227,-198,1,0,0.090909,0,13,11,10,2.461538,0,0,10,14,false,true,true,1,0
25,24,1,12.5,24,1,1177,1214,-37,0,0,0,0,88,2,1,0.397727,0,0,8,12,false,true,true,0.668,0.332
87,65,22,21.75,21.666667,22,1148,1164,-16,0,0,0,0,73,4,3,0.342466,1,0,13,8,false,true,true,0.727,0.273
346,242,104,28.833333,22,104,1004,840,164,1,0,0.083333,0,3,12,11,10,0,0,23,13,false,true,true,1,0
267,300,-33,15.705882,18.75,-33,999,1011,-12,0,0,0,0,-7,17,16,-6.571429,1,0,11,7,false,true,false,0.386,0.614
46,13,33,23,13,33,916,837,79,0,0,0,0,89,2,1,0.449438,0,0,7,12,false,true,true,0.7,0.3
151,187,-36,15.1,18.7,-36,1176,1127,49,0,0,0,0,32,10,10,1.15625,0,0,14,16,false,true,false,0.2,0.8
49,37,12,24.5,18.5,12,739,480,259,0,0,0,0,84,2,2,0.428571,0,0,11,16,false,true,true,0.696,0.304
358,270,88,17.047619,13.5,88,711,876,-165,0,0,0,0,-16,21,20,-2.6875,0,0,3,1,false,true,true,1,0
170,66,104,42.5,22,104,1054,917,137,0,0,0,0,67,4,3,0.522388,0,0,7,12,false,true,true,0.884,0.116
18,0,18,18,0,18,1078,1130,-52,0,0,0,0,95,1,0,0.410526,0,0,24,0,false,true,true,0.627,0.373
40,42,-2,13.333333,14,-2,1210,1253,-43,0,0,0,0,78,3,3,0.435897,1,1,7,8,false,true,true,0.602,0.398
159,87,72,31.8,21.75,72,1256,1232,24,1,0,0.2,0,64,5,4,0.46875,0,1,10,11,false,true,true,0.846,0.154
79,45,34,26.333333,22.5,34,1302,1082,220,0,0,0,0,77,3,2,0.38961,0,0,10,13,false,true,true,0.686,0.314
187,77,110,37.4,19.25,110,1510,1583,-73,1,0,0.2,0,60,5,4,0.533333,0,1,17,6,false,true,true,0.849,0.151
8,3,5,8,3,5,1394,1230,164,0,0,0,0,93,1,1,0.408602,0,0,13,8,false,true,true,0.677,0.323
270,206,64,22.5,18.727273,64,866,949,-83,0,0,0,0,19,12,11,2.105263,1,0,8,14,false,true,true,0.986,0.014
157,129,28,17.444444,16.125,28,786,847,-61,0,0,0,0,47,9,8,0.723404,1,0,14,9,false,true,true,0.729,0.271
42,82,-40,10.5,27.333333,-40,1161,1166,-5,0,0,0,0,76,4,3,0.460526,0,0,7,8,false,true,false,0.204,0.796
180,173,7,20,21.625,7,1364,1093,271,0,1,0,0.125,43,9,8,0.883721,0,0,10,14,false,true,true,1,0
316,223,93,31.6,22.3,93,1334,1477,-143,2,1,0.2,0.1,17,10,10,1.764706,0,0,9,10,false,true,true,1,0
271,259,12,20.846154,19.923077,12,1277,1166,111,0,1,0,0.076923,8,13,13,4.5,0,0,17,18,false,true,true,0.754,0.246
22,0,22,22,0,22,1550,1624,-74,0,0,0,0,95,1,0,0.315789,0,0,28,0,false,true,true,0.679,0.321
198,105,93,22,13.125,93,1253,1166,87,1,0,0.111111,0,49,9,8,0.877551,0,0,12,26,false,true,true,0.971,0.029
56,70,-14,18.666667,23.333333,-14,1606,1544,62,0,0,0,0,85,3,3,0.529412,1,0,14,9,false,true,true,0.897,0.103
69,43,26,11.5,8.6,26,310,359,-49,0,0,0,0,65,6,5,0.753846,1,0,9,22,false,true,true,0.666,0.334
162,101,61,27,20.2,61,907,752,155,0,0,0,0,65,6,5,0.507692,0,0,11,12,false,true,true,0.899,0.101
410,323,87,27.333333,23.071429,87,1394,1424,-30,1,1,0.066667,0.071429,-3,15,14,-10.666667,0,0,1,8,false,true,true,1,0
413,323,90,21.736842,17.944444,90,1227,1060,167,0,2,0,0.111111,-27,19,18,-1.481481,0,0,1,5,false,true,true,1,0
106,67,39,21.2,13.4,39,1397,1422,-25,1,0,0.2,0,68,5,5,0.529412,0,1,10,11,false,true,true,0.708,0.292
291,192,99,36.375,27.428571,99,1197,1127,70,0,0,0,0,37,8,7,0.810811,0,0,9,17,false,true,true,1,0
199,89,110,33.166667,14.833333,110,996,1063,-67,1,1,0.166667,0.166667,49,6,6,0.653061,0,1,18,11,false,true,true,0.856,0.144
170,165,5,18.888889,18.333333,5,921,1072,-151,1,0,0.111111,0,43,9,9,0.883721,0,0,9,7,false,true,false,0.393,0.607
52,44,8,17.333333,14.666667,8,1439,1413,26,0,0,0,0,81,3,3,0.444444,0,0,15,8,false,true,true,0.681,0.319
15,18,-3,7.5,18,-3,95,378,-283,0,0,0,0,90,2,1,0.388889,0,0,10,14,false,true,false,0.247,0.753
60,34,26,20,17,26,1075,989,86,0,0,0,0,82,3,2,0.47561,0,0,26,7,false,true,true,0.694,0.306
374,347,27,22,21.6875,27,1154,1062,92,2,0,0.117647,0,-10,17,16,-3.5,0,0,2,1,false,true,true,1,0
125,83,42,20.833333,13.833333,42,834,758,76,0,0,0,0,60,6,6,0.6,0,1,20,10,false,true,true,0.848,0.152
249,134,115,24.9,14.888889,115,1014,1303,-289,1,0,0.1,0,30,10,9,1.266667,0,1,8,19,false,true,true,0.95,0.05
249,297,-48,20.75,27,-48,1501,1473,28,0,0,0,0,17,12,11,2.117647,0,1,10,6,false,true,false,0.007,0.993
14,0,14,14,0,14,801,925,-124,0,0,0,0,95,1,0,0.368421,0,0,10,0,false,true,false,0.252,0.748
238,170,68,26.444444,18.888889,68,1826,1803,23,1,0,0.111111,0,33,9,9,0.909091,1,0,9,7,false,true,true,0.99,0.01
203,228,-25,22.555556,25.333333,-25,1439,1397,42,0,2,0,0.222222,25,9,9,1.36,2,0,8,10,false,true,true,0.892,0.108
89,63,26,17.8,12.6,26,1091,1078,13,0,0,0,0,69,5,5,0.623188,0,0,16,20,false,true,true,0.759,0.241
359,273,86,19.944444,16.058824,86,527,581,-54,0,0,0,0,-19,18,17,-2.210526,0,0,4,7,false,true,true,1,0
224,177,47,18.666667,16.090909,47,916,837,79,0,0,0,0,33,12,11,1.212121,1,0,6,13,false,true,true,0.868,0.132
385,360,25,32.083333,30,25,1890,2020,-130,1,2,0.083333,0.166667,-5,12,12,-5.8,0,0,9,3,false,true,true,1,0
39,47,-8,9.75,11.75,-8,299,315,-16,0,0,0,0,75,4,4,0.56,0,0,10,24,false,true,false,0.263,0.737
188,89,99,37.6,22.25,99,971,621,350,2,0,0.4,0,60,5,4,0.533333,0,0,10,17,false,true,true,0.97,0.03
159,71,88,19.875,8.875,88,1067,95,972,0,0,0,0,56,8,8,0.607143,0,0,13,10,false,true,true,1,0
163,146,17,27.166667,29.2,17,1030,1144,-114,0,1,0,0.2,61,6,5,0.57377,0,0,24,7,false,true,true,0.687,0.313
40,35,5,20,17.5,5,500,567,-67,0,0,0,0,87,2,2,0.505747,0,0,12,16,false,true,false,0.254,0.746
354,300,54,22.125,20,54,960,1070,-110,1,0,0.0625,0,-7,16,15,-5,0,0,4,4,false,true,true,1,0
45,32,13,22.5,32,13,334,446,-112,0,0,0,0,91,2,1,0.43956,0,0,12,11,false,true,false,0.06,0.94
410,379,31,24.117647,23.6875,31,1266,1144,122,0,0,0,0,-21,17,16,-1.619048,0,0,4,4,false,true,true,1,0
397,313,84,28.357143,22.357143,84,1349,1302,47,0,0,0,0,-10,14,14,-2.9,0,0,11,2,false,true,true,1,0
334,316,18,14.521739,13.73913,18,1030,1045,-15,1,1,0.043478,0.043478,-35,23,23,-1.314286,0,0,1,4,true,true,true,1,0
161,97,64,23,16.166667,64,941,926,15,1,0,0.142857,0,59,7,6,0.644068,0,0,13,14,false,true,true,0.966,0.034
238,132,106,23.8,14.666667,106,1439,1413,26,0,0,0,0,42,10,9,0.857143,1,0,16,10,false,true,true,0.992,0.008
432,342,90,24,20.117647,90,1397,1422,-25,4,1,0.222222,0.058824,-12,18,17,-3,0,0,8,14,false,true,true,1,0
372,319,53,19.578947,16.789474,53,580,620,-40,1,0,0.052632,0,-21,19,19,-2.047619,0,0,5,3,false,true,true,1,0
53,79,-26,13.25,19.75,-26,1221,1266,-45,0,0,0,0,70,4,4,0.5,0,0,16,7,false,true,true,0.663,0.337
387,251,136,20.368421,13.210526,136,1011,921,90,1,0,0.052632,0,-13,19,19,-3.769231,0,0,6,13,false,true,true,1,0
187,180,7,15.583333,15,7,758,750,8,0,0,0,0,18,12,12,2.055556,0,1,19,6,false,true,true,0.909,0.091
329,294,35,21.933333,19.6,35,795,830,-35,1,1,0.066667,0.066667,-2,15,15,-21,0,0,13,13,false,true,true,0.997,0.003
308,207,101,23.692308,15.923077,101,526,370,156,0,0,0,0,3,13,13,11.666667,0,0,18,16,false,true,true,1,0
290,254,36,17.058824,15.875,36,95,360,-265,0,1,0,0.0625,-13,17,16,-3.076923,0,0,9,8,false,true,true,0.84,0.16
49,82,-33,9.8,20.5,-33,480,518,-38,0,0,0,0,74,5,4,0.621622,0,0,9,10,false,true,false,0.142,0.858
103,81,22,20.6,16.2,22,1043,1055,-12,0,0,0,0,63,5,5,0.587302,0,0,11,11,false,true,true,0.73,0.27
14,0,14,14,0,14,1762,1582,180,0,0,0,0,97,1,1,0.329897,0,1,17,8,false,true,true,0.696,0.304
308,179,129,23.692308,14.916667,129,526,370,156,0,0,0,0,8,13,12,4.375,0,0,18,11,false,true,true,1,0
307,192,115,30.7,21.333333,115,1803,1552,251,1,1,0.1,0.111111,26,10,9,1.076923,0,0,10,10,false,true,true,1,0
184,80,104,30.666667,16,104,1439,1353,86,1,0,0.166667,0,58,6,5,0.517241,0,0,14,8,false,true,true,0.955,0.045
112,138,-26,14,19.714286,-26,725,771,-46,0,1,0,0.142857,48,8,7,0.958333,0,0,11,12,false,true,false,0.15,0.85
24,36,-12,24,36,-12,1302,1234,68,0,0,0,0,93,1,1,0.333333,0,0,8,18,false,true,false,0.388,0.612
273,179,94,21,14.916667,94,620,658,-38,0,0,0,0,17,13,12,2.117647,0,0,17,7,false,true,true,0.983,0.017
171,153,18,24.428571,21.857143,18,1227,1060,167,0,1,0,0.142857,53,7,7,0.754717,0,0,16,9,false,true,false,0.472,0.528
150,91,59,21.428571,13,59,939,913,26,0,0,0,0,63,7,7,0.634921,0,0,10,7,false,true,true,0.945,0.055
36,32,4,12,16,4,566,542,24,0,0,0,0,82,3,2,0.5,0,0,9,18,false,true,false,0.391,0.609
30,24,6,30,24,6,921,1072,-151,0,0,0,0,90,1,1,0.422222,0,0,10,16,false,true,false,0.252,0.748
195,127,68,27.857143,18.142857,68,971,1180,-209,1,0,0.142857,0,52,7,7,0.615385,0,0,11,12,false,true,true,0.838,0.162
60,31,29,20,15.5,29,1048,1000,48,0,0,0,0,82,3,2,0.487805,0,0,14,13,false,true,true,0.69,0.31
284,287,-3,15.777778,16.882353,-3,316,306,10,0,2,0,0.117647,-15,18,17,-2.533333,0,0,1,13,false,true,true,0.976,0.024
245,146,99,24.5,16.222222,99,1220,1261,-41,2,0,0.2,0,40,10,9,1.125,0,0,20,15,false,true,true,0.949,0.051
336,248,88,15.272727,11.272727,88,576,532,44,0,0,0,0,-30,22,22,-1.533333,1,0,8,18,false,true,true,1,0
305,270,35,23.461538,20.769231,35,416,282,134,1,0,0.076923,0,2,13,13,17,1,0,13,8,false,true,true,0.969,0.031
241,201,40,24.1,20.1,40,1156,1184,-28,1,0,0.1,0,26,10,10,1.076923,1,0,10,17,false,true,true,0.962,0.038
208,167,41,17.333333,13.916667,41,272,288,-16,0,0,0,0,38,12,12,1.368421,0,0,12,17,false,true,true,0.819,0.181
276,274,2,18.4,18.266667,2,947,810,137,0,1,0,0.066667,2,15,15,21,1,0,8,13,false,true,false,0.309,0.691
68,29,39,22.666667,14.5,39,1216,1217,-1,0,0,0,0,81,3,2,0.419753,0,0,14,24,false,true,true,0.692,0.308
222,229,-7,27.75,28.625,-7,1428,1606,-178,1,0,0.125,0,37,8,8,0.864865,1,0,13,7,false,true,false,0.345,0.655
80,69,11,16,17.25,11,1050,1144,-94,0,0,0,0,70,5,4,0.542857,0,0,16,9,false,true,false,0.31,0.69
122,105,17,11.090909,10.5,17,416,222,194,0,0,0,0,41,11,10,1.341463,1,0,7,20,false,true,true,0.654,0.346
34,22,12,34,22,12,1094,1030,64,0,0,0,0,90,1,1,0.4,0,0,11,10,false,true,true,0.683,0.317
233,131,102,23.3,13.1,102,1075,1152,-77,0,0,0,0,36,10,10,1.111111,0,1,9,8,false,true,true,0.972,0.028
107,43,64,35.666667,14.333333,64,976,965,11,0,0,0,0,71,3,3,0.450704,0,0,23,22,false,true,true,0.873,0.127
260,196,64,21.666667,16.333333,64,527,503,24,0,0,0,0,31,12,12,1.322581,0,0,10,9,false,true,true,0.914,0.086
456,313,143,25.333333,17.388889,143,1270,1322,-52,1,0,0.055556,0,-20,18,18,-1.9,0,0,2,2,false,true,true,1,0
343,262,81,24.5,18.714286,81,1510,1583,-73,1,0,0.071429,0,-3,14,14,-10.666667,0,0,10,7,false,true,true,1,0
364,290,74,26,22.307692,74,1670,1770,-100,1,1,0.071429,0.076923,-4,14,13,-8,0,1,8,6,false,true,true,1,0
337,304,33,19.823529,17.882353,33,1090,1244,-154,0,0,0,0,-17,17,17,-2.176471,0,0,7,1,false,true,true,1,0
117,89,28,16.714286,14.833333,28,371,435,-64,0,0,0,0,49,7,6,0.897959,0,0,14,12,false,true,true,0.551,0.449
262,287,-25,20.153846,23.916667,-25,971,761,210,0,0,0,0,9,13,12,3.333333,0,0,9,14,false,true,false,0.018,0.982
77,54,23,25.666667,18,23,1397,1195,202,0,0,0,0,80,3,3,0.4375,0,0,14,23,false,true,false,0.375,0.625
134,52,82,26.8,13,82,993,897,96,1,0,0.2,0,65,5,4,0.723077,0,0,7,7,false,true,true,0.945,0.055
183,130,53,26.142857,18.571429,53,1439,1294,145,1,0,0.142857,0,50,7,7,0.72,0,0,7,25,false,true,true,0.934,0.066
254,100,154,31.75,14.285714,154,1482,1554,-72,1,0,0.125,0,47,8,7,0.765957,0,0,7,13,false,true,true,1,0
105,81,24,21,20.25,24,941,926,15,1,0,0.2,0,65,5,4,0.584615,0,0,20,9,false,true,true,0.698,0.302
47,19,28,23.5,19,28,820,822,-2,0,0,0,0,88,2,1,0.443182,0,0,17,17,false,true,true,0.675,0.325
44,26,18,22,13,18,771,754,17,0,0,0,0,84,2,2,0.380952,1,0,9,8,false,true,true,0.69,0.31
247,190,57,24.7,21.111111,57,695,671,24,0,0,0,0,25,10,9,1.32,0,0,17,9,false,true,true,0.97,0.03
148,130,18,18.5,16.25,18,1181,1069,112,0,0,0,0,45,8,8,0.822222,1,0,22,7,false,true,true,0.871,0.129
241,181,60,21.909091,18.1,60,1548,1493,55,1,0,0.090909,0,28,11,10,1.464286,0,0,7,14,false,true,true,0.928,0.072
62,20,42,20.666667,6.666667,42,595,543,52,0,0,0,0,83,3,3,0.566265,0,0,10,13,false,true,true,0.863,0.137
58,37,21,11.6,9.25,21,1281,1339,-58,0,0,0,0,73,5,4,0.561644,0,0,27,12,false,true,true,0.67,0.33
225,146,79,28.125,20.857143,79,1501,1622,-121,1,0,0.125,0,44,8,7,0.704545,0,0,9,10,false,true,true,0.922,0.078
318,176,142,24.461538,13.538462,142,554,342,212,0,0,0,0,3,13,13,12,1,0,13,22,false,true,true,1,0
18,22,-4,18,22,-4,1036,1181,-145,0,0,0,0,94,1,1,0.361702,0,1,19,8,false,true,false,0.251,0.749
22,18,4,22,18,4,1550,1624,-74,0,0,0,0,91,1,1,0.32967,0,0,28,13,false,true,true,0.678,0.322
248,162,86,27.555556,20.25,86,1556,1591,-35,1,0,0.111111,0,38,9,8,0.947368,0,0,9,11,false,true,true,0.972,0.028
339,227,112,28.25,20.636364,112,996,1063,-67,1,1,0.083333,0.090909,11,12,11,2.909091,1,0,18,9,false,true,true,1,0
134,58,76,26.8,11.6,76,993,897,96,1,0,0.2,0,60,5,5,0.783333,0,0,7,16,false,true,true,0.969,0.031
179,197,-18,22.375,24.625,-18,942,976,-34,0,0,0,0,40,8,8,1,0,0,15,7,false,true,true,0.56,0.44
315,258,57,18.529412,16.125,57,1077,1094,-17,0,0,0,0,0,17,16,0,1,1,6,6,false,true,true,0.998,0.002
431,252,179,30.785714,19.384615,179,1501,1622,-121,2,0,0.142857,0,-1,14,13,-31,0,0,16,7,false,true,true,1,0
254,176,78,23.090909,16,78,1159,1031,128,1,0,0.090909,0,19,11,11,2.052632,0,0,7,16,false,true,true,1,0
69,40,29,23,13.333333,29,1094,1030,64,0,0,0,0,79,3,3,0.455696,0,0,11,14,false,true,true,0.758,0.242
129,73,56,25.8,18.25,56,1550,1624,-74,0,0,0,0,68,5,4,0.441176,0,0,23,14,false,true,true,0.784,0.216
210,146,64,23.333333,18.25,64,1439,1294,145,1,0,0.111111,0,40,9,8,0.9,0,0,14,33,false,true,true,0.859,0.141
289,245,44,28.9,24.5,44,1397,1195,202,1,0,0.1,0,27,10,10,1.296296,0,1,9,6,false,true,true,0.824,0.176
371,314,57,23.1875,20.933333,57,856,897,-41,0,1,0,0.066667,-16,16,15,-2.1875,0,0,5,6,false,true,true,1,0
87,79,8,17.4,19.75,8,758,750,8,0,0,0,0,61,5,4,0.606557,1,0,7,12,false,true,true,0.687,0.313
301,278,23,20.066667,19.857143,23,561,526,35,0,0,0,0,-8,15,14,-4.375,0,0,13,8,false,true,true,0.795,0.205
61,77,-16,15.25,19.25,-16,778,758,20,0,0,0,0,67,4,4,0.58209,0,0,9,7,false,true,true,0.676,0.324
336,261,75,22.4,17.4,75,1305,1218,87,1,0,0.066667,0,-8,15,15,-4.75,0,0,10,10,false,true,true,1,0
79,72,7,39.5,72,7,1344,1209,135,0,1,0,1,82,2,1,0.414634,0,0,10,7,false,true,false,0.236,0.764
96,42,54,32,21,54,1036,1181,-145,0,0,0,0,86,3,2,0.395349,0,1,17,10,false,true,false,0.408,0.592
172,192,-20,19.111111,21.333333,-20,995,912,83,1,0,0.111111,0,48,9,9,0.916667,1,0,8,7,false,true,true,0.787,0.213
157,125,32,26.166667,20.833333,32,1036,1181,-145,0,0,0,0,59,6,6,0.576271,0,0,24,11,false,true,false,0.382,0.618
92,53,39,23,17.666667,39,901,1159,-258,1,0,0.25,0,75,4,3,0.466667,1,0,7,18,false,true,true,0.624,0.376
348,345,3,21.75,21.5625,3,1096,1009,87,2,0,0.125,0,3,16,16,14.666667,0,0,10,15,false,true,false,0.248,0.752
116,158,-42,19.333333,26.333333,-42,869,820,49,0,1,0,0.166667,61,6,6,0.606557,0,0,20,10,false,true,false,0.203,0.797
409,262,147,17.782609,11.909091,147,1413,1422,-9,0,0,0,0,-22,23,22,-2.590909,0,0,3,7,false,true,true,1,0
221,260,-39,17,20,-39,999,1011,-12,0,0,0,0,13,13,13,3.538462,1,0,7,25,false,true,false,0.172,0.828
136,88,48,22.666667,17.6,48,830,907,-77,1,0,0.166667,0,60,6,5,0.65,0,0,16,13,false,true,true,0.777,0.223
350,294,56,18.421053,16.333333,56,1572,1550,22,1,0,0.052632,0,-20,19,18,-1.95,0,0,3,1,false,true,true,1,0
235,77,158,29.375,11,158,925,801,124,1,0,0.125,0,54,8,7,0.740741,1,0,6,15,false,true,true,1,0
0,34,-34,0,17,-34,1897,1793,104,0,0,0,0,95,2,2,0.336842,0,0,17,9,false,true,false,0.29,0.71
297,235,62,22.846154,19.583333,62,1065,1030,35,0,1,0,0.083333,9,13,12,3.777778,1,0,9,10,false,true,true,0.992,0.008
351,273,78,20.647059,16.058824,78,527,581,-54,0,0,0,0,-15,17,17,-2.8,0,0,8,7,false,true,true,1,0
119,64,55,23.8,16,55,1875,1793,82,1,0,0.2,0,69,5,4,0.434783,1,0,13,8,false,true,true,0.928,0.072
152,130,22,19,16.25,22,1094,1030,64,0,0,0,0,47,8,8,0.765957,1,0,10,18,false,true,true,0.876,0.124
329,304,25,21.933333,20.266667,25,847,952,-105,0,0,0,0,2,15,15,18,0,1,9,6,false,true,true,0.523,0.477
64,14,50,64,14,50,809,868,-59,1,0,1,0,89,1,1,0.359551,0,0,12,11,false,true,false,0.258,0.742
264,245,19,16.5,16.333333,19,859,822,37,0,0,0,0,-3,16,15,-12.666667,1,0,9,8,false,true,true,0.669,0.331
229,176,53,22.9,17.6,53,1022,1095,-73,0,0,0,0,25,10,10,1.32,0,1,14,12,false,true,true,0.941,0.059
271,240,31,16.9375,16,31,916,876,40,0,0,0,0,-14,16,15,-2.428571,1,0,0,9,false,true,true,0.924,0.076
348,290,58,18.315789,16.111111,58,1548,1493,55,1,0,0.052632,0,-18,19,18,-2.277778,0,0,2,5,false,true,true,1,0
322,318,4,26.833333,26.5,4,1297,1606,-309,1,1,0.083333,0.083333,6,12,12,5,0,0,12,14,false,true,true,0.785,0.215
122,107,15,24.4,21.4,15,1153,1065,88,0,1,0,0.2,56,5,5,0.5,0,0,21,17,false,true,true,0.664,0.336
55,35,20,18.333333,17.5,20,500,567,-67,0,0,0,0,85,3,2,0.517647,0,0,11,16,false,true,false,0.256,0.744
247,266,-19,16.466667,17.733333,-19,1043,1055,-12,0,0,0,0,2,15,15,18.5,1,0,17,8,false,true,true,0.597,0.403
46,73,-27,11.5,24.333333,-27,1211,1173,38,0,0,0,0,77,4,3,0.454545,0,0,21,7,false,true,false,0.318,0.682
223,113,110,22.3,12.555556,110,1159,1031,128,1,0,0.1,0,31,10,9,1.258065,1,0,15,13,false,true,true,0.976,0.024
354,295,59,27.230769,24.583333,59,1394,1424,-30,1,1,0.076923,0.083333,12,13,12,2.666667,1,0,10,15,false,true,true,1,0
343,225,118,31.181818,22.5,118,1245,1241,4,1,1,0.090909,0.1,14,11,10,2.071429,1,0,11,7,false,true,true,1,0
248,237,11,22.545455,21.545455,11,290,416,-126,0,0,0,0,22,11,11,1.545455,0,0,9,11,false,true,true,0.701,0.299
104,86,18,17.333333,17.2,18,1090,1244,-154,0,0,0,0,61,6,5,0.606557,0,0,15,16,false,true,false,0.252,0.748
0,26,-26,0,26,-26,421,306,115,0,0,0,0,94,1,1,0.468085,0,1,15,8,false,true,false,0.151,0.849
293,276,17,15.421053,15.333333,17,262,306,-44,1,0,0.052632,0,-26,19,18,-1.769231,0,0,5,8,false,true,true,0.864,0.136
43,22,21,21.5,22,21,1501,1473,28,0,0,0,0,89,2,1,0.404494,0,1,14,6,false,true,true,0.68,0.32
396,342,54,23.294118,20.117647,54,1142,1176,-34,1,0,0.058824,0,-15,17,17,-2.4,0,0,1,1,false,true,true,1,0
123,90,33,24.6,22.5,33,1148,1164,-16,0,0,0,0,63,5,4,0.396825,1,0,9,12,false,true,true,0.731,0.269
242,151,91,22,15.1,91,1551,1550,1,0,0,0,0,28,11,10,1.5,0,1,13,18,false,true,true,0.971,0.029
202,193,9,13.466667,13.785714,9,1030,1045,-15,0,0,0,0,17,15,14,2.705882,0,0,7,9,false,true,false,0.107,0.893
312,212,100,24,17.666667,100,1014,1303,-289,1,0,0.076923,0,11,13,12,3.454545,0,0,10,13,false,true,true,1,0
373,303,70,17.761905,14.428571,70,505,95,410,0,1,0,0.047619,-23,21,21,-1.913043,0,0,2,4,false,true,true,1,0
74,86,-12,12.333333,14.333333,-12,658,817,-159,0,0,0,0,65,6,6,0.584615,0,0,33,10,false,true,false,0.255,0.745
188,216,-28,23.5,30.857143,-28,1885,1846,39,1,1,0.125,0.142857,32,8,7,0.90625,1,0,18,9,false,true,false,0.494,0.506
195,180,15,16.25,15,15,523,480,43,1,0,0.083333,0,13,12,12,2.538462,0,1,20,14,false,true,true,0.792,0.208
348,359,-11,23.2,23.933333,-11,1539,1537,2,0,1,0,0.066667,-7,15,15,-4.571429,0,0,6,2,false,true,false,0.036,0.964
330,296,34,30,26.909091,34,1762,1616,146,2,0,0.181818,0,10,11,11,3,1,0,7,10,false,true,true,1,0
324,268,56,19.058824,15.764706,56,864,808,56,1,0,0.058824,0,-23,17,17,-1.478261,0,0,10,5,true,true,true,1,0
312,233,79,19.5,14.5625,79,830,907,-77,1,0,0.0625,0,-1,16,16,-39,0,1,18,6,false,true,true,0.997,0.003
52,62,-10,10.4,15.5,-10,1037,950,87,0,0,0,0,71,5,4,0.43662,1,0,8,11,false,true,false,0.47,0.53
346,205,141,18.210526,10.789474,141,896,818,78,0,1,0,0.052632,-8,19,19,-5.5,1,0,20,7,false,true,true,1,0
131,62,69,32.75,15.5,69,1439,1353,86,1,0,0.25,0,67,4,4,0.447761,0,0,11,9,false,true,true,0.85,0.15
398,268,130,22.111111,14.888889,130,939,907,32,1,0,0.055556,0,-14,18,18,-2.857143,0,0,2,1,false,true,true,1,0
20,0,20,20,0,20,1803,1552,251,0,0,0,0,95,1,0,0.294737,0,0,25,0,false,true,true,1,0
211,141,70,35.166667,23.5,70,1510,1583,-73,1,0,0.166667,0,47,6,6,0.680851,0,0,14,9,false,true,true,0.88,0.12
373,321,52,21.941176,20.0625,52,1439,1397,42,1,2,0.058824,0.125,-17,17,16,-2,0,0,1,15,false,true,true,1,0
262,238,24,20.153846,18.307692,24,971,658,313,0,0,0,0,7,13,13,5.142857,0,0,18,9,false,true,true,0.823,0.177
220,191,29,22,19.1,29,613,569,44,0,0,0,0,28,10,10,1.392857,1,0,21,10,false,true,true,0.952,0.048
363,273,90,20.166667,16.058824,90,539,500,39,0,0,0,0,-19,18,17,-2.105263,0,0,14,9,false,true,true,1,0
157,108,49,31.4,27,49,948,933,15,1,0,0.2,0,68,5,4,0.558824,0,0,7,10,false,true,true,0.835,0.165
221,246,-25,20.090909,22.363636,-25,1181,1149,32,0,1,0,0.090909,33,11,11,1.363636,1,0,9,18,false,true,true,0.571,0.429
272,227,45,14.315789,12.611111,45,611,584,27,0,0,0,0,-10,19,18,-4.4,1,0,4,14,false,true,true,1,0
132,62,70,16.5,7.75,70,1428,1302,126,0,0,0,0,51,8,8,1.039216,0,1,10,15,false,true,true,0.841,0.159
148,107,41,21.142857,15.285714,41,561,526,35,0,0,0,0,44,7,7,0.795455,0,0,13,11,false,true,true,0.96,0.04
280,273,7,14,13.65,7,361,493,-132,1,0,0.05,0,-38,20,20,-1.078947,0,0,1,1,false,true,true,0.904,0.096
198,78,120,39.6,19.5,120,1396,1454,-58,1,0,0.2,0,65,5,4,0.507692,1,0,9,10,false,true,true,0.994,0.006
169,218,-49,15.363636,21.8,-49,1100,1008,92,0,0,0,0,34,11,10,1.058824,2,0,7,13,false,true,false,0.209,0.791
288,262,26,13.090909,11.909091,26,611,584,27,0,0,0,0,-24,22,22,-1.833333,0,0,1,3,true,true,true,1,0
188,63,125,31.333333,12.6,125,1144,1014,130,0,0,0,0,59,6,5,0.610169,0,1,15,11,false,true,true,0.873,0.127
10,0,10,10,0,10,468,542,-74,0,0,0,0,96,1,0,0.40625,0,0,21,0,false,true,false,0.252,0.748
320,240,80,29.090909,21.818182,80,1093,1197,-104,2,0,0.181818,0,17,11,11,1.823529,1,0,7,9,false,true,true,1,0
281,231,50,35.125,28.875,50,1645,1777,-132,2,0,0.25,0,22,8,8,1.136364,0,0,15,7,false,true,true,0.978,0.022
349,227,122,34.9,22.7,122,1396,1454,-58,2,0,0.2,0,23,10,10,1.434783,0,0,7,11,false,true,true,1,0
358,282,76,19.888889,15.666667,76,939,913,26,0,1,0,0.055556,-17,18,18,-2.352941,1,0,1,4,false,true,true,1,0
273,274,-1,16.058824,17.125,-1,1043,1055,-12,0,0,0,0,-10,17,16,-3.7,0,0,6,4,false,true,false,0.22,0.78
222,251,-29,17.076923,19.307692,-29,1077,1094,-17,0,0,0,0,19,13,13,2.210526,0,1,7,6,false,true,false,0.045,0.955
403,322,81,21.210526,17.888889,81,892,788,104,3,0,0.157895,0,-18,19,18,-2.388889,0,0,1,4,false,true,true,1,0
18,0,18,18,0,18,698,742,-44,0,0,0,0,97,1,0,0.42268,0,0,26,0,false,true,false,0.278,0.722
35,64,-29,11.666667,21.333333,-29,95,360,-265,0,1,0,0.333333,72,3,3,0.555556,0,0,21,7,false,true,false,0.379,0.621
176,122,54,22,17.428571,54,1244,1361,-117,1,0,0.125,0,58,8,7,0.655172,1,1,7,6,false,true,false,0.252,0.748
103,94,9,20.6,23.5,9,1731,1691,40,0,0,0,0,64,5,4,0.53125,0,0,21,13,false,true,false,0.394,0.606
332,224,108,27.666667,18.666667,108,1030,998,32,1,0,0.083333,0,10,12,12,3.8,0,0,10,19,false,true,true,1,0
95,62,33,15.833333,12.4,33,1128,889,239,0,1,0,0.2,64,6,5,0.734375,1,0,11,7,false,true,true,1,0
223,165,58,22.3,16.5,58,580,620,-40,1,0,0.1,0,36,10,10,1.194444,0,0,15,7,false,true,true,0.85,0.15
197,154,43,21.888889,17.111111,43,830,907,-77,1,0,0.111111,0,37,9,9,1.054054,0,0,9,18,false,true,true,0.84,0.16
350,367,-17,21.875,22.9375,-17,1320,1339,-19,2,1,0.125,0.0625,-10,16,16,-3.9,0,0,7,5,false,true,false,0.003,0.997
58,86,-28,19.333333,43,-28,1076,1176,-100,0,1,0,0.5,76,3,2,0.421053,0,0,10,17,false,true,false,0.202,0.798
186,132,54,23.25,18.857143,54,971,906,65,0,0,0,0,41,8,7,0.780488,0,0,7,13,false,true,true,0.86,0.14
219,154,65,21.9,17.111111,65,746,796,-50,0,1,0,0.111111,31,10,9,1.548387,0,0,25,8,false,true,true,0.97,0.03
304,287,17,16.888889,15.944444,17,859,822,37,0,0,0,0,-18,18,18,-2.111111,2,0,2,4,false,true,true,1,0
300,301,-1,23.076923,25.083333,-1,1266,1144,122,0,0,0,0,8,13,12,4.25,1,0,9,7,false,true,true,0.759,0.241
212,187,25,17.666667,15.583333,25,864,808,56,1,0,0.083333,0,10,12,12,3.4,0,1,7,10,false,true,true,0.845,0.155
50,62,-12,16.666667,31,-12,1710,1636,74,0,0,0,0,84,3,2,0.428571,0,0,16,14,false,true,false,0.203,0.797
391,258,133,24.4375,17.2,133,1211,1173,38,0,0,0,0,-4,16,15,-8.75,0,0,12,8,false,true,true,1,0
33,22,11,16.5,22,11,1023,1070,-47,0,0,0,0,90,2,1,0.355556,1,0,18,10,false,true,true,0.682,0.318
138,106,32,17.25,15.142857,32,1221,1438,-217,0,0,0,0,52,8,7,0.865385,0,2,10,5,false,true,true,0.866,0.134
214,214,0,17.833333,19.454545,0,491,398,93,0,0,0,0,23,12,11,1.565217,0,0,7,19,false,true,true,0.53,0.47
77,94,-17,19.25,23.5,-17,869,820,49,0,1,0,0.25,74,4,4,0.5,0,0,19,14,false,true,false,0.307,0.693
389,268,121,18.52381,12.761905,121,1011,921,90,1,0,0.047619,0,-20,21,21,-2.45,0,0,5,11,false,true,true,1,0
372,348,24,24.8,23.2,24,1014,948,66,1,0,0.066667,0,-8,15,15,-4.125,0,0,9,1,false,true,true,1,0
152,110,42,21.714286,18.333333,42,859,786,73,0,0,0,0,56,7,6,0.678571,0,0,22,9,false,true,true,0.854,0.146
14,17,-3,14,17,-3,1029,1075,-46,0,0,0,0,92,1,1,0.521739,0,0,20,10,false,true,true,0.655,0.345
135,209,-74,19.285714,29.857143,-74,758,952,-194,0,0,0,0,42,7,7,0.952381,1,0,19,7,false,true,false,0.023,0.977
152,108,44,19,15.428571,44,1266,1247,19,0,0,0,0,48,8,7,0.666667,0,0,10,19,false,true,true,0.697,0.303
197,163,34,28.142857,27.166667,34,416,282,134,1,0,0.142857,0,54,7,6,0.62963,0,0,9,12,false,true,true,0.605,0.395
339,289,50,22.6,19.266667,50,995,912,83,2,0,0.133333,0,8,15,15,5.5,0,0,11,9,false,true,true,1,0
391,284,107,16.291667,12.347826,107,746,796,-50,0,1,0,0.043478,-30,24,23,-1.6,0,0,1,1,false,true,true,1,0
222,202,20,18.5,16.833333,20,1452,1469,-17,0,1,0,0.083333,18,12,12,2.111111,1,0,11,23,false,true,true,0.691,0.309
56,49,7,18.666667,24.5,7,1606,1544,62,0,0,0,0,88,3,2,0.511364,1,0,14,7,false,true,true,0.926,0.074
255,218,37,28.333333,24.222222,37,965,1013,-48,1,0,0.111111,0,26,9,9,1.269231,0,1,13,12,false,true,false,0.172,0.828
279,331,-52,19.928571,23.642857,-52,1501,1473,28,0,0,0,0,2,14,14,18,0,0,8,7,false,true,false,0.001,0.999
297,219,78,21.214286,15.642857,78,1055,1050,5,0,0,0,0,7,14,14,4.857143,0,0,16,9,false,true,true,1,0
300,284,16,25,23.666667,16,1636,1576,60,0,2,0,0.166667,11,12,12,3.090909,0,0,11,14,false,true,true,1,0
24,46,-22,24,46,-22,758,796,-38,0,0,0,0,92,1,1,0.413043,1,0,9,12,false,true,false,0.135,0.865
216,65,151,24,8.125,151,896,818,78,0,0,0,0,53,9,8,0.830189,0,0,13,7,false,true,true,0.971,0.029
355,219,136,22.1875,14.6,136,554,342,212,0,0,0,0,-13,16,15,-2.769231,0,0,2,8,false,true,true,1,0
52,42,10,13,10.5,10,719,614,105,0,0,0,0,73,4,4,0.589041,0,2,12,10,false,true,true,0.751,0.249
154,104,50,22,17.333333,50,421,306,115,0,1,0,0.166667,40,7,6,1.1,0,0,19,9,false,true,true,0.977,0.023
58,153,-95,19.333333,51,-95,1885,1793,92,0,0,0,0,74,3,3,0.364865,0,0,12,10,false,true,false,0.011,0.989
56,37,19,18.666667,12.333333,19,1089,1063,26,0,0,0,0,83,3,3,0.457831,1,0,12,21,false,true,true,0.712,0.288
371,254,117,19.526316,14.111111,117,596,595,1,1,0,0.052632,0,-17,19,18,-2.352941,0,0,1,14,false,true,true,1,0
358,264,94,19.888889,15.529412,94,711,876,-165,0,0,0,0,-12,18,17,-3.583333,0,0,3,3,false,true,true,1,0
311,283,28,16.368421,15.722222,28,1583,1422,161,1,0,0.052632,0,5,19,18,10.2,0,0,7,17,false,true,true,1,0
175,175,0,19.444444,19.444444,0,349,315,34,0,0,0,0,24,9,9,1.416667,0,0,10,10,false,true,true,0.849,0.151
325,336,-11,21.666667,22.4,-11,1127,1134,-7,0,1,0,0.066667,-10,15,15,-3,0,0,5,8,true,true,false,0.086,0.914
20,0,20,20,0,20,526,370,156,0,0,0,0,95,1,0,0.368421,0,0,13,0,false,true,true,0.698,0.302
246,176,70,22.363636,17.6,70,820,822,-2,0,0,0,0,27,11,10,1.444444,0,0,13,9,false,true,true,0.97,0.03
12,0,12,12,0,12,1408,1454,-46,0,0,0,0,96,1,0,0.333333,0,0,16,0,false,true,true,0.673,0.327
280,245,35,17.5,16.333333,35,739,480,259,1,0,0.0625,0,0,16,15,0,0,1,11,6,false,true,true,0.844,0.156
72,20,52,18,6.666667,52,595,543,52,0,0,0,0,81,4,3,0.580247,0,0,12,13,false,true,true,0.871,0.129
33,13,20,16.5,13,20,960,1070,-110,0,0,0,0,89,2,1,0.393258,0,0,10,15,false,true,false,0.252,0.748
24,0,24,24,0,24,1633,1580,53,0,0,0,0,97,1,0,0.28866,1,0,13,0,false,true,true,0.928,0.072
49,82,-33,9.8,16.4,-33,480,518,-38,0,0,0,0,74,5,5,0.621622,0,0,9,12,false,true,false,0.177,0.823
111,74,37,15.857143,12.333333,37,1128,889,239,0,1,0,0.166667,58,7,6,0.810345,1,0,11,7,false,true,true,1,0
255,186,69,18.214286,14.307692,69,1037,950,87,1,0,0.071429,0,11,14,13,2.818182,0,0,8,18,false,true,true,0.997,0.003
148,135,13,21.142857,19.285714,13,1295,1281,14,0,0,0,0,59,7,7,0.644068,0,0,17,13,false,true,true,0.539,0.461
47,13,34,23.5,13,34,872,818,54,0,0,0,0,87,2,1,0.471264,0,1,11,15,false,true,true,0.714,0.286
317,303,14,21.133333,21.642857,14,1265,1045,220,0,1,0,0.071429,-2,15,14,-21,0,0,15,8,false,true,true,0.988,0.012
378,246,132,17.181818,11.181818,132,620,513,107,0,0,0,0,-20,22,22,-2.25,0,0,1,3,false,true,true,1,0
12,7,5,12,7,5,986,856,130,0,0,0,0,94,1,1,0.329787,1,0,10,16,false,true,true,0.679,0.321
257,209,48,25.7,20.9,48,880,952,-72,0,0,0,0,30,10,10,1.166667,0,0,19,7,false,true,true,0.962,0.038
324,289,35,18,17,35,1176,1127,49,0,0,0,0,-18,18,17,-2.055556,0,0,1,1,false,true,true,1,0
235,150,85,23.5,16.666667,85,960,1070,-110,1,0,0.1,0,35,10,9,1,0,0,11,16,false,true,true,0.848,0.152
55,49,6,18.333333,16.333333,6,885,719,166,0,0,0,0,81,3,3,0.469136,0,1,25,9,false,true,true,0.713,0.287
305,260,45,17.941176,16.25,45,1159,1031,128,1,0,0.058824,0,-15,17,16,-2.6,0,0,6,10,false,true,true,1,0
61,72,-11,15.25,18,-11,272,238,34,0,0,0,0,68,4,4,0.588235,0,0,14,19,false,true,false,0.434,0.566
35,18,17,17.5,18,17,526,370,156,0,0,0,0,89,2,1,0.393258,0,0,11,17,false,true,true,0.681,0.319
364,255,109,18.2,13.421053,109,539,632,-93,0,0,0,0,-12,20,19,-3.833333,0,0,7,7,false,true,true,1,0
54,28,26,18,14,26,916,876,40,0,0,0,0,79,3,2,0.43038,0,0,14,15,false,true,true,0.686,0.314
282,220,62,23.5,18.333333,62,960,1070,-110,1,0,0.083333,0,21,12,12,1.666667,0,1,21,6,false,true,true,0.915,0.085
316,293,23,15.8,15.421053,23,1583,1422,161,1,0,0.05,0,0,20,19,0,0,0,7,17,false,true,true,1,0
234,189,45,26,21,45,1101,1078,23,0,0,0,0,38,9,9,0.868421,0,1,8,8,false,true,true,0.862,0.138
280,224,56,20,17.230769,56,1159,1031,128,1,0,0.071429,0,2,14,13,19.5,0,0,9,10,false,true,true,0.997,0.003
298,204,94,19.866667,14.571429,94,1181,1069,112,0,0,0,0,4,15,14,9.25,1,0,8,11,false,true,true,1,0
81,81,0,13.5,16.2,0,1221,1438,-217,0,0,0,0,68,6,5,0.661765,0,1,22,6,false,true,false,0.251,0.749
205,148,57,18.636364,13.454545,57,871,867,4,0,0,0,0,28,11,11,1.535714,0,1,19,9,false,true,true,0.983,0.017
226,232,-6,20.545455,23.2,-6,1277,1166,111,0,1,0,0.1,24,11,10,1.5,0,0,12,8,false,true,false,0.176,0.824
353,236,117,25.214286,18.153846,117,1030,998,32,1,0,0.071429,0,3,14,13,12.666667,0,0,8,18,false,true,true,1,0
57,29,28,19,14.5,28,1029,1075,-46,0,0,0,0,83,3,2,0.578313,0,0,19,10,false,true,true,0.665,0.335
302,229,73,20.133333,16.357143,73,1221,1258,-37,1,0,0.066667,0,11,15,14,3.545455,0,0,7,15,false,true,true,1,0
121,89,32,40.333333,29.666667,32,1493,1513,-20,1,0,0.333333,0,74,3,3,0.445946,0,1,13,6,false,true,true,0.69,0.31
37,22,15,18.5,11,15,527,514,13,0,0,0,0,88,2,2,0.443182,0,0,10,7,false,true,true,0.573,0.427
74,26,48,37,13,48,2219,2106,113,0,0,0,0,88,2,2,0.306818,0,1,10,15,false,true,true,0.963,0.037
96,81,15,19.2,16.2,15,1164,1201,-37,0,0,0,0,66,5,5,0.636364,0,1,13,9,false,true,true,0.608,0.392
374,258,116,18.7,13.578947,116,596,595,1,1,0,0.05,0,-22,20,19,-1.818182,0,0,1,11,false,true,true,1,0
206,239,-33,15.846154,18.384615,-33,658,817,-159,0,0,0,0,19,13,13,2,0,0,12,20,false,true,false,0.061,0.939
357,211,146,23.8,15.071429,146,1482,1554,-72,1,0,0.066667,0,3,15,14,12,0,0,16,10,false,true,true,1,0
22,14,8,22,14,8,1439,1294,145,0,0,0,0,89,1,1,0.404494,0,0,17,7,false,true,true,0.681,0.319
179,167,12,19.888889,18.555556,12,1161,1166,-5,1,0,0.111111,0,30,9,9,1.166667,0,1,19,13,false,true,true,0.797,0.203
325,294,31,21.666667,21,31,1344,1209,135,1,1,0.066667,0.071429,-8,15,14,-4.25,0,0,7,9,false,true,true,0.991,0.009
287,192,95,13.666667,9.6,95,416,222,194,0,0,0,0,-14,21,20,-3.928571,0,0,21,13,false,true,true,1,0
116,38,78,23.2,9.5,78,1413,1422,-9,0,0,0,0,67,5,4,0.850746,1,0,15,18,false,true,true,0.965,0.035
262,167,95,37.428571,23.857143,95,1507,1554,-47,1,2,0.142857,0.285714,34,7,7,0.852941,0,0,13,16,false,true,true,0.987,0.013
158,173,-15,22.571429,24.714286,-15,1431,802,629,0,0,0,0,41,7,7,0.780488,0,0,12,19,false,true,true,0.997,0.003
133,79,54,22.166667,15.8,54,1572,1550,22,1,0,0.166667,0,62,6,5,0.629032,0,0,29,11,false,true,true,0.837,0.163
279,194,85,16.411765,11.411765,85,1128,889,239,0,1,0,0.058824,1,17,17,47,0,1,16,17,false,true,true,1,0
281,175,106,23.416667,15.909091,106,518,533,-15,1,0,0.083333,0,14,12,11,2.5,0,0,14,11,false,true,true,1,0
135,119,16,27,23.8,16,518,448,70,0,0,0,0,66,5,5,0.515152,0,0,7,12,false,true,true,0.756,0.244
94,119,-25,18.8,23.8,-25,334,446,-112,0,0,0,0,64,5,5,0.625,0,0,10,10,false,true,false,0.24,0.76
307,285,22,21.928571,21.923077,22,795,830,-35,1,1,0.071429,0.076923,3,14,13,14,0,0,16,12,false,true,true,0.927,0.073
400,268,132,17.391304,12.181818,132,1011,921,90,1,0,0.043478,0,-23,23,22,-2.130435,0,0,1,11,false,true,true,1,0
358,281,77,23.866667,20.071429,77,1530,1550,-20,1,1,0.066667,0.071429,-8,15,14,-4.25,0,0,7,10,false,true,true,1,0
251,151,100,31.375,18.875,100,1075,1027,48,2,0,0.25,0,38,8,8,0.973684,0,1,7,6,false,true,true,0.822,0.178
22,12,10,22,12,10,1265,1045,220,0,0,0,0,90,1,1,0.466667,0,1,23,18,false,true,true,0.674,0.326
354,260,94,29.5,23.636364,94,1093,1100,-7,3,2,0.25,0.181818,18,12,11,1.777778,0,0,11,10,false,true,true,1,0
248,197,51,15.5,12.3125,51,892,768,124,0,0,0,0,12,16,16,3.583333,0,0,10,12,false,true,true,0.834,0.166
82,89,-7,20.5,22.25,-7,290,416,-126,0,0,0,0,71,4,4,0.478873,0,0,13,19,false,true,false,0.258,0.742
362,299,63,20.111111,16.611111,63,1214,1176,38,0,0,0,0,-8,18,18,-4.5,0,0,2,5,true,true,true,1,0
234,201,33,16.714286,15.461538,33,613,461,152,0,1,0,0.076923,0,14,13,0,0,0,25,15,false,true,true,0.963,0.037
94,92,2,18.8,18.4,2,786,976,-190,0,0,0,0,73,5,5,0.438356,0,0,8,7,false,true,false,0.253,0.747
289,135,154,22.230769,11.25,154,942,1003,-61,0,0,0,0,16,13,12,2.8125,1,1,19,15,false,true,true,1,0
168,120,48,21,17.142857,48,1073,1177,-104,0,0,0,0,49,8,7,0.653061,0,0,9,19,false,true,false,0.436,0.564
222,228,-6,18.5,19,-6,1572,1550,22,1,0,0.083333,0,22,12,12,1.772727,1,1,15,9,false,true,false,0.333,0.667
258,214,44,25.8,21.4,44,1109,1065,44,0,0,0,0,16,10,10,2.0625,0,0,20,10,false,true,true,0.956,0.044
311,285,26,13.521739,12.954545,26,262,306,-44,1,0,0.043478,0,-40,23,22,-1.15,0,0,1,4,false,true,true,1,0
246,199,47,24.6,19.9,47,866,949,-83,0,0,0,0,29,10,10,1.37931,1,0,6,15,false,true,true,0.904,0.096
222,184,38,20.181818,18.4,38,1572,1550,22,1,0,0.090909,0,29,11,10,1.344828,0,1,14,9,false,true,true,0.816,0.184
52,34,18,26,17,18,1075,989,86,0,0,0,0,86,2,2,0.453488,0,0,11,7,false,true,true,0.702,0.298
240,177,63,18.461538,14.75,63,739,480,259,1,0,0.076923,0,20,13,12,1.8,0,1,16,9,false,true,true,0.961,0.039
293,280,13,20.928571,20,13,290,416,-126,0,0,0,0,2,14,14,17,0,0,7,9,false,true,true,0.781,0.219
101,81,20,25.25,20.25,20,1302,1082,220,0,0,0,0,63,4,4,0.47619,0,0,12,14,false,true,true,0.656,0.344
234,232,2,16.714286,17.846154,2,1090,1244,-154,0,0,0,0,11,14,13,3.363636,1,1,6,6,false,true,false,0.356,0.644
83,73,10,20.75,18.25,10,1127,1134,-7,0,0,0,0,69,4,4,0.434783,1,0,15,16,false,true,true,0.706,0.294
36,48,-12,9,12,-12,450,412,38,0,0,0,0,74,4,4,0.513514,0,1,13,16,false,true,false,0.236,0.764
324,293,31,17.052632,15.421053,31,334,446,-112,0,0,0,0,-31,19,19,-1.290323,0,0,2,3,false,true,true,1,0
404,222,182,21.263158,12.333333,182,1033,1037,-4,0,1,0,0.055556,-18,19,18,-2.5,0,1,2,5,false,true,true,1,0
303,281,22,17.823529,17.5625,22,942,976,-34,0,0,0,0,-11,17,16,-3.636364,0,0,8,9,false,true,true,0.848,0.152
157,146,11,22.428571,20.857143,11,1501,1622,-121,0,0,0,0,51,7,7,0.607843,1,0,7,10,false,true,true,0.735,0.265
369,318,51,24.6,21.2,51,630,786,-156,1,0,0.066667,0,-1,15,15,-35,0,0,8,4,false,true,true,1,0
279,212,67,16.411765,12.470588,67,566,542,24,0,0,0,0,-3,17,17,-13.666667,0,1,21,14,false,true,true,0.977,0.023
302,281,21,15.894737,14.789474,21,95,360,-265,0,1,0,0.052632,-27,19,19,-1.481481,0,0,2,1,false,true,true,0.849,0.151
98,78,20,12.25,11.142857,20,904,857,47,0,0,0,0,52,8,7,0.788462,0,1,22,16,false,true,true,0.63,0.37
272,225,47,27.2,22.5,47,1156,1114,42,1,0,0.1,0,17,10,10,1.882353,0,0,15,15,false,true,true,0.985,0.015
117,33,84,29.25,11,84,1093,1100,-7,1,0,0.25,0,83,4,3,0.385542,0,1,12,15,false,true,false,0.474,0.526
157,86,71,26.166667,14.333333,71,871,867,4,0,0,0,0,59,6,6,0.728814,0,0,8,11,false,true,true,0.961,0.039
191,150,41,17.363636,15,41,1127,1176,-49,0,0,0,0,34,11,10,1.235294,0,1,13,10,false,true,true,0.579,0.421
39,25,14,19.5,25,14,1731,1691,40,0,0,0,0,88,2,1,0.386364,1,0,6,14,false,true,true,0.923,0.077
350,229,121,26.923077,19.083333,121,1394,1118,276,0,1,0,0.083333,11,13,12,3.363636,0,0,20,12,false,true,true,1,0
134,72,62,26.8,18,62,791,885,-94,1,0,0.2,0,67,5,4,0.567164,0,0,24,12,false,true,true,0.833,0.167
80,23,57,80,23,57,1210,1252,-42,1,0,1,0,90,1,1,0.355556,0,0,18,14,false,true,true,0.715,0.285
338,280,58,24.142857,21.538462,58,1388,1506,-118,2,1,0.142857,0.076923,9,14,13,3.777778,0,0,10,17,false,true,true,1,0
10,0,10,10,0,10,1216,1217,-1,0,0,0,0,95,1,0,0.357895,0,0,23,0,false,true,true,0.678,0.322
327,273,54,16.35,14.368421,54,1221,1438,-217,0,0,0,0,-7,20,19,-6.428571,0,1,7,7,false,true,true,0.999,0.001
72,68,4,18,17,4,864,808,56,0,0,0,0,68,4,4,0.5,0,0,8,11,false,true,true,0.682,0.318
33,16,17,16.5,16,17,620,658,-38,0,0,0,0,88,2,1,0.409091,1,0,9,11,false,true,false,0.384,0.616
362,216,146,30.166667,19.636364,146,1101,1078,23,1,0,0.083333,0,17,12,11,1.941176,0,1,11,16,false,true,true,1,0
177,178,-1,22.125,22.25,-1,1040,925,115,0,0,0,0,39,8,8,1.102564,0,0,13,7,false,true,false,0.384,0.616
335,246,89,25.769231,20.5,89,1550,1466,84,1,0,0.076923,0,11,13,12,3.363636,0,0,10,12,false,true,true,1,0
195,103,92,27.857143,17.166667,92,976,965,11,1,0,0.142857,0,47,7,6,0.680851,0,1,10,17,false,true,true,0.846,0.154
346,361,-15,23.066667,24.066667,-15,1762,1538,224,1,2,0.066667,0.133333,-4,15,15,-8.5,0,0,4,4,false,true,true,0.999,0.001
250,221,29,31.25,31.571429,29,1265,1237,28,1,0,0.125,0,30,8,7,1,0,0,16,19,false,true,true,0.752,0.248
342,333,9,18,17.526316,9,901,889,12,0,1,0,0.052632,-20,19,19,-2.15,0,0,5,4,false,true,true,0.986,0.014
59,139,-80,19.666667,46.333333,-80,1265,1237,28,0,0,0,0,71,3,3,0.422535,0,0,14,9,false,true,false,0.144,0.856
284,249,35,21.846154,19.153846,35,820,822,-2,0,0,0,0,10,13,13,3.9,0,0,22,10,false,true,true,0.969,0.031
392,381,11,23.058824,22.411765,11,1397,1195,202,1,0,0.058824,0,-17,17,17,-2.058824,0,0,3,2,false,true,true,1,0
278,192,86,23.166667,17.454545,86,859,811,48,0,0,0,0,21,12,11,1.714286,1,1,9,13,false,true,true,0.998,0.002
349,310,39,17.45,15.5,39,725,771,-46,0,1,0,0.05,-24,20,20,-1.916667,0,0,6,4,false,true,true,1,0
35,35,0,17.5,17.5,0,1237,1277,-40,0,0,0,0,82,2,2,0.353659,0,0,7,10,false,true,true,0.678,0.322
58,22,36,19.333333,11,36,346,231,115,0,0,0,0,81,3,2,0.506173,0,1,14,12,false,true,true,0.811,0.189
183,171,12,22.875,21.375,12,1078,1130,-52,0,1,0,0.125,44,8,8,0.886364,0,0,9,16,false,true,false,0.475,0.525
345,325,20,15.681818,14.772727,20,628,658,-30,0,0,0,0,-27,22,22,-1.703704,0,0,1,3,false,true,true,1,0
362,336,26,15.73913,14.608696,26,1388,1477,-89,1,0,0.043478,0,-36,23,23,-1.333333,0,0,1,1,false,true,true,1,0
268,253,15,20.615385,19.461538,15,1027,856,171,1,1,0.076923,0.076923,-2,13,13,-16.5,0,0,22,9,false,true,true,0.88,0.12
154,218,-64,15.4,21.8,-64,1100,1008,92,0,0,0,0,38,10,10,0.947368,2,0,10,13,false,true,false,0.393,0.607
51,6,45,25.5,3,45,1101,1078,23,0,0,0,0,89,2,2,0.370787,0,0,23,16,false,true,true,0.836,0.164
279,162,117,31,18,117,1270,1322,-52,1,0,0.111111,0,39,9,9,0.974359,0,0,14,20,false,true,true,1,0
164,129,35,16.4,14.333333,35,947,909,38,0,0,0,0,36,10,9,1.277778,1,0,9,37,false,true,true,0.599,0.401
289,253,36,17,15.8125,36,468,542,-74,0,0,0,0,-6,17,16,-6.5,0,0,15,8,false,true,true,0.95,0.05
339,298,41,21.1875,18.625,41,892,819,73,0,1,0,0.0625,-11,16,16,-3.090909,0,0,4,2,false,true,true,0.998,0.002
20,18,2,20,18,2,526,370,156,0,0,0,0,91,1,1,0.384615,0,0,13,17,false,true,true,0.681,0.319
77,94,-17,19.25,23.5,-17,1731,1691,40,0,0,0,0,67,4,4,0.507463,0,0,28,13,false,true,false,0.342,0.658
302,301,1,21.571429,21.5,1,786,976,-190,0,0,0,0,0,14,14,0,0,0,8,6,false,true,true,0.538,0.462
18,0,18,18,0,18,1439,1397,42,0,0,0,0,96,1,0,0.354167,0,0,24,0,false,true,true,0.679,0.321
138,91,47,19.714286,13,47,1069,917,152,0,0,0,0,56,7,7,0.607143,0,1,10,7,false,true,true,0.847,0.153
137,74,63,34.25,18.5,63,1513,1482,31,1,0,0.25,0,67,4,4,0.492537,0,0,8,19,false,true,true,0.844,0.156
39,44,-5,13,22,-5,421,306,115,0,0,0,0,77,3,2,0.571429,1,0,14,11,false,true,true,0.693,0.307
108,60,48,54,30,48,1210,1252,-42,1,0,0.5,0,84,2,2,0.380952,0,0,11,7,false,true,true,0.701,0.299
93,53,40,31,17.666667,40,1890,2020,-130,0,0,0,0,78,3,3,0.371795,0,0,15,19,false,true,true,0.703,0.297
374,348,26,34,31.636364,26,2219,2106,113,2,0,0.181818,0,-3,11,11,-9,0,0,13,10,false,true,true,1,0
164,90,74,20.5,12.857143,74,303,342,-39,0,0,0,0,51,8,7,0.745098,1,0,15,14,false,true,true,0.862,0.138
127,119,8,18.142857,19.833333,8,628,658,-30,0,0,0,0,55,7,6,0.836364,0,0,22,10,false,true,false,0.407,0.593
111,78,33,15.857143,11.142857,33,1128,889,239,0,1,0,0.142857,55,7,7,0.854545,1,0,11,9,false,true,true,1,0
291,203,88,29.1,22.555556,88,1793,1897,-104,2,0,0.2,0,27,10,9,1.111111,0,1,10,6,false,true,true,0.961,0.039
312,254,58,13.565217,11.043478,58,310,359,-49,0,0,0,0,-47,23,23,-1.042553,0,0,4,2,false,true,true,1,0
307,249,58,21.928571,17.785714,58,1216,1217,-1,1,0,0.071429,0,1,14,14,34,0,0,12,7,false,true,true,1,0
369,313,56,24.6,22.357143,56,630,786,-156,1,0,0.066667,0,2,15,14,17.5,0,0,8,6,false,true,true,1,0
87,93,-6,17.4,18.6,-6,758,750,8,0,0,0,0,58,5,5,0.637931,1,0,7,8,false,true,true,0.684,0.316
38,51,-13,12.666667,17,-13,1110,1039,71,0,0,0,0,81,3,3,0.444444,1,0,22,9,false,true,true,0.711,0.289
40,28,12,20,14,12,871,867,4,0,0,0,0,84,2,2,0.511905,0,0,21,12,false,true,true,0.688,0.312
82,48,34,20.5,12,34,1216,1217,-1,0,0,0,0,72,4,4,0.472222,0,0,15,27,false,true,true,0.754,0.246
391,282,109,17.772727,13.428571,109,746,796,-50,0,1,0,0.047619,-28,22,21,-1.714286,0,0,1,2,false,true,true,1,0
227,74,153,45.4,18.5,153,1513,1482,31,1,0,0.2,0,58,5,4,0.568966,0,0,19,19,false,true,true,1,0
161,159,2,20.125,22.714286,2,1554,1573,-19,0,0,0,0,51,8,7,0.666667,0,0,8,14,false,true,false,0.202,0.798
381,370,11,47.625,46.25,11,1370,1431,-61,2,1,0.25,0.125,28,8,8,0.821429,0,0,9,9,false,true,true,1,0
346,228,118,19.222222,13.411765,118,925,801,124,1,0,0.055556,0,-7,18,17,-5.714286,0,0,8,11,false,true,true,1,0
170,89,81,42.5,22.25,81,971,621,350,1,0,0.25,0,67,4,4,0.477612,0,0,9,17,false,true,true,0.97,0.03
225,124,101,20.454545,12.4,101,421,306,115,0,1,0,0.1,20,11,10,2.2,0,0,42,10,false,true,true,1,0
40,53,-13,20,26.5,-13,864,808,56,0,0,0,0,84,2,2,0.404762,0,0,9,10,false,true,true,0.675,0.325
352,191,161,16,8.681818,161,421,306,115,0,1,0,0.045455,-20,22,22,-2.2,0,0,8,5,true,true,true,1,0
264,217,47,22,19.727273,47,892,819,73,0,1,0,0.090909,18,12,11,1.888889,0,0,16,12,false,true,true,0.865,0.135
345,278,67,15.681818,12.636364,67,272,288,-16,0,0,0,0,-22,22,22,-2.363636,0,0,3,2,false,true,true,1,0
178,49,129,35.6,12.25,129,539,500,39,0,0,0,0,58,5,4,0.689655,0,1,9,24,false,true,true,0.868,0.132
83,39,44,20.75,13,44,971,658,313,0,0,0,0,74,4,3,0.486486,0,0,17,11,false,true,true,0.828,0.172
60,59,1,20,19.666667,1,1167,1216,-49,0,0,0,0,78,3,3,0.525641,1,0,9,26,false,true,true,0.573,0.427
98,73,25,19.6,14.6,25,971,658,313,0,0,0,0,66,5,5,0.545455,0,0,23,7,false,true,true,0.838,0.162
239,282,-43,17.071429,20.142857,-43,999,1011,-12,0,0,0,0,8,14,14,5.75,1,0,12,16,false,true,false,0.248,0.752
265,173,92,15.588235,10.8125,92,1428,1302,126,0,0,0,0,-2,17,16,-26.5,0,1,11,17,false,true,true,1,0
182,96,86,26,16,86,1093,1090,3,1,0,0.142857,0,58,7,6,0.586207,0,0,12,7,false,true,true,0.969,0.031
14,14,0,14,14,0,416,282,134,0,0,0,0,92,1,1,0.369565,0,0,11,16,false,true,true,0.681,0.319
118,65,53,29.5,16.25,53,1216,1230,-14,1,0,0.25,0,66,4,4,0.484848,0,0,18,11,false,true,true,0.851,0.149
400,359,41,23.529412,22.4375,41,1144,1014,130,0,0,0,0,-17,17,16,-2.117647,0,0,1,3,false,true,true,1,0
221,220,1,22.1,22,1,1270,1348,-78,0,0,0,0,32,10,10,1.1875,0,0,7,7,false,true,false,0.225,0.775
145,124,21,24.166667,24.8,21,1210,1253,-43,0,1,0,0.2,54,6,5,0.62963,0,0,19,18,false,true,true,0.593,0.407
249,156,93,20.75,14.181818,93,1397,1422,-25,2,0,0.166667,0,35,12,11,1.028571,0,2,7,16,false,true,false,0.438,0.562
280,288,-8,17.5,19.2,-8,491,398,93,0,0,0,0,-1,16,15,-36,1,0,11,12,false,true,true,0.868,0.132
16,0,16,16,0,16,527,503,24,0,0,0,0,96,1,0,0.427083,1,0,11,0,false,true,true,0.58,0.42
486,267,219,48.6,29.666667,219,991,996,-5,3,0,0.3,0,19,10,9,1.578947,0,0,11,7,false,true,true,1,0
249,200,49,20.75,16.666667,49,1170,1156,14,1,0,0.083333,0,18,12,12,2.111111,1,0,6,13,false,true,true,0.984,0.016
301,146,155,18.8125,9.733333,155,993,897,96,1,0,0.0625,0,-1,16,15,-47,0,1,27,20,false,true,true,1,0
169,235,-66,18.777778,26.111111,-66,1501,1473,28,0,0,0,0,33,9,9,1.090909,0,1,18,16,false,true,false,0.077,0.923
294,254,40,22.615385,21.166667,40,1177,1214,-37,0,0,0,0,9,13,12,3.888889,0,1,18,8,false,true,true,0.957,0.043
107,81,26,26.75,20.25,26,1036,1181,-145,0,0,0,0,74,4,4,0.459459,0,1,16,15,false,true,false,0.304,0.696
171,184,-13,17.1,18.4,-13,361,493,-132,0,0,0,0,28,10,10,1.464286,0,0,15,20,false,true,true,0.527,0.473
269,245,24,14.944444,13.611111,24,613,502,111,0,0,0,0,-15,18,18,-3.266667,1,0,9,28,false,true,true,1,0
173,181,-8,24.714286,25.857143,-8,1406,1454,-48,0,1,0,0.142857,40,7,7,0.85,1,1,6,6,false,true,true,0.864,0.136
12,0,12,12,0,12,1156,1184,-28,0,0,0,0,95,1,0,0.294737,0,0,24,0,false,true,true,0.673,0.327
396,346,50,26.4,24.714286,50,1454,1531,-77,1,1,0.066667,0.071429,-13,15,14,-2.307692,0,0,3,4,false,true,true,1,0
205,120,85,29.285714,17.142857,85,769,527,242,1,0,0.142857,0,45,7,7,0.8,0,0,11,8,false,true,true,0.97,0.03
178,159,19,17.8,15.9,19,613,461,152,0,1,0,0.1,24,10,10,1.541667,0,0,12,19,false,true,true,0.833,0.167
247,198,49,17.642857,15.230769,49,916,837,79,0,0,0,0,17,14,13,2.352941,1,0,15,11,false,true,true,0.93,0.07
281,220,61,25.545455,20,61,1050,1144,-94,0,1,0,0.090909,27,11,11,1.407407,1,1,10,9,false,true,true,0.934,0.066
402,355,47,25.125,23.666667,47,1093,1197,-104,4,0,0.25,0,-16,16,15,-1.9375,0,0,1,6,true,true,true,0.998,0.002
454,344,110,28.375,22.933333,110,1216,1230,-14,1,0,0.0625,0,-9,16,15,-3.555556,0,0,3,5,false,true,true,1,0
320,271,49,29.090909,27.1,49,1075,1009,66,2,0,0.181818,0,19,11,10,1.684211,0,0,16,9,false,true,true,0.995,0.005
31,26,5,15.5,26,5,363,668,-305,0,0,0,0,92,2,1,0.467391,0,0,14,16,false,true,false,0.186,0.814
108,92,16,18,15.333333,16,786,976,-190,0,0,0,0,69,6,6,0.463768,1,0,17,10,false,true,true,0.654,0.346
83,88,-5,27.666667,29.333333,-5,1431,802,629,0,0,0,0,73,3,3,0.438356,0,0,9,12,false,true,true,0.998,0.002
222,137,85,27.75,17.125,85,539,500,39,0,0,0,0,35,8,8,1.142857,0,0,12,10,false,true,true,0.97,0.03
63,47,16,12.6,11.75,16,299,315,-16,0,0,0,0,72,5,4,0.583333,0,0,7,24,false,true,false,0.367,0.633
259,171,88,19.923077,14.25,88,1091,1078,13,0,0,0,0,29,13,12,1.482759,0,0,9,8,false,true,true,0.975,0.025
44,22,22,22,11,22,346,231,115,0,0,0,0,85,2,2,0.482353,0,1,14,12,false,true,true,0.809,0.191
283,223,60,20.214286,17.153846,60,691,675,16,0,0,0,0,7,14,13,5.285714,0,1,20,7,false,true,true,0.986,0.014
386,256,130,24.125,16,130,939,907,32,1,0,0.0625,0,-6,16,16,-6.666667,0,0,5,3,false,true,true,1,0
247,207,40,24.7,23,40,1189,1266,-77,1,0,0.1,0,29,10,9,1.172414,0,0,14,14,false,true,true,0.906,0.094
187,136,51,18.7,15.111111,51,620,513,107,0,0,0,0,37,10,9,1.216216,0,0,9,15,false,true,true,0.964,0.036
230,174,56,25.555556,19.333333,56,976,965,11,1,0,0.111111,0,29,9,9,1.103448,0,1,12,20,false,true,true,0.823,0.177
399,329,70,26.6,21.933333,70,1333,1331,2,1,0,0.066667,0,-18,15,15,-1.666667,0,0,3,7,true,true,true,1,0
212,221,-9,26.5,31.571429,-9,1554,1716,-162,1,1,0.125,0.142857,38,8,7,0.921053,0,0,16,8,false,true,true,0.655,0.345
152,128,24,16.888889,16,24,580,620,-40,0,0,0,0,50,9,8,0.86,1,0,8,10,false,true,true,0.67,0.33
217,110,107,27.125,13.75,107,1211,1173,38,0,0,0,0,48,8,8,0.729167,0,1,15,6,false,true,true,0.972,0.028
215,225,-10,16.538462,18.75,-10,1043,1055,-12,0,0,0,0,19,13,12,1.947368,1,0,18,10,false,true,true,0.521,0.479
246,209,37,35.142857,29.857143,37,1633,1580,53,2,0,0.285714,0,40,7,7,0.7,0,0,9,18,false,true,true,0.925,0.075
206,145,61,17.166667,12.083333,61,1069,1040,29,0,0,0,0,17,12,12,2.588235,0,2,7,7,false,true,true,0.987,0.013
272,256,16,30.222222,32,16,1265,1237,28,1,0,0.111111,0,24,9,8,1.25,0,1,11,12,false,true,false,0.098,0.902
291,220,71,26.454545,20,71,880,952,-72,0,0,0,0,24,11,11,1.458333,0,0,19,8,false,true,true,0.981,0.019
107,67,40,35.666667,22.333333,40,1550,1466,84,1,0,0.333333,0,75,3,3,0.493333,0,0,9,27,false,true,true,0.699,0.301
113,82,31,28.25,20.5,31,1153,1065,88,0,1,0,0.25,63,4,4,0.444444,0,0,21,18,false,true,true,0.812,0.188
30,10,20,15,10,20,913,871,42,0,0,0,0,87,2,1,0.494253,0,0,11,16,false,true,true,0.679,0.321
279,260,19,15.5,15.294118,19,801,807,-6,0,0,0,0,-17,18,17,-2.058824,0,0,2,2,true,true,false,0.269,0.731
62,20,42,31,20,42,1586,1782,-196,0,0,0,0,88,2,1,0.454545,0,0,12,7,false,true,false,0.455,0.545
398,247,151,24.875,16.466667,151,1221,1266,-45,1,0,0.0625,0,-15,16,15,-2.333333,0,0,14,10,false,true,true,1,0
286,196,90,15.888889,10.888889,90,1428,1302,126,0,0,0,0,-9,18,18,-5.888889,0,1,11,18,false,true,true,1,0
321,283,38,21.4,20.214286,38,315,294,21,0,1,0,0.071429,-13,15,14,-2.692308,0,0,10,6,false,true,true,0.965,0.035
20,14,6,20,14,6,371,435,-64,0,0,0,0,93,1,1,0.473118,1,0,6,16,false,true,false,0.465,0.535
375,313,62,28.846154,26.083333,62,1153,1065,88,0,1,0,0.083333,-12,13,12,-2.333333,0,0,7,13,false,true,true,1,0
30,0,30,30,0,30,1824,1793,31,0,0,0,0,95,1,1,0.294737,0,0,16,10,false,true,true,0.707,0.293
355,213,142,32.272727,19.363636,142,1501,1622,-121,2,0,0.181818,0,16,11,11,1.9375,0,0,21,12,false,true,true,1,0
198,131,67,24.75,18.714286,67,820,822,-2,0,0,0,0,47,8,7,0.829787,0,0,7,10,false,true,true,0.964,0.036
258,226,32,19.846154,17.384615,32,1159,1051,108,0,0,0,0,17,13,13,2.352941,0,0,12,10,false,true,true,0.761,0.239
290,289,1,24.166667,24.083333,1,1023,1110,-87,1,1,0.083333,0.083333,0,12,12,0,1,0,13,9,false,true,true,0.93,0.07
383,258,125,25.533333,17.2,125,1691,1692,-1,0,0,0,0,-3,15,15,-10,1,0,2,5,true,true,true,1,0
293,188,105,13.952381,9.4,105,310,359,-49,0,0,0,0,-34,21,20,-1.441176,0,0,14,26,false,true,true,1,0
314,209,105,28.545455,20.9,105,1550,1466,84,1,0,0.090909,0,23,11,10,1.608696,0,0,7,10,false,true,true,1,0
245,240,5,24.5,24,5,1023,1110,-87,1,1,0.1,0.1,16,10,10,1.875,1,0,14,9,false,true,true,0.931,0.069
335,292,43,17.631579,16.222222,43,1040,925,115,0,0,0,0,-26,19,18,-1.653846,0,0,11,3,false,true,true,1,0
361,296,65,22.5625,18.5,65,1036,1181,-145,0,0,0,0,0,16,16,0,1,0,5,5,false,true,true,1,0
360,308,52,18.947368,17.111111,52,1221,1258,-37,1,0,0.052632,0,-16,19,18,-2.4375,1,0,0,5,false,true,true,1,0
313,269,44,13.041667,11.695652,44,613,502,111,0,0,0,0,-30,24,23,-1.633333,0,0,3,15,false,true,true,1,0
134,113,21,16.75,14.125,21,777,830,-53,0,0,0,0,47,8,8,0.87234,0,0,14,17,false,true,true,0.579,0.421
272,232,40,24.727273,23.2,40,1394,1424,-30,0,1,0,0.1,26,11,10,1.230769,1,0,6,15,false,true,true,0.754,0.246
12,71,-59,12,71,-59,1370,1431,-61,0,1,0,1,90,1,1,0.255556,1,0,17,9,false,true,false,0.4,0.6
241,191,50,24.1,21.222222,50,1210,1252,-42,1,0,0.1,0,31,10,9,1.032258,0,0,10,17,false,true,true,0.961,0.039
436,307,129,29.066667,20.466667,129,1519,1782,-263,2,0,0.133333,0,-5,15,15,-6.6,0,0,3,2,false,true,true,1,0
16,19,-3,8,9.5,-3,1281,1339,-58,0,0,0,0,86,2,2,0.476744,0,0,18,8,false,true,true,0.668,0.332
47,68,-21,11.75,22.666667,-21,691,675,16,0,0,0,0,74,4,3,0.513514,1,0,17,9,false,true,true,0.67,0.33
200,165,35,16.666667,15,35,613,502,111,0,0,0,0,23,12,11,2.130435,0,0,7,27,false,true,true,0.782,0.218
392,270,122,30.153846,20.769231,122,1826,1803,23,1,0,0.076923,0,1,13,13,30,1,0,5,5,false,true,true,1,0
380,326,54,19,16.3,54,580,620,-40,1,0,0.05,0,-26,20,20,-1.653846,0,0,2,1,false,true,true,1,0
319,270,49,17.722222,15,49,450,412,38,0,0,0,0,-25,18,18,-1.52,0,0,1,3,false,true,true,1,0
365,283,82,21.470588,17.6875,82,904,668,236,0,0,0,0,-28,17,16,-1.214286,0,0,2,1,false,true,true,1,0
213,102,111,30.428571,14.571429,111,1054,917,137,1,0,0.142857,0,42,7,7,0.833333,1,0,9,8,false,true,true,0.974,0.026
400,351,49,25,21.9375,49,1554,1573,-19,1,0,0.0625,0,-8,16,16,-4.25,0,0,2,2,false,true,true,1,0
371,326,45,21.823529,20.375,45,834,758,76,0,1,0,0.0625,-20,17,16,-1.8,0,0,2,6,false,true,true,1,0
129,97,32,21.5,16.166667,32,704,691,13,0,0,0,0,57,6,6,0.666667,0,0,14,18,false,true,true,0.911,0.089
208,160,48,23.111111,17.777778,48,820,822,-2,0,0,0,0,36,9,9,1.083333,0,0,14,10,false,true,true,0.968,0.032
383,258,125,25.533333,18.428571,125,1691,1692,-1,0,0,0,0,-3,15,14,-10,1,0,2,5,false,true,true,1,0
231,147,84,28.875,18.375,84,742,696,46,0,0,0,0,38,8,8,0.842105,0,0,10,16,false,true,true,0.975,0.025
16,0,16,16,0,16,1075,1009,66,0,0,0,0,97,1,0,0.329897,1,0,15,0,false,true,true,0.683,0.317
195,150,45,24.375,21.428571,45,596,595,1,1,0,0.125,0,47,8,7,0.851064,0,0,19,12,false,true,true,0.907,0.093
347,340,7,20.411765,20,7,1100,1008,92,1,0,0.058824,0,-19,17,17,-1.894737,0,0,1,1,false,true,true,1,0
173,97,76,28.833333,19.4,76,1023,1070,-47,1,0,0.166667,0,57,6,5,0.561404,1,0,7,11,false,true,true,0.967,0.033
221,131,90,27.625,18.714286,90,880,952,-72,0,0,0,0,48,8,7,0.729167,0,0,22,18,false,true,true,0.955,0.045
142,103,39,17.75,14.714286,39,299,315,-16,0,0,0,0,51,8,7,0.823529,1,0,8,17,false,true,true,0.71,0.29
220,142,78,20,14.2,78,609,620,-11,0,0,0,0,32,11,10,1.15625,0,1,8,6,false,true,true,0.903,0.097
224,166,58,18.666667,15.090909,58,620,513,107,0,0,0,0,26,12,11,1.730769,0,0,19,12,false,true,true,0.968,0.032
209,225,-16,17.416667,20.454545,-16,947,810,137,0,1,0,0.090909,28,12,11,1.5,0,0,15,14,false,true,false,0.231,0.769
72,89,-17,18,22.25,-17,1548,1493,55,0,0,0,0,69,4,4,0.594203,1,0,6,16,false,true,true,0.556,0.444
301,169,132,27.363636,16.9,132,1550,1546,4,0,0,0,0,30,11,10,1,1,0,15,10,false,true,true,1,0
229,190,39,17.615385,14.615385,39,1164,1201,-37,0,0,0,0,17,13,13,2.470588,0,1,18,9,false,true,true,0.973,0.027
225,198,27,17.307692,15.230769,27,859,822,37,0,0,0,0,11,13,13,3.454545,0,0,9,16,false,true,true,0.804,0.196
65,87,-22,13,17.4,-22,611,584,27,0,0,0,0,72,5,5,0.611111,0,0,16,9,false,true,false,0.365,0.635
304,292,12,21.714286,20.857143,12,1710,1636,74,1,1,0.071429,0.071429,7,14,14,5.142857,1,0,8,14,false,true,true,0.955,0.045
62,41,21,31,20.5,21,746,796,-50,0,1,0,0.5,78,2,2,0.615385,0,0,10,14,false,true,true,0.743,0.257
134,78,56,26.8,19.5,56,691,675,16,0,0,0,0,68,5,4,0.544118,0,1,8,9,false,true,true,0.784,0.216
179,130,49,25.571429,18.571429,49,1221,1266,-45,0,0,0,0,44,7,7,0.795455,1,0,8,10,false,true,true,0.94,0.06
269,249,20,24.454545,22.636364,20,1093,1090,3,1,2,0.090909,0.181818,25,11,11,1.36,0,0,13,19,false,true,true,0.911,0.089
426,261,165,28.4,17.4,165,971,621,350,2,0,0.133333,0,-19,15,15,-1.684211,0,0,1,6,false,true,true,1,0
327,224,103,20.4375,14.933333,103,518,533,-15,1,0,0.0625,0,-12,16,15,-2.916667,0,0,5,9,false,true,true,1,0
344,188,156,22.933333,12.533333,156,1413,1422,-9,0,0,0,0,8,15,15,7.125,0,0,9,20,false,true,true,1,0
19,13,6,9.5,13,6,1159,1031,128,0,0,0,0,90,2,1,0.433333,1,0,14,14,false,true,true,0.673,0.327
257,174,83,25.7,19.333333,83,1029,1227,-198,1,0,0.1,0,25,10,9,1.28,1,0,7,12,false,true,true,0.968,0.032
42,26,16,21,26,16,1454,1531,-77,0,0,0,0,91,2,1,0.32967,1,0,10,7,false,true,true,0.907,0.093
397,319,78,17.26087,13.869565,78,1583,1422,161,1,0,0.043478,0,-16,23,23,-3.1875,0,0,3,7,false,true,true,1,0
130,70,60,18.571429,11.666667,60,595,543,52,0,0,0,0,58,7,6,0.810345,0,0,10,15,false,true,true,0.966,0.034
136,63,73,27.2,15.75,73,904,668,236,0,0,0,0,64,5,4,0.53125,0,0,18,19,false,true,true,0.935,0.065
271,261,10,19.357143,18.642857,10,1176,1127,49,0,0,0,0,2,14,14,18.5,0,0,14,9,false,true,true,0.506,0.494
179,127,52,29.833333,25.4,52,1550,1466,84,1,0,0.166667,0,56,6,5,0.660714,0,0,18,20,false,true,true,0.788,0.212
242,144,98,40.333333,24,98,1880,1777,103,1,0,0.166667,0,47,6,6,0.595745,0,1,11,15,false,true,true,0.994,0.006
84,75,9,16.8,18.75,9,1452,1469,-17,0,0,0,0,66,5,4,0.575758,0,0,16,14,false,true,true,0.618,0.382
319,250,69,22.785714,19.230769,69,1216,1228,-12,1,0,0.071429,0,13,14,13,2.538462,0,0,16,10,false,true,true,1,0
29,13,16,9.666667,6.5,16,698,742,-44,0,0,0,0,91,3,2,0.450549,0,1,24,11,false,true,false,0.264,0.736
205,139,66,18.636364,13.9,66,871,867,4,0,0,0,0,33,11,10,1.30303,0,0,19,10,false,true,true,0.97,0.03
318,259,59,26.5,21.583333,59,1302,1234,68,1,1,0.083333,0.083333,13,12,12,2.384615,0,0,8,13,false,true,true,1,0
290,92,198,41.428571,15.333333,198,1513,1482,31,1,0,0.142857,0,46,7,6,0.717391,0,0,11,16,false,true,true,1,0
210,158,52,23.333333,19.75,52,948,933,15,1,0,0.111111,0,47,9,8,0.808511,0,0,10,17,false,true,true,0.915,0.085
319,242,77,29,22,77,1004,840,164,1,0,0.090909,0,7,11,11,4.285714,0,0,18,13,false,true,true,1,0
309,257,52,14.045455,12.238095,52,584,565,19,0,0,0,0,-33,22,21,-1.393939,0,0,1,3,false,true,true,1,0
284,258,26,18.933333,18.428571,26,1547,1439,108,1,0,0.066667,0,4,15,14,9.25,0,0,17,13,false,true,true,0.745,0.255
234,241,-7,23.4,26.777778,-7,1431,802,629,0,0,0,0,26,10,9,1.230769,0,0,7,7,false,true,true,0.997,0.003
277,226,51,21.307692,17.384615,51,719,651,68,0,1,0,0.076923,22,13,13,2.045455,0,0,10,10,false,true,true,0.882,0.118
422,377,45,32.461538,31.416667,45,1633,1580,53,3,1,0.230769,0.083333,-7,13,12,-4,0,0,2,10,false,true,true,1,0
160,184,-24,26.666667,30.666667,-24,1428,1606,-178,1,0,0.166667,0,49,6,6,0.653061,1,0,11,9,false,true,false,0.194,0.806
255,232,23,21.25,19.333333,23,1270,1348,-78,0,0,0,0,24,12,12,1.583333,0,0,14,8,false,true,true,0.522,0.478
404,233,171,18.363636,11.095238,171,1033,1037,-4,0,1,0,0.047619,-25,22,21,-1.8,0,1,2,1,false,true,true,1,0
298,282,16,14.9,14.842105,16,262,306,-44,1,0,0.05,0,-31,20,19,-1.483871,0,0,4,6,false,true,true,0.925,0.075
22,11,11,22,11,11,262,306,-44,0,0,0,0,94,1,1,0.489362,0,0,16,7,false,true,false,0.276,0.724
208,276,-68,26,34.5,-68,1489,1558,-69,0,1,0,0.125,39,8,8,0.717949,0,0,7,10,false,true,false,0.125,0.875
365,251,114,26.071429,17.928571,114,1305,1390,-85,0,1,0,0.071429,-3,14,14,-12,0,2,10,14,false,true,true,1,0
91,35,56,22.75,11.666667,56,872,818,54,0,0,0,0,73,4,3,0.561644,0,1,11,9,false,true,true,0.844,0.156
56,51,5,18.666667,17,5,1029,1227,-198,0,0,0,0,76,3,3,0.421053,0,0,16,17,false,true,false,0.251,0.749
339,238,101,17.842105,12.526316,101,371,336,35,2,0,0.105263,0,-28,19,19,-1.357143,0,0,1,13,true,true,true,1,0
342,336,6,24.428571,25.846154,6,1297,1606,-309,1,1,0.071429,0.076923,-5,14,13,-6,0,0,3,8,false,true,true,0.814,0.186
265,120,145,24.090909,12,145,1295,1477,-182,2,0,0.181818,0,34,11,10,1.352941,0,0,22,10,false,true,true,0.999,0.001
26,29,-3,26,29,-3,791,885,-94,0,0,0,0,91,1,1,0.417582,1,0,6,19,false,true,false,0.202,0.798
277,192,85,13.85,9.6,85,416,222,194,0,0,0,0,-11,20,20,-5,0,0,9,13,false,true,true,1,0
413,329,84,21.736842,17.315789,84,995,912,83,2,0,0.105263,0,-18,19,19,-2.444444,0,0,2,11,false,true,true,1,0
186,153,33,31,25.5,33,1735,1770,-35,1,1,0.166667,0.166667,43,6,6,0.651163,1,1,8,10,false,true,true,0.938,0.062
281,215,66,23.416667,17.916667,66,596,595,1,1,0,0.083333,0,17,12,12,2.352941,0,0,7,15,false,true,true,1,0
324,182,142,27,16.545455,142,1144,1014,130,0,0,0,0,22,12,11,1.636364,0,1,14,18,false,true,true,1,0
315,246,69,21,16.4,69,939,913,26,0,1,0,0.066667,1,15,15,40,1,0,6,13,false,true,true,1,0
342,326,16,24.428571,25.076923,16,908,1070,-162,2,0,0.142857,0,-5,14,13,-6,0,0,2,7,false,true,true,0.998,0.002
137,131,6,10.538462,10.916667,6,416,222,194,0,0,0,0,28,13,12,1.964286,1,0,10,24,false,true,true,0.63,0.37
77,79,-2,19.25,19.75,-2,1023,1070,-47,0,0,0,0,72,4,4,0.444444,1,0,15,10,false,true,true,0.674,0.326
157,101,56,17.444444,12.625,56,1281,1339,-58,0,0,0,0,54,9,8,0.759259,1,1,14,8,false,true,true,0.773,0.227
34,48,-14,17,24,-14,480,518,-38,0,0,0,0,87,2,2,0.528736,0,0,8,12,false,true,false,0.253,0.747
145,131,14,24.166667,21.833333,14,820,822,-2,0,0,0,0,53,6,6,0.735849,0,0,12,7,false,true,true,0.706,0.294
108,89,19,21.6,22.25,19,290,416,-126,0,0,0,0,67,5,4,0.507463,0,0,18,19,false,true,false,0.491,0.509
215,205,10,14.333333,14.642857,10,1583,1422,161,0,0,0,0,31,15,14,1.645161,2,0,6,20,false,true,true,0.778,0.222
265,125,140,26.5,13.888889,140,778,758,20,0,0,0,0,29,10,9,1.344828,1,0,8,9,false,true,true,1,0
16,24,-8,16,24,-8,1431,825,606,0,0,0,0,93,1,1,0.365591,0,0,10,14,false,true,true,0.998,0.002
336,248,88,14.608696,10.782609,88,576,532,44,0,0,0,0,-30,23,23,-1.533333,1,0,8,18,true,true,true,1,0
264,163,101,29.333333,18.111111,101,1075,1027,48,2,0,0.222222,0,32,9,9,1.15625,0,1,10,9,false,true,true,0.906,0.094
354,268,86,23.6,19.142857,86,1220,1261,-41,2,0,0.133333,0,10,15,14,4.5,1,0,15,8,false,true,true,1,0
192,201,-9,24,25.125,-9,1142,1176,-34,1,0,0.125,0,37,8,8,0.972973,0,0,17,10,false,true,true,0.672,0.328
240,213,27,14.117647,12.529412,27,611,584,27,0,0,0,0,3,17,17,14.666667,0,0,9,14,false,true,true,0.562,0.438
354,282,72,22.125,18.8,72,1047,1094,-47,1,1,0.0625,0.066667,-2,16,15,-18,1,0,8,6,false,true,true,1,0
218,221,-3,19.818182,22.1,-3,1530,1550,-20,0,1,0,0.1,25,11,10,1.36,1,0,24,13,false,true,true,0.587,0.413
24,0,24,24,0,24,518,448,70,0,0,0,0,95,1,0,0.357895,0,0,10,0,false,true,true,0.698,0.302
357,306,51,18.789474,17,51,1075,989,86,1,0,0.052632,0,-14,19,18,-2.785714,0,0,8,6,false,true,true,1,0
198,158,40,22,17.555556,40,1216,1228,-12,0,0,0,0,44,9,9,0.75,1,0,6,12,false,true,true,0.946,0.054
67,27,40,16.75,9,40,584,565,19,0,0,0,0,75,4,3,0.613333,0,0,16,24,false,true,true,0.708,0.292
348,313,35,19.333333,18.411765,35,315,294,21,0,1,0,0.058824,-26,18,17,-1.346154,0,0,1,1,true,true,true,1,0
96,31,65,32,15.5,65,742,696,46,0,0,0,0,80,3,2,0.4,0,1,13,6,false,true,true,0.847,0.153
134,29,105,44.666667,14.5,105,539,500,39,0,0,0,0,74,3,2,0.540541,0,1,17,24,false,true,true,0.86,0.14
232,188,44,17.846154,14.461538,44,620,513,107,0,0,0,0,18,13,13,2.5,1,0,24,7,false,true,true,0.988,0.012
207,249,-42,20.7,24.9,-42,1434,1493,-59,1,0,0.1,0,20,10,10,1.85,1,1,19,6,false,true,false,0.11,0.89
179,163,16,16.272727,16.3,16,523,480,43,1,0,0.090909,0,24,11,10,1.375,0,0,13,14,false,true,true,0.959,0.041
360,220,140,24,15.714286,140,1482,1394,88,2,0,0.133333,0,1,15,14,36,0,0,10,11,false,true,true,1,0
143,127,16,14.3,14.111111,16,416,374,42,0,0,0,0,49,10,9,0.938776,1,0,6,14,false,true,true,0.55,0.45
163,81,82,32.6,16.2,82,1408,1454,-46,1,0,0.2,0,66,5,5,0.484848,0,0,17,11,false,true,true,0.953,0.047
142,100,42,17.75,12.5,42,1069,1040,29,0,0,0,0,43,8,8,1.023256,0,2,9,5,false,true,true,0.98,0.02
350,228,122,29.166667,19,122,1334,1256,78,2,0,0.166667,0,10,12,12,3.1,0,0,9,17,false,true,true,1,0
278,193,85,30.888889,21.444444,85,1397,1361,36,1,0,0.111111,0,24,9,9,1.208333,0,0,15,10,false,true,true,1,0
187,194,-7,17,17.636364,-7,695,523,172,0,0,0,0,18,11,11,2.055556,0,0,21,20,false,true,false,0.448,0.552
338,263,75,16.9,13.842105,75,1091,1078,13,0,0,0,0,-14,20,19,-3.071429,1,0,4,7,false,true,true,1,0
81,91,-10,27,45.5,-10,1571,1554,17,1,1,0.333333,0.5,76,3,2,0.434211,0,0,9,10,false,true,true,0.676,0.324
231,181,50,23.1,18.1,50,1548,1493,55,1,0,0.1,0,32,10,10,1.28125,0,0,11,14,false,true,true,0.945,0.055
80,0,80,80,0,80,1210,1252,-42,1,0,1,0,93,1,0,0.344086,0,0,18,0,false,true,false,0.393,0.607
126,196,-70,21,32.666667,-70,834,844,-10,0,1,0,0.166667,50,6,6,0.72,0,1,12,7,false,true,false,0.187,0.813
10,0,10,10,0,10,658,817,-159,0,0,0,0,98,1,0,0.387755,0,0,21,0,false,true,false,0.251,0.749
119,46,73,19.833333,9.2,73,939,913,26,0,0,0,0,72,6,5,0.555556,0,0,11,13,false,true,true,0.924,0.076
98,49,49,16.333333,9.8,49,561,526,35,0,0,0,0,56,6,5,0.625,1,0,16,18,false,true,true,0.948,0.052
168,118,50,12.923077,9.833333,50,310,359,-49,0,0,0,0,15,13,12,3.266667,0,0,7,18,false,true,true,0.866,0.134
22,24,-2,22,24,-2,1176,1127,49,0,0,0,0,90,1,1,0.411111,0,0,19,14,false,true,true,0.678,0.322
412,323,89,22.888889,17.944444,89,1075,1027,48,2,1,0.111111,0.055556,-20,18,18,-1.85,0,0,4,4,false,true,true,1,0
258,186,72,25.8,20.666667,72,1109,1065,44,0,0,0,0,20,10,9,1.65,0,0,20,12,false,true,true,0.969,0.031
139,86,53,19.857143,12.285714,53,415,518,-103,0,0,0,0,57,7,7,0.666667,1,0,7,27,false,true,true,0.821,0.179
379,300,79,19.947368,16.666667,79,539,500,39,0,0,0,0,-24,19,18,-1.666667,0,0,4,4,false,true,true,1,0
286,233,53,15.052632,12.944444,53,584,565,19,0,0,0,0,-17,19,18,-2.705882,0,0,19,8,false,true,true,0.995,0.005
335,215,120,19.705882,12.647059,120,942,1003,-61,0,0,0,0,-9,17,17,-5,1,1,20,13,false,true,true,1,0
126,115,11,21,23,11,315,294,21,0,1,0,0.2,60,6,5,0.583333,0,0,14,26,false,true,true,0.669,0.331
300,291,9,17.647059,17.117647,9,658,817,-159,0,0,0,0,-2,17,17,-19,1,0,10,6,false,true,true,0.903,0.097
14,15,-1,14,15,-1,1452,1469,-17,0,0,0,0,92,1,1,0.413043,0,0,7,12,false,true,true,0.676,0.324
114,148,-34,16.285714,21.142857,-34,334,446,-112,0,0,0,0,50,7,7,0.8,0,0,11,8,false,true,false,0.247,0.753
187,221,-34,17,22.1,-34,1177,1214,-37,0,0,0,0,28,11,10,1.25,1,0,18,11,false,true,false,0.177,0.823
219,158,61,27.375,19.75,61,1388,1506,-118,2,1,0.25,0.125,42,8,8,0.809524,0,0,13,24,false,true,true,0.93,0.07
284,177,107,31.555556,22.125,107,1203,1221,-18,2,0,0.222222,0,43,9,8,0.813953,0,0,10,10,false,true,true,1,0
12,0,12,12,0,12,986,856,130,0,0,0,0,97,1,0,0.319588,1,0,10,0,false,true,true,0.679,0.321
46,27,19,15.333333,13.5,19,1880,1777,103,0,0,0,0,85,3,2,0.329412,0,1,9,16,false,true,false,0.22,0.78
300,191,109,21.428571,14.692308,109,831,830,1,0,0,0,0,11,14,13,3.363636,0,0,7,10,false,true,true,1,0
34,24,10,34,24,10,540,518,22,0,0,0,0,91,1,1,0.43956,0,1,10,7,false,true,true,0.569,0.431
149,160,-11,16.555556,20,-11,725,771,-46,0,1,0,0.125,41,9,8,1.121951,1,0,9,11,false,true,true,0.743,0.257
163,244,-81,18.111111,30.5,-81,1762,1538,224,0,2,0,0.25,39,9,8,0.871795,1,0,9,8,false,true,true,1,0
52,40,12,17.333333,13.333333,12,913,871,42,0,0,0,0,77,3,3,0.558442,0,0,8,19,false,true,true,0.684,0.316
69,56,13,17.25,18.666667,13,1065,1030,35,0,0,0,0,77,4,3,0.441558,0,0,20,8,false,true,true,0.679,0.321
358,260,98,22.375,17.333333,98,1516,1397,119,0,1,0,0.066667,-9,16,15,-3.666667,0,1,1,6,false,true,true,1,0
363,304,59,24.2,21.714286,59,856,897,-41,0,1,0,0.071429,-10,15,14,-3.5,0,0,9,7,false,true,true,1,0
112,66,46,28,22,46,880,952,-72,0,0,0,0,74,4,3,0.472973,1,1,28,6,false,true,true,0.876,0.124
176,136,40,22,17,40,1244,1361,-117,1,0,0.125,0,55,8,8,0.690909,1,1,7,6,false,true,false,0.336,0.664
158,148,10,22.571429,24.666667,10,290,416,-126,0,0,0,0,54,7,6,0.62963,0,0,10,12,false,true,false,0.286,0.714
263,181,82,29.222222,22.625,82,1550,1466,84,1,0,0.111111,0,40,9,8,0.925,0,0,8,12,false,true,true,0.994,0.006
428,256,172,22.526316,14.222222,172,954,1078,-124,1,1,0.052632,0.055556,-24,19,18,-1.583333,0,0,1,2,false,true,true,1,0
107,96,11,21.4,19.2,11,613,461,152,0,0,0,0,65,5,5,0.569231,0,1,7,11,false,true,true,0.737,0.263
285,253,32,17.8125,15.8125,32,468,542,-74,0,0,0,0,-4,16,16,-9.75,0,0,16,8,false,true,true,0.971,0.029
364,179,185,14,7.16,185,859,719,140,0,1,0,0.04,-36,26,25,-1.472222,0,1,11,9,false,true,true,1,0
28,18,10,14,9,10,1265,1045,220,0,0,0,0,82,2,2,0.512195,0,1,22,21,false,true,false,0.4,0.6
342,233,109,20.117647,14.5625,109,831,830,1,0,0,0,0,-7,17,16,-5.285714,0,0,9,10,false,true,true,1,0
246,172,74,15.375,11.466667,74,947,909,38,0,0,0,0,-3,16,15,-15.333333,0,0,8,32,false,true,true,1,0
370,193,177,37,19.3,177,1550,1624,-74,2,0,0.2,0,27,10,10,1.111111,0,0,11,8,false,true,true,1,0
212,99,113,26.5,14.142857,113,1159,1031,128,1,0,0.125,0,40,8,7,0.975,1,0,15,7,false,true,true,0.971,0.029
80,44,36,20,11,36,1550,1546,4,0,0,0,0,73,4,4,0.410959,0,0,18,17,false,true,true,0.774,0.226
321,237,84,16.894737,13.166667,84,272,288,-16,0,0,0,0,1,19,18,52,0,0,10,9,false,true,true,1,0
117,83,34,23.4,16.6,34,704,691,13,0,0,0,0,64,5,5,0.59375,0,0,15,14,false,true,true,0.864,0.136
104,54,50,26,18,50,1803,1552,251,0,0,0,0,75,4,3,0.373333,0,0,11,10,false,true,true,1,0
212,109,103,30.285714,15.571429,103,1439,1353,86,1,0,0.142857,0,49,7,7,0.612245,1,0,18,11,false,true,true,0.991,0.009
326,307,19,18.111111,17.055556,19,1078,1130,-52,0,1,0,0.055556,-24,18,18,-1.625,0,0,2,1,false,true,true,0.959,0.041
271,276,-5,15.055556,15.333333,-5,262,306,-44,0,0,0,0,-19,18,18,-2.421053,0,0,8,8,false,true,false,0.357,0.643
162,91,71,40.5,30.333333,71,1633,1580,53,1,0,0.25,0,71,4,3,0.394366,0,0,14,18,false,true,true,0.816,0.184
114,159,-45,19,26.5,-45,1554,1573,-19,0,0,0,0,57,6,6,0.596491,0,0,18,11,false,true,false,0.202,0.798
186,134,52,18.6,14.888889,52,711,876,-165,0,0,0,0,37,10,9,1.162162,0,1,11,18,false,true,true,0.663,0.337
333,211,122,16.65,10.55,122,218,86,132,0,0,0,0,-30,20,20,-1.333333,0,0,2,6,true,true,true,1,0
15,27,-12,7.5,13.5,-12,95,378,-283,0,0,0,0,86,2,2,0.406977,0,0,10,11,false,true,false,0.254,0.746
10,76,-66,10,76,-66,315,294,21,0,1,0,1,89,1,1,0.393258,0,0,17,23,false,true,false,0.005,0.995
328,294,34,19.294118,18.375,34,561,526,35,0,0,0,0,-21,17,16,-1.666667,0,0,3,9,false,true,true,1,0
22,14,8,22,14,8,880,952,-72,0,0,0,0,91,1,1,0.450549,0,0,9,7,false,true,false,0.41,0.59
6,0,6,6,0,6,450,412,38,0,0,0,0,97,1,0,0.391753,0,0,14,0,false,true,false,0.347,0.653
142,197,-55,20.285714,28.142857,-55,1539,1537,2,0,1,0,0.142857,53,7,7,0.603774,1,0,6,8,false,true,false,0.229,0.771
288,193,95,28.8,19.3,95,1030,998,32,1,0,0.1,0,23,10,10,1.652174,0,0,13,10,false,true,true,1,0
33,32,1,11,16,1,628,658,-30,0,0,0,0,82,3,2,0.560976,1,0,35,12,false,true,true,0.69,0.31
350,220,130,17.5,11,130,871,867,4,0,0,0,0,-18,20,20,-2.388889,0,0,6,9,false,true,true,1,0
159,106,53,22.714286,17.666667,53,1572,1550,22,1,0,0.142857,0,55,7,6,0.709091,0,0,24,10,false,true,true,0.84,0.16
121,88,33,24.2,17.6,33,830,907,-77,1,0,0.2,0,63,5,5,0.619048,0,0,9,13,false,true,true,0.602,0.398
98,113,-15,19.6,28.25,-15,1554,1573,-19,0,0,0,0,68,5,4,0.5,0,0,9,9,false,true,false,0.23,0.77
103,56,47,20.6,14,47,947,909,38,0,0,0,0,72,5,4,0.638889,1,0,13,28,false,true,true,0.926,0.074
128,77,51,32,25.666667,51,1793,1897,-104,1,0,0.25,0,75,4,3,0.4,0,0,7,21,false,true,true,0.604,0.396
329,328,1,25.307692,25.230769,1,1102,1245,-143,2,0,0.153846,0,-22,13,13,-1.272727,0,0,1,1,false,true,true,0.999,0.001
37,15,22,18.5,7.5,22,584,565,19,0,0,0,0,86,2,2,0.534884,0,0,15,19,false,true,true,0.55,0.45
14,20,-6,14,20,-6,1245,1232,13,0,0,0,0,88,1,1,0.329545,0,0,10,11,false,true,true,0.677,0.323
403,288,115,25.1875,19.2,115,1489,1445,44,1,0,0.0625,0,-11,16,15,-2.909091,0,0,2,4,false,true,true,1,0
355,378,-23,23.666667,25.2,-23,834,844,-10,1,2,0.066667,0.133333,-14,15,15,-2.571429,0,0,3,9,false,true,false,0,1
117,114,3,16.714286,19,3,316,306,10,0,2,0,0.333333,56,7,6,0.678571,0,1,16,13,false,true,true,1,0
30,0,30,30,0,30,1004,653,351,0,0,0,0,94,1,0,0.37234,1,0,11,0,false,true,true,0.927,0.073
318,248,70,22.714286,19.076923,70,1305,1218,87,1,0,0.071429,0,3,14,13,12.666667,0,0,13,8,false,true,true,1,0
346,326,20,18.210526,18.111111,20,1334,1270,64,1,0,0.052632,0,-12,19,18,-3.083333,0,0,2,2,true,true,true,1,0
432,393,39,30.857143,30.230769,39,1633,1580,53,3,1,0.214286,0.076923,-13,14,13,-2.153846,0,0,2,3,false,true,true,1,0
192,159,33,17.454545,15.9,33,613,461,152,0,1,0,0.1,20,11,10,1.85,0,0,11,19,false,true,true,0.826,0.174
340,326,14,17,17.157895,14,1127,1176,-49,0,0,0,0,-20,20,19,-2.1,0,0,2,1,false,true,true,0.999,0.001
181,143,38,25.857143,23.833333,38,965,1013,-48,1,0,0.142857,0,47,7,6,0.702128,0,1,20,10,false,true,false,0.192,0.808
395,325,70,32.916667,29.545455,70,1348,1331,17,4,1,0.333333,0.090909,-12,12,11,-2,0,0,1,3,false,true,true,1,0
369,219,150,21.705882,13.6875,150,777,830,-53,1,0,0.058824,0,-4,17,16,-10.25,0,0,13,12,false,true,true,1,0
183,166,17,30.5,27.666667,17,1770,1689,81,0,0,0,0,47,6,6,0.553191,0,1,8,7,false,true,true,0.516,0.484
232,163,69,23.2,18.111111,69,825,907,-82,1,0,0.1,0,34,10,9,1.176471,0,0,24,9,false,true,true,0.884,0.116
271,229,42,19.357143,16.357143,42,808,639,169,0,0,0,0,10,14,14,4.1,0,1,11,8,false,true,true,0.898,0.102
323,212,111,24.846154,17.666667,111,801,925,-124,1,0,0.076923,0,10,13,12,3.5,1,0,11,12,false,true,true,1,0
101,177,-76,20.2,35.4,-76,2219,2029,190,0,0,0,0,55,5,5,0.472727,1,0,12,8,false,true,false,0.031,0.969
463,425,38,35.615385,35.416667,38,1885,1793,92,0,0,0,0,-7,13,12,-3.857143,0,0,3,2,false,true,true,1,0
334,285,49,20.875,17.8125,49,306,169,137,0,0,0,0,-26,16,16,-1.307692,0,0,1,1,false,true,true,1,0
189,177,12,18.9,19.666667,12,1547,1439,108,1,0,0.1,0,37,10,9,1,0,0,15,7,false,true,false,0.383,0.617
328,296,32,14.909091,14.095238,32,480,518,-38,0,0,0,0,-27,22,21,-1.703704,0,0,1,4,false,true,true,1,0
311,178,133,20.733333,11.866667,133,1067,95,972,1,0,0.066667,0,-1,15,15,-34,1,0,6,12,false,true,true,1,0
124,30,94,41.333333,15,94,1408,1454,-46,1,0,0.333333,0,78,3,2,0.410256,0,0,10,22,false,true,true,0.868,0.132
162,59,103,32.4,14.75,103,1156,1114,42,1,0,0.2,0,59,5,4,0.542373,0,0,16,10,false,true,true,0.968,0.032
14,0,14,14,0,14,306,169,137,0,0,0,0,96,1,0,0.354167,0,0,22,0,false,true,true,0.695,0.305
11,20,-9,5.5,20,-9,977,976,1,0,0,0,0,94,2,1,0.361702,0,0,14,9,false,true,true,0.607,0.393
258,195,63,17.2,13.928571,63,566,542,24,0,0,0,0,11,15,14,3.727273,0,1,22,6,false,true,true,0.972,0.028
396,321,75,22,18.882353,75,1556,1591,-35,2,0,0.111111,0,-26,18,17,-1.384615,0,0,1,1,false,true,true,1,0
395,325,70,32.916667,27.083333,70,1348,1331,17,4,1,0.333333,0.083333,-12,12,12,-2,0,0,1,3,true,true,true,1,0
367,312,55,17.47619,15.6,55,904,783,121,0,0,0,0,-31,21,20,-1.354839,1,0,1,3,false,true,true,1,0
221,199,22,17,16.583333,22,527,581,-54,0,0,0,0,15,13,12,2.8,0,0,17,16,false,true,true,0.611,0.389
165,87,78,33,21.75,78,1935,2020,-85,0,0,0,0,65,5,4,0.476923,1,0,7,12,false,true,true,0.944,0.056
207,197,10,20.7,19.7,10,809,868,-59,1,0,0.1,0,28,10,10,1.142857,0,0,17,20,false,true,true,0.756,0.244
279,236,43,25.363636,21.454545,43,1109,1065,44,0,0,0,0,7,11,11,4.714286,0,0,20,10,false,true,true,0.968,0.032
378,307,71,37.8,34.111111,71,1885,1793,92,0,0,0,0,18,10,9,1.5,1,0,8,9,false,true,true,1,0
217,297,-80,19.727273,27,-80,1501,1473,28,0,0,0,0,20,11,11,1.8,0,1,13,6,false,true,false,0,1
357,179,178,15.521739,7.782609,178,859,719,140,0,1,0,0.043478,-33,23,23,-1.606061,0,1,12,9,false,true,true,1,0
164,140,24,18.222222,15.555556,24,1397,1422,-25,1,0,0.111111,0,47,9,9,0.765957,0,2,9,19,false,true,true,0.545,0.455
97,133,-36,19.4,26.6,-36,1102,1245,-143,0,0,0,0,54,5,5,0.518519,1,0,11,8,false,true,true,0.532,0.468
210,214,-4,21,21.4,-4,1304,1040,264,1,0,0.1,0,31,10,10,1.064516,0,0,21,12,false,true,false,0.254,0.746
302,170,132,30.2,18.888889,132,1826,1803,23,1,0,0.1,0,25,10,9,1.2,1,0,15,7,false,true,true,1,0
102,18,84,51,18,84,1770,1689,81,0,0,0,0,83,2,1,0.313253,0,1,10,20,false,true,true,0.968,0.032
257,209,48,32.125,29.857143,48,1633,1580,53,2,0,0.25,0,37,8,7,0.756757,0,0,9,18,false,true,true,0.96,0.04
253,220,33,19.461538,18.333333,33,518,448,70,0,0,0,0,11,13,12,3.090909,0,0,14,18,false,true,true,0.806,0.194
244,199,45,22.181818,18.090909,45,1439,1294,145,1,0,0.090909,0,26,11,11,1.384615,0,0,10,28,false,true,true,0.98,0.02
110,88,22,22,17.6,22,1069,917,152,0,0,0,0,65,5,5,0.523077,0,1,11,7,false,true,true,0.798,0.202
83,53,30,20.75,13.25,30,971,658,313,0,0,0,0,71,4,4,0.507042,0,0,17,10,false,true,true,0.836,0.164
380,212,168,25.333333,15.142857,168,778,758,20,0,1,0,0.071429,-5,15,14,-7.8,0,0,8,11,false,true,true,1,0
358,272,86,17.047619,12.952381,86,711,876,-165,0,0,0,0,-18,21,21,-2.388889,0,0,3,1,false,true,true,1,0
253,192,61,21.083333,16,61,746,796,-50,0,1,0,0.083333,17,12,12,2.823529,0,1,23,6,false,true,true,0.944,0.056
158,144,14,17.555556,16,14,871,999,-128,0,0,0,0,40,9,9,1.2,0,1,7,25,false,true,false,0.087,0.913
370,292,78,24.666667,19.466667,78,977,976,1,1,0,0.066667,0,-2,15,15,-17,1,0,10,6,false,true,true,1,0
164,213,-49,23.428571,35.5,-49,1554,1716,-162,1,1,0.142857,0.166667,45,7,6,0.777778,0,0,18,7,false,true,false,0.368,0.632
324,317,7,19.058824,18.647059,7,901,889,12,0,1,0,0.058824,-9,17,17,-4.777778,0,0,11,16,false,true,true,0.936,0.064
317,285,32,17.611111,15.833333,32,334,446,-112,0,0,0,0,-25,18,18,-1.6,0,0,4,7,false,true,true,1,0
131,74,57,21.833333,12.333333,57,838,786,52,0,0,0,0,60,6,6,0.533333,0,1,9,11,false,true,true,0.848,0.152
184,204,-20,26.285714,29.142857,-20,1434,1493,-59,1,0,0.142857,0,40,7,7,0.925,1,1,9,11,false,true,false,0.278,0.722
374,253,121,26.714286,18.071429,121,1211,1173,38,0,0,0,0,8,14,14,4.375,0,0,7,7,false,true,true,1,0
236,232,4,18.153846,19.333333,4,892,788,104,2,0,0.153846,0,19,13,12,2.263158,0,0,12,22,false,true,false,0.131,0.869
20,8,12,10,8,12,1011,921,90,0,0,0,0,90,2,1,0.544444,0,0,7,17,false,true,true,0.654,0.346
218,152,66,24.222222,19,66,1295,1281,14,0,0,0,0,48,9,8,0.791667,0,0,7,19,false,true,true,0.891,0.109
160,160,0,16,17.777778,0,725,771,-46,0,1,0,0.111111,39,10,9,1.179487,1,0,9,19,false,true,false,0.348,0.652
131,127,4,21.833333,21.166667,4,871,999,-128,0,0,0,0,57,6,6,0.842105,0,0,8,9,false,true,false,0.255,0.745
326,249,77,21.733333,17.785714,77,1439,1413,26,0,0,0,0,6,15,14,6,1,1,11,6,false,true,true,1,0
37,50,-13,9.25,12.5,-13,904,857,47,0,0,0,0,72,4,4,0.569444,0,1,33,15,false,true,true,0.651,0.349
303,230,73,23.307692,17.692308,73,1110,1039,71,0,0,0,0,6,13,13,6,0,0,11,10,false,true,true,1,0
73,101,-28,18.25,25.25,-28,1177,1214,-37,0,0,0,0,72,4,4,0.486111,0,0,15,12,false,true,false,0.486,0.514
122,101,21,30.5,33.666667,21,1030,998,32,0,0,0,0,72,4,3,0.527778,0,0,10,10,false,true,true,0.679,0.321
92,90,2,23,30,2,1333,1331,2,0,0,0,0,72,4,3,0.416667,1,0,20,7,false,true,true,0.928,0.072
293,215,78,24.416667,17.916667,78,371,336,35,2,0,0.166667,0,-2,12,12,-19,0,0,8,20,false,true,true,1,0
268,221,47,22.333333,18.416667,47,1439,1413,26,0,0,0,0,23,12,12,1.565217,1,0,12,7,false,true,true,0.979,0.021
291,226,65,22.384615,17.384615,65,1221,1266,-45,0,0,0,0,7,13,13,5,2,0,9,7,false,true,true,1,0
326,279,47,17.157895,14.684211,47,468,542,-74,0,0,0,0,-19,19,19,-2.052632,0,0,2,1,false,true,true,1,0
225,111,114,32.142857,18.5,114,1075,1027,48,2,0,0.285714,0,49,7,6,0.755102,0,0,8,13,false,true,true,0.975,0.025
294,258,36,21,19.846154,36,1244,1361,-117,2,1,0.142857,0.076923,17,14,13,2.235294,0,0,16,11,false,true,true,0.842,0.158
266,237,29,20.461538,19.75,29,804,988,-184,1,0,0.076923,0,11,13,12,3,1,0,6,14,false,true,false,0.248,0.752
247,171,76,27.444444,21.375,76,1731,1691,40,1,0,0.111111,0,31,9,8,1.096774,0,0,8,8,false,true,true,0.874,0.126
22,0,22,22,0,22,1670,1770,-100,0,0,0,0,96,1,0,0.333333,0,0,19,0,false,true,true,0.672,0.328
165,115,50,41.25,28.75,50,991,996,-5,1,0,0.25,0,67,4,4,0.447761,0,0,15,7,false,true,true,0.894,0.106
402,262,140,19.142857,12.47619,140,1413,1422,-9,0,0,0,0,-20,21,21,-2.85,0,0,5,7,false,true,true,1,0
204,122,82,34,24.4,82,971,621,350,2,0,0.333333,0,52,6,5,0.615385,0,0,17,11,false,true,true,0.97,0.03
127,147,-20,21.166667,24.5,-20,942,976,-34,0,0,0,0,57,6,6,0.701754,1,0,12,17,false,true,false,0.403,0.597
66,56,10,16.5,18.666667,10,421,306,115,0,1,0,0.333333,66,4,3,0.666667,0,0,14,8,false,true,true,0.796,0.204
364,354,10,24.266667,25.285714,10,1265,1237,28,1,0,0.066667,0,-12,15,14,-2.5,0,0,4,7,false,true,true,1,0
329,204,125,19.352941,12,125,595,543,52,0,0,0,0,-5,17,17,-9.4,0,0,7,9,false,true,true,1,0
221,159,62,24.555556,17.666667,62,526,370,156,0,0,0,0,32,9,9,1.09375,0,0,7,7,false,true,true,0.97,0.03
68,22,46,68,22,46,1245,1241,4,1,1,1,1,86,1,1,0.337209,0,0,14,17,false,true,true,0.925,0.075
83,74,9,16.6,14.8,9,620,658,-38,0,0,0,0,64,5,5,0.5625,1,0,16,7,false,true,true,0.873,0.127
139,151,-12,17.375,18.875,-12,527,514,13,0,0,0,0,42,8,8,0.928571,0,1,10,14,false,true,false,0.074,0.926
130,131,-1,32.5,32.75,-1,1428,1606,-178,1,0,0.25,0,63,4,4,0.507937,1,0,15,12,false,true,false,0.456,0.544
214,191,23,23.777778,21.222222,23,1489,1445,44,0,0,0,0,36,9,9,0.888889,0,0,11,13,false,true,false,0.287,0.713
16,0,16,16,0,16,1431,825,606,0,0,0,0,96,1,0,0.354167,0,0,10,0,false,true,true,1,0
249,86,163,22.636364,7.818182,163,896,818,78,0,0,0,0,40,11,11,1.1,0,0,8,11,false,true,true,1,0
81,54,27,16.2,13.5,27,847,952,-105,0,0,0,0,75,5,4,0.48,0,0,16,15,false,true,false,0.268,0.732
342,308,34,22.8,20.533333,34,901,1159,-258,2,0,0.133333,0,-7,15,15,-5,0,0,22,8,false,true,true,1,0
38,63,-25,9.5,15.75,-25,1221,1258,-37,0,0,0,0,78,4,4,0.5,0,0,8,19,false,true,false,0.05,0.95
360,321,39,24,22.928571,39,1439,1397,42,1,2,0.066667,0.142857,-11,15,14,-3.090909,0,0,3,15,false,true,true,1,0
318,281,37,18.705882,16.529412,37,363,668,-305,0,0,0,0,-2,17,17,-21.5,0,1,12,8,false,true,true,0.881,0.119
70,48,22,23.333333,16,22,739,480,259,0,0,0,0,78,3,3,0.461538,0,0,9,9,false,true,true,0.79,0.21
34,0,34,34,0,34,1428,1452,-24,0,0,0,0,95,1,0,0.326316,0,0,24,0,false,true,true,0.693,0.307
307,278,29,19.1875,18.533333,29,784,758,26,0,0,0,0,-10,16,15,-3.5,1,0,3,6,false,true,true,0.99,0.01
307,285,22,19.1875,17.8125,22,784,758,26,0,0,0,0,-13,16,16,-2.692308,1,0,3,2,false,true,true,0.993,0.007
340,236,104,20,14.75,104,1181,1069,112,0,0,0,0,-10,17,16,-3.7,0,0,3,12,false,true,true,1,0
259,175,84,19.923077,13.461538,84,1091,1078,13,0,0,0,0,25,13,13,1.72,0,0,9,15,false,true,true,0.998,0.002
218,215,3,19.818182,19.545455,3,892,788,104,2,0,0.181818,0,26,11,11,1.653846,0,0,7,19,false,true,true,0.842,0.158
366,222,144,24.4,15.857143,144,939,907,32,1,0,0.066667,0,7,15,14,5.714286,0,0,11,7,false,true,true,1,0
367,307,60,21.588235,19.1875,60,1089,1063,26,1,0,0.058824,0,-14,17,16,-2.714286,0,0,3,6,false,true,true,1,0
75,91,-16,15,18.2,-16,1221,1266,-45,0,0,0,0,63,5,5,0.555556,0,0,9,7,false,true,true,0.663,0.337
247,245,2,22.454545,22.272727,2,1127,1075,52,1,1,0.090909,0.090909,19,11,11,1.631579,0,1,11,7,false,true,true,0.536,0.464
352,265,87,19.555556,14.722222,87,971,658,313,0,0,0,0,-19,18,18,-1.894737,0,0,1,3,true,true,true,1,0
61,58,3,15.25,14.5,3,808,812,-4,0,0,0,0,68,4,4,0.544118,0,1,11,11,false,true,true,0.55,0.45
345,275,70,19.166667,15.277778,70,1170,1156,14,1,0,0.055556,0,-24,18,18,-1.583333,0,0,1,2,false,true,true,1,0
343,226,117,26.384615,18.833333,117,1144,1014,130,0,0,0,0,16,13,12,2.25,0,1,9,9,false,true,true,1,0
91,97,-6,22.75,32.333333,-6,1554,1573,-19,0,0,0,0,76,4,3,0.447368,0,0,12,9,false,true,false,0.447,0.553
62,25,37,20.666667,12.5,37,786,976,-190,0,0,0,0,87,3,2,0.367816,0,0,8,12,false,true,false,0.273,0.727
172,201,-29,21.5,25.125,-29,290,416,-126,0,0,0,0,44,8,8,0.772727,0,0,18,12,false,true,false,0.108,0.892
63,33,30,21,11,30,1270,1348,-78,0,0,0,0,82,3,3,0.463415,1,0,16,17,false,true,true,0.67,0.33
122,46,76,24.4,11.5,76,1115,1078,37,0,0,0,0,66,5,4,0.515152,0,0,17,15,false,true,true,0.858,0.142
342,260,82,31.090909,23.636364,82,1093,1100,-7,3,2,0.272727,0.181818,22,11,11,1.454545,0,0,14,10,false,true,true,1,0
330,315,15,17.368421,17.5,15,1164,1201,-37,0,0,0,0,-20,19,18,-2.1,0,0,6,5,false,true,true,0.998,0.002
194,136,58,19.4,13.6,58,1413,1422,-9,0,0,0,0,38,10,10,1.5,2,0,17,9,false,true,true,0.993,0.007
235,179,56,15.666667,12.785714,56,871,999,-128,0,0,0,0,16,15,14,3,0,0,7,15,false,true,true,0.747,0.253
291,279,12,24.25,23.25,12,1355,1210,145,1,0,0.083333,0,17,12,12,1.764706,1,0,9,11,false,true,true,0.828,0.172
197,187,10,28.142857,26.714286,10,1428,1452,-24,0,0,0,0,51,7,7,0.607843,0,1,12,9,false,true,false,0.5,0.5
137,87,50,22.833333,17.4,50,421,306,115,0,1,0,0.2,50,6,5,0.88,0,0,9,10,false,true,true,0.971,0.029
325,282,43,21.666667,20.142857,43,1304,1040,264,1,0,0.066667,0,1,15,14,33,0,1,4,14,false,true,true,0.989,0.011
384,267,117,29.538462,22.25,117,1396,1454,-58,2,0,0.153846,0,8,13,12,4.125,0,0,13,20,false,true,true,1,0
117,127,-10,16.714286,18.142857,-10,611,584,27,0,0,0,0,59,7,7,0.745763,0,0,10,7,false,true,false,0.392,0.608
340,217,123,13.6,8.68,123,1428,1302,126,0,0,0,0,-29,25,25,-1.827586,0,1,12,11,false,true,true,1,0
135,169,-34,27,33.8,-34,1333,1331,2,0,0,0,0,59,5,5,0.508475,1,0,8,11,false,true,true,0.706,0.294
339,214,125,24.214286,16.461538,125,1482,1394,88,2,0,0.142857,0,8,14,13,4.5,0,0,10,8,false,true,true,1,0
423,265,158,26.4375,17.666667,158,1167,1216,-49,1,0,0.0625,0,4,16,15,10.25,0,0,7,10,false,true,true,1,0
314,292,22,17.444444,16.222222,22,908,859,49,0,0,0,0,-12,18,18,-3.25,0,0,5,2,false,true,true,0.981,0.019
123,226,-103,20.5,37.666667,-103,1762,1538,224,0,2,0,0.333333,50,6,6,0.68,1,0,9,14,false,true,true,0.999,0.001
374,224,150,28.769231,18.666667,150,1270,1322,-52,1,0,0.076923,0,13,13,12,2.923077,0,0,13,17,false,true,true,1,0
352,307,45,22,19.1875,45,1089,1063,26,1,0,0.0625,0,-11,16,16,-3.454545,0,0,5,6,false,true,true,1,0
203,157,46,15.615385,12.076923,46,777,830,-53,0,0,0,0,23,13,13,1.782609,0,0,14,10,false,true,true,0.898,0.102
114,61,53,22.8,15.25,53,576,532,44,0,0,0,0,67,5,4,0.686567,1,0,9,10,false,true,true,0.948,0.052
262,239,23,16.375,15.933333,23,808,812,-4,0,0,0,0,-3,16,15,-12.333333,1,0,11,11,false,true,true,0.768,0.232
233,223,10,25.888889,27.875,10,974,995,-21,0,1,0,0.125,32,9,8,1.03125,0,0,18,11,false,true,false,0.441,0.559
245,175,70,18.846154,14.583333,70,566,542,24,0,0,0,0,20,13,12,2.05,0,1,26,7,false,true,true,0.984,0.016
277,238,39,27.7,23.8,39,965,1013,-48,1,0,0.1,0,22,10,10,1.5,0,1,10,9,false,true,false,0.139,0.861
290,181,109,22.307692,15.083333,109,954,1078,-124,0,1,0,0.083333,15,13,12,2.533333,1,0,6,14,false,true,true,1,0
110,113,-3,15.714286,16.142857,-3,566,542,24,0,0,0,0,50,7,7,0.82,0,0,21,11,false,true,true,0.701,0.299
264,139,125,18.857143,10.692308,125,1176,1076,100,0,0,0,0,40,14,13,1.475,0,0,10,11,false,true,true,1,0
12,0,12,12,0,12,1344,1325,19,0,0,0,0,96,1,0,0.322917,0,0,20,0,false,true,true,0.678,0.322
58,26,32,19.333333,13,32,1501,1473,28,0,0,0,0,81,3,2,0.444444,0,1,14,10,false,true,true,0.696,0.304
322,173,149,24.769231,14.416667,149,742,696,46,0,0,0,0,7,13,12,4.571429,0,0,12,16,false,true,true,1,0
162,106,56,16.2,11.777778,56,498,43,455,0,0,0,0,32,10,9,1.15625,0,0,11,7,false,true,true,0.963,0.037
10,26,-16,10,26,-16,566,542,24,0,0,0,0,94,1,1,0.43617,0,0,11,12,false,true,true,0.606,0.394
50,72,-22,12.5,18,-22,1093,1090,3,0,0,0,0,77,4,4,0.441558,1,0,13,10,false,true,true,0.657,0.343
288,226,62,16.941176,13.294118,62,786,788,-2,0,0,0,0,-20,17,17,-1.7,1,0,2,14,true,true,true,1,0
258,177,81,36.857143,25.285714,81,1203,1221,-18,2,0,0.285714,0,48,7,7,0.729167,0,0,9,9,false,true,true,0.985,0.015
21,68,-47,10.5,68,-47,1762,1538,224,0,1,0,1,86,2,1,0.395349,0,0,13,24,false,true,true,0.997,0.003
169,124,45,16.9,12.4,45,1048,1000,48,0,0,0,0,40,10,10,1,0,1,11,15,false,true,true,0.77,0.23
299,254,45,19.933333,18.142857,45,1210,1253,-43,0,1,0,0.071429,-2,15,14,-17.5,1,0,8,16,false,true,true,0.994,0.006
107,57,50,35.666667,19,50,1270,1322,-52,1,0,0.333333,0,81,3,3,0.469136,1,0,18,16,false,true,true,0.975,0.025
120,109,11,24,21.8,11,1302,1082,220,0,0,0,0,55,5,5,0.545455,0,0,17,12,false,true,true,0.508,0.492
99,155,-56,16.5,31,-56,758,952,-194,0,0,0,0,53,6,5,0.754717,0,0,24,13,false,true,false,0.111,0.889
78,49,29,26,16.333333,29,576,532,44,0,0,0,0,77,3,3,0.597403,1,0,9,9,false,true,true,0.911,0.089
248,213,35,24.8,23.666667,35,1030,1144,-114,0,1,0,0.111111,37,10,9,0.945946,0,1,13,14,false,true,false,0.198,0.802
381,292,89,23.8125,19.466667,89,977,976,1,2,0,0.125,0,-9,16,15,-3.777778,0,0,4,6,false,true,true,1,0
365,363,2,21.470588,22.6875,2,1636,1576,60,0,2,0,0.125,-17,17,16,-2,0,0,1,13,false,true,true,1,0
245,203,42,16.333333,14.5,42,613,502,111,0,0,0,0,3,15,14,16.333333,1,1,7,18,false,true,true,0.559,0.441
12,0,12,12,0,12,1077,1094,-17,0,0,0,0,96,1,0,0.4375,0,0,12,0,false,true,true,0.648,0.352
136,99,37,34,33,37,1344,1209,135,0,1,0,0.333333,69,4,3,0.492754,0,0,10,12,false,true,true,0.606,0.394
156,154,2,26,25.666667,2,1793,1897,-104,1,0,0.166667,0,55,6,6,0.545455,0,0,10,13,false,true,true,0.654,0.346
309,203,106,17.166667,11.941176,106,913,871,42,0,0,0,0,-8,18,17,-5.375,0,1,4,15,false,true,true,1,0
241,162,79,17.214286,12.461538,79,1128,889,239,0,1,0,0.076923,24,14,13,1.958333,0,0,18,18,false,true,true,1,0
201,161,40,16.75,13.416667,40,498,43,455,0,0,0,0,17,12,12,2.176471,0,0,14,12,false,true,true,0.967,0.033
224,177,47,20.363636,16.090909,47,1159,1051,108,0,0,0,0,31,11,11,1.290323,0,0,7,11,false,true,true,0.825,0.175
131,121,10,26.2,30.25,10,1428,1452,-24,0,0,0,0,70,5,4,0.442857,0,0,15,9,false,true,true,0.653,0.347
159,210,-51,19.875,30,-51,834,844,-10,0,1,0,0.142857,41,8,7,0.878049,0,2,14,9,false,true,false,0.004,0.996
341,283,58,28.416667,25.727273,58,1793,1897,-104,2,0,0.166667,0,11,12,11,2.727273,0,0,14,10,false,true,true,1,0
66,0,66,66,0,66,1075,1027,48,1,0,1,0,93,1,0,0.397849,0,0,8,0,false,true,true,0.656,0.344
314,198,116,26.166667,18,116,1029,1227,-198,1,0,0.083333,0,5,12,11,6.4,0,0,7,11,false,true,true,1,0
368,280,88,18.4,14,88,719,651,68,0,1,0,0.05,-21,20,20,-2.142857,0,0,4,3,false,true,true,1,0
107,36,71,21.4,9,71,1516,1397,119,0,0,0,0,69,5,4,0.478261,0,1,21,9,false,true,true,0.848,0.152
153,146,7,17,18.25,7,1583,1422,161,0,0,0,0,53,9,8,0.962264,1,0,16,9,false,true,true,0.578,0.422
76,22,54,25.333333,11,54,901,889,12,0,0,0,0,87,3,2,0.494253,0,1,9,7,false,true,true,0.687,0.313
339,187,152,30.818182,18.7,152,1826,1803,23,1,0,0.090909,0,20,11,10,1.5,1,0,18,10,false,true,true,1,0
284,188,96,17.75,12.533333,96,218,86,132,0,0,0,0,-7,16,15,-5.714286,0,0,19,12,false,true,true,1,0
0,30,-30,0,30,-30,1397,1195,202,0,0,0,0,95,1,1,0.368421,1,0,6,25,false,true,false,0.187,0.813
10,9,1,10,9,1,584,565,19,0,0,0,0,93,1,1,0.494624,0,1,13,20,false,true,false,0.253,0.747
66,60,6,16.5,20,6,921,1072,-151,0,0,0,0,77,4,3,0.493506,0,0,10,9,false,true,false,0.251,0.749
311,228,83,34.555556,28.5,83,1302,1349,-47,0,1,0,0.125,27,9,8,1.037037,0,0,9,16,false,true,true,1,0
56,20,36,28,20,36,695,671,24,0,0,0,0,86,2,1,0.383721,0,0,17,12,false,true,true,0.716,0.284
342,224,118,26.307692,18.666667,118,1030,998,32,1,0,0.076923,0,7,13,12,5.428571,0,0,17,19,false,true,true,1,0
24,37,-13,12,18.5,-13,971,761,210,0,0,0,0,85,2,2,0.352941,0,1,7,7,false,true,false,0.408,0.592
323,203,120,35.888889,25.375,120,1890,2020,-130,1,1,0.111111,0.125,24,9,8,1.208333,0,0,12,9,false,true,true,1,0
416,273,143,27.733333,19.5,143,1101,1078,23,1,0,0.066667,0,-6,15,14,-5.5,0,1,4,5,false,true,true,1,0
465,256,209,29.0625,16,209,1054,917,137,2,0,0.125,0,-26,16,16,-1.346154,0,0,24,6,false,true,true,1,0
148,145,3,18.5,18.125,3,808,812,-4,0,0,0,0,40,8,8,0.925,1,0,16,16,false,true,true,0.918,0.082
276,240,36,23,21.818182,36,1388,1506,-118,2,1,0.166667,0.090909,26,12,11,1.307692,0,0,11,21,false,true,true,0.838,0.162
235,208,27,19.583333,17.333333,27,885,719,166,0,0,0,0,22,12,12,1.727273,1,0,7,12,false,true,true,0.752,0.248
440,249,191,19.130435,11.318182,191,1295,1477,-182,3,0,0.130435,0,-26,23,22,-1.769231,0,0,1,1,false,true,true,1,0
347,325,22,15.086957,14.130435,22,628,658,-30,0,0,0,0,-29,23,23,-1.586207,0,0,1,3,true,true,true,1,0
218,178,40,14.533333,12.714286,40,1029,1075,-46,0,0,0,0,20,15,14,2.4,2,0,8,20,false,true,true,0.625,0.375
393,307,86,26.2,21.928571,86,1428,1606,-178,1,0,0.066667,0,-9,15,14,-3.555556,0,0,2,3,false,true,true,1,0
118,111,7,16.857143,15.857143,7,758,750,8,0,0,0,0,47,7,7,0.787234,0,1,13,9,false,true,true,0.721,0.279
53,38,15,26.5,19,15,880,952,-72,0,0,0,0,85,2,2,0.411765,0,1,22,9,false,true,false,0.286,0.714
18,0,18,18,0,18,859,786,73,0,0,0,0,96,1,0,0.395833,0,0,12,0,false,true,true,0.683,0.317
8,14,-6,8,14,-6,1100,1008,92,0,0,0,0,93,1,1,0.387097,0,0,21,9,false,true,true,0.677,0.323
130,86,44,21.666667,14.333333,44,1055,1050,5,0,0,0,0,60,6,6,0.566667,0,0,13,11,false,true,true,0.847,0.153
47,27,20,23.5,13.5,20,1216,1228,-12,0,0,0,0,85,2,2,0.388235,0,0,12,16,false,true,true,0.688,0.312
81,53,28,16.2,13.25,28,1519,1782,-263,0,0,0,0,76,5,4,0.434211,0,1,9,6,false,true,false,0.257,0.743
316,226,90,26.333333,20.545455,90,1034,1040,-6,1,0,0.083333,0,15,12,11,2.333333,1,0,6,16,false,true,true,1,0
310,186,124,31,20.666667,124,1093,1197,-104,2,0,0.2,0,30,10,9,1.033333,1,0,8,9,false,true,true,1,0
338,153,185,42.25,21.857143,185,1571,1554,17,2,1,0.25,0.142857,31,8,7,1.064516,0,0,20,18,false,true,true,1,0
187,108,79,23.375,13.5,79,421,306,115,0,1,0,0.125,33,8,8,1.333333,0,0,34,7,false,true,true,1,0
51,30,21,17,15,21,526,370,156,0,0,0,0,83,3,2,0.421687,1,0,11,17,false,true,true,0.892,0.108
414,284,130,18.818182,12.909091,130,942,1003,-61,0,0,0,0,-37,22,22,-1.216216,1,0,0,1,false,true,true,1,0
354,248,106,32.181818,24.8,106,1489,1405,84,2,0,0.181818,0,16,11,10,1.75,0,0,8,19,false,true,true,1,0
296,207,89,17.411765,12.9375,89,691,675,16,0,0,0,0,-8,17,16,-4.75,0,0,4,16,false,true,true,1,0
236,203,33,19.666667,16.916667,33,1159,1051,108,0,0,0,0,25,12,12,1.6,0,0,11,9,false,true,true,0.685,0.315
465,332,133,35.769231,27.666667,133,1824,1793,31,1,0,0.076923,0,-5,13,12,-5.6,0,0,7,11,false,true,true,1,0
18,28,-10,18,28,-10,1482,1554,-72,0,0,0,0,94,1,1,0.382979,1,0,9,11,false,true,true,0.909,0.091
72,82,-10,14.4,16.4,-10,580,620,-40,0,0,0,0,68,5,5,0.632353,1,0,18,11,false,true,true,0.537,0.463
99,96,3,12.375,13.714286,3,416,222,194,0,0,0,0,50,8,7,1.1,1,0,9,7,false,true,true,0.897,0.103
198,176,22,15.230769,14.666667,22,1029,1075,-46,0,0,0,0,28,13,12,1.714286,2,0,9,20,false,true,true,0.609,0.391
183,141,42,15.25,12.818182,42,218,86,132,0,0,0,0,18,12,11,2.222222,0,0,19,11,false,true,true,0.97,0.03
125,108,17,15.625,13.5,17,448,598,-150,0,0,0,0,44,8,8,0.818182,1,0,20,12,false,true,true,0.68,0.32
372,338,34,26.571429,26,34,1762,1616,146,2,0,0.142857,0,-9,14,13,-3.333333,1,0,2,4,false,true,true,1,0
324,284,40,19.058824,17.75,40,721,689,32,0,0,0,0,-27,17,16,-1.259259,0,0,1,1,false,true,true,1,0
79,62,17,11.285714,8.857143,17,310,359,-49,0,0,0,0,51,7,7,0.960784,1,0,7,21,false,true,true,0.687,0.313
385,169,216,55,28.166667,216,991,996,-5,3,0,0.428571,0,41,7,6,0.731707,0,0,10,11,false,true,true,1,0
114,158,-44,16.285714,22.571429,-44,1181,1149,32,0,1,0,0.142857,61,7,7,0.737705,1,0,10,20,false,true,false,0.204,0.796
313,269,44,12.52,11.208333,44,613,502,111,0,0,0,0,-30,25,24,-1.633333,0,0,3,15,true,true,true,1,0
334,316,18,14.521739,14.363636,18,1030,1045,-15,1,1,0.043478,0.045455,-35,23,22,-1.314286,0,0,1,4,false,true,true,1,0
253,209,44,23,19,44,1302,1082,220,0,0,0,0,12,11,11,2.5,0,0,10,12,false,true,true,0.533,0.467
404,233,171,19.238095,11.095238,171,1033,1037,-4,0,1,0,0.047619,-25,21,21,-1.8,0,1,2,1,false,true,true,1,0
24,13,11,24,13,11,872,818,54,0,0,0,0,91,1,1,0.450549,0,1,12,15,false,true,true,0.678,0.322
354,312,42,18.631579,16.421053,42,795,830,-35,1,1,0.052632,0.052632,-21,19,19,-2,0,0,1,5,false,true,true,1,0
41,14,27,20.5,14,27,880,952,-72,0,0,0,0,87,2,1,0.471264,0,0,8,7,false,true,false,0.446,0.554
360,249,111,27.692308,20.75,111,1156,1114,42,1,0,0.076923,0,2,13,12,16,0,0,8,18,false,true,true,1,0
145,219,-74,14.5,21.9,-74,316,306,10,0,2,0,0.2,29,10,10,1.310345,0,0,29,18,false,true,true,0.816,0.184
332,252,80,19.529412,14.823529,80,695,523,172,0,0,0,0,-17,17,17,-2.176471,0,0,1,7,false,true,true,1,0
166,147,19,27.666667,29.4,19,791,885,-94,1,1,0.166667,0.2,57,6,5,0.666667,0,0,20,9,false,true,true,0.876,0.124
296,292,4,21.142857,20.857143,4,1513,1479,34,0,0,0,0,4,14,14,8.5,1,1,13,6,false,true,true,0.947,0.053
276,223,53,21.230769,17.153846,53,691,675,16,0,0,0,0,10,13,13,3.7,0,1,24,7,false,true,true,0.987,0.013
336,306,30,16,14.571429,30,363,668,-305,0,0,0,0,-19,21,21,-2.263158,0,0,7,1,false,true,true,1,0
162,143,19,18,15.888889,19,1159,1051,108,0,0,0,0,44,9,9,0.909091,0,0,10,10,false,true,false,0.43,0.57
66,41,25,22,13.666667,25,834,758,76,0,0,0,0,78,3,3,0.461538,0,1,10,12,false,true,true,0.795,0.205
325,236,89,19.117647,14.75,89,1606,1544,62,0,0,0,0,4,17,16,11.25,0,0,21,8,false,true,true,1,0
345,260,85,23,17.333333,85,1516,1397,119,0,1,0,0.066667,-6,15,15,-5.5,0,1,5,6,false,true,true,1,0
203,96,107,25.375,13.714286,107,1093,1090,3,1,0,0.125,0,55,8,7,0.618182,0,0,9,9,false,true,true,0.97,0.03
407,351,56,23.941176,21.9375,56,1554,1573,-19,1,0,0.058824,0,-11,17,16,-3.090909,0,0,2,2,false,true,true,1,0
129,59,70,21.5,11.8,70,415,518,-103,0,0,0,0,66,6,5,0.575758,1,0,7,28,false,true,true,0.814,0.186
216,129,87,21.6,12.9,87,1586,1782,-196,0,0,0,0,30,10,10,1.333333,1,0,12,7,false,true,true,0.971,0.029
154,160,-6,15.4,16,-6,658,817,-159,0,0,0,0,42,10,10,0.904762,0,0,23,10,false,true,false,0.427,0.573
37,38,-1,9.25,12.666667,-1,416,374,42,0,0,0,0,85,4,3,0.541176,1,0,9,14,false,true,true,0.52,0.48
36,23,13,18,23,13,1554,1716,-162,0,0,0,0,89,2,1,0.393258,1,0,9,13,false,true,true,0.607,0.393
360,283,77,30,23.583333,77,1349,1302,47,0,0,0,0,8,12,12,3.625,0,0,22,7,false,true,true,1,0
194,129,65,19.4,14.333333,65,303,342,-39,0,0,0,0,40,10,9,0.95,1,0,22,14,false,true,true,0.863,0.137
224,217,7,17.230769,16.692308,7,695,523,172,0,0,0,0,5,13,13,7.4,0,0,20,21,false,true,true,0.768,0.232
198,95,103,33,19,103,1270,1322,-52,1,0,0.166667,0,61,6,5,0.622951,0,0,12,20,false,true,true,0.969,0.031
278,253,25,16.352941,14.882353,25,272,238,34,0,1,0,0.058824,-20,17,17,-2,0,1,18,3,false,true,true,0.972,0.028
78,126,-48,9.75,15.75,-48,480,518,-38,0,0,0,0,58,8,8,0.793103,0,1,14,8,false,true,false,0.034,0.966
143,137,6,20.428571,19.571429,6,1302,1234,68,0,0,0,0,52,7,7,0.596154,1,0,11,8,false,true,true,0.742,0.258
189,205,-16,21,22.777778,-16,771,754,17,0,0,0,0,36,9,9,0.888889,0,0,16,19,false,true,false,0.167,0.833
164,165,-1,16.4,18.333333,-1,500,567,-67,0,0,0,0,41,10,9,1.073171,0,0,12,24,false,true,false,0.147,0.853
241,247,-6,20.083333,20.583333,-6,771,754,17,0,0,0,0,17,12,12,1.882353,0,1,10,16,false,true,false,0.045,0.955
358,280,78,27.538462,21.538462,78,1397,1361,36,1,0,0.076923,0,-3,13,13,-9.666667,0,0,3,1,false,true,true,1,0
268,191,77,19.142857,13.642857,77,1227,1060,167,0,1,0,0.071429,11,14,14,3.636364,0,0,15,16,false,true,true,0.989,0.011
294,207,87,29.4,23,87,1203,1221,-18,2,0,0.2,0,37,10,9,0.945946,0,0,19,11,false,true,true,0.998,0.002
164,139,25,18.222222,15.444444,25,1029,1075,-46,0,0,0,0,44,9,9,1.090909,1,0,10,7,false,true,true,0.927,0.073
126,92,34,25.2,18.4,34,1556,1591,-35,0,0,0,0,64,5,5,0.5625,1,0,21,10,false,true,true,0.931,0.069
305,210,95,21.785714,16.153846,95,1452,1469,-17,1,1,0.071429,0.076923,5,14,13,7.6,0,0,9,25,false,true,true,1,0
189,169,20,27,24.142857,20,1210,1253,-43,0,1,0,0.142857,43,7,7,0.790698,0,0,19,15,false,true,true,0.772,0.228
18,0,18,18,0,18,1244,1361,-117,0,0,0,0,96,1,0,0.395833,0,0,15,0,false,true,false,0.269,0.731
252,256,-4,21,21.333333,-4,1344,1209,135,1,1,0.083333,0.083333,8,12,12,4.25,0,0,8,14,false,true,false,0.119,0.881
8,15,-7,8,15,-7,904,857,47,0,0,0,0,93,1,1,0.44086,0,0,26,7,false,true,true,0.678,0.322
65,34,31,32.5,17,31,1489,1405,84,0,0,0,0,87,2,2,0.321839,1,0,7,17,false,true,true,0.929,0.071
260,252,8,18.571429,18,8,859,786,73,0,0,0,0,5,14,14,7.6,0,0,20,10,false,true,true,0.771,0.229
79,100,-21,19.75,25,-21,902,866,36,0,0,0,0,66,4,4,0.484848,0,0,11,10,false,true,true,0.652,0.348
429,338,91,25.235294,21.125,91,791,885,-94,1,1,0.058824,0.0625,-18,17,16,-2.111111,0,0,2,4,false,true,true,1,0
155,123,32,25.833333,24.6,32,1305,1242,63,1,0,0.166667,0,60,6,5,0.566667,0,1,7,21,false,true,false,0.479,0.521
216,200,16,27,28.571429,16,791,885,-94,1,1,0.125,0.142857,44,8,7,0.863636,0,0,24,7,false,true,true,0.854,0.146
303,256,47,18.9375,17.066667,47,1077,1094,-17,0,0,0,0,5,16,15,8.4,1,1,9,6,false,true,true,0.835,0.165
351,320,31,23.4,21.333333,31,971,761,210,1,0,0.066667,0,-9,15,15,-3.333333,0,0,7,11,true,true,true,1,0
302,165,137,37.75,23.571429,137,1489,1405,84,2,0,0.25,0,43,8,7,0.651163,0,0,12,10,false,true,true,1,0
12,0,12,12,0,12,613,569,44,0,0,0,0,95,1,0,0.410526,0,0,8,0,false,true,true,0.644,0.356
313,292,21,20.866667,19.466667,21,290,416,-126,0,0,0,0,-8,15,15,-4.25,0,0,7,4,false,true,true,0.874,0.126
265,292,-27,20.384615,22.461538,-27,971,906,65,0,0,0,0,4,13,13,8,1,0,9,10,false,true,true,0.539,0.461
334,307,27,18.555556,18.058824,27,758,796,-38,0,0,0,0,-18,18,17,-2.111111,0,0,1,5,false,true,true,1,0
194,150,44,24.25,21.428571,44,1127,1134,-7,0,0,0,0,42,8,7,0.714286,0,1,9,9,false,true,true,0.805,0.195
117,107,10,16.714286,17.833333,10,611,584,27,0,0,0,0,62,7,6,0.709677,0,0,10,14,false,true,false,0.247,0.753
89,123,-34,14.833333,20.5,-34,95,360,-265,0,1,0,0.166667,51,6,6,0.784314,0,0,9,19,false,true,false,0.466,0.534
276,217,59,21.230769,18.083333,59,691,675,16,0,0,0,0,14,13,12,2.642857,0,1,24,6,false,true,true,0.986,0.014
191,177,14,19.1,17.7,14,1305,1390,-85,0,1,0,0.1,29,10,10,1.241379,0,1,7,22,false,true,false,0.273,0.727
291,113,178,18.1875,7.0625,178,859,719,140,0,1,0,0.0625,2,16,16,26.5,0,1,16,16,false,true,true,1,0
168,134,34,28,22.333333,34,1089,1063,26,1,0,0.166667,0,60,6,6,0.633333,0,0,20,13,false,true,true,0.941,0.059
365,217,148,21.470588,12.764706,148,1033,1037,-4,0,1,0,0.058824,-8,17,17,-5.625,1,1,17,9,false,true,true,1,0
361,367,-6,30.083333,30.583333,-6,1489,1558,-69,0,1,0,0.083333,2,12,12,14,0,0,10,14,false,true,true,0.998,0.002
391,261,130,27.928571,20.076923,130,1334,1256,78,2,0,0.142857,0,0,14,13,0,0,1,4,6,false,true,true,1,0
260,231,29,14.444444,12.833333,29,947,909,38,0,0,0,0,-16,18,18,-2.875,0,1,10,24,false,true,true,0.977,0.023
62,77,-15,15.5,25.666667,-15,334,446,-112,0,0,0,0,76,4,3,0.526316,0,0,9,16,false,true,false,0.149,0.851
318,232,86,28.909091,21.090909,86,1510,1583,-73,1,0,0.090909,0,14,11,11,2.285714,0,0,11,10,false,true,true,1,0
14,24,-10,14,24,-10,1177,1214,-37,0,0,0,0,91,1,1,0.384615,0,0,10,12,false,true,true,0.674,0.326
196,219,-23,19.6,24.333333,-23,1554,1573,-19,0,0,0,0,40,10,9,0.85,0,0,11,10,false,true,false,0.191,0.809
322,263,59,11.5,9.740741,59,416,222,194,0,0,0,0,-44,28,27,-1.25,0,0,7,2,true,true,true,1,0
238,238,0,13.222222,14,0,1029,1075,-46,0,0,0,0,5,18,17,9.6,2,0,9,12,false,true,true,0.674,0.326
111,102,9,15.857143,17,9,540,518,22,0,0,0,0,58,7,6,0.689655,0,0,8,13,false,true,false,0.376,0.624
292,151,141,29.2,15.1,141,1482,1554,-72,1,0,0.1,0,30,10,10,1.2,0,0,10,8,false,true,true,1,0
334,176,158,23.857143,13.538462,158,554,342,212,0,0,0,0,0,14,13,0,0,0,7,22,false,true,true,1,0
356,274,82,29.666667,22.833333,82,1189,1266,-77,1,0,0.083333,0,6,12,12,5.666667,0,0,22,11,false,true,true,1,0
105,74,31,21,18.5,31,1167,1216,-49,0,0,0,0,70,5,4,0.585714,1,0,10,26,false,true,true,0.639,0.361
236,210,26,19.666667,17.5,26,1334,1270,64,1,0,0.083333,0,28,12,12,1.321429,1,0,16,13,false,true,true,0.942,0.058
281,250,31,28.1,27.777778,31,1428,1606,-178,1,0,0.1,0,26,10,9,1.230769,1,0,16,9,false,true,true,0.696,0.304
85,81,4,14.166667,13.5,4,954,1078,-124,0,1,0,0.166667,56,6,6,0.678571,2,0,21,10,false,true,true,0.992,0.008
296,222,74,17.411765,13.058824,74,691,675,16,0,0,0,0,-11,17,17,-3.454545,0,0,4,12,false,true,true,1,0
251,205,46,17.928571,14.642857,46,523,480,43,1,0,0.071429,0,-3,14,14,-11,0,0,16,18,false,true,true,0.975,0.025
304,228,76,23.384615,19,76,1731,1691,40,1,0,0.076923,0,9,13,12,3.777778,0,0,7,9,false,true,true,1,0
358,333,25,19.888889,19.588235,25,1265,1045,220,0,1,0,0.058824,-18,18,17,-2.333333,0,0,3,6,false,true,true,1,0
304,276,28,25.333333,23,28,1554,1573,-19,1,0,0.083333,0,20,12,12,1.7,0,1,21,9,false,true,true,0.962,0.038
274,231,43,14.421053,12.833333,43,1016,1037,-21,0,0,0,0,1,19,18,48,1,0,6,20,false,true,true,1,0
352,329,23,27.076923,25.307692,23,1397,1195,202,1,0,0.076923,0,5,13,13,7,0,0,15,9,false,true,true,1,0
76,9,67,25.333333,4.5,67,1067,95,972,0,0,0,0,83,3,2,0.409639,0,0,16,14,false,true,true,1,0
187,124,63,23.375,15.5,63,939,907,32,0,0,0,0,51,8,8,0.784314,1,0,16,17,false,true,true,0.97,0.03
22,32,-10,22,32,-10,1431,802,629,0,0,0,0,91,1,1,0.351648,0,1,24,12,false,true,true,1,0
151,117,34,21.571429,16.714286,34,704,691,13,0,0,0,0,50,7,7,0.76,1,0,7,11,false,true,true,0.943,0.057
301,297,4,21.5,22.846154,4,1265,1045,220,0,1,0,0.076923,3,14,13,14,0,0,14,8,false,true,true,0.985,0.015
253,153,100,18.071429,11.769231,100,346,231,115,0,0,0,0,-8,14,13,-5.125,0,0,19,14,false,true,true,0.989,0.011
199,129,70,22.111111,14.333333,70,561,526,35,0,0,0,0,27,9,9,1.296296,0,0,13,11,false,true,true,0.97,0.03
29,60,-31,9.666667,20,-31,596,595,1,0,0,0,0,79,3,3,0.506329,1,0,19,12,false,true,true,0.554,0.446
192,171,21,24,21.375,21,1304,1040,264,1,0,0.125,0,43,8,8,0.767442,0,0,11,23,false,true,false,0.44,0.56
149,144,5,21.285714,20.571429,5,1040,925,115,0,0,0,0,48,7,7,0.895833,0,0,21,7,false,true,true,0.67,0.33
362,299,63,20.111111,17.588235,63,1214,1176,38,0,0,0,0,-8,18,17,-4.5,0,0,2,5,false,true,true,1,0
170,124,46,24.285714,20.666667,46,809,868,-59,1,0,0.142857,0,47,7,6,0.680851,0,0,8,27,false,true,true,0.784,0.216
0,0,0,0,0,0,977,976,1,0,0,0,0,100,1,0,0.34,0,0,17,0,false,true,false,0.455,0.545
263,176,87,26.3,19.555556,87,1266,1144,122,0,0,0,0,31,10,9,1.096774,1,0,9,16,false,true,true,1,0
82,36,46,41,18,46,1439,1353,86,1,0,0.5,0,81,2,2,0.37037,0,0,11,9,false,true,true,0.706,0.294
151,156,-5,15.1,17.333333,-5,576,494,82,0,0,0,0,40,10,9,1.1,0,0,12,10,false,true,false,0.226,0.774
119,97,22,23.8,19.4,22,1034,1040,-6,0,0,0,0,65,5,5,0.538462,0,1,18,8,false,true,true,0.761,0.239
289,229,60,32.111111,25.444444,60,1237,1277,-40,0,0,0,0,23,9,9,1.26087,1,0,6,14,false,true,true,1,0
130,93,37,14.444444,11.625,37,880,952,-72,0,0,0,0,45,9,8,0.911111,0,0,16,8,false,true,true,0.734,0.266
171,100,71,24.428571,16.666667,71,1334,1477,-143,0,0,0,0,57,7,6,0.526316,0,2,12,8,false,true,true,0.921,0.079
214,181,33,21.4,18.1,33,1513,1479,34,0,0,0,0,31,10,10,1.096774,1,0,10,15,false,true,true,0.842,0.158
135,99,36,27,24.75,36,518,448,70,0,0,0,0,70,5,4,0.485714,0,0,7,12,false,true,true,0.793,0.207
208,189,19,18.909091,18.9,19,1547,1439,108,1,0,0.090909,0,28,11,10,1.321429,0,0,23,10,false,true,false,0.436,0.564
12,26,-14,12,26,-14,363,668,-305,0,0,0,0,95,1,1,0.452632,0,0,15,16,false,true,false,0.215,0.785
358,351,7,23.866667,23.4,7,992,1100,-108,2,0,0.133333,0,-6,15,15,-5.666667,0,0,4,4,false,true,true,0.998,0.002
355,329,26,19.722222,18.277778,26,1244,1361,-117,2,1,0.111111,0.055556,-8,18,18,-4.75,0,0,2,5,false,true,true,1,0
37,0,37,18.5,0,37,1045,1009,36,0,0,0,0,93,2,1,0.408602,0,0,12,0,false,true,true,0.745,0.255
133,120,13,19,17.142857,13,786,847,-61,0,0,0,0,54,7,7,0.62963,0,0,8,7,false,true,false,0.369,0.631
300,197,103,21.428571,15.153846,103,620,658,-38,0,0,0,0,9,14,13,4,0,0,14,9,false,true,true,1,0
265,270,-5,20.384615,20.769231,-5,1344,1209,135,1,1,0.076923,0.076923,0,13,13,0,0,0,19,13,false,true,true,0.598,0.402
29,15,14,14.5,15,14,1452,1469,-17,0,0,0,0,90,2,1,0.422222,0,0,10,12,false,true,true,0.676,0.324
344,307,37,18.105263,16.157895,37,921,1072,-151,1,0,0.052632,0,-15,19,19,-2.533333,0,0,2,4,true,true,true,1,0
312,243,69,19.5,16.2,69,1270,1315,-45,0,0,0,0,-6,16,15,-6,0,0,2,31,false,true,true,1,0
156,183,-27,15.6,18.3,-27,916,876,40,0,0,0,0,25,10,10,1.36,1,0,12,16,false,true,false,0.268,0.732
63,71,-8,21,23.666667,-8,948,933,15,0,0,0,0,80,3,3,0.475,1,0,10,11,false,true,true,0.688,0.312
22,21,1,22,21,1,999,1011,-12,0,0,0,0,92,1,1,0.5,0,0,10,15,false,true,true,0.673,0.327
12,0,12,12,0,12,580,620,-40,0,0,0,0,97,1,0,0.443299,0,0,11,0,false,true,false,0.253,0.747
39,26,13,19.5,13,13,416,222,194,0,0,0,0,84,2,2,0.654762,1,1,6,8,false,true,true,0.672,0.328
317,266,51,21.133333,17.733333,51,866,949,-83,0,0,0,0,0,15,15,0,1,0,7,12,false,true,true,1,0
141,77,64,23.5,15.4,64,885,719,166,0,0,0,0,67,6,5,0.567164,0,1,10,10,false,true,true,0.848,0.152
24,4,20,12,4,20,896,818,78,0,0,0,0,91,2,1,0.483516,0,0,18,11,false,true,true,0.684,0.316
314,207,107,26.166667,17.25,107,1029,1227,-198,1,0,0.083333,0,2,12,12,16,0,0,7,8,false,true,true,1,0
146,62,84,20.857143,10.333333,84,993,897,96,1,0,0.142857,0,51,7,6,0.921569,0,0,14,18,false,true,true,0.97,0.03
205,186,19,25.625,26.571429,19,1102,1245,-143,1,0,0.125,0,29,8,7,0.965517,0,0,13,12,false,true,true,0.529,0.471
239,233,6,15.933333,16.642857,6,908,859,49,0,0,0,0,8,15,14,4.875,0,0,17,14,false,true,true,0.554,0.446
156,194,-38,19.5,27.714286,-38,947,810,137,0,1,0,0.142857,46,8,7,0.913043,0,0,29,10,false,true,false,0.201,0.799
231,228,3,21,20.727273,3,1161,1166,-5,1,0,0.090909,0,17,11,11,2.058824,1,1,9,13,false,true,false,0.116,0.884
363,344,19,27.923077,26.461538,19,1125,1227,-102,2,1,0.153846,0.076923,-10,13,13,-3,0,0,4,6,false,true,true,1,0
254,201,53,19.538462,15.461538,53,844,821,23,0,0,0,0,34,13,13,1.235294,0,0,19,8,false,true,true,0.922,0.078
93,12,81,46.5,12,81,908,1070,-162,1,0,0.5,0,87,2,1,0.344828,1,0,9,9,false,true,true,0.695,0.305
329,237,92,27.416667,19.75,92,1556,1591,-35,1,0,0.083333,0,15,12,12,2.4,0,0,11,10,false,true,true,1,0
125,85,40,31.25,21.25,40,1550,1466,84,1,0,0.25,0,67,4,4,0.552239,0,0,11,27,false,true,true,0.736,0.264
341,264,77,17.05,13.894737,77,830,907,-77,1,0,0.05,0,-15,20,19,-2.6,0,1,14,1,true,true,true,1,0
278,206,72,19.857143,14.714286,72,576,532,44,0,0,0,0,11,14,14,4.181818,0,0,9,12,false,true,true,0.998,0.002
0,0,0,0,0,0,786,847,-61,0,0,0,0,100,1,0,0.34,0,0,8,0,false,true,false,0.251,0.749
346,311,35,21.625,19.4375,35,1513,1479,34,0,0,0,0,-12,16,16,-2.833333,0,0,1,3,false,true,true,1,0
89,43,46,17.8,10.75,46,1651,1691,-40,0,0,0,0,76,5,4,0.447368,1,0,12,22,false,true,true,0.802,0.198
219,88,131,31.285714,14.666667,131,1875,1793,82,2,0,0.285714,0,53,7,6,0.566038,0,1,12,18,false,true,true,0.871,0.129
79,12,67,39.5,6,67,918,619,299,1,0,0.5,0,86,2,2,0.406977,0,0,13,18,false,true,true,0.959,0.041
326,299,27,20.375,18.6875,27,1090,1244,-154,0,0,0,0,-10,16,16,-3.7,0,0,13,2,false,true,true,0.968,0.032
151,98,53,25.166667,16.333333,53,1014,948,66,0,0,0,0,62,6,6,0.532258,0,0,11,13,false,true,true,0.889,0.111
10,0,10,10,0,10,315,294,21,0,0,0,0,96,1,0,0.364583,0,0,17,0,false,true,false,0.274,0.726
188,153,35,23.5,21.857143,35,1227,1060,167,0,1,0,0.142857,50,8,7,0.8,0,0,14,9,false,true,false,0.456,0.544
210,175,35,26.25,25,35,1793,1897,-104,1,0,0.125,0,44,8,7,0.681818,0,0,11,7,false,true,true,0.696,0.304
220,147,73,20,13.363636,73,566,542,24,0,0,0,0,26,11,11,1.576923,0,1,20,10,false,true,true,0.986,0.014
342,318,24,21.375,19.875,24,847,952,-105,0,0,0,0,-3,16,16,-12,0,1,6,4,false,true,true,0.773,0.227
382,283,99,29.384615,23.583333,99,1349,1302,47,0,0,0,0,2,13,12,14.5,0,0,17,7,false,true,true,1,0
321,284,37,20.0625,17.75,37,721,689,32,0,0,0,0,-25,16,16,-1.36,0,0,1,1,false,true,true,1,0
193,81,112,32.166667,16.2,112,539,500,39,0,0,0,0,50,6,5,0.8,0,0,7,19,false,true,true,0.972,0.028
301,251,50,15.842105,13.210526,50,346,231,115,0,0,0,0,-38,19,19,-1.078947,0,1,13,1,false,true,true,0.992,0.008
117,115,2,23.4,23,2,1237,1277,-40,0,0,0,0,59,5,5,0.491525,0,0,16,18,false,true,true,0.657,0.343
357,228,129,19.833333,12.666667,129,872,818,54,0,1,0,0.055556,-5,18,18,-8.2,0,0,8,6,false,true,true,1,0
221,166,55,17,13.833333,55,1048,1000,48,0,0,0,0,28,13,12,1.428571,0,1,12,6,false,true,true,0.957,0.043
389,335,54,22.882353,19.705882,54,630,786,-156,1,0,0.058824,0,-11,17,17,-3.181818,0,0,1,2,false,true,true,1,0
303,181,122,30.3,20.111111,122,1334,1256,78,2,0,0.2,0,29,10,9,1.068966,0,0,10,11,false,true,true,1,0
22,0,22,22,0,22,303,342,-39,0,0,0,0,98,1,0,0.387755,0,0,13,0,false,true,false,0.268,0.732
284,266,18,21.846154,22.166667,18,1554,1622,-68,2,0,0.153846,0,6,13,12,5.166667,1,0,6,8,false,true,true,0.964,0.036
106,80,26,17.666667,16,26,1176,1127,49,0,0,0,0,61,6,5,0.606557,0,0,8,11,false,true,true,0.682,0.318
92,88,4,13.142857,14.666667,4,299,315,-16,0,0,0,0,58,7,6,0.724138,1,0,16,17,false,true,true,0.651,0.349
272,135,137,22.666667,11.25,137,942,1003,-61,0,0,0,0,19,12,12,2.368421,1,1,22,15,false,true,true,1,0
69,40,29,13.8,8,29,1016,1037,-21,0,0,0,0,70,5,5,0.685714,0,1,10,13,false,true,true,0.515,0.485
195,192,3,21.666667,21.333333,3,1530,1550,-20,0,1,0,0.111111,32,9,9,1.0625,0,0,9,16,false,true,false,0.217,0.783
175,115,60,25,16.428571,60,1075,1152,-77,0,0,0,0,56,7,7,0.714286,0,1,7,7,false,true,true,0.501,0.499
240,230,10,18.461538,19.166667,10,942,976,-34,0,0,0,0,12,13,12,3.333333,0,0,20,7,false,true,false,0.432,0.568
100,56,44,20,11.2,44,1551,1550,1,0,0,0,0,67,5,5,0.626866,0,1,16,24,false,true,true,0.821,0.179
136,65,71,15.111111,7.222222,71,1428,1302,126,0,0,0,0,47,9,9,1.12766,0,1,12,16,false,true,true,0.82,0.18
138,135,3,13.8,13.5,3,904,857,47,0,0,0,0,37,10,10,1.108108,0,0,13,20,false,true,false,0.264,0.736
40,27,13,20,27,13,1334,1477,-143,0,0,0,0,88,2,1,0.340909,0,0,22,16,false,true,false,0.398,0.602
195,116,79,27.857143,19.333333,79,971,1180,-209,1,0,0.142857,0,55,7,6,0.581818,0,0,11,14,false,true,true,0.838,0.162
197,218,-21,24.625,27.25,-21,1331,1399,-68,0,0,0,0,38,8,8,0.921053,0,0,20,7,false,true,false,0.413,0.587
302,306,-4,20.133333,20.4,-4,1439,1294,145,1,0,0.066667,0,-5,15,15,-7.2,1,0,7,18,false,true,true,0.999,0.001
177,111,66,17.7,12.333333,66,299,315,-16,0,0,0,0,39,10,9,1.076923,0,0,12,17,false,true,true,0.851,0.149
77,46,31,25.666667,23,31,1397,1195,202,0,0,0,0,84,3,2,0.416667,0,0,14,23,false,true,false,0.273,0.727
116,118,-2,23.2,29.5,-2,1030,1144,-114,0,1,0,0.25,66,5,4,0.530303,0,0,22,14,false,true,true,0.624,0.376
216,68,148,24,7.555556,148,896,818,78,0,0,0,0,50,9,9,0.88,0,0,13,9,false,true,true,0.974,0.026
149,132,17,16.555556,14.666667,17,448,598,-150,0,0,0,0,39,9,9,0.923077,1,0,19,11,false,true,true,0.686,0.314
81,46,35,20.25,15.333333,35,1501,1473,28,0,0,0,0,73,4,3,0.493151,0,1,21,14,false,true,true,0.709,0.291
84,60,24,16.8,12,24,1159,1051,108,0,0,0,0,70,5,5,0.571429,0,0,18,17,false,true,true,0.759,0.241
185,157,28,15.416667,13.083333,28,698,742,-44,0,0,0,0,36,12,12,1.138889,0,0,7,14,false,true,true,0.655,0.345
224,221,3,13.176471,13.8125,3,1029,1075,-46,0,0,0,0,12,17,16,4,2,0,10,12,false,true,true,0.642,0.358
169,141,28,15.363636,14.1,28,539,632,-93,0,0,0,0,38,11,10,1.210526,0,0,10,7,false,true,true,0.773,0.227
47,51,-4,15.666667,17,-4,725,771,-46,0,1,0,0.333333,74,3,3,0.621622,0,1,20,22,false,true,true,0.505,0.495
318,240,78,26.5,20,78,1510,1583,-73,1,0,0.083333,0,11,12,12,2.909091,0,0,9,8,false,true,true,1,0
259,256,3,17.266667,18.285714,3,1077,1094,-17,0,0,0,0,9,15,14,4.666667,0,1,13,6,false,true,false,0.393,0.607
83,46,37,27.666667,23,37,1428,1452,-24,0,0,0,0,83,3,2,0.373494,0,0,16,11,false,true,true,0.688,0.312
81,92,-11,13.5,15.333333,-11,1221,1438,-217,0,0,0,0,65,6,6,0.692308,0,1,22,6,false,true,false,0.251,0.749
257,168,89,16.0625,11.2,89,1428,1302,126,0,0,0,0,4,16,15,13.25,0,1,7,15,false,true,true,0.996,0.004
56,58,-2,28,29,-2,1109,1065,44,0,0,0,0,88,2,2,0.375,0,0,15,10,false,true,true,0.678,0.322
146,135,11,10.428571,10.384615,11,416,222,194,0,0,0,0,24,14,13,2.291667,1,0,10,24,false,true,true,0.693,0.307
345,266,79,15.681818,12.666667,79,272,288,-16,0,0,0,0,-19,22,21,-2.736842,0,0,3,4,false,true,true,1,0
294,278,16,22.615385,21.384615,16,1177,1214,-37,0,0,0,0,6,13,13,5.833333,0,1,18,6,false,true,true,0.904,0.096
36,64,-28,12,21.333333,-28,804,988,-184,0,0,0,0,78,3,3,0.423077,1,0,6,29,false,true,false,0.185,0.815
373,321,52,21.941176,18.882353,52,1439,1397,42,1,2,0.058824,0.117647,-17,17,17,-2,0,0,1,15,true,true,true,1,0
334,292,42,18.555556,17.176471,42,1270,1348,-78,0,0,0,0,-12,18,17,-3.166667,0,0,2,14,false,true,true,1,0
226,139,87,18.833333,12.636364,87,415,518,-103,0,0,0,0,31,12,11,1.225806,1,0,9,20,false,true,true,0.893,0.107
181,135,46,30.166667,27,46,2219,2106,113,1,0,0.166667,0,50,6,5,0.54,0,0,15,12,false,true,true,0.707,0.293
291,200,91,29.1,22.222222,91,977,976,1,1,0,0.1,0,35,10,9,0.971429,0,0,12,7,false,true,true,0.997,0.003
191,157,34,17.363636,14.272727,34,272,288,-16,0,0,0,0,42,11,11,1.238095,0,1,17,13,false,true,true,0.743,0.257
163,47,116,32.6,11.75,116,1014,1303,-289,1,0,0.2,0,65,5,4,0.584615,0,1,18,7,false,true,true,0.515,0.485
252,261,-9,14.823529,15.352941,-9,540,518,22,0,0,0,0,-11,17,17,-3.636364,0,0,7,9,false,true,true,0.649,0.351
157,93,64,26.166667,18.6,64,1036,1181,-145,0,0,0,0,62,6,5,0.548387,0,1,24,13,false,true,true,0.568,0.432
64,27,37,21.333333,9,37,1030,1045,-15,0,0,0,0,84,3,3,0.547619,0,0,13,10,false,true,true,0.813,0.187
340,326,14,17,16.3,14,1127,1176,-49,0,0,0,0,-20,20,20,-2.1,0,0,2,1,false,true,true,1,0
316,229,87,17.555556,13.470588,87,539,632,-93,0,0,0,0,-2,18,17,-23,0,0,11,10,false,true,true,1,0
138,109,29,23,18.166667,29,691,473,218,0,0,0,0,54,6,6,0.666667,0,0,16,7,false,true,true,0.858,0.142
390,237,153,19.5,11.85,153,1586,1782,-196,0,0,0,0,-27,20,20,-1.481481,1,0,0,2,true,true,true,1,0
79,40,39,26.333333,20,39,1550,1624,-74,0,0,0,0,82,3,2,0.365854,0,0,26,17,false,true,true,0.686,0.314
330,297,33,25.384615,24.75,33,1439,1397,42,1,2,0.076923,0.166667,0,13,12,0,0,0,11,23,false,true,true,1,0
23,59,-36,11.5,29.5,-36,1305,1242,63,0,0,0,0,88,2,2,0.386364,0,0,10,11,false,true,false,0.208,0.792
174,86,88,34.8,21.5,88,820,783,37,0,0,0,0,66,5,4,0.5,0,0,7,11,false,true,true,0.958,0.042
170,152,18,18.888889,16.888889,18,847,952,-105,0,0,0,0,50,9,9,0.72,0,1,10,17,false,true,false,0.284,0.716
69,30,39,23,10,39,1055,1050,5,0,0,0,0,81,3,3,0.419753,0,0,20,7,false,true,true,0.831,0.169
161,160,1,17.888889,20,1,719,785,-66,0,1,0,0.125,39,9,8,0.923077,0,0,18,18,false,true,false,0.335,0.665
296,304,-8,14.8,15.2,-8,576,494,82,0,0,0,0,-20,20,20,-2.2,0,0,4,4,false,true,true,0.576,0.424
122,115,7,20.333333,23,7,1539,1537,2,0,0,0,0,65,6,5,0.492308,1,0,9,8,false,true,true,0.884,0.116
79,76,3,19.75,19,3,262,306,-44,0,0,0,0,81,4,4,0.567901,0,0,23,14,false,true,true,0.529,0.471
208,121,87,18.909091,12.1,87,415,518,-103,0,0,0,0,36,11,10,1.055556,1,0,12,22,false,true,true,0.861,0.139
203,184,19,11.277778,10.222222,19,416,222,194,0,0,0,0,-3,18,18,-18.333333,0,0,14,26,false,true,true,0.91,0.09
115,143,-28,16.428571,20.428571,-28,1394,1230,164,0,1,0,0.142857,48,7,7,0.791667,0,0,17,18,false,true,true,0.764,0.236
44,16,28,22,16,28,808,639,169,0,0,0,0,86,2,1,0.476744,0,0,19,11,false,true,true,0.702,0.298
179,197,-18,25.571429,32.833333,-18,1489,1558,-69,0,1,0,0.166667,54,7,6,0.518519,0,0,10,8,false,true,false,0.202,0.798
73,48,25,24.333333,16,25,1875,1793,82,0,0,0,0,86,3,3,0.348837,0,0,8,10,false,true,true,0.686,0.314
315,286,29,17.5,16.823529,29,725,771,-46,0,1,0,0.058824,-7,18,17,-6.571429,1,0,10,9,false,true,true,0.792,0.208
52,60,-8,13,15,-8,1547,1439,108,0,0,0,0,75,4,4,0.493333,2,0,5,18,false,true,true,0.707,0.293
381,330,51,47.625,47.142857,51,1370,1431,-61,2,1,0.25,0.142857,30,8,7,0.766667,0,0,9,18,false,true,true,1,0
162,135,27,14.727273,12.272727,27,1016,1037,-21,0,0,0,0,35,11,11,1.371429,0,0,7,19,false,true,false,0.406,0.594
216,103,113,30.857143,14.714286,113,1144,1014,130,0,0,0,0,50,7,7,0.72,0,1,15,9,false,true,true,0.941,0.059
318,299,19,18.705882,18.6875,19,758,952,-194,0,0,0,0,-18,17,16,-2.222222,0,0,4,3,false,true,true,0.777,0.223
76,71,5,19,23.666667,5,1040,925,115,0,0,0,0,73,4,3,0.589041,1,0,18,9,false,true,true,0.806,0.194
286,292,-6,20.428571,22.461538,-6,971,761,210,0,0,0,0,3,14,13,10,0,0,7,14,false,true,false,0.04,0.96
122,144,-22,13.555556,18,-22,272,238,34,0,0,0,0,42,9,8,0.952381,0,0,17,12,false,true,false,0.097,0.903
294,275,19,19.6,18.333333,19,1176,1127,49,0,0,0,0,-2,15,15,-18.5,0,0,11,7,false,true,true,0.645,0.355
94,102,-8,15.666667,20.4,-8,671,725,-54,0,0,0,0,60,6,5,0.616667,1,0,6,9,false,true,false,0.308,0.692
60,42,18,20,14,18,1075,989,86,0,0,0,0,79,3,3,0.493671,0,0,26,16,false,true,true,0.711,0.289
61,60,1,15.25,20,1,272,238,34,0,0,0,0,71,4,3,0.56338,0,0,14,19,false,true,false,0.435,0.565
117,72,45,16.714286,12,45,1253,1166,87,0,0,0,0,61,7,6,0.704918,1,0,6,16,false,true,true,0.796,0.204
36,0,36,36,0,36,609,620,-11,0,0,0,0,96,1,0,0.385417,0,0,17,0,false,true,true,0.585,0.415
374,283,91,34,28.3,91,2219,2106,113,2,0,0.181818,0,5,11,10,5.4,0,0,13,10,false,true,true,1,0
313,229,84,16.473684,12.722222,84,892,768,124,0,0,0,0,-2,19,18,-21.5,0,0,10,13,false,true,true,1,0
295,236,59,21.071429,18.153846,59,1364,1093,271,0,1,0,0.076923,7,14,13,5.428571,0,0,20,7,false,true,true,1,0
168,113,55,18.666667,14.125,55,1011,921,90,0,0,0,0,46,9,8,1.065217,0,0,7,22,false,true,true,0.782,0.218
364,336,28,15.166667,14,28,1388,1477,-89,1,0,0.041667,0,-38,24,24,-1.263158,0,0,1,1,true,true,true,1,0
372,328,44,21.882353,20.5,44,1014,1303,-289,1,0,0.058824,0,-19,17,16,-2,0,0,2,7,false,true,true,1,0
319,262,57,29,26.2,57,1659,1782,-123,1,0,0.090909,0,10,11,10,2.9,0,1,14,16,false,true,true,1,0
330,224,106,23.571429,16,106,526,370,156,0,0,0,0,-2,14,14,-17.5,0,0,16,12,false,true,true,1,0
367,289,78,24.466667,20.642857,78,880,952,-72,0,0,0,0,-2,15,14,-17.5,0,0,4,8,false,true,true,1,0
123,110,13,20.5,18.333333,13,859,786,73,0,0,0,0,60,6,6,0.633333,0,0,23,9,false,true,true,0.739,0.261
135,71,64,33.75,23.666667,64,695,671,24,0,0,0,0,70,4,3,0.471429,0,0,16,16,false,true,true,0.908,0.092
270,239,31,18,17.071429,31,671,725,-54,0,0,0,0,-2,15,14,-18.5,0,0,23,8,false,true,true,0.979,0.021
175,201,-26,21.875,25.125,-26,1023,1110,-87,1,1,0.125,0.125,30,8,8,1,0,0,22,19,false,true,true,0.68,0.32
24,0,24,24,0,24,1333,1331,2,0,0,0,0,94,1,0,0.319149,0,0,9,0,false,true,true,0.681,0.319
319,185,134,26.583333,15.416667,134,778,758,20,0,1,0,0.083333,8,12,12,4.875,0,0,8,20,false,true,true,1,0
314,288,26,17.444444,16.941176,26,908,859,49,0,0,0,0,-9,18,17,-4.333333,0,0,5,4,false,true,true,0.956,0.044
363,336,27,27.923077,28,27,1125,1227,-102,2,1,0.153846,0.083333,-8,13,12,-3.75,0,0,4,7,false,true,true,1,0
362,345,17,27.846154,28.75,17,1419,1488,-69,1,1,0.076923,0.083333,-3,13,12,-9.333333,1,0,3,5,false,true,true,1,0
167,179,-12,15.181818,16.272727,-12,450,412,38,0,0,0,0,22,11,11,1.727273,0,0,10,12,false,true,false,0.415,0.585
179,141,38,25.571429,23.5,38,892,819,73,0,1,0,0.166667,51,7,6,0.666667,0,0,7,7,false,true,true,0.877,0.123
160,201,-41,22.857143,28.714286,-41,1023,1110,-87,1,1,0.142857,0.142857,33,7,7,0.909091,0,0,14,7,false,true,true,0.676,0.324
335,254,81,20.9375,15.875,81,711,876,-165,0,0,0,0,-5,16,16,-8.6,0,1,9,3,false,true,true,1,0
55,45,10,18.333333,15,10,1176,1127,49,0,0,0,0,79,3,3,0.468354,0,0,14,9,false,true,true,0.685,0.315
412,298,114,27.466667,21.285714,114,1396,1454,-58,2,0,0.133333,0,-1,15,14,-33,0,0,4,6,false,true,true,1,0
345,287,58,31.363636,28.7,58,1302,1349,-47,0,1,0,0.1,13,11,10,2.153846,0,1,12,8,false,true,true,0.968,0.032
461,308,153,28.8125,20.533333,153,1571,1554,17,2,1,0.125,0.066667,-18,16,15,-1.833333,1,0,0,2,false,true,true,1,0
344,272,72,26.461538,20.923077,72,1093,1197,-104,2,0,0.153846,0,10,13,13,3.1,1,1,11,13,false,true,true,1,0
252,240,12,16.8,16,12,801,807,-6,0,0,0,0,-3,15,15,-11.666667,1,0,10,8,false,true,true,0.81,0.19
261,243,18,14.5,14.294118,18,480,518,-38,0,0,0,0,-3,18,17,-15.333333,1,0,6,16,false,true,true,0.773,0.227
22,41,-19,11,20.5,-19,1214,1176,38,0,0,0,0,86,2,2,0.418605,0,0,10,7,false,true,true,0.651,0.349
51,59,-8,10.2,11.8,-8,904,857,47,0,0,0,0,66,5,5,0.621212,0,1,32,15,false,true,true,0.655,0.345
108,124,-16,15.428571,17.714286,-16,361,493,-132,0,0,0,0,48,7,7,0.854167,0,0,15,26,false,true,false,0.33,0.67
262,221,41,21.833333,18.416667,41,1036,1181,-145,0,0,0,0,22,12,12,1.545455,1,0,22,10,false,true,true,0.935,0.065
252,126,126,36,21,126,1684,1320,364,1,0,0.142857,0,39,7,6,0.769231,0,1,18,6,false,true,true,0.923,0.077
75,81,-6,18.75,27,-6,1096,1009,87,0,0,0,0,83,4,3,0.53012,1,0,18,12,false,true,true,0.839,0.161
173,139,34,28.833333,23.166667,34,1023,1070,-47,1,0,0.166667,0,54,6,6,0.592593,1,0,7,9,false,true,true,0.922,0.078
238,171,67,26.444444,19,67,758,796,-38,0,0,0,0,33,9,9,1.151515,0,0,12,23,false,true,true,0.975,0.025
326,291,35,23.285714,20.785714,35,1302,1082,220,0,0,0,0,-13,14,14,-2.307692,0,0,2,6,false,true,true,1,0
32,35,-3,10.666667,17.5,-3,1142,1176,-34,0,0,0,0,84,3,2,0.428571,0,0,16,18,false,true,false,0.448,0.552
191,137,54,15.916667,12.454545,54,584,565,19,0,0,0,0,27,12,11,1.703704,0,0,8,9,false,true,true,0.969,0.031
368,293,75,21.647059,17.235294,75,1305,1218,87,1,0,0.058824,0,-25,17,17,-1.52,0,0,2,2,false,true,true,1,0
50,47,3,16.666667,15.666667,3,1043,1055,-12,0,0,0,0,77,3,3,0.480519,0,0,20,12,false,true,true,0.68,0.32
227,128,99,22.7,14.222222,99,1606,1544,62,0,0,0,0,44,10,9,1.022727,0,0,10,7,false,true,true,0.917,0.083
64,70,-6,16,23.333333,-6,1102,1245,-143,0,0,0,0,67,4,3,0.41791,0,0,18,8,false,true,false,0.474,0.526
76,0,76,76,0,76,925,801,124,1,0,1,0,93,1,0,0.430108,1,0,15,0,false,true,true,0.98,0.02
138,183,-45,15.333333,20.333333,-45,262,306,-44,0,0,0,0,46,9,9,1,0,1,13,6,false,true,false,0.004,0.996
322,304,18,26.833333,27.636364,18,1297,1606,-309,1,1,0.083333,0.090909,11,12,11,2.727273,0,0,12,8,false,true,true,0.711,0.289
238,188,50,17,13.428571,50,620,513,107,0,0,0,0,14,14,14,3.214286,1,0,29,7,false,true,true,0.997,0.003
22,15,7,22,15,7,1670,1770,-100,0,0,0,0,92,1,1,0.347826,0,0,19,10,false,true,true,0.677,0.323
254,243,11,18.142857,18.692308,11,1388,1477,-89,1,0,0.071429,0,14,14,13,3.428571,1,0,10,12,false,true,false,0.319,0.681
209,156,53,23.222222,19.5,53,315,294,21,0,1,0,0.125,30,9,8,1.166667,0,0,11,27,false,true,true,0.967,0.033
295,99,196,19.666667,6.6,196,896,818,78,0,0,0,0,21,15,15,2.095238,1,1,9,6,false,true,true,1,0
24,0,24,24,0,24,498,43,455,0,0,0,0,95,1,0,0.389474,1,0,12,0,false,true,true,0.999,0.001
259,270,-11,16.1875,18,-11,1388,1477,-89,1,0,0.0625,0,5,16,15,9.6,1,0,12,16,false,true,false,0.189,0.811
86,91,-5,12.285714,13,-5,218,86,132,0,0,0,0,50,7,7,0.8,0,0,26,14,false,true,true,0.901,0.099
102,110,-8,17,18.333333,-8,272,238,34,0,0,0,0,54,6,6,0.740741,0,0,14,10,false,true,true,0.681,0.319
159,80,79,31.8,16,79,1735,1770,-35,1,0,0.2,0,54,5,5,0.518519,1,0,9,8,false,true,true,0.978,0.022
65,71,-6,16.25,17.75,-6,620,658,-38,0,0,0,0,71,4,4,0.507042,2,0,5,7,false,true,true,0.977,0.023
108,171,-63,13.5,21.375,-63,262,306,-44,0,0,0,0,55,8,8,0.836364,0,0,20,9,false,true,false,0.027,0.973
251,186,65,17.928571,14.307692,65,523,480,43,1,0,0.071429,0,1,14,13,33,0,1,16,12,false,true,true,0.812,0.188
438,249,189,19.909091,11.318182,189,1295,1477,-182,3,0,0.136364,0,-24,22,22,-1.916667,0,0,1,1,false,true,true,1,0
91,31,60,45.5,15.5,60,1510,1583,-73,1,0,0.5,0,79,2,2,0.405063,0,0,13,17,false,true,true,0.729,0.271
63,43,20,12.6,8.6,20,310,359,-49,0,0,0,0,69,5,5,0.710145,1,0,6,22,false,true,true,0.675,0.325
164,97,67,32.8,19.4,67,746,796,-50,0,1,0,0.2,53,5,5,0.90566,0,0,10,10,false,true,true,0.97,0.03
152,202,-50,16.888889,22.444444,-50,999,1011,-12,0,0,0,0,38,9,9,1.210526,0,0,15,10,false,true,false,0.139,0.861
301,256,45,23.153846,21.333333,45,1710,1636,74,1,1,0.076923,0.083333,15,13,12,2.4,1,0,9,14,false,true,true,0.998,0.002
295,209,86,18.4375,13.933333,86,620,513,107,0,0,0,0,5,16,15,9,0,0,21,7,false,true,true,0.999,0.001
253,191,62,23,19.1,62,1302,1082,220,0,0,0,0,15,11,10,2,0,0,10,9,false,true,true,0.668,0.332
96,90,6,19.2,18,6,349,315,34,0,0,0,0,59,5,5,0.576271,0,0,9,11,false,true,true,0.71,0.29
68,42,26,22.666667,14,26,859,786,73,0,0,0,0,79,3,3,0.481013,0,1,7,17,false,true,true,0.78,0.22
377,344,33,25.133333,24.571429,33,1659,1782,-123,1,0,0.066667,0,-14,15,14,-2.071429,0,0,1,4,true,true,true,1,0
370,179,191,37,19.888889,191,1550,1624,-74,2,0,0.2,0,29,10,9,1.034483,0,0,11,7,false,true,true,1,0
233,204,29,25.888889,25.5,29,1554,1622,-68,2,0,0.222222,0,33,9,8,0.939394,0,0,22,9,false,true,true,0.81,0.19
200,73,127,25,10.428571,127,942,1003,-61,0,0,0,0,45,8,7,1,0,0,22,16,false,true,true,0.97,0.03
117,112,5,13,12.444444,5,218,86,132,0,0,0,0,36,9,9,1.111111,1,0,25,16,false,true,true,0.937,0.063
360,282,78,18.947368,15.666667,78,939,913,26,0,1,0,0.055556,-19,19,18,-2.105263,1,0,0,4,false,true,true,1,0
394,268,126,30.307692,22.333333,126,1507,1554,-47,1,2,0.076923,0.166667,0,13,12,0,0,0,6,13,false,true,true,1,0
378,219,159,25.2,15.642857,159,954,1078,-124,1,1,0.066667,0.071429,-1,15,14,-38,0,0,8,10,false,true,true,1,0
39,57,-18,13,19,-18,758,750,8,0,0,0,0,74,3,3,0.5,1,0,6,11,false,true,true,0.676,0.324
283,143,140,25.727273,14.3,140,1691,1692,-1,0,0,0,0,27,11,10,1.111111,0,0,17,15,false,true,true,1,0
215,236,-21,16.538462,18.153846,-21,1043,1055,-12,0,0,0,0,15,13,13,2.466667,1,0,18,13,false,true,true,0.563,0.437
94,70,24,18.8,14,24,1181,1149,32,0,0,0,0,76,5,5,0.592105,0,0,10,7,false,true,true,0.774,0.226
302,238,64,23.230769,18.307692,64,1036,1181,-145,0,0,0,0,16,13,13,2.125,1,0,14,7,false,true,true,1,0
136,136,0,17,17,0,620,513,107,0,0,0,0,45,8,8,1,0,0,16,7,false,true,true,0.71,0.29
256,169,87,25.6,16.9,87,1550,1546,4,0,0,0,0,33,10,10,0.909091,1,0,25,10,false,true,true,0.997,0.003
215,176,39,23.888889,22,39,1266,1144,122,0,0,0,0,35,9,8,0.971429,1,0,15,12,false,true,true,0.974,0.026
210,103,107,26.25,12.875,107,1394,1118,276,0,0,0,0,43,8,8,0.860465,0,1,17,6,false,true,true,0.889,0.111
335,234,101,25.769231,19.5,101,1014,948,66,1,0,0.076923,0,12,13,12,2.75,0,0,11,11,false,true,true,1,0
354,315,39,29.5,28.636364,39,1148,1164,-16,1,2,0.083333,0.181818,-1,12,11,-25,0,0,3,2,false,true,true,0.991,0.009
123,127,-4,17.571429,18.142857,-4,1043,1055,-12,0,0,0,0,52,7,7,0.711538,0,0,23,7,false,true,true,0.678,0.322
184,139,45,18.4,15.444444,45,786,847,-61,0,0,0,0,41,10,9,0.829268,1,0,9,16,false,true,true,0.745,0.255
461,302,159,30.733333,21.571429,159,1571,1554,17,2,1,0.133333,0.071429,-16,15,14,-2.0625,1,0,0,4,false,true,true,1,0
228,173,55,19,15.727273,55,804,683,121,0,0,0,0,26,12,11,1.730769,0,1,18,9,false,true,true,0.974,0.026
239,174,65,21.727273,17.4,65,830,907,-77,1,0,0.090909,0,27,11,10,1.444444,0,0,18,23,false,true,true,0.846,0.154
380,317,63,22.352941,18.647059,63,1142,1095,47,1,0,0.058824,0,-21,17,17,-1.666667,0,0,3,5,false,true,true,1,0
236,170,66,16.857143,13.076923,66,913,871,42,0,0,0,0,17,14,13,2.529412,0,0,12,27,false,true,true,0.899,0.101
432,393,39,30.857143,28.071429,39,1633,1580,53,3,1,0.214286,0.071429,-13,14,14,-2.153846,0,0,2,3,true,true,true,1,0
310,225,85,28.181818,22.5,85,1156,1114,42,1,0,0.090909,0,13,11,10,2.461538,0,0,18,15,false,true,true,1,0
364,336,28,15.166667,14.608696,28,1388,1477,-89,1,0,0.041667,0,-38,24,23,-1.263158,0,0,1,1,false,true,true,1,0
349,285,64,17.45,14.25,64,1253,1166,87,1,0,0.05,0,-21,20,20,-2.047619,0,0,3,2,false,true,true,1,0
181,199,-18,25.857143,28.428571,-18,1428,1606,-178,1,0,0.142857,0,43,7,7,0.744186,1,0,18,10,false,true,false,0.281,0.719
87,111,-24,17.4,22.2,-24,1261,1349,-88,0,0,0,0,62,5,5,0.209677,1,0,10,19,false,true,false,0.324,0.676
351,220,131,19.5,12.222222,131,595,543,52,0,0,0,0,-12,18,18,-3.916667,0,0,10,7,false,true,true,1,0
301,259,42,14.333333,12.95,42,346,231,115,0,0,0,0,-40,21,20,-1.025,0,1,13,1,true,true,true,0.97,0.03
12,8,4,12,8,4,1011,921,90,0,0,0,0,95,1,1,0.515789,0,0,9,17,false,true,true,0.674,0.326
146,115,31,18.25,14.375,31,1030,1045,-15,0,0,0,0,53,8,8,0.867925,0,0,12,14,false,true,true,0.821,0.179
206,199,7,34.333333,33.166667,7,1265,1237,28,1,0,0.166667,0,41,6,6,0.731707,0,0,8,24,false,true,true,0.605,0.395
158,167,-9,31.6,33.4,-9,1885,1793,92,0,0,0,0,58,5,5,0.465517,0,0,10,7,false,true,false,0.291,0.709
309,250,59,23.769231,19.230769,59,1216,1228,-12,1,0,0.076923,0,15,13,13,2.2,0,0,13,10,false,true,true,1,0
231,186,45,21,18.6,45,1040,925,115,0,0,0,0,21,11,10,2.047619,0,0,13,10,false,true,true,0.836,0.164
136,61,75,22.666667,10.166667,75,896,818,78,0,0,0,0,68,6,6,0.647059,0,0,17,16,false,true,true,0.97,0.03
39,37,2,19.5,18.5,2,908,859,49,0,0,0,0,85,2,2,0.458824,0,0,11,18,false,true,true,0.676,0.324
260,225,35,20,18.75,35,1210,1253,-43,0,1,0,0.083333,11,13,12,3.181818,1,0,10,17,false,true,true,0.742,0.258
382,217,165,17.363636,9.863636,165,1176,1076,100,0,0,0,0,-1,22,22,-59,0,0,10,19,false,true,true,1,0
111,34,77,37,17,77,942,1003,-61,0,0,0,0,80,3,2,0.5625,0,0,9,7,false,true,true,0.846,0.154
73,40,33,24.333333,20,33,965,1013,-48,0,0,0,0,81,3,2,0.407407,1,0,6,15,false,true,true,0.664,0.336
133,101,32,22.166667,16.833333,32,1305,1390,-85,0,0,0,0,57,6,6,0.631579,0,0,10,20,false,true,true,0.707,0.293
446,380,66,21.238095,18.095238,66,1220,1261,-41,2,0,0.095238,0,-25,21,21,-1.8,0,0,1,1,false,true,true,1,0
249,262,-13,20.75,23.818182,-13,1076,1176,-100,0,1,0,0.090909,15,12,11,2.133333,0,0,18,15,false,true,false,0.18,0.82
136,64,72,22.666667,12.8,72,1439,1413,26,0,0,0,0,65,6,5,0.553846,0,0,25,7,false,true,true,0.848,0.152
196,150,46,16.333333,13.636364,46,947,909,38,0,0,0,0,23,12,11,2,0,0,9,32,false,true,true,0.784,0.216
190,152,38,17.272727,15.2,38,1029,1075,-46,0,0,0,0,37,11,10,1.297297,2,0,5,10,false,true,true,0.983,0.017
338,289,49,24.142857,20.642857,49,1434,1493,-59,1,0,0.071429,0,-3,14,14,-12.333333,0,1,11,3,false,true,true,1,0
283,188,95,21.769231,15.666667,95,1551,1550,1,0,0,0,0,13,13,12,3.230769,0,1,13,18,false,true,true,1,0
388,274,114,17.636364,13.047619,114,539,632,-93,0,0,0,0,-23,22,21,-2,0,0,1,5,false,true,true,1,0
284,265,19,18.933333,17.666667,19,1547,1439,108,1,0,0.066667,0,1,15,15,37,0,0,17,10,false,true,true,0.809,0.191
330,280,50,22,20,50,1406,1454,-48,0,2,0,0.142857,-6,15,14,-5.666667,0,0,4,11,false,true,true,0.993,0.007
112,55,57,14,7.857143,57,1016,1037,-21,0,0,0,0,57,8,7,0.842105,0,1,9,13,false,true,true,0.542,0.458
177,177,0,12.642857,13.615385,0,611,584,27,0,0,0,0,24,14,13,1.833333,0,0,11,18,false,true,false,0.184,0.816
75,76,-1,15,15.2,-1,566,542,24,0,0,0,0,66,5,5,0.621212,0,1,8,10,false,true,false,0.296,0.704
28,20,8,28,20,8,2219,2029,190,0,0,0,0,94,1,1,0.276596,1,0,10,7,false,true,true,0.926,0.074
95,64,31,15.833333,10.666667,31,859,719,140,0,1,0,0.166667,52,6,6,1.019231,0,2,19,8,false,true,true,0.968,0.032
119,86,33,14.875,12.285714,33,498,43,455,0,0,0,0,49,8,7,0.755102,1,0,11,17,false,true,true,0.986,0.014
339,328,11,24.214286,23.428571,11,1102,1245,-143,2,0,0.142857,0,-24,14,14,-1.166667,0,0,1,1,true,true,true,1,0
52,38,14,17.333333,12.666667,14,1670,1770,-100,1,0,0.333333,0,78,3,3,0.410256,0,0,28,9,false,true,true,0.659,0.341
328,278,50,21.866667,19.857143,50,820,822,-2,0,0,0,0,2,15,14,19.5,0,0,11,7,false,true,true,1,0
65,93,-28,32.5,46.5,-28,1030,1144,-114,0,1,0,0.5,82,2,2,0.426829,0,0,8,14,false,true,false,0.461,0.539
364,179,185,14.56,7.16,185,859,719,140,0,1,0,0.04,-36,25,25,-1.472222,0,1,11,9,false,true,true,1,0
302,285,17,15.1,14.25,17,826,771,55,0,0,0,0,-14,20,20,-3.214286,0,0,11,3,false,true,true,0.988,0.012
50,36,14,12.5,12,14,847,952,-105,0,0,0,0,81,4,3,0.444444,0,0,21,15,false,true,false,0.253,0.747
398,299,99,24.875,19.933333,99,1334,1256,78,2,0,0.125,0,-9,16,15,-3.444444,0,0,2,2,true,true,true,1,0
273,221,52,22.75,18.416667,52,1221,1266,-45,0,0,0,0,14,12,12,2.5,2,0,6,7,false,true,true,1,0
126,137,-11,21,22.833333,-11,315,294,21,0,1,0,0.166667,51,6,6,0.686275,0,0,14,28,false,true,true,0.613,0.387
401,184,217,30.846154,15.333333,217,918,619,299,2,0,0.153846,0,9,13,12,3.888889,1,0,19,15,false,true,true,1,0
278,178,100,18.533333,11.866667,100,871,867,4,0,0,0,0,8,15,15,5.375,0,1,17,16,false,true,true,1,0
195,229,-34,21.666667,25.444444,-34,1434,1493,-59,1,0,0.111111,0,28,9,9,1.321429,1,1,7,10,false,true,false,0.026,0.974
290,104,186,41.428571,14.857143,186,1513,1482,31,1,0,0.142857,0,42,7,7,0.785714,0,0,11,16,false,true,true,1,0
20,17,3,20,17,3,892,768,124,0,0,0,0,95,1,1,0.452632,0,0,19,16,false,true,true,0.68,0.32
363,303,60,25.928571,21.642857,60,1554,1573,-19,1,0,0.071429,0,5,14,14,6.8,1,1,15,10,false,true,true,1,0
400,336,64,30.769231,25.846154,64,1684,1320,364,1,0,0.076923,0,-6,13,13,-5,0,0,10,11,false,true,true,1,0
90,99,-9,15,16.5,-9,566,542,24,0,0,0,0,58,6,6,0.706897,0,0,7,11,false,true,true,0.627,0.373
127,89,38,18.142857,12.714286,38,272,288,-16,0,0,0,0,59,7,7,0.881356,1,0,13,20,false,true,true,0.802,0.198
88,82,6,14.666667,16.4,6,540,518,22,0,0,0,0,65,6,5,0.615385,0,1,10,13,false,true,false,0.227,0.773
247,214,33,16.466667,14.266667,33,371,435,-64,0,0,0,0,-1,15,15,-44,0,0,17,14,false,true,true,0.971,0.029
127,79,48,25.4,19.75,48,1803,1552,251,0,0,0,0,66,5,4,0.424242,0,1,10,7,false,true,true,0.748,0.252
262,191,71,23.818182,17.363636,71,1220,1261,-41,2,0,0.181818,0,33,11,11,1.363636,0,0,20,14,false,true,true,0.897,0.103
340,326,14,17.894737,17.157895,14,1127,1176,-49,0,0,0,0,-20,19,19,-2.1,0,0,2,1,false,true,true,1,0
135,153,-18,13.5,17,-18,699,448,251,0,0,0,0,42,10,9,0.952381,0,1,12,8,false,true,false,0.192,0.808
293,257,36,17.235294,15.117647,36,609,620,-11,0,0,0,0,-16,17,17,-2.3125,0,1,7,2,false,true,true,0.975,0.025
176,151,25,25.142857,21.571429,25,1170,1156,14,1,0,0.142857,0,51,7,7,0.745098,1,0,18,17,false,true,true,0.929,0.071
97,79,18,24.25,19.75,18,1216,1228,-12,0,0,0,0,70,4,4,0.471429,0,0,7,8,false,true,true,0.691,0.309
136,117,19,19.428571,16.714286,19,1090,1244,-154,0,0,0,0,49,7,7,0.755102,0,0,11,18,false,true,false,0.274,0.726
250,246,4,16.666667,17.571429,4,95,360,-265,0,1,0,0.071429,-3,15,14,-13.333333,1,0,10,9,false,true,true,0.668,0.332
321,296,25,21.4,19.733333,25,1244,1361,-117,2,1,0.133333,0.066667,8,15,15,4.75,0,0,11,18,false,true,true,0.999,0.001
205,156,49,17.083333,14.181818,49,1048,1000,48,0,0,0,0,34,12,11,1.176471,0,1,17,6,false,true,true,0.968,0.032
71,81,-10,11.833333,16.2,-10,218,86,132,0,0,0,0,59,6,5,0.677966,0,0,20,10,false,true,true,0.672,0.328
218,173,45,24.222222,19.222222,45,1295,1281,14,0,0,0,0,45,9,9,0.844444,0,1,7,16,false,true,true,0.534,0.466
176,198,-22,17.6,22,-22,1177,1214,-37,0,0,0,0,34,10,9,1.029412,1,0,17,15,false,true,false,0.186,0.814
370,332,38,24.666667,23.714286,38,907,752,155,0,1,0,0.071429,-1,15,14,-33,0,0,5,14,false,true,true,1,0
239,159,80,23.9,15.9,80,526,370,156,0,0,0,0,27,10,10,1.296296,1,0,6,9,false,true,true,0.975,0.025
454,294,160,26.705882,18.375,160,1270,1322,-52,1,0,0.058824,0,-14,17,16,-2.714286,0,0,3,5,false,true,true,1,0
328,257,71,20.5,16.0625,71,971,658,313,0,0,0,0,-11,16,16,-3.272727,1,0,6,4,false,true,true,1,0
373,311,62,21.941176,18.294118,62,1034,1040,-6,1,0,0.058824,0,-17,17,17,-2.058824,0,0,3,3,false,true,true,1,0
301,205,96,23.153846,15.769231,96,518,533,-15,1,0,0.076923,0,4,13,13,8.75,0,0,7,12,false,true,true,1,0
181,175,6,13.923077,13.461538,6,1030,1045,-15,0,0,0,0,26,13,13,1.769231,0,1,7,10,false,true,false,0.124,0.876
300,162,138,33.333333,20.25,138,1093,1197,-104,2,0,0.222222,0,35,9,8,0.885714,1,0,9,16,false,true,true,1,0
38,15,23,19,15,23,971,906,65,0,0,0,0,89,2,1,0.359551,0,1,11,12,false,true,true,0.685,0.315
244,181,63,24.4,18.1,63,976,965,11,1,0,0.1,0,22,10,10,1.454545,0,1,11,19,false,true,true,0.869,0.131
80,28,52,20,7,52,901,889,12,0,0,0,0,82,4,4,0.52439,1,1,8,9,false,true,true,0.636,0.364
95,108,-13,13.571429,18,-13,576,494,82,0,0,0,0,60,7,6,0.733333,0,0,7,16,false,true,false,0.156,0.844
22,15,7,22,15,7,349,315,34,0,0,0,0,92,1,1,0.369565,0,0,13,11,false,true,true,0.579,0.421
147,178,-31,14.7,17.8,-31,272,238,34,0,0,0,0,34,10,10,1.176471,0,0,14,11,false,true,false,0.086,0.914
103,49,54,25.75,16.333333,54,1014,948,66,0,0,0,0,72,4,3,0.458333,0,1,17,11,false,true,true,0.838,0.162
221,135,86,24.555556,16.875,86,526,370,156,0,0,0,0,37,9,8,0.945946,0,0,7,11,false,true,true,0.97,0.03
406,312,94,23.882353,18.352941,94,1550,1466,84,1,0,0.058824,0,-17,17,17,-2.176471,0,0,3,1,false,true,true,1,0
135,33,102,45,16.5,102,925,801,124,1,0,0.333333,0,82,3,2,0.487805,1,0,8,7,false,true,true,0.988,0.012
183,109,74,26.142857,18.166667,74,1439,1294,145,1,0,0.142857,0,53,7,6,0.679245,0,0,7,17,false,true,true,0.903,0.097
188,192,-4,15.666667,17.454545,-4,719,614,105,0,1,0,0.090909,22,12,11,1.954545,0,0,13,12,false,true,false,0.422,0.578
14,3,11,14,3,11,947,909,38,0,0,0,0,93,1,1,0.494624,1,0,10,25,false,true,true,0.669,0.331
18,0,18,18,0,18,1065,1030,35,0,0,0,0,96,1,0,0.354167,0,0,19,0,false,true,true,0.681,0.319
185,190,-5,16.818182,17.272727,-5,95,378,-283,0,0,0,0,20,11,11,1.75,0,0,10,9,false,true,true,0.677,0.323
132,102,30,18.857143,14.571429,30,698,742,-44,0,0,0,0,63,7,7,0.650794,0,0,7,13,false,true,true,0.668,0.332
262,126,136,21.833333,11.454545,136,786,757,29,1,0,0.083333,0,25,12,11,1.56,0,0,12,15,false,true,true,1,0
42,88,-46,10.5,22,-46,1161,1166,-5,0,0,0,0,73,4,4,0.479452,0,1,7,15,false,true,false,0.045,0.955
294,271,23,21,19.357143,23,1244,1361,-117,2,1,0.142857,0.071429,14,14,14,2.714286,0,0,16,14,false,true,true,0.84,0.16
347,283,64,21.6875,17.6875,64,941,926,15,1,0,0.0625,0,-5,16,16,-7.6,0,0,10,8,false,true,true,1,0
356,295,61,27.384615,22.692308,61,1075,1027,48,2,1,0.153846,0.076923,2,13,13,18.5,0,0,26,9,false,true,true,1,0
234,195,39,29.25,24.375,39,1397,1195,202,1,0,0.125,0,40,8,8,0.875,0,0,20,10,false,true,true,0.931,0.069
33,48,-15,11,24,-15,831,830,1,0,0,0,0,83,3,2,0.445783,0,0,11,10,false,true,true,0.611,0.389
142,80,62,28.4,20,62,1270,1315,-45,0,0,0,0,65,5,4,0.553846,0,1,10,8,false,true,true,0.838,0.162
6,0,6,6,0,6,1014,1303,-289,0,0,0,0,97,1,0,0.391753,1,0,8,0,false,true,false,0.251,0.749
57,22,35,19,11,35,939,913,26,0,0,0,0,85,3,2,0.470588,0,0,12,7,false,true,true,0.727,0.273
61,64,-3,15.25,21.333333,-3,778,758,20,0,0,0,0,70,4,3,0.557143,0,0,9,7,false,true,true,0.677,0.323
0,0,0,0,0,0,1554,1573,-19,0,0,0,0,100,1,0,0.34,0,0,7,0,false,true,true,0.67,0.33
231,237,-6,21,21.545455,-6,809,868,-59,1,0,0.090909,0,22,11,11,1.454545,0,0,9,8,false,true,true,0.618,0.382
343,249,94,24.5,19.153846,94,1510,1583,-73,1,0,0.071429,0,0,14,13,0,0,0,10,13,false,true,true,1,0
356,265,91,18.736842,13.947368,91,925,801,124,1,0,0.052632,0,-18,19,19,-2.222222,0,0,2,4,false,true,true,1,0
262,256,6,18.714286,18.285714,6,947,810,137,0,1,0,0.071429,8,14,14,5.25,1,0,10,13,false,true,true,0.72,0.28
357,310,47,17,14.761905,47,725,771,-46,0,1,0,0.047619,-27,21,21,-1.703704,0,0,3,4,false,true,true,1,0
79,46,33,26.333333,23,33,554,342,212,0,0,0,0,81,3,2,0.444444,0,0,14,10,false,true,true,0.755,0.245
564,193,371,33.176471,11.352941,371,1431,825,606,2,1,0.117647,0.058824,-7,17,17,-4.857143,0,0,2,16,true,true,true,1,0
212,194,18,21.2,19.4,18,1452,1469,-17,0,1,0,0.1,31,10,10,1.225806,1,0,6,22,false,true,true,0.614,0.386
185,149,36,18.5,14.9,36,527,581,-54,0,0,0,0,31,10,10,1.354839,1,0,19,16,false,true,true,0.911,0.089
397,291,106,26.466667,19.4,106,1051,1030,21,0,0,0,0,-9,15,15,-3.333333,0,0,4,4,true,true,true,1,0
309,305,4,19.3125,19.0625,4,613,611,2,0,0,0,0,-16,16,16,-2.375,0,0,10,3,false,true,true,0.786,0.214
258,184,74,18.428571,14.153846,74,566,542,24,0,0,0,0,14,14,13,2.928571,0,1,16,6,false,true,true,0.983,0.017
30,8,22,15,8,22,1027,856,171,0,0,0,0,88,2,1,0.375,0,0,7,7,false,true,true,0.686,0.314
79,96,-17,15.8,24,-17,1659,1782,-123,0,0,0,0,67,5,4,0.432836,0,0,7,7,false,true,false,0.438,0.562
137,81,56,17.125,11.571429,56,801,807,-6,0,0,0,0,48,8,7,0.729167,0,0,9,16,false,true,true,0.925,0.075
98,111,-13,19.6,22.2,-13,1826,1656,170,0,0,0,0,61,5,5,0.442623,0,0,10,17,false,true,false,0.387,0.613
292,150,142,32.444444,18.75,142,971,621,350,2,0,0.222222,0,32,9,8,1,0,0,22,13,false,true,true,1,0
136,108,28,22.666667,21.6,28,1297,1606,-309,0,0,0,0,62,6,5,0.483871,2,0,5,22,false,true,true,0.918,0.082
122,119,3,17.428571,17,3,691,675,16,0,0,0,0,49,7,7,0.77551,0,0,16,11,false,true,true,0.699,0.301
225,136,89,16.071429,9.714286,89,1428,1302,126,0,0,0,0,16,14,14,3.3125,0,1,15,19,false,true,true,0.923,0.077
52,50,2,17.333333,25,2,1142,1095,47,0,0,0,0,82,3,2,0.426829,1,0,6,15,false,true,true,0.663,0.337
246,230,16,35.142857,32.857143,16,1770,1689,81,0,1,0,0.142857,32,7,7,0.8125,0,0,10,27,false,true,false,0.304,0.696
162,106,56,23.142857,15.142857,56,576,532,44,0,0,0,0,52,7,7,0.884615,1,0,10,16,false,true,true,0.969,0.031
208,164,44,23.111111,18.222222,44,939,907,32,0,0,0,0,43,9,9,0.930233,1,0,13,8,false,true,true,0.964,0.036
46,87,-41,9.2,17.4,-41,1221,1258,-37,0,0,0,0,72,5,5,0.541667,0,0,8,10,false,true,false,0.068,0.932
384,341,43,27.428571,24.357143,43,1408,1454,-46,1,0,0.071429,0,0,14,14,0,0,0,8,5,false,true,true,1,0
93,86,7,11.625,12.285714,7,658,817,-159,0,0,0,0,59,8,7,0.644068,0,0,32,12,false,true,false,0.286,0.714
213,139,74,23.666667,17.375,74,960,1070,-110,1,0,0.111111,0,40,9,8,0.875,0,0,14,16,false,true,true,0.843,0.157
251,164,87,20.916667,14.909091,87,561,526,35,0,0,0,0,10,12,11,3.5,0,0,10,14,false,true,true,0.98,0.02
41,60,-19,13.666667,30,-19,902,866,36,0,0,0,0,77,3,2,0.415584,0,1,16,8,false,true,true,0.551,0.449
93,60,33,23.25,20,33,1388,1477,-89,1,0,0.25,0,74,4,3,0.648649,0,0,13,9,false,true,true,0.558,0.442
91,70,21,18.2,17.5,21,786,757,29,0,0,0,0,70,5,4,0.557143,2,0,8,12,false,true,true,0.987,0.013
60,57,3,15,19,3,1452,1469,-17,0,0,0,0,75,4,3,0.506667,0,0,16,10,false,true,true,0.66,0.34
351,330,21,50.142857,47.142857,21,1370,1431,-61,2,1,0.285714,0.142857,33,7,7,0.69697,0,0,12,18,false,true,true,1,0
43,96,-53,10.75,24,-53,416,306,110,0,0,0,0,76,4,4,0.552632,0,1,25,8,false,true,false,0.011,0.989
170,152,18,17,16.888889,18,704,691,13,0,0,0,0,38,10,9,1,1,0,9,10,false,true,true,0.916,0.084
379,323,56,22.294118,19,56,1530,1550,-20,1,1,0.058824,0.058824,-18,17,17,-1.888889,0,0,2,3,true,true,true,1,0
236,145,91,19.666667,12.083333,91,421,306,115,0,1,0,0.083333,13,12,12,3.384615,0,0,33,11,false,true,true,1,0
145,188,-43,18.125,26.857143,-43,594,605,-11,0,0,0,0,51,8,7,0.72549,1,0,6,9,false,true,false,0.003,0.997
400,268,132,16.666667,11.652174,132,1011,921,90,1,0,0.041667,0,-23,24,23,-2.130435,0,0,1,11,false,true,true,1,0
316,295,21,21.066667,19.666667,21,1513,1479,34,0,0,0,0,-4,15,15,-8.5,1,1,12,5,false,true,true,0.959,0.041
108,103,5,21.6,20.6,5,1110,1039,71,0,0,0,0,64,5,5,0.5625,0,0,17,8,false,true,true,0.681,0.319
71,88,-17,14.2,22,-17,1583,1422,161,0,0,0,0,72,5,4,0.708333,0,0,21,11,false,true,false,0.206,0.794
312,151,161,28.363636,15.1,161,1482,1554,-72,1,0,0.090909,0,27,11,10,1.333333,0,0,7,8,false,true,true,1,0
104,129,-25,11.555556,16.125,-25,826,771,55,0,0,0,0,55,9,8,0.818182,0,0,11,11,false,true,false,0.065,0.935
352,291,61,16.761905,13.857143,61,1253,1166,87,1,0,0.047619,0,-27,21,21,-1.592593,0,0,1,2,false,true,true,1,0
146,177,-31,20.857143,29.5,-31,1305,1218,87,0,0,0,0,46,7,6,0.826087,1,0,10,15,false,true,true,0.525,0.475
249,197,52,20.75,17.909091,52,1548,1493,55,1,0,0.083333,0,22,12,11,1.863636,0,0,7,18,false,true,true,0.834,0.166
357,205,152,17.85,10.789474,152,896,818,78,0,1,0,0.052632,-10,20,19,-4.4,1,0,11,7,false,true,true,1,0
241,205,36,18.538462,15.769231,36,786,788,-2,0,0,0,0,4,13,13,8.5,1,0,9,11,false,true,true,0.969,0.031
377,310,67,19.842105,16.315789,67,1551,1550,1,0,0,0,0,-29,19,19,-1.448276,0,1,3,2,false,true,true,1,0
239,227,12,26.555556,28.375,12,1554,1716,-162,1,1,0.111111,0.125,33,9,8,1.060606,0,0,12,8,false,true,true,0.663,0.337
210,169,41,15,13,41,584,565,19,0,0,0,0,14,14,13,3.285714,0,0,14,14,false,true,true,0.927,0.073
193,238,-45,16.083333,21.636364,-45,1177,1214,-37,0,0,0,0,22,12,11,1.590909,1,0,15,9,false,true,false,0.152,0.848
109,116,-7,15.571429,16.571429,-7,491,398,93,0,0,0,0,57,7,7,0.631579,0,1,8,6,false,true,false,0.498,0.502
12,84,-72,12,84,-72,1782,1512,270,0,1,0,1,89,1,1,0.47191,1,0,8,16,false,true,true,0.899,0.101
129,59,70,25.8,11.8,70,415,518,-103,0,0,0,0,66,5,5,0.575758,0,0,7,28,false,true,true,0.838,0.162
120,62,58,30,20.666667,58,1556,1591,-35,0,0,0,0,77,4,3,0.467532,0,0,19,13,false,true,true,0.786,0.214
20,0,20,20,0,20,1069,917,152,0,0,0,0,95,1,0,0.357895,0,0,12,0,false,true,true,0.684,0.316
238,214,24,19.833333,17.833333,24,1040,925,115,0,0,0,0,12,12,12,3.583333,0,0,13,10,false,true,true,0.629,0.371
265,153,112,22.083333,13.909091,112,1045,1009,36,1,0,0.083333,0,28,12,11,1.357143,1,0,8,19,false,true,true,1,0
94,105,-11,18.8,26.25,-11,334,446,-112,0,0,0,0,68,5,4,0.588235,0,0,10,10,false,true,false,0.175,0.825
310,239,71,18.235294,14.058824,71,620,513,107,0,0,0,0,-3,17,17,-15,0,0,16,6,false,true,true,1,0
93,28,65,46.5,28,65,996,1063,-67,1,1,0.5,1,81,2,1,0.395062,0,0,13,13,false,true,true,0.925,0.075
345,272,73,19.166667,16,73,691,675,16,0,0,0,0,-15,18,17,-2.466667,0,0,1,1,false,true,true,1,0
316,317,-1,14.363636,15.095238,-1,999,1011,-12,0,0,0,0,-31,22,21,-1.483871,1,0,1,5,false,true,true,1,0
84,95,-11,16.8,19,-11,1452,1469,-17,0,1,0,0.2,59,5,5,0.644068,0,0,16,16,false,true,false,0.235,0.765
68,104,-36,13.6,20.8,-36,691,675,16,0,0,0,0,62,5,5,0.612903,0,0,20,7,false,true,true,0.654,0.346
129,118,11,21.5,19.666667,11,1034,1040,-6,0,0,0,0,57,6,6,0.614035,0,1,18,9,false,true,true,0.697,0.303
274,144,130,39.142857,20.571429,130,1093,1197,-104,2,0,0.285714,0,46,7,7,0.673913,0,0,10,18,false,true,true,1,0
290,239,51,20.714286,18.384615,51,786,847,-61,0,0,0,0,8,14,13,4.25,0,0,10,14,false,true,true,0.936,0.064
236,238,-2,18.153846,18.307692,-2,892,788,104,2,0,0.153846,0,16,13,13,2.6875,0,0,12,22,false,true,false,0.412,0.588
336,211,125,16,10.047619,125,1069,1040,29,0,0,0,0,-31,21,21,-1.419355,0,0,1,1,false,true,true,1,0
374,223,151,20.777778,12.388889,151,942,1003,-61,0,0,0,0,-14,18,18,-3.214286,1,1,11,13,false,true,true,1,0
303,279,24,17.823529,16.411765,24,349,315,34,0,0,0,0,-26,17,17,-1.307692,0,0,1,4,true,true,true,1,0
77,24,53,38.5,24,53,1302,1349,-47,0,0,0,0,83,2,1,0.337349,0,0,15,7,false,true,true,0.752,0.248
103,57,46,25.75,19,46,1295,1281,14,0,0,0,0,75,4,3,0.506667,0,0,23,12,false,true,true,0.753,0.247
298,270,28,17.529412,15.882353,28,334,446,-112,0,0,0,0,-18,17,17,-2.222222,1,1,6,11,false,true,true,0.921,0.079
320,298,22,22.857143,22.923077,22,1355,1210,145,1,0,0.071429,0,8,14,13,3.75,1,0,6,8,false,true,true,0.999,0.001
112,24,88,112,24,88,1397,1361,36,1,0,1,0,89,1,1,0.325843,0,0,9,10,false,true,true,0.975,0.025
118,93,25,23.6,23.25,25,1302,1234,68,0,0,0,0,68,5,4,0.455882,1,0,13,8,false,true,true,0.92,0.08
236,223,13,16.857143,17.153846,13,808,812,-4,0,0,0,0,11,14,13,3.363636,1,0,12,10,false,true,true,0.668,0.332
194,165,29,17.636364,15,29,613,502,111,0,0,0,0,26,11,11,1.884615,0,0,7,27,false,true,true,0.792,0.208
12,0,12,12,0,12,480,518,-38,0,0,0,0,96,1,0,0.479167,0,0,10,0,false,true,false,0.253,0.747
120,98,22,20,19.6,22,1388,1506,-118,1,1,0.166667,0.2,63,6,5,0.539683,1,0,8,20,false,true,true,0.849,0.151
158,135,23,22.571429,22.5,23,844,821,23,0,0,0,0,63,7,6,0.666667,0,0,17,7,false,true,true,0.678,0.322
148,108,40,21.142857,18,40,916,837,79,0,0,0,0,60,7,6,0.666667,0,0,12,10,false,true,true,0.813,0.187
94,76,18,15.666667,12.666667,18,1181,1149,32,0,0,0,0,72,6,6,0.625,0,0,11,9,false,true,true,0.749,0.251
243,242,1,15.1875,16.133333,1,540,518,22,0,0,0,0,-2,16,15,-20,0,0,9,14,false,true,false,0.288,0.712
159,139,20,19.875,19.857143,20,1452,1469,-17,0,1,0,0.142857,44,8,7,0.863636,1,1,15,12,false,true,true,0.709,0.291
391,281,110,23,17.5625,110,695,671,24,0,0,0,0,-11,17,16,-3,0,1,4,4,true,true,true,1,0
406,273,133,29,21,133,1519,1782,-263,2,0,0.142857,0,4,14,13,8.25,0,0,10,12,false,true,true,1,0
339,254,85,19.941176,15.875,85,1170,1156,14,1,0,0.058824,0,-15,17,16,-2.533333,0,0,4,5,false,true,true,1,0
332,189,143,36.888889,23.625,143,1880,1777,103,1,0,0.111111,0,30,9,8,0.933333,0,1,17,10,false,true,true,1,0
265,243,22,22.083333,20.25,22,1493,1513,-20,1,0,0.083333,0,19,12,12,1.736842,0,2,11,8,false,true,false,0.369,0.631
58,106,-48,19.333333,35.333333,-48,719,785,-66,0,1,0,0.333333,76,3,3,0.473684,0,0,9,9,false,true,false,0.281,0.719
32,0,32,32,0,32,1793,1897,-104,0,0,0,0,96,1,0,0.3125,1,0,6,0,false,true,true,0.927,0.073
114,115,-1,22.8,23,-1,315,294,21,0,1,0,0.2,65,5,5,0.538462,0,0,9,26,false,true,true,0.598,0.402
56,51,5,14,17,5,971,761,210,0,0,0,0,74,4,3,0.405405,0,1,14,6,false,true,true,0.558,0.442
147,89,58,16.333333,11.125,58,272,288,-16,0,0,0,0,55,9,8,0.945455,0,0,18,19,false,true,true,0.838,0.162
427,259,168,35.583333,23.545455,168,1571,1554,17,2,1,0.166667,0.090909,5,12,11,6.6,1,0,15,12,false,true,true,1,0
273,309,-36,24.818182,28.090909,-36,1125,1227,-102,1,1,0.090909,0.090909,11,11,11,2.727273,1,0,8,9,false,true,true,0.731,0.269
256,238,18,16,14.875,18,272,238,34,0,1,0,0.0625,-14,16,16,-2.857143,0,1,25,9,false,true,true,0.958,0.042
246,256,-10,17.571429,18.285714,-10,1077,1094,-17,0,0,0,0,13,14,14,3.230769,0,1,13,6,false,true,false,0.337,0.663
149,75,74,24.833333,12.5,74,1159,1031,128,1,0,0.166667,0,51,6,6,0.764706,0,0,19,14,false,true,true,0.968,0.032
130,90,40,18.571429,12.857143,40,1069,1040,29,0,0,0,0,49,7,7,0.897959,0,2,10,6,false,true,true,0.966,0.034
264,228,36,26.4,22.8,36,1302,1234,68,1,1,0.1,0.1,27,10,10,1.148148,0,0,9,11,false,true,true,0.966,0.034
218,202,16,14.533333,13.466667,16,1029,1075,-46,0,0,0,0,17,15,15,2.823529,2,0,8,14,false,true,true,0.584,0.416
216,164,52,21.6,18.222222,52,844,821,23,0,0,0,0,48,10,9,0.875,1,0,18,9,false,true,true,0.957,0.043
95,73,22,19,18.25,22,1127,1134,-7,0,0,0,0,65,5,4,0.461538,1,0,13,16,false,true,true,0.687,0.313
307,291,16,20.466667,20.785714,16,771,754,17,0,0,0,0,-6,15,14,-5.333333,0,0,6,9,false,true,true,0.701,0.299
220,169,51,20,15.363636,51,609,620,-11,0,0,0,0,26,11,11,1.423077,0,0,8,16,false,true,true,0.962,0.038
59,28,31,19.666667,14,31,1394,1118,276,0,0,0,0,78,3,2,0.474359,0,0,11,12,false,true,true,0.75,0.25
285,259,26,25.909091,23.545455,26,1320,1339,-19,2,1,0.181818,0.090909,20,11,11,1.95,0,0,21,13,false,true,true,0.97,0.03
332,288,44,16.6,15.157895,44,719,614,105,0,1,0,0.052632,-26,20,19,-1.653846,0,0,3,7,false,true,true,1,0
206,174,32,25.75,21.75,32,1210,1252,-42,1,0,0.125,0,42,8,8,0.761905,0,0,11,18,false,true,true,0.921,0.079
337,243,94,33.7,24.3,94,1507,1554,-47,1,2,0.1,0.2,14,10,10,2.071429,0,0,11,12,false,true,true,1,0
197,160,37,19.7,17.777778,37,505,95,410,0,1,0,0.111111,46,10,9,0.956522,0,1,18,10,false,true,true,1,0
312,227,85,16.421053,11.947368,85,691,675,16,0,0,0,0,-19,19,19,-2,0,0,1,11,true,true,true,1,0
146,80,66,29.2,16,66,1439,1353,86,1,0,0.2,0,60,5,5,0.5,0,0,18,8,false,true,true,0.857,0.143
18,20,-2,18,20,-2,1334,1270,64,0,0,0,0,93,1,1,0.397849,0,0,8,12,false,true,true,0.672,0.328
151,21,130,21.571429,3.5,130,1033,1037,-4,0,0,0,0,62,7,6,0.725806,0,0,11,8,false,true,true,0.97,0.03
135,95,40,16.875,11.875,40,1128,889,239,0,1,0,0.125,49,8,8,0.959184,0,0,25,11,false,true,true,1,0
49,16,33,24.5,16,33,971,1180,-209,0,0,0,0,89,2,1,0.359551,1,0,11,14,false,true,false,0.254,0.746
146,154,-8,18.25,19.25,-8,361,493,-132,0,0,0,0,39,8,8,1.051282,0,0,15,23,false,true,true,0.568,0.432
321,249,72,22.928571,19.153846,72,820,822,-2,0,0,0,0,8,14,13,4.875,0,0,16,10,false,true,true,1,0
130,113,17,16.25,16.142857,17,566,542,24,0,0,0,0,48,8,7,0.854167,0,0,28,11,false,true,true,0.82,0.18
159,47,112,31.8,11.75,112,371,336,35,2,0,0.4,0,54,5,4,0.703704,0,0,19,12,false,true,true,0.97,0.03
226,199,27,17.384615,16.583333,27,704,691,13,0,0,0,0,19,13,12,2,1,0,6,7,false,true,true,0.918,0.082
164,219,-55,18.222222,24.333333,-55,1181,1149,32,0,1,0,0.111111,45,9,9,1,0,0,19,19,false,true,false,0.187,0.813
307,267,40,16.157895,14.833333,40,609,620,-11,0,0,0,0,-21,19,18,-1.761905,0,1,2,2,true,true,true,0.987,0.013
63,71,-8,12.6,14.2,-8,299,315,-16,0,0,0,0,69,5,5,0.608696,0,0,7,21,false,true,false,0.264,0.736
265,179,86,15.588235,10.529412,86,1428,1302,126,0,0,0,0,-4,17,17,-13.25,0,1,11,17,false,true,true,1,0
129,101,28,25.8,20.2,28,1397,1195,202,0,0,0,0,61,5,5,0.57377,0,0,7,17,false,true,false,0.402,0.598
153,103,50,19.125,14.714286,50,620,658,-38,0,0,0,0,48,8,7,0.75,0,0,37,10,false,true,true,0.968,0.032
12,6,6,12,6,6,1408,1454,-46,0,0,0,0,92,1,1,0.347826,0,0,16,9,false,true,true,0.677,0.323
305,256,49,21.785714,18.285714,49,825,907,-82,1,0,0.071429,0,10,14,14,4,0,0,20,18,false,true,true,1,0
340,326,14,16.190476,16.3,14,1127,1176,-49,0,0,0,0,-20,21,20,-2.1,0,0,2,1,false,true,true,1,0
187,115,72,23.375,14.375,72,1004,653,351,0,0,0,0,37,8,8,0.945946,0,0,8,25,false,true,true,0.856,0.144
262,178,84,32.75,25.428571,84,1762,1616,146,2,0,0.25,0,35,8,7,0.857143,0,0,9,15,false,true,true,1,0
20,32,-12,10,16,-12,628,658,-30,0,0,0,0,85,2,2,0.541176,0,0,32,12,false,true,false,0.42,0.58
138,103,35,27.6,20.6,35,1295,1281,14,0,0,0,0,66,5,5,0.575758,0,0,16,7,false,true,true,0.794,0.206
465,176,289,29.0625,11.733333,289,1054,917,137,2,0,0.125,0,-18,16,15,-1.944444,0,0,24,8,false,true,true,1,0
63,9,54,31.5,9,54,1826,1803,23,0,0,0,0,89,2,1,0.337079,0,0,9,10,false,true,true,0.737,0.263
266,214,52,26.6,23.777778,52,1093,1100,-7,2,2,0.2,0.222222,36,10,9,0.888889,0,0,11,12,false,true,true,0.999,0.001
433,294,139,27.0625,18.375,139,1270,1322,-52,1,0,0.0625,0,-10,16,16,-3.8,0,0,4,5,false,true,true,1,0
140,89,51,20,14.833333,51,1181,1069,112,0,0,0,0,55,7,6,0.672727,0,0,24,12,false,true,true,0.841,0.159
281,206,75,23.416667,18.727273,75,1216,1217,-1,1,0,0.083333,0,19,12,11,1.789474,0,0,12,11,false,true,true,0.996,0.004
345,323,22,31.363636,29.363636,22,1302,1349,-47,0,1,0,0.090909,9,11,11,3.111111,0,1,12,14,false,true,true,0.765,0.235
318,229,89,21.2,15.266667,89,691,675,16,0,0,0,0,2,15,15,18.5,0,1,11,9,false,true,true,1,0
229,148,81,25.444444,18.5,81,1051,1030,21,0,0,0,0,35,9,8,0.857143,0,0,9,10,false,true,true,0.966,0.034
100,77,23,20,15.4,23,1305,1390,-85,0,0,0,0,66,5,5,0.545455,0,0,19,20,false,true,true,0.627,0.373
86,25,61,43,12.5,61,371,336,35,1,0,0.5,0,80,2,2,0.475,1,0,10,10,false,true,true,0.936,0.064
170,139,31,21.25,17.375,31,921,1072,-151,1,0,0.125,0,46,8,8,0.826087,0,0,9,12,false,true,true,0.791,0.209
25,39,-14,12.5,19.5,-14,1885,1846,39,0,1,0,0.5,79,2,2,0.367089,1,0,9,12,false,true,false,0.348,0.652
271,224,47,18.066667,16,47,804,683,121,0,0,0,0,11,15,14,4.090909,0,1,15,9,false,true,true,0.901,0.099
284,207,77,31.555556,23,77,1203,1221,-18,2,0,0.222222,0,40,9,9,0.875,0,0,10,11,false,true,true,1,0
383,305,78,31.916667,25.416667,78,1684,1320,364,1,0,0.083333,0,-2,12,12,-15,0,0,12,13,false,true,true,1,0
329,314,15,29.909091,28.545455,15,1265,1237,28,1,0,0.090909,0,10,11,11,3,0,1,7,18,false,true,true,0.971,0.029
327,264,63,23.357143,18.857143,63,613,569,44,0,0,0,0,3,14,14,13,1,0,9,10,false,true,true,1,0
300,279,21,20,18.6,21,1161,1166,-5,1,0,0.066667,0,-8,15,15,-4.375,0,1,6,13,false,true,true,0.929,0.071
347,261,86,26.692308,20.076923,86,880,952,-72,0,0,0,0,9,13,13,3.888889,0,0,7,8,false,true,true,1,0
390,263,127,30,20.230769,127,1216,1230,-14,1,0,0.076923,0,9,13,13,3.555556,0,0,8,20,false,true,true,1,0
130,71,59,18.571429,11.833333,59,1069,1040,29,0,0,0,0,53,7,6,0.830189,0,2,10,8,false,true,true,0.971,0.029
148,103,45,24.666667,17.166667,45,1295,1281,14,0,0,0,0,64,6,6,0.59375,0,0,16,13,false,true,true,0.84,0.16
171,124,47,21.375,17.714286,47,505,95,410,0,1,0,0.142857,59,8,7,0.745763,0,0,7,8,false,true,true,1,0
335,270,65,22.333333,19.285714,65,960,1070,-110,1,0,0.066667,0,2,15,14,17.5,0,1,9,12,false,true,true,1,0
302,278,24,20.133333,18.533333,24,721,689,32,0,0,0,0,-20,15,15,-1.7,0,0,9,2,false,true,true,0.971,0.029
348,313,35,20.470588,18.411765,35,315,294,21,0,1,0,0.058824,-26,17,17,-1.346154,0,0,1,1,false,true,true,1,0
198,227,-29,16.5,20.636364,-29,95,360,-265,0,1,0,0.090909,15,12,11,2.666667,2,0,6,7,false,true,false,0.197,0.803
109,37,72,27.25,9.25,72,1144,1014,130,0,0,0,0,71,4,4,0.507042,1,0,16,14,false,true,true,0.99,0.01
405,280,125,21.315789,14.736842,125,1394,1230,164,0,1,0,0.052632,-27,19,19,-1.407407,0,1,7,11,true,true,true,1,0
232,211,21,17.846154,17.583333,21,95,378,-283,0,0,0,0,7,13,12,5,0,0,16,17,false,true,true,0.736,0.264
332,329,3,20.75,21.933333,3,1439,1413,26,0,1,0,0.066667,-4,16,15,-9,1,0,7,13,false,true,true,0.794,0.206
79,86,-7,19.75,28.666667,-7,902,866,36,0,0,0,0,69,4,3,0.463768,0,0,11,12,false,true,true,0.636,0.364
10,12,-2,10,12,-2,1159,1051,108,0,0,0,0,92,1,1,0.434783,0,0,18,11,false,true,true,0.676,0.324
312,207,105,18.352941,12.9375,105,1253,1166,87,1,0,0.058824,0,2,17,16,21.5,0,0,8,17,false,true,true,1,0
58,86,-28,19.333333,43,-28,1885,1793,92,0,0,0,0,82,3,2,0.329268,0,0,12,12,false,true,false,0.203,0.797
251,165,86,22.818182,16.5,86,580,620,-40,1,0,0.090909,0,33,11,10,1.30303,0,0,12,7,false,true,true,0.853,0.147
368,351,17,21.647059,21.9375,17,1554,1716,-162,1,1,0.058824,0.0625,-18,17,16,-1.944444,0,0,2,2,false,true,true,1,0
403,316,87,23.705882,18.588235,87,1050,1144,-94,0,1,0,0.058824,-19,17,17,-2,0,0,2,3,false,true,true,1,0
245,247,-2,20.416667,20.583333,-2,1782,1512,270,1,1,0.083333,0.083333,21,12,12,2,0,0,11,12,false,true,true,0.999,0.001
